TILEID,PROGRAM,SURVEY,LASTNIGHT,PETALID,H,N_GAL,N_STAR,N_QSO,N_GOOD_Z
1774,dark,main,20210528,0,0.9909188239917216,291,15,76,382
1774,dark,main,20210528,1,0.9941854142045127,255,14,85,354
1774,dark,main,20210528,2,0.9899360065284695,271,15,91,377
1774,dark,main,20210528,3,0.9910373831790092,248,12,74,334
1774,dark,main,20210528,4,0.992027916091249,261,12,82,355
1774,dark,main,20210528,5,0.9949910171529852,278,14,80,372
1774,dark,main,20210528,6,0.9919142645856504,243,12,69,324
1774,dark,main,20210528,7,0.9904681265629751,234,13,74,321
1774,dark,main,20210528,8,0.9927158033851221,259,14,96,369
1774,dark,main,20210528,9,0.992590793013977,285,18,82,385
20093,bright,main,20210608,0,0.9841851853403946,347,88,3,438
20093,bright,main,20210608,1,0.9908459460685868,315,81,3,399
20093,bright,main,20210608,2,0.9954475406636105,351,81,1,433
20093,bright,main,20210608,3,0.9926578562003652,297,101,2,400
20093,bright,main,20210608,4,0.9932955687811034,260,140,3,403
20093,bright,main,20210608,5,0.9915301968402094,322,84,2,408
20093,bright,main,20210608,6,0.9918243022366671,276,89,3,368
20093,bright,main,20210608,7,0.988622035389513,299,59,3,361
20093,bright,main,20210608,8,0.993123419407733,336,82,5,423
20093,bright,main,20210608,9,0.9915705305225507,315,101,4,420
20096,bright,main,20210608,0,0.9920262915909133,325,110,2,437
20096,bright,main,20210608,1,0.9948485518309969,335,64,1,400
20096,bright,main,20210608,2,0.9938969808597948,372,62,0,434
20096,bright,main,20210608,3,0.9893168456052543,353,44,2,399
20096,bright,main,20210608,4,0.9955354536794199,321,88,1,410
20096,bright,main,20210608,5,0.997332940906042,334,80,1,415
20096,bright,main,20210608,6,0.9966051950302365,277,90,1,368
20096,bright,main,20210608,7,0.9862899373950588,273,85,3,361
20096,bright,main,20210608,8,0.9943666806098334,322,99,4,425
20096,bright,main,20210608,9,0.9882166808722592,306,126,3,435
1914,dark,main,20210609,0,0.9861859992591285,265,35,70,370
1914,dark,main,20210609,1,0.9924560530108643,245,29,81,355
1914,dark,main,20210609,2,0.9892165981401698,235,62,72,369
1914,dark,main,20210609,3,0.9965562948002892,242,34,79,355
1914,dark,main,20210609,4,0.9847903793939283,238,38,71,347
1914,dark,main,20210609,5,0.9897654609286183,246,39,81,366
1914,dark,main,20210609,6,0.9951517327488821,222,25,72,319
1914,dark,main,20210609,7,0.9922735939834278,223,31,56,310
1914,dark,main,20210609,8,0.991510338143611,244,36,77,357
1914,dark,main,20210609,9,0.9929367964610615,256,38,72,366
1920,dark,main,20210611,0,0.9930626892440069,269,43,80,392
1920,dark,main,20210611,1,0.989533186090114,231,38,100,369
1920,dark,main,20210611,2,0.9927741299000107,275,44,80,399
1920,dark,main,20210611,3,0.9902537989906082,227,54,81,362
1920,dark,main,20210611,4,0.9914530885639907,263,39,71,373
1920,dark,main,20210611,5,0.9945497190968363,268,39,79,386
1920,dark,main,20210611,6,0.993168600043086,221,24,92,337
1920,dark,main,20210611,7,0.9905182589022941,213,33,79,325
1920,dark,main,20210611,8,0.9907824407639163,276,36,85,397
1920,dark,main,20210611,9,0.9905690673365699,274,30,72,376
1431,dark,main,20210611,0,0.9909668666989191,254,30,97,381
1431,dark,main,20210611,1,0.9838861020499744,241,25,89,355
1431,dark,main,20210611,2,0.9874716515735672,253,27,94,374
1431,dark,main,20210611,3,0.9908939061298739,239,20,81,340
1431,dark,main,20210611,4,0.9916378104699904,265,22,72,359
1431,dark,main,20210611,5,0.9893061506780505,256,25,79,360
1431,dark,main,20210611,6,0.9835601806286266,202,19,88,309
1431,dark,main,20210611,7,0.9912817626460395,224,29,69,322
1431,dark,main,20210611,8,0.9915146681934747,277,17,82,376
1431,dark,main,20210611,9,0.9915146681934747,277,17,82,376
20392,bright,main,20210613,0,0.9927124970088627,327,97,8,432
20392,bright,main,20210613,1,0.9942233661595928,297,101,4,402
20392,bright,main,20210613,2,0.9923565881440037,315,108,6,429
20392,bright,main,20210613,3,0.9925240448524788,264,112,4,380
20392,bright,main,20210613,4,0.9924726496504841,288,81,6,375
20392,bright,main,20210613,5,0.991404112231432,334,85,3,422
20392,bright,main,20210613,6,0.9965551889782134,283,83,4,370
20392,bright,main,20210613,7,0.9962542065378596,291,74,4,369
20392,bright,main,20210613,8,0.9918571752264342,321,104,4,429
20392,bright,main,20210613,9,0.9918571752264342,321,104,4,429
20086,bright,main,20210613,0,0.993487527223373,372,62,1,435
20086,bright,main,20210613,1,0.9959413987092646,354,39,2,395
20086,bright,main,20210613,2,0.9943864042077455,337,86,4,427
20086,bright,main,20210613,3,0.987862710204715,334,63,2,399
20086,bright,main,20210613,4,0.9902318181146804,318,70,5,393
20086,bright,main,20210613,5,0.9933108322154395,354,59,3,416
20086,bright,main,20210613,6,0.9972027589914572,296,68,1,365
20086,bright,main,20210613,7,0.9889681588210716,308,49,3,360
20086,bright,main,20210613,8,0.9859938049080237,370,50,2,422
20086,bright,main,20210613,9,0.9859938049080237,370,50,2,422
20844,bright,main,20210615,0,0.9951348782445961,308,132,1,441
20844,bright,main,20210615,1,0.9915800429435535,280,119,2,401
20844,bright,main,20210615,2,0.9940080887394553,283,147,1,431
20844,bright,main,20210615,3,0.99456591803274,281,119,2,402
20844,bright,main,20210615,4,0.9908927512682278,277,132,1,410
20844,bright,main,20210615,5,0.996729912612411,310,109,5,424
20844,bright,main,20210615,6,0.9908646873221861,274,94,3,371
20844,bright,main,20210615,7,0.9839535713679937,254,96,1,351
20844,bright,main,20210615,8,0.9922011192189008,317,112,1,430
20844,bright,main,20210615,9,0.9922011192189008,317,112,1,430
1869,dark,main,20210708,0,0.9899078786304412,258,24,101,383
1869,dark,main,20210708,1,0.9801449457002684,214,34,87,335
1869,dark,main,20210708,2,0.994804894563681,231,38,87,356
1869,dark,main,20210708,3,0.9861192551627347,236,26,90,352
1869,dark,main,20210708,4,0.9926220393768886,251,12,85,348
1869,dark,main,20210708,5,0.9925584967410567,252,20,85,357
1869,dark,main,20210708,6,0.9923688190987036,245,19,61,325
1869,dark,main,20210708,7,0.9894612139694124,226,26,72,324
1869,dark,main,20210708,8,0.9900834742907438,274,24,86,384
1869,dark,main,20210708,9,0.9937273852197026,287,20,76,383
82237,dark,special,20210917,0,0.9946108670117416,293,22,80,395
82237,dark,special,20210917,1,0.9846607548007126,108,10,52,170
82237,dark,special,20210917,2,0.9933349059413087,272,20,88,380
82237,dark,special,20210917,3,0.9853819243401044,242,25,77,344
82237,dark,special,20210917,4,0.9853819243401044,242,25,77,344
82237,dark,special,20210917,5,0.9879918635028608,253,19,95,367
82237,dark,special,20210917,6,0.9888338809086391,217,21,81,319
82237,dark,special,20210917,7,0.9915948873245594,232,18,69,319
82237,dark,special,20210917,8,0.9940450646781986,267,16,85,368
82237,dark,special,20210917,9,0.9880829508915243,285,18,79,382
82258,bright,special,20210919,0,0.9859538373822192,342,88,0,430
82258,bright,special,20210919,1,0.9732126648034087,158,33,2,193
82258,bright,special,20210919,2,0.9878226300050226,324,60,6,390
82258,bright,special,20210919,3,0.992916815940457,304,82,4,390
82258,bright,special,20210919,4,0.9845430228763281,157,49,1,207
82258,bright,special,20210919,5,0.9951342041432732,306,88,5,399
82258,bright,special,20210919,6,0.9893919645834746,272,83,3,358
82258,bright,special,20210919,7,0.9921639724265651,271,87,3,361
82258,bright,special,20210919,8,0.9874140024846559,296,112,1,409
82258,bright,special,20210919,9,0.9940032556815687,311,106,3,420
26173,bright,main,20210921,0,0.9959424798892778,389,50,4,443
26173,bright,main,20210921,1,0.960953835076143,166,26,3,195
26173,bright,main,20210921,2,0.9939194001354286,340,87,3,430
26173,bright,main,20210921,3,0.9890806817618693,326,62,4,392
26173,bright,main,20210921,4,0.9890806817618693,326,62,4,392
26173,bright,main,20210921,5,0.9908749564702913,345,62,3,410
26173,bright,main,20210921,6,0.9965852900593388,364,50,5,419
26173,bright,main,20210921,7,0.9939803803493691,282,77,6,365
26173,bright,main,20210921,8,0.9950610121251304,324,91,5,420
26173,bright,main,20210921,9,0.992556018562446,340,77,7,424
24767,bright,main,20210921,0,0.9943923327619603,342,93,1,436
24767,bright,main,20210921,1,0.9868421572752727,134,61,0,195
24767,bright,main,20210921,2,0.9957190116693332,324,103,5,432
24767,bright,main,20210921,3,0.9939226914870803,282,114,5,401
24767,bright,main,20210921,4,0.9785045712481951,141,67,2,210
24767,bright,main,20210921,5,0.994631124279375,243,160,8,411
24767,bright,main,20210921,6,0.9957090457442703,284,147,4,435
24767,bright,main,20210921,7,0.9823256443442554,203,174,0,377
24767,bright,main,20210921,8,0.9884253317487854,220,201,3,424
24767,bright,main,20210921,9,0.989139318140106,293,129,3,425
22386,bright,main,20210921,0,0.9910598522910211,322,110,6,438
22386,bright,main,20210921,1,0.965357258890755,162,32,2,196
22386,bright,main,20210921,2,0.9914731465539508,286,142,2,430
22386,bright,main,20210921,3,0.990491183196847,235,162,5,402
22386,bright,main,20210921,4,0.9878077499360552,131,72,1,204
22386,bright,main,20210921,5,0.9923823462595583,243,164,6,413
22386,bright,main,20210921,6,0.9930431898735035,254,163,4,421
22386,bright,main,20210921,7,0.9881654210929298,292,80,3,375
22386,bright,main,20210921,8,0.9905459574869236,328,91,3,422
22386,bright,main,20210921,9,0.9954404977422291,308,125,2,435
23209,bright,main,20210921,0,0.9928002843305499,328,109,1,438
23209,bright,main,20210921,1,0.9799285837525854,99,98,0,197
23209,bright,main,20210921,2,0.9934220133617087,285,145,3,433
23209,bright,main,20210921,3,0.9920561303743629,295,106,3,404
23209,bright,main,20210921,4,0.9911154721578447,170,36,0,206
23209,bright,main,20210921,5,0.991955003762734,321,98,0,419
23209,bright,main,20210921,6,0.9956499645751818,365,59,1,425
23209,bright,main,20210921,7,0.9934856163832448,291,82,3,376
23209,bright,main,20210921,8,0.9887560850993988,338,87,4,429
23209,bright,main,20210921,9,0.9923996950183287,318,110,4,432
23208,bright,main,20210921,0,0.9939174796277402,327,105,2,434
23208,bright,main,20210921,1,0.9863839314922264,115,76,3,194
23208,bright,main,20210921,2,0.9946594379368137,277,156,3,436
23208,bright,main,20210921,3,0.9923894382718783,250,149,1,400
23208,bright,main,20210921,4,0.982422533804362,149,58,0,207
23208,bright,main,20210921,5,0.9941600928122857,296,113,1,410
23208,bright,main,20210921,6,0.9936156488679333,304,127,4,435
23208,bright,main,20210921,7,0.9937595178403,303,69,3,375
23208,bright,main,20210921,8,0.9927820962072529,353,66,7,426
23208,bright,main,20210921,9,0.98894177006469,320,89,6,415
26175,bright,main,20210921,0,0.9907264713414397,363,69,4,436
26175,bright,main,20210921,1,0.9925523856690718,161,33,2,196
26175,bright,main,20210921,2,0.990985420589773,344,71,8,423
26175,bright,main,20210921,3,0.996546092517509,330,56,4,390
26175,bright,main,20210921,4,0.9887082254178777,177,22,1,200
26175,bright,main,20210921,5,0.9869145590615263,318,81,3,402
26175,bright,main,20210921,6,0.9912184703737487,333,89,2,424
26175,bright,main,20210921,7,0.9943079707424504,294,71,2,367
26175,bright,main,20210921,8,0.9893270114656519,326,86,4,416
26175,bright,main,20210921,9,0.992048097956828,330,83,6,419
20078,bright,main,20210921,0,0.9909006303337323,331,105,8,444
20078,bright,main,20210921,1,0.9679366889787507,151,38,4,193
20078,bright,main,20210921,2,0.9936974166618523,349,83,5,437
20078,bright,main,20210921,3,0.9853838999737,293,101,5,399
20078,bright,main,20210921,4,0.9671437566411315,155,52,2,209
20078,bright,main,20210921,5,0.9923705585203708,323,91,6,420
20078,bright,main,20210921,6,0.9880325833006476,318,109,4,431
20078,bright,main,20210921,7,0.9904210960051804,273,95,7,375
20078,bright,main,20210921,8,0.9945370049806411,321,97,9,427
20078,bright,main,20210921,9,0.9956710048702001,298,129,3,430
23960,bright,main,20210921,0,0.9928877054790013,293,146,5,444
23960,bright,main,20210921,1,0.9814213423113389,148,48,1,197
23960,bright,main,20210921,2,0.9902543962940804,361,66,4,431
23960,bright,main,20210921,3,0.991472732834946,311,80,5,396
23960,bright,main,20210921,4,0.991472732834946,311,80,5,396
23960,bright,main,20210921,5,0.9901405968719211,320,96,4,420
23960,bright,main,20210921,6,0.9891777761039143,290,138,3,431
23960,bright,main,20210921,7,0.9866900824024631,203,172,1,376
23960,bright,main,20210921,8,0.9926832948061667,266,147,5,418
23960,bright,main,20210921,9,0.9943364070219222,270,154,3,427
22471,bright,main,20210921,0,0.9921763489640166,336,94,6,436
22471,bright,main,20210921,1,0.9846160881237425,117,77,2,196
22471,bright,main,20210921,2,0.996030418449524,264,165,5,434
22471,bright,main,20210921,3,0.9961999622160064,251,149,0,400
22471,bright,main,20210921,4,0.9876986395047403,125,86,0,211
22471,bright,main,20210921,5,0.9943771407959578,287,118,7,412
22471,bright,main,20210921,6,0.9914493599981529,317,104,4,425
22471,bright,main,20210921,7,0.9908473422782014,292,83,0,375
22471,bright,main,20210921,8,0.9967867983235712,327,95,7,429
22471,bright,main,20210921,9,0.9911624128773052,347,70,3,420
24770,bright,main,20210921,0,0.9933139682827562,338,96,4,438
24770,bright,main,20210921,1,0.9721602990563928,142,54,2,198
24770,bright,main,20210921,2,0.9926142875398243,319,106,4,429
24770,bright,main,20210921,3,0.9854621771099649,313,81,4,398
24770,bright,main,20210921,4,0.9925920274706668,127,78,2,207
24770,bright,main,20210921,5,0.9962844992570279,272,139,1,412
24770,bright,main,20210921,6,0.9948873459025825,260,169,2,431
24770,bright,main,20210921,7,0.9910216557187459,207,156,3,366
24770,bright,main,20210921,8,0.9924440243844224,266,148,7,421
24770,bright,main,20210921,9,0.995268280358451,310,102,7,419
25534,bright,main,20210921,0,0.991596202956492,316,121,3,440
25534,bright,main,20210921,1,0.9814645588160552,116,78,2,196
25534,bright,main,20210921,2,0.9906311734879419,326,102,6,434
25534,bright,main,20210921,3,0.9917982039829846,257,142,3,402
25534,bright,main,20210921,4,0.9796964933381077,140,66,2,208
25534,bright,main,20210921,5,0.990539352987814,301,103,7,411
25534,bright,main,20210921,6,0.991083440123128,271,155,4,430
25534,bright,main,20210921,7,0.9943623544359457,252,124,2,378
25534,bright,main,20210921,8,0.996790424000803,303,110,7,420
25534,bright,main,20210921,9,0.9893703800206127,254,174,2,430
25606,bright,main,20210921,0,0.9946010980057893,320,110,4,434
25606,bright,main,20210921,1,0.9853262942541374,140,55,2,197
25606,bright,main,20210921,2,0.9947520231898674,269,155,1,425
25606,bright,main,20210921,3,0.9956001129859674,197,198,3,398
25606,bright,main,20210921,4,0.9875226131230463,109,93,2,204
25606,bright,main,20210921,5,0.9932684517394917,263,146,0,409
25606,bright,main,20210921,6,0.9937293165195122,260,154,4,418
25606,bright,main,20210921,7,0.9938446982156408,217,159,2,378
25606,bright,main,20210921,8,0.9952924749492025,288,120,3,411
25606,bright,main,20210921,9,0.9918945174710001,301,109,7,417
25557,bright,main,20210921,0,0.9909064986517727,300,129,7,436
25557,bright,main,20210921,1,0.9757663125682993,125,66,4,195
25557,bright,main,20210921,2,0.9961526999302136,292,137,3,432
25557,bright,main,20210921,3,0.9917867745180009,252,146,1,399
25557,bright,main,20210921,4,0.9867477338510464,99,109,4,212
25557,bright,main,20210921,5,0.9877472855317454,242,166,5,413
25557,bright,main,20210921,6,0.994390268458702,253,175,6,434
25557,bright,main,20210921,7,0.9956026178702124,227,148,2,377
25557,bright,main,20210921,8,0.9920357017084533,241,184,0,425
25557,bright,main,20210921,9,0.9952612113354723,281,145,6,432
26176,bright,main,20210921,0,0.9952753895541878,319,104,2,425
26176,bright,main,20210921,1,0.9703071880882473,147,32,3,182
26176,bright,main,20210921,2,0.9946860812104448,319,83,6,408
26176,bright,main,20210921,3,0.9907922648819694,312,51,5,368
26176,bright,main,20210921,4,0.9933428340170151,152,44,4,200
26176,bright,main,20210921,5,0.9950387304481654,316,73,4,393
26176,bright,main,20210921,6,0.990291566109368,312,95,5,412
26176,bright,main,20210921,7,0.9904794186803378,254,92,6,352
26176,bright,main,20210921,8,0.9937311514366178,323,72,7,402
26176,bright,main,20210921,9,0.9898553475310664,325,84,8,417
23068,bright,main,20210921,0,0.99376348328621,342,88,8,438
23068,bright,main,20210921,1,0.975267931006609,157,32,1,190
23068,bright,main,20210921,2,0.990361899071204,352,63,9,424
23068,bright,main,20210921,3,0.9909592298414419,321,63,7,391
23068,bright,main,20210921,4,0.9630303449101489,175,24,3,202
23068,bright,main,20210921,5,0.9970608093321274,326,66,2,394
23068,bright,main,20210921,6,0.9931893928469987,357,63,3,423
23068,bright,main,20210921,7,0.9888454651251757,291,71,6,368
23068,bright,main,20210921,8,0.99275077604603,341,50,4,395
23068,bright,main,20210921,9,0.995593814307987,348,71,3,422
22372,bright,main,20210921,0,0.9943000920992445,259,177,1,437
22372,bright,main,20210921,1,0.9878509682000893,140,54,2,196
22372,bright,main,20210921,2,0.9923840338696385,320,110,8,438
22372,bright,main,20210921,3,0.9943198140528713,314,83,2,399
22372,bright,main,20210921,4,0.9830721028504821,158,45,3,206
22372,bright,main,20210921,5,0.9903222031562764,305,103,8,416
22372,bright,main,20210921,6,0.9931707842962327,301,127,4,432
22372,bright,main,20210921,7,0.9908003302312236,256,115,4,375
22372,bright,main,20210921,8,0.9927033606604374,284,136,6,426
22372,bright,main,20210921,9,0.9952587814642135,282,146,2,430
22377,bright,main,20210921,0,0.9958306796921836,294,132,8,434
22377,bright,main,20210921,1,0.9921220735599117,145,49,3,197
22377,bright,main,20210921,2,0.9951607136466868,296,143,1,440
22377,bright,main,20210921,3,0.9893409447911409,233,163,2,398
22377,bright,main,20210921,4,0.9863787864693538,120,88,0,208
22377,bright,main,20210921,5,0.9863663442625025,255,154,2,411
22377,bright,main,20210921,6,0.9838612395080238,259,163,5,427
22377,bright,main,20210921,7,0.9857272898067162,275,97,3,375
22377,bright,main,20210921,8,0.9919848677908116,332,79,6,417
22377,bright,main,20210921,9,0.9914656399837306,294,128,6,428
25649,bright,main,20210921,0,0.9848379954926652,374,71,2,447
25649,bright,main,20210921,1,0.9771804287463801,156,37,2,195
25649,bright,main,20210921,2,0.9908208743610043,341,83,3,427
25649,bright,main,20210921,3,0.9930291983180717,307,83,7,397
25649,bright,main,20210921,4,0.969396566307217,155,48,2,205
25649,bright,main,20210921,5,0.9929055731587335,335,74,3,412
25649,bright,main,20210921,6,0.9938896473668279,340,86,4,430
25649,bright,main,20210921,7,0.9921451820676407,286,84,3,373
25649,bright,main,20210921,8,0.9951605124081376,315,102,2,419
25649,bright,main,20210921,9,0.9917402689152643,344,74,5,423
22402,bright,main,20210921,0,0.9872225811901338,307,129,6,442
22402,bright,main,20210921,1,0.9836386646871355,139,51,1,191
22402,bright,main,20210921,2,0.9950441920270447,322,105,2,429
22402,bright,main,20210921,3,0.9832170783848384,276,123,3,402
22402,bright,main,20210921,4,0.9891997006036125,149,52,3,204
22402,bright,main,20210921,5,0.9895708332286431,291,113,2,406
22402,bright,main,20210921,6,0.989418841101655,290,133,3,426
22402,bright,main,20210921,7,0.9943572434608218,268,103,2,373
22402,bright,main,20210921,8,0.9944997727967225,294,121,7,422
22402,bright,main,20210921,9,0.9921514654406394,278,142,5,425
22427,bright,main,20210923,0,0.9909499276120609,282,158,3,443
22427,bright,main,20210923,1,0.9885616756188245,143,52,2,197
22427,bright,main,20210923,2,0.9895250021096946,276,161,3,440
22427,bright,main,20210923,3,0.9895250021096946,276,161,3,440
22427,bright,main,20210923,4,0.9869565936350679,145,63,0,208
22427,bright,main,20210923,5,0.9960531722793302,281,123,6,410
22427,bright,main,20210923,6,0.9967225318966406,261,163,4,428
22427,bright,main,20210923,7,0.9916649838700418,269,96,3,368
22427,bright,main,20210923,8,0.9932286409738933,328,94,2,424
22427,bright,main,20210923,9,0.9918589066307484,333,90,3,426
26260,bright,main,20210923,0,0.9939769031020436,326,111,6,443
26260,bright,main,20210923,1,0.9802743910688118,154,40,2,196
26260,bright,main,20210923,2,0.9948877388302219,351,84,1,436
26260,bright,main,20210923,3,0.9880318906190468,328,65,3,396
26260,bright,main,20210923,4,0.9801992664482654,153,55,1,209
26260,bright,main,20210923,5,0.9962592676846969,281,123,7,411
26260,bright,main,20210923,6,0.9936982449908786,310,116,5,431
26260,bright,main,20210923,7,0.9924714337059387,269,104,2,375
26260,bright,main,20210923,8,0.9923215672404383,293,126,7,426
26260,bright,main,20210923,9,0.995789183060243,320,107,7,434
25567,bright,main,20210923,0,0.9928248879681184,300,127,9,436
25567,bright,main,20210923,1,0.9764796039101586,135,49,9,193
25567,bright,main,20210923,2,0.9937998844516954,335,96,6,437
25567,bright,main,20210923,3,0.9924391192710962,313,80,4,397
25567,bright,main,20210923,4,0.9800645941996351,151,53,2,206
25567,bright,main,20210923,5,0.9899874165385469,275,129,5,409
25567,bright,main,20210923,6,0.9924366080808339,283,144,2,429
25567,bright,main,20210923,7,0.9871799446651067,207,152,3,362
25567,bright,main,20210923,8,0.9903713122204896,260,150,8,418
25567,bright,main,20210923,9,0.9940652474758235,244,179,2,425
22102,bright,main,20210923,0,0.9942672153809223,289,127,5,421
22102,bright,main,20210923,1,0.9916977190577009,150,35,1,186
22102,bright,main,20210923,2,0.9926369998384778,327,86,6,419
22102,bright,main,20210923,3,0.9932451488752917,297,78,9,384
22102,bright,main,20210923,4,0.9827878180469921,150,49,4,203
22102,bright,main,20210923,5,0.9936881041317501,316,83,3,402
22102,bright,main,20210923,6,0.9934696837518587,335,77,8,420
22102,bright,main,20210923,7,0.9946018044555293,279,80,5,364
22102,bright,main,20210923,8,0.9895295719973283,305,94,2,401
22102,bright,main,20210923,9,0.9941845462642471,272,116,8,396
22436,bright,main,20210923,0,0.9913195235302831,345,93,3,441
22436,bright,main,20210923,1,0.9842971702755489,138,51,1,190
22436,bright,main,20210923,2,0.9895806406740236,312,116,4,432
22436,bright,main,20210923,3,0.9955067511611988,234,147,7,388
22436,bright,main,20210923,4,0.9816679513429337,151,49,4,204
22436,bright,main,20210923,5,0.9922340196786227,284,125,6,415
22436,bright,main,20210923,6,0.9960230973337666,225,182,5,412
22436,bright,main,20210923,7,0.9860801771681732,266,100,3,369
22436,bright,main,20210923,8,0.9923008011024653,315,93,6,414
22436,bright,main,20210923,9,0.9946010366321105,337,82,3,422
25535,bright,main,20210923,0,0.9950944314763762,288,146,2,436
25535,bright,main,20210923,1,0.9699641600814133,100,96,1,197
25535,bright,main,20210923,2,0.9924584573192774,269,155,6,430
25535,bright,main,20210923,3,0.9979988446671334,255,139,5,399
25535,bright,main,20210923,4,0.9852404290441036,124,84,0,208
25535,bright,main,20210923,5,0.988481309540903,279,131,5,415
25535,bright,main,20210923,6,0.9959083883994884,302,128,4,434
25535,bright,main,20210923,7,0.993760686022474,240,130,5,375
25535,bright,main,20210923,8,0.9925518058776226,247,175,3,425
25535,bright,main,20210923,9,0.9938301663447023,290,141,2,433
21311,bright,main,20210923,0,0.9939533055147606,328,109,5,442
21311,bright,main,20210923,1,0.9725597055911478,137,51,1,189
21311,bright,main,20210923,2,0.9903821986972985,145,120,2,267
21311,bright,main,20210923,3,0.9903824273180586,283,100,8,391
21311,bright,main,20210923,4,0.986593428036017,151,54,1,206
21311,bright,main,20210923,5,0.9902802909854482,290,115,5,410
21311,bright,main,20210923,6,0.9900162176415389,304,112,5,421
21311,bright,main,20210923,7,0.9958035101748545,258,106,5,369
21311,bright,main,20210923,8,0.991544040987471,282,140,1,423
21311,bright,main,20210923,9,0.9854165996085825,303,113,5,421
21580,bright,main,20210923,0,0.9903332478241392,332,91,9,432
21580,bright,main,20210923,1,0.9886876004636062,140,48,4,192
21580,bright,main,20210923,2,0.9921881803404998,309,113,5,427
21580,bright,main,20210923,3,0.9875493779504585,249,141,6,396
21580,bright,main,20210923,4,0.9794795753297001,116,84,1,201
21580,bright,main,20210923,5,0.9919516170316848,246,158,6,410
21580,bright,main,20210923,6,0.9944869437275736,293,131,5,429
21580,bright,main,20210923,7,0.9934954586800319,258,108,6,372
21580,bright,main,20210923,8,0.9942402647306172,347,69,6,422
21580,bright,main,20210923,9,0.9952630921850512,309,114,4,427
20532,bright,main,20210923,0,0.9901022833163469,334,92,5,431
20532,bright,main,20210923,1,0.9820508027740658,154,29,3,186
20532,bright,main,20210923,2,0.9951510176050535,346,72,6,424
20532,bright,main,20210923,3,0.9951583806480375,304,73,5,382
20532,bright,main,20210923,4,0.9890695661282966,153,49,2,204
20532,bright,main,20210923,5,0.995155928270322,236,144,3,383
20532,bright,main,20210923,6,0.9952995409166325,290,110,9,409
20532,bright,main,20210923,7,0.9921579913825181,281,73,4,358
20532,bright,main,20210923,8,0.9941829115788392,330,68,7,405
20532,bright,main,20210923,9,0.9921966848315661,310,84,7,401
26017,bright,main,20210923,0,0.9967989648344338,323,96,15,434
26017,bright,main,20210923,1,0.9807336774586426,153,44,1,198
26017,bright,main,20210923,2,0.9901608042559643,347,75,3,425
26017,bright,main,20210923,3,0.9882683072273618,294,94,5,393
26017,bright,main,20210923,4,0.9861494486057831,155,47,3,205
26017,bright,main,20210923,5,0.9908594267426535,276,138,1,415
26017,bright,main,20210923,6,0.9874794269445247,315,106,2,423
26017,bright,main,20210923,7,0.993824968887876,276,93,6,375
26017,bright,main,20210923,8,0.9941878896425632,317,100,3,420
26017,bright,main,20210923,9,0.9874199574060786,327,97,4,428
21224,bright,main,20210923,0,0.9929591417891745,361,68,4,433
21224,bright,main,20210923,1,0.9830664996428053,157,28,2,187
21224,bright,main,20210923,2,0.9945582359616649,348,77,5,430
21224,bright,main,20210923,3,0.9931155808565868,293,88,4,385
21224,bright,main,20210923,4,0.9809559742414292,171,32,1,204
21224,bright,main,20210923,5,0.9931591976417027,330,72,2,404
21224,bright,main,20210923,6,0.9920169871509377,341,83,4,428
21224,bright,main,20210923,7,0.9970373857938486,309,53,7,369
21224,bright,main,20210923,8,0.9895057331234327,357,53,6,416
21224,bright,main,20210923,9,0.9931907164682812,337,80,3,420
26043,bright,main,20210923,0,0.9892734815563767,314,116,3,433
26043,bright,main,20210923,1,0.982269439344325,103,62,0,165
26043,bright,main,20210923,2,0.9895014152230892,170,195,1,366
26043,bright,main,20210923,3,0.9942619873363102,288,104,7,399
26043,bright,main,20210923,4,0.9797699685826466,170,35,1,206
26043,bright,main,20210923,5,0.9910241305471633,332,74,4,410
26043,bright,main,20210923,6,0.9918809511755351,354,71,7,432
26043,bright,main,20210923,7,0.9891211002913775,282,85,1,368
26043,bright,main,20210923,8,0.9942144396961262,307,109,3,419
26043,bright,main,20210923,9,0.9893919896342808,304,121,4,429
22121,bright,main,20210923,0,0.98812505771074,361,69,6,436
22121,bright,main,20210923,1,0.9788188667667419,161,27,3,191
22121,bright,main,20210923,2,0.9943646009580225,342,81,5,428
22121,bright,main,20210923,3,0.9910888519294091,300,82,2,384
22121,bright,main,20210923,4,0.9787682219861776,151,48,2,201
22121,bright,main,20210923,5,0.9872542058310061,314,82,7,403
22121,bright,main,20210923,6,0.9892058875495978,318,98,7,423
22121,bright,main,20210923,7,0.9933604180873136,275,89,3,367
22121,bright,main,20210923,8,0.9955019547827474,328,76,6,410
22121,bright,main,20210923,9,0.9955312069058091,315,103,4,422
22379,bright,main,20210923,0,0.9942889957074814,279,156,4,439
22379,bright,main,20210923,1,0.9687280772750446,132,59,3,194
22379,bright,main,20210923,2,0.9884640961935278,306,122,3,431
22379,bright,main,20210923,3,0.9924754346080247,238,163,0,401
22379,bright,main,20210923,4,0.9863938694804387,134,72,1,207
22379,bright,main,20210923,5,0.9911199270698775,298,120,2,420
22379,bright,main,20210923,6,0.9921353888573283,282,147,2,431
22379,bright,main,20210923,7,0.9964601692186582,271,106,1,378
22379,bright,main,20210923,8,0.9957806642749117,249,166,5,420
22379,bright,main,20210923,9,0.9937960929202,229,196,4,429
25588,bright,main,20210923,0,0.9847360926101759,166,103,7,276
25588,bright,main,20210923,1,0.9864958553109028,112,73,3,188
25588,bright,main,20210923,2,0.9931544032270542,301,123,5,429
25588,bright,main,20210923,3,0.9928782571554403,243,153,5,401
25588,bright,main,20210923,4,0.9738440615676388,122,87,2,211
25588,bright,main,20210923,5,0.9902622873591469,172,235,2,409
25588,bright,main,20210923,6,0.9928063422442901,192,227,0,419
25588,bright,main,20210923,7,0.9944802349588441,199,180,1,380
25588,bright,main,20210923,8,0.9944233289491519,306,109,4,419
25588,bright,main,20210923,9,0.992616266246181,262,154,2,418
22096,bright,main,20210923,0,0.9902916674417072,316,100,12,428
22096,bright,main,20210923,1,0.9806516308624172,135,49,3,187
22096,bright,main,20210923,2,0.992386948654278,330,83,4,417
22096,bright,main,20210923,3,0.9872865599781614,308,70,2,380
22096,bright,main,20210923,4,0.9836850390138717,154,46,2,202
22096,bright,main,20210923,5,0.9875874110831487,283,106,6,395
22096,bright,main,20210923,6,0.9915599561141863,333,65,8,406
22096,bright,main,20210923,7,0.9930384978071173,299,58,8,365
22096,bright,main,20210923,8,0.9866100212139974,342,64,4,410
22096,bright,main,20210923,9,0.9965569433079046,304,99,9,412
20864,bright,main,20210923,0,0.9979554489111289,373,54,5,432
20864,bright,main,20210923,1,0.982304964207482,156,37,2,195
20864,bright,main,20210923,2,0.9952967215466342,350,82,2,434
20864,bright,main,20210923,3,0.9900290354800353,328,62,5,395
20864,bright,main,20210923,4,0.980317857391765,174,29,3,206
20864,bright,main,20210923,5,0.994119725380846,332,79,3,414
20864,bright,main,20210923,6,0.9950208893911298,347,72,10,429
20864,bright,main,20210923,7,0.9888477223448461,313,57,4,374
20864,bright,main,20210923,8,0.9936869108904001,350,64,4,418
20864,bright,main,20210923,9,0.9925327276722161,342,79,3,424
23961,bright,main,20210923,0,0.9951246060249175,299,130,4,433
23961,bright,main,20210923,1,0.981771987658318,136,57,3,196
23961,bright,main,20210923,2,0.993906276514609,314,115,3,432
23961,bright,main,20210923,3,0.9949096092492995,288,102,2,392
23961,bright,main,20210923,4,0.9757097110020008,159,44,3,206
23961,bright,main,20210923,5,0.992646965620105,277,131,3,411
23961,bright,main,20210923,6,0.9893715375709315,312,114,4,430
23961,bright,main,20210923,7,0.9925452483800792,251,125,4,380
23961,bright,main,20210923,8,0.9915757704729267,238,188,2,428
23961,bright,main,20210923,9,0.9910501259462514,236,188,7,431
22108,bright,main,20210923,0,0.9898912308545916,321,102,5,428
22108,bright,main,20210923,1,0.9903193868796947,163,31,0,194
22108,bright,main,20210923,2,0.9924443521266753,335,84,8,427
22108,bright,main,20210923,3,0.9914180538342449,304,76,5,385
22108,bright,main,20210923,4,0.9919138478449403,159,46,0,205
22108,bright,main,20210923,5,0.9856785126780956,295,100,3,398
22108,bright,main,20210923,6,0.9930442385499942,308,113,4,425
22108,bright,main,20210923,7,0.9925801241939864,283,67,5,355
22108,bright,main,20210923,8,0.9935597786085233,292,102,8,402
22108,bright,main,20210923,9,0.9880732213091533,295,109,5,409
25546,bright,main,20210923,0,0.9955316558526088,305,137,3,445
25546,bright,main,20210923,1,0.9917208949217406,134,60,1,195
25546,bright,main,20210923,2,0.9925939074596969,285,140,6,431
25546,bright,main,20210923,3,0.9916509536397208,255,143,1,399
25546,bright,main,20210923,4,0.9904721992521417,96,113,0,209
25546,bright,main,20210923,5,0.9938931616292506,198,220,1,419
25546,bright,main,20210923,6,0.9933583371511723,235,194,4,433
25546,bright,main,20210923,7,0.992409161756162,204,174,1,379
25546,bright,main,20210923,8,0.9951821354397619,278,143,5,426
25546,bright,main,20210923,9,0.9966818373485504,239,192,2,433
22472,bright,main,20210923,0,0.9898709858600399,348,90,0,438
22472,bright,main,20210923,1,0.988039256029321,149,46,0,195
22472,bright,main,20210923,2,0.9936665530115114,300,134,4,438
22472,bright,main,20210923,3,0.994716437523022,261,134,5,400
22472,bright,main,20210923,4,0.9763013674430979,148,64,0,212
22472,bright,main,20210923,5,0.995380510604997,319,87,1,407
22472,bright,main,20210923,6,0.9932790374886009,301,123,3,427
22472,bright,main,20210923,7,0.9949659928040692,254,122,3,379
22472,bright,main,20210923,8,0.9903656023212551,329,89,9,427
22472,bright,main,20210923,9,0.9921981431826492,279,146,3,428
25540,bright,main,20210923,0,0.9913122861094619,315,117,8,440
25540,bright,main,20210923,1,0.9883286669397227,125,68,3,196
25540,bright,main,20210923,2,0.9880340467548543,314,113,1,428
25540,bright,main,20210923,3,0.9890451517176748,229,167,3,399
25540,bright,main,20210923,4,0.9773278902773721,84,123,2,209
25540,bright,main,20210923,5,0.9910368427099187,180,234,2,416
25540,bright,main,20210923,6,0.994665763329723,168,254,3,425
25540,bright,main,20210923,7,0.9920915734199742,178,198,0,376
25540,bright,main,20210923,8,0.9946887116593314,268,158,2,428
25540,bright,main,20210923,9,0.9922820980207833,291,134,8,433
23687,bright,main,20210926,0,0.9952741772180191,350,76,2,428
23687,bright,main,20210926,1,0.9856768242643773,153,37,2,192
23687,bright,main,20210926,2,0.9946606095940392,311,110,3,424
23687,bright,main,20210926,3,0.9886724226203003,270,114,5,389
23687,bright,main,20210926,4,0.9790701467885162,108,94,3,205
23687,bright,main,20210926,5,0.9947611512167461,254,139,7,400
23687,bright,main,20210926,6,0.9928925974989355,269,146,2,417
23687,bright,main,20210926,7,0.9914599839978563,231,123,5,359
23687,bright,main,20210926,8,0.9889207717603186,246,155,2,403
23687,bright,main,20210926,9,0.9938979312887934,247,159,2,408
3379,dark,main,20210926,0,0.9801994127385453,249,20,122,391
3379,dark,main,20210926,1,0.9843342500241291,126,11,39,176
3379,dark,main,20210926,2,0.9863276367345581,304,22,71,397
3379,dark,main,20210926,3,0.988993695894655,254,18,64,336
3379,dark,main,20210926,4,0.9913686780962406,137,13,33,183
3379,dark,main,20210926,5,0.9857174448948107,288,17,54,359
3379,dark,main,20210926,6,0.9857194550821574,296,14,63,373
3379,dark,main,20210926,7,0.9958535358591701,247,16,57,320
3379,dark,main,20210926,8,0.9894247482879449,261,16,72,349
3379,dark,main,20210926,9,0.9929211542628172,261,19,84,364
4956,dark,main,20210926,0,0.9874258130924835,299,17,74,390
4956,dark,main,20210926,1,0.9751801956527772,133,8,32,173
4956,dark,main,20210926,2,0.9912836840642679,301,22,52,375
4956,dark,main,20210926,3,0.9882842347052784,267,20,71,358
4956,dark,main,20210926,4,0.988337815501311,161,8,26,195
4956,dark,main,20210926,5,0.9905436664405554,289,16,54,359
4956,dark,main,20210926,6,0.9907144736626667,259,30,86,375
4956,dark,main,20210926,7,0.9899506456496996,233,16,79,328
4956,dark,main,20210926,8,0.9943774268623292,293,17,75,385
4956,dark,main,20210926,9,0.9913760358664894,292,37,43,372
8108,dark,main,20210926,0,0.9916345980517247,303,13,75,391
8108,dark,main,20210926,1,0.986292747811154,142,10,30,182
8108,dark,main,20210926,2,0.9870022081054716,306,12,67,385
8108,dark,main,20210926,3,0.9950236855517042,241,22,85,348
8108,dark,main,20210926,4,0.976428038100907,131,7,47,185
8108,dark,main,20210926,5,0.9918433307685994,284,15,73,372
8108,dark,main,20210926,6,0.9950213148416952,306,10,69,385
8108,dark,main,20210926,7,0.9920691251376227,237,14,71,322
8108,dark,main,20210926,8,0.9944676679996993,293,13,60,366
8108,dark,main,20210926,9,0.9922673423643436,309,13,55,377
21235,bright,main,20210926,0,0.9933165184925585,355,75,6,436
21235,bright,main,20210926,1,0.975037397945728,136,51,2,189
21235,bright,main,20210926,2,0.9892783019936972,320,96,4,420
21235,bright,main,20210926,3,0.9917562095438575,296,78,7,381
21235,bright,main,20210926,4,0.9918239941954058,169,35,3,207
21235,bright,main,20210926,5,0.9859666982177665,332,65,4,401
21235,bright,main,20210926,6,0.9957956174498659,306,106,2,414
21235,bright,main,20210926,7,0.9927121404372173,281,79,1,361
21235,bright,main,20210926,8,0.9886755758678473,295,106,3,404
21235,bright,main,20210926,9,0.9911260325757486,328,78,2,408
8080,dark,main,20210926,0,0.9881475617696325,264,21,81,366
8080,dark,main,20210926,1,0.9810496641425086,122,14,36,172
8080,dark,main,20210926,2,0.9874147684889509,246,33,73,352
8080,dark,main,20210926,3,0.9894005107575911,254,36,59,349
8080,dark,main,20210926,4,0.9881898009541515,123,33,21,177
8080,dark,main,20210926,5,0.9925065785628963,279,29,52,360
8080,dark,main,20210926,6,0.9953189902842939,316,20,51,387
8080,dark,main,20210926,7,0.9986830502132403,266,20,48,334
8080,dark,main,20210926,8,0.9939125893718408,278,29,58,365
8080,dark,main,20210926,9,0.9928566167083972,292,19,59,370
25240,bright,main,20210926,0,0.9845701713298053,336,90,5,431
25240,bright,main,20210926,1,0.9779236805585794,133,51,1,185
25240,bright,main,20210926,2,0.994576037667792,247,174,2,423
25240,bright,main,20210926,3,0.9928539720833643,225,144,4,373
25240,bright,main,20210926,4,0.9870449832738987,141,54,3,198
25240,bright,main,20210926,5,0.9911829661437948,305,93,6,404
25240,bright,main,20210926,6,0.9921437111873241,322,84,8,414
25240,bright,main,20210926,7,0.9890019417473725,282,72,6,360
25240,bright,main,20210926,8,0.9937261099449518,317,82,7,406
25240,bright,main,20210926,9,0.9872661358439336,331,85,2,418
23139,bright,main,20210926,0,0.9978303513858177,340,94,4,438
23139,bright,main,20210926,1,0.9875163769489003,114,78,1,193
23139,bright,main,20210926,2,0.9839577836846812,247,174,4,425
23139,bright,main,20210926,3,0.9938359033501342,281,105,1,387
23139,bright,main,20210926,4,0.9686859020624834,115,91,0,206
23139,bright,main,20210926,5,0.9904217219053185,238,163,7,408
23139,bright,main,20210926,6,0.9878260413776879,314,106,2,422
23139,bright,main,20210926,7,0.9940934715448352,218,146,5,369
23139,bright,main,20210926,8,0.9895863618626034,266,144,6,416
23139,bright,main,20210926,9,0.9893159118646057,322,101,4,427
8956,dark,main,20210926,0,0.9910608430851494,254,13,96,363
8956,dark,main,20210926,1,0.9780004558515071,121,5,43,169
8956,dark,main,20210926,2,0.9930929416034066,275,16,101,392
8956,dark,main,20210926,3,0.9881225514184757,242,18,95,355
8956,dark,main,20210926,4,0.9844858877306139,123,9,49,181
8956,dark,main,20210926,5,0.9813033383141739,244,13,107,364
8956,dark,main,20210926,6,0.9904378031773567,282,13,99,394
8956,dark,main,20210926,7,0.9943357079976223,262,11,81,354
8956,dark,main,20210926,8,0.9949117218783455,267,13,97,377
8956,dark,main,20210926,9,0.9839039984718038,294,14,78,386
25536,bright,main,20210926,0,0.989198334424669,241,196,1,438
25536,bright,main,20210926,1,0.9769597859573385,108,88,1,197
25536,bright,main,20210926,2,0.9905062692724749,224,204,7,435
25536,bright,main,20210926,3,0.9925734673192416,227,170,1,398
25536,bright,main,20210926,4,0.9770406036195713,123,86,2,211
25536,bright,main,20210926,5,0.9945476559012231,162,247,3,412
25536,bright,main,20210926,6,0.9930973238276859,176,241,3,420
25536,bright,main,20210926,7,0.9870341574192575,225,153,0,378
25536,bright,main,20210926,8,0.9941900217847838,234,182,3,419
25536,bright,main,20210926,9,0.9932620181487037,199,220,2,421
3414,dark,main,20210926,0,0.993747357123609,273,19,96,388
3414,dark,main,20210926,1,0.9819605835338996,113,9,33,155
3414,dark,main,20210926,2,0.9895940584934914,263,25,91,379
3414,dark,main,20210926,3,0.9949350497674434,232,11,90,333
3414,dark,main,20210926,4,0.9930046012238494,133,12,46,191
3414,dark,main,20210926,5,0.9896295780276383,264,17,93,374
3414,dark,main,20210926,6,0.993746113389832,257,19,102,378
3414,dark,main,20210926,7,0.9930818078654409,240,17,74,331
3414,dark,main,20210926,8,0.9847795786771112,268,15,89,372
3414,dark,main,20210926,9,0.9880601550741833,259,13,90,362
22273,bright,main,20210927,0,0.9955266632510563,355,64,7,426
22273,bright,main,20210927,1,0.9843600643757854,156,25,3,184
22273,bright,main,20210927,2,0.9970219573567546,376,42,3,421
22273,bright,main,20210927,3,0.9926250664747279,345,42,2,389
22273,bright,main,20210927,4,0.9745146723743561,171,30,2,203
22273,bright,main,20210927,5,0.9954424952851892,337,60,3,400
22273,bright,main,20210927,6,0.9916244436521481,348,56,3,407
22273,bright,main,20210927,7,0.9895344202525437,316,45,2,363
22273,bright,main,20210927,8,0.9891582781959801,324,76,2,402
22273,bright,main,20210927,9,0.993608458238949,372,43,2,417
21739,bright,main,20210927,0,0.9930610179658707,351,64,3,418
21739,bright,main,20210927,1,0.9805089790920715,174,12,2,188
21739,bright,main,20210927,2,0.9924073548299313,355,55,4,414
21739,bright,main,20210927,3,0.9925738206506913,324,56,2,382
21739,bright,main,20210927,4,0.9783254424269721,173,27,1,201
21739,bright,main,20210927,5,0.9949776053996031,314,64,8,386
21739,bright,main,20210927,6,0.9944308141260136,357,62,2,421
21739,bright,main,20210927,7,0.9891896492525372,304,52,2,358
21739,bright,main,20210927,8,0.9954198913877912,357,42,2,401
21739,bright,main,20210927,9,0.9900406179371615,368,45,4,417
20175,bright,main,20210927,0,0.9891739330392127,352,64,4,420
20175,bright,main,20210927,1,0.9857082908719452,150,33,1,184
20175,bright,main,20210927,2,0.9903214616428831,325,76,7,408
20175,bright,main,20210927,3,0.9961014912614216,279,90,5,374
20175,bright,main,20210927,4,0.9771493138969257,169,28,1,198
20175,bright,main,20210927,5,0.994426884626141,314,72,5,391
20175,bright,main,20210927,6,0.9930566624435112,312,89,6,407
20175,bright,main,20210927,7,0.9956224564193104,268,84,2,354
20175,bright,main,20210927,8,0.9940658003050973,307,75,6,388
20175,bright,main,20210927,9,0.9901988378625547,322,80,7,409
22231,bright,main,20210927,0,0.9921895582383942,368,50,11,429
22231,bright,main,20210927,1,0.9779598182715195,158,29,2,189
22231,bright,main,20210927,2,0.9896268260781872,326,80,1,407
22231,bright,main,20210927,3,0.9882609200728739,304,69,4,377
22231,bright,main,20210927,4,0.9803141342904123,169,29,3,201
22231,bright,main,20210927,5,0.9911493500271791,328,66,2,396
22231,bright,main,20210927,6,0.9899169815964917,309,96,1,406
22231,bright,main,20210927,7,0.9890350315461371,284,68,3,355
22231,bright,main,20210927,8,0.9864246837734487,329,61,7,397
22231,bright,main,20210927,9,0.993336149941295,364,50,3,417
21764,bright,main,20210927,0,0.9907255875747492,326,81,2,409
21764,bright,main,20210927,1,0.9754346102834492,149,32,4,185
21764,bright,main,20210927,2,0.9895121676460558,341,62,3,406
21764,bright,main,20210927,3,0.990271259252914,322,56,2,380
21764,bright,main,20210927,4,0.9867390574146805,164,34,4,202
21764,bright,main,20210927,5,0.9899196358180463,339,47,5,391
21764,bright,main,20210927,6,0.9902718514650719,342,59,4,405
21764,bright,main,20210927,7,0.9900562668443152,309,51,4,364
21764,bright,main,20210927,8,0.992889612227397,314,80,2,396
21764,bright,main,20210927,9,0.9932132934179635,330,77,4,411
20006,bright,main,20210927,0,0.9940888014720456,345,70,5,420
20006,bright,main,20210927,1,0.9906444832146237,152,29,2,183
20006,bright,main,20210927,2,0.9923454418148349,359,43,5,407
20006,bright,main,20210927,3,0.9915149464113564,308,56,3,367
20006,bright,main,20210927,4,0.9740999582341695,172,17,3,192
20006,bright,main,20210927,5,0.989449607119587,324,64,3,391
20006,bright,main,20210927,6,0.9872436568595946,362,54,4,420
20006,bright,main,20210927,7,0.9881529880009832,299,52,4,355
20006,bright,main,20210927,8,0.9969501493025793,318,73,6,397
20006,bright,main,20210927,9,0.9971556612169523,333,67,3,403
22238,bright,main,20210927,0,0.9919975726950102,357,61,4,422
22238,bright,main,20210927,1,0.9854414884841847,156,27,3,186
22238,bright,main,20210927,2,0.9878737237453181,360,61,5,426
22238,bright,main,20210927,3,0.9929473122689875,302,72,4,378
22238,bright,main,20210927,4,0.9832083832585713,166,27,2,195
22238,bright,main,20210927,5,0.9904903056498475,329,59,7,395
22238,bright,main,20210927,6,0.990695430734451,354,56,2,412
22238,bright,main,20210927,7,0.9943075710889115,315,44,2,361
22238,bright,main,20210927,8,0.9902488850350368,331,67,3,401
22238,bright,main,20210927,9,0.997081557244063,340,79,6,425
25960,bright,main,20210927,0,0.9905987098188905,303,122,6,431
25960,bright,main,20210927,1,0.9794537078006396,122,63,1,186
25960,bright,main,20210927,2,0.9911120492199115,208,195,10,413
25960,bright,main,20210927,3,0.9941269015579972,241,133,3,377
25960,bright,main,20210927,4,0.9850472921244021,124,69,2,195
25960,bright,main,20210927,5,0.9941030012976015,272,131,5,408
25960,bright,main,20210927,6,0.9958227080363515,286,121,7,414
25960,bright,main,20210927,7,0.9930968845872127,238,119,5,362
25960,bright,main,20210927,8,0.9881912622727076,221,106,6,333
25960,bright,main,20210927,9,0.9888526185245669,316,100,5,421
22272,bright,main,20210927,0,0.9928232089831998,371,55,4,430
22272,bright,main,20210927,1,0.9843070015422701,148,36,2,186
22272,bright,main,20210927,2,0.9930597890140027,357,57,4,418
22272,bright,main,20210927,3,0.9936257019258452,303,64,4,371
22272,bright,main,20210927,4,0.9885800254256752,174,25,1,200
22272,bright,main,20210927,5,0.9909568016111561,321,65,2,388
22272,bright,main,20210927,6,0.9923897819478684,328,76,4,408
22272,bright,main,20210927,7,0.9897590518854812,314,46,4,364
22272,bright,main,20210927,8,0.992107610293792,338,56,6,400
22272,bright,main,20210927,9,0.9867741242629515,335,68,9,412
2286,dark,main,20210927,0,0.9918587881585821,278,17,99,394
2286,dark,main,20210927,1,0.9789651498946489,141,7,26,174
2286,dark,main,20210927,2,0.9846826790477559,281,15,108,404
2286,dark,main,20210927,3,0.980243777733096,259,13,82,354
2286,dark,main,20210927,4,0.9662610022634801,122,7,56,185
2286,dark,main,20210927,5,0.9932387310597071,266,12,95,373
2286,dark,main,20210927,6,0.9960564836446839,278,14,94,386
2286,dark,main,20210927,7,0.9803941566467436,227,10,85,322
2286,dark,main,20210927,8,0.9945142601347373,268,16,91,375
2286,dark,main,20210927,9,0.9860221574375551,261,11,108,380
21049,bright,main,20210927,0,0.9892842192398881,311,105,5,421
21049,bright,main,20210927,1,0.9815698706002081,150,33,7,190
21049,bright,main,20210927,2,0.9932662401096071,356,63,6,425
21049,bright,main,20210927,3,0.9791072230764466,328,46,3,377
21049,bright,main,20210927,4,0.9890568822410548,161,38,0,199
21049,bright,main,20210927,5,0.9947754426435129,326,52,8,386
21049,bright,main,20210927,6,0.9891367943433319,321,85,5,411
21049,bright,main,20210927,7,0.9916063686719876,295,53,8,356
21049,bright,main,20210927,8,0.9899985214875389,332,65,3,400
21049,bright,main,20210927,9,0.9876242693415332,344,62,6,412
10928,dark,main,20210927,0,0.9935581872797922,256,18,119,393
10928,dark,main,20210927,1,0.9793495176122934,128,8,40,176
10928,dark,main,20210927,2,0.9933364655185049,298,11,84,393
10928,dark,main,20210927,3,0.9901534204920354,261,13,89,363
10928,dark,main,20210927,4,0.9855570437472609,132,15,39,186
10928,dark,main,20210927,5,0.993513380385551,269,17,86,372
10928,dark,main,20210927,6,0.9962120267676492,268,16,97,381
10928,dark,main,20210927,7,0.9906869116390704,236,13,84,333
10928,dark,main,20210927,8,0.9925099619279063,271,13,90,374
10928,dark,main,20210927,9,0.9879927290420445,258,19,95,372
22264,bright,main,20210927,0,0.9970884067902555,349,68,4,421
22264,bright,main,20210927,1,0.9928858045640123,155,32,3,190
22264,bright,main,20210927,2,0.9939071647576554,332,79,3,414
22264,bright,main,20210927,3,0.9953048296762277,333,44,8,385
22264,bright,main,20210927,4,0.9750906448748856,176,24,3,203
22264,bright,main,20210927,5,0.9887323158624743,339,48,5,392
22264,bright,main,20210927,6,0.9900945656562613,360,54,2,416
22264,bright,main,20210927,7,0.9909854074666159,292,59,7,358
22264,bright,main,20210927,8,0.9948308647563906,349,46,4,399
22264,bright,main,20210927,9,0.9911615702096055,350,60,6,416
22109,bright,main,20210927,0,0.9943429740193604,350,75,4,429
22109,bright,main,20210927,1,0.9848551802965846,163,29,2,194
22109,bright,main,20210927,2,0.9939314639878827,336,92,3,431
22109,bright,main,20210927,3,0.9882271352711722,250,134,5,389
22109,bright,main,20210927,4,0.9860009825565266,155,49,3,207
22109,bright,main,20210927,5,0.9937604718380834,238,161,0,399
22109,bright,main,20210927,6,0.991184182986536,219,197,4,420
22109,bright,main,20210927,7,0.9958906933420635,271,89,3,363
22109,bright,main,20210927,8,0.9926384126072474,320,86,3,409
22109,bright,main,20210927,9,0.9904583925954557,318,94,6,418
22390,bright,main,20210928,0,0.9933623589495875,213,222,0,435
22390,bright,main,20210928,1,0.9728958048087613,106,91,1,198
22390,bright,main,20210928,2,0.9942613896278051,147,279,3,429
22390,bright,main,20210928,3,0.9957774138978838,121,275,0,396
22390,bright,main,20210928,4,0.9885182176680563,76,130,3,209
22390,bright,main,20210928,5,0.9929979599478536,184,232,2,418
22390,bright,main,20210928,6,0.9927449994049176,211,216,2,429
22390,bright,main,20210928,7,0.9955206522144817,218,159,3,380
22390,bright,main,20210928,8,0.9967275972650399,280,144,2,426
22390,bright,main,20210928,9,0.9970601340013215,260,167,5,432
23955,bright,main,20210928,0,0.9974535549519723,217,215,5,437
23955,bright,main,20210928,1,0.9791944140578509,100,97,2,199
23955,bright,main,20210928,2,0.9939938967837818,277,149,1,427
23955,bright,main,20210928,3,0.9934536177150751,243,151,3,397
23955,bright,main,20210928,4,0.9817866909805092,113,96,2,211
23955,bright,main,20210928,5,0.9897511021299619,213,191,3,407
23955,bright,main,20210928,6,0.9938246289373226,248,178,3,429
23955,bright,main,20210928,7,0.9912847698048339,210,162,6,378
23955,bright,main,20210928,8,0.9929320909868793,147,276,3,426
23955,bright,main,20210928,9,0.9887138168100114,180,246,4,430
23956,bright,main,20210928,0,0.9964471087437586,349,84,3,436
23956,bright,main,20210928,1,0.9799456938449036,115,78,2,195
23956,bright,main,20210928,2,0.9977324050578169,200,231,4,435
23956,bright,main,20210928,3,0.994586193969514,253,144,2,399
23956,bright,main,20210928,4,0.9868421194071132,99,110,1,210
23956,bright,main,20210928,5,0.9896185175952618,156,254,2,412
23956,bright,main,20210928,6,0.9937132906251731,213,214,4,431
23956,bright,main,20210928,7,0.9929249420452737,259,119,1,379
23956,bright,main,20210928,8,0.989713235493846,253,172,4,429
23956,bright,main,20210928,9,0.9953928215142821,233,192,5,430
25580,bright,main,20210928,0,0.9941074186494602,301,123,5,429
25580,bright,main,20210928,1,0.984454175422613,100,95,1,196
25580,bright,main,20210928,2,0.9903406259863043,236,184,0,420
25580,bright,main,20210928,3,0.9929533948092661,249,148,3,400
25580,bright,main,20210928,4,0.9833575766895584,130,78,2,210
25580,bright,main,20210928,5,0.9955954431990895,226,185,4,415
25580,bright,main,20210928,6,0.994036398178173,273,143,5,421
25580,bright,main,20210928,7,0.9909343931025794,216,161,2,379
25580,bright,main,20210928,8,0.992496158146704,295,121,5,421
25580,bright,main,20210928,9,0.9895176339102617,314,118,3,435
25538,bright,main,20210928,0,0.9828676125515592,342,83,7,432
25538,bright,main,20210928,1,0.9750378366601368,147,50,1,198
25538,bright,main,20210928,2,0.994770870028217,350,70,5,425
25538,bright,main,20210928,3,0.9931251019526296,273,118,4,395
25538,bright,main,20210928,4,0.9811876129926653,153,56,2,211
25538,bright,main,20210928,5,0.989732980086655,346,70,3,419
25538,bright,main,20210928,6,0.9911099511785126,355,64,4,423
25538,bright,main,20210928,7,0.9905570158766922,261,113,3,377
25538,bright,main,20210928,8,0.9933691204362435,299,125,2,426
25538,bright,main,20210928,9,0.9960590785006734,290,130,5,425
23948,bright,main,20210928,0,0.9963998364365666,318,115,4,437
23948,bright,main,20210928,1,0.9689261755912338,105,90,2,197
23948,bright,main,20210928,2,0.9915093409007631,267,162,8,437
23948,bright,main,20210928,3,0.9893600003152311,218,174,5,397
23948,bright,main,20210928,4,0.9858872164651458,152,54,3,209
23948,bright,main,20210928,5,0.9923410045598675,280,129,4,413
23948,bright,main,20210928,6,0.9889778373714744,234,193,4,431
23948,bright,main,20210928,7,0.9946079804471155,266,103,7,376
23948,bright,main,20210928,8,0.9945365951373903,350,71,6,427
23948,bright,main,20210928,9,0.9926388359543409,336,82,4,422
9652,dark,main,20210928,0,0.9884479217486245,283,16,87,386
9652,dark,main,20210928,1,0.9731186488873431,121,6,32,159
9652,dark,main,20210928,2,0.9867072994770609,309,17,49,375
9652,dark,main,20210928,3,0.9919725275469231,270,12,67,349
9652,dark,main,20210928,4,0.9806579627565457,154,7,28,189
9652,dark,main,20210928,5,0.9861076619414654,290,13,63,366
9652,dark,main,20210928,6,0.9915353793904922,272,16,84,372
9652,dark,main,20210928,7,0.9860109656129018,234,16,77,327
9652,dark,main,20210928,8,0.9974553929103686,294,16,63,373
9652,dark,main,20210928,9,0.9890789434456944,259,16,96,371
23946,bright,main,20210928,0,0.9914492810465547,246,179,1,426
23946,bright,main,20210928,1,0.9919749758894923,113,83,3,199
23946,bright,main,20210928,2,0.9895909142413455,298,130,7,435
23946,bright,main,20210928,3,0.9885336238874688,275,117,6,398
23946,bright,main,20210928,4,0.9669956966737591,145,64,1,210
23946,bright,main,20210928,5,0.9940262445758352,304,107,4,415
23946,bright,main,20210928,6,0.9943270127834498,358,63,6,427
23946,bright,main,20210928,7,0.9741116270711708,255,116,6,377
23946,bright,main,20210928,8,0.990684378754555,293,130,3,426
23946,bright,main,20210928,9,0.9886900635952867,294,141,1,436
23296,bright,main,20210928,0,0.9963498179518989,349,71,4,424
23296,bright,main,20210928,1,0.9641411612141787,148,36,5,189
23296,bright,main,20210928,2,0.99395524708982,347,71,1,419
23296,bright,main,20210928,3,0.9877300280425905,337,44,2,383
23296,bright,main,20210928,4,0.9948324223063211,177,28,0,205
23296,bright,main,20210928,5,0.9936905151671243,324,61,6,391
23296,bright,main,20210928,6,0.9952616850233706,375,39,5,419
23296,bright,main,20210928,7,0.9891915791095005,322,42,7,371
23296,bright,main,20210928,8,0.9935345031438503,332,66,2,400
23296,bright,main,20210928,9,0.993064858420228,355,56,5,416
23991,bright,main,20210928,0,0.9924976449142467,279,150,3,432
23991,bright,main,20210928,1,0.9873926107255799,108,86,0,194
23991,bright,main,20210928,2,0.9919805534938115,230,190,5,425
23991,bright,main,20210928,3,0.9953488572638846,259,127,6,392
23991,bright,main,20210928,4,0.9922305376708821,118,86,2,206
23991,bright,main,20210928,5,0.9922064760225517,157,247,4,408
23991,bright,main,20210928,6,0.9926278497190707,233,180,7,420
23991,bright,main,20210928,7,0.9876412463280528,259,107,4,370
23991,bright,main,20210928,8,0.995351231634582,244,177,3,424
23991,bright,main,20210928,9,0.995185873130455,245,177,2,424
22389,bright,main,20210928,0,0.9899679192232446,116,320,1,437
22389,bright,main,20210928,1,0.9767743263325288,97,102,0,199
22389,bright,main,20210928,2,0.9932438887335814,286,143,1,430
22389,bright,main,20210928,3,0.9903780913349476,291,101,5,397
22389,bright,main,20210928,4,0.9915680854951695,146,62,4,212
22389,bright,main,20210928,5,0.9968280668513626,285,125,4,414
22389,bright,main,20210928,6,0.9934125464262255,310,112,4,426
22389,bright,main,20210928,7,0.9888551602258673,192,185,4,381
22389,bright,main,20210928,8,0.995516802218369,211,212,2,425
22389,bright,main,20210928,9,0.9946880381437394,122,308,1,431
25745,bright,main,20210928,0,0.9920469572801695,363,57,4,424
25745,bright,main,20210928,1,0.9718460321976462,151,24,1,176
25745,bright,main,20210928,2,0.9808082497135917,382,36,7,425
25745,bright,main,20210928,3,0.9914211596018555,310,72,4,386
25745,bright,main,20210928,4,0.982822565974537,180,19,2,201
25745,bright,main,20210928,5,0.9952778766049407,352,44,4,400
25745,bright,main,20210928,6,0.9941884548683662,359,54,2,415
25745,bright,main,20210928,7,0.9922073252549525,304,45,2,351
25745,bright,main,20210928,8,0.9912799061601659,352,48,1,401
25745,bright,main,20210928,9,0.9906777414510195,331,69,4,404
25984,bright,main,20210928,0,0.9880716539684118,345,74,4,423
25984,bright,main,20210928,1,0.9880716539684118,345,74,4,423
25984,bright,main,20210928,2,0.992194191979401,319,85,6,410
25984,bright,main,20210928,3,0.9943823524681111,307,64,6,377
25984,bright,main,20210928,4,0.9861978816327696,181,25,0,206
25984,bright,main,20210928,5,0.9909191072249302,328,61,8,397
25984,bright,main,20210928,6,0.9930101430775701,338,60,7,405
25984,bright,main,20210928,7,0.9937173015889138,301,58,1,360
25984,bright,main,20210928,8,0.9924028113207639,317,77,5,399
25984,bright,main,20210928,9,0.9967966465078291,340,69,0,409
9495,dark,main,20210930,0,0.9884607901172524,296,17,83,396
9495,dark,main,20210930,1,0.9762060812217491,126,7,39,172
9495,dark,main,20210930,2,0.989802379439467,291,14,88,393
9495,dark,main,20210930,3,0.9882289268304765,253,16,86,355
9495,dark,main,20210930,4,0.9920663258994613,130,10,38,178
9495,dark,main,20210930,5,0.9921882538698553,249,19,81,349
9495,dark,main,20210930,6,0.9878705996278759,266,13,102,381
9495,dark,main,20210930,7,0.9944369580544723,250,14,78,342
9495,dark,main,20210930,8,0.9946223655429878,263,17,97,377
9495,dark,main,20210930,9,0.9911892343175542,296,16,73,385
1682,dark,main,20210930,0,0.9900590153105993,296,15,88,399
1682,dark,main,20210930,1,0.9740097198299829,132,7,45,184
1682,dark,main,20210930,2,0.9939639851692331,290,18,101,409
1682,dark,main,20210930,3,0.9914830123829235,246,18,80,344
1682,dark,main,20210930,4,0.9865993655587405,110,11,43,164
1682,dark,main,20210930,5,0.99192494367431,148,12,63,223
1682,dark,main,20210930,6,0.9883269061708257,216,16,70,302
1682,dark,main,20210930,7,0.9957221367560143,232,20,69,321
1682,dark,main,20210930,8,0.9937190688239561,267,14,107,388
1682,dark,main,20210930,9,0.9899529959624745,275,13,92,380
10315,dark,main,20210930,0,0.9929037242827556,262,20,119,401
10315,dark,main,20210930,1,0.9768059423358172,131,6,36,173
10315,dark,main,20210930,2,0.9930784310456576,276,17,94,387
10315,dark,main,20210930,3,0.9910875078799064,223,14,120,357
10315,dark,main,20210930,4,0.9805623554200236,130,13,44,187
10315,dark,main,20210930,5,0.9945243674326439,265,15,95,375
10315,dark,main,20210930,6,0.9902165658387616,274,19,86,379
10315,dark,main,20210930,7,0.9888430260380299,242,14,86,342
10315,dark,main,20210930,8,0.9905641529610192,268,17,102,387
10315,dark,main,20210930,9,0.9912823766487922,291,19,76,386
21490,bright,main,20210930,0,0.9856536566732957,376,62,3,441
21490,bright,main,20210930,1,0.9842406915682106,163,34,0,197
21490,bright,main,20210930,2,0.9934444091964075,344,81,3,428
21490,bright,main,20210930,3,0.9944414804767024,311,82,2,395
21490,bright,main,20210930,4,0.9882115658011265,148,59,1,208
21490,bright,main,20210930,5,0.9939793668346192,323,85,0,408
21490,bright,main,20210930,6,0.9909107052713306,347,71,4,422
21490,bright,main,20210930,7,0.9929558895234507,323,40,8,371
21490,bright,main,20210930,8,0.9927344291264372,331,83,7,421
21490,bright,main,20210930,9,0.9890153375133798,354,58,9,421
4842,dark,main,20210930,0,0.9951709880842551,285,15,89,389
4842,dark,main,20210930,1,0.9825519929644481,130,5,36,171
4842,dark,main,20210930,2,0.9925853450003873,278,19,97,394
4842,dark,main,20210930,3,0.9890956072009897,249,12,86,347
4842,dark,main,20210930,4,0.9856572255531421,124,9,50,183
4842,dark,main,20210930,5,0.9920495289076652,282,11,73,366
4842,dark,main,20210930,6,0.9901785945771743,256,18,86,360
4842,dark,main,20210930,7,0.9944991307647733,235,18,80,333
4842,dark,main,20210930,8,0.9888050810899627,252,19,91,362
4842,dark,main,20210930,9,0.9937410954268996,278,14,77,369
10553,dark,main,20210930,0,0.9911915646750283,268,14,102,384
10553,dark,main,20210930,1,0.9765436040920811,134,11,35,180
10553,dark,main,20210930,2,0.9941625775518244,276,15,98,389
10553,dark,main,20210930,3,0.9872131354246102,257,18,89,364
10553,dark,main,20210930,4,0.9799895621993777,130,7,53,190
10553,dark,main,20210930,5,0.993339060820001,260,12,96,368
10553,dark,main,20210930,6,0.9892024706788036,272,13,105,390
10553,dark,main,20210930,7,0.9842200388107869,232,15,94,341
10553,dark,main,20210930,8,0.9929532590462882,245,22,102,369
10553,dark,main,20210930,9,0.9903668996757796,263,14,96,373
21718,bright,main,20210930,0,0.9895827579419249,338,86,2,426
21718,bright,main,20210930,1,0.9792800234245264,147,33,2,182
21718,bright,main,20210930,2,0.9968657154399087,319,99,6,424
21718,bright,main,20210930,3,0.9873802584215688,292,85,2,379
21718,bright,main,20210930,4,0.9880823182980246,180,18,2,200
21718,bright,main,20210930,5,0.9939683198852077,356,40,6,402
21718,bright,main,20210930,6,0.992104325162558,368,45,6,419
21718,bright,main,20210930,7,0.9911902026587638,296,65,6,367
21718,bright,main,20210930,8,0.9955820607148486,327,72,2,401
21718,bright,main,20210930,9,0.9904171642584553,301,100,3,404
23465,bright,main,20210930,0,0.9935454925372966,339,93,6,438
23465,bright,main,20210930,1,0.9752613061973449,141,45,4,190
23465,bright,main,20210930,2,0.9872064730306944,307,115,8,430
23465,bright,main,20210930,3,0.9905413944453565,278,113,3,394
23465,bright,main,20210930,4,0.9809451805489362,148,54,4,206
23465,bright,main,20210930,5,0.9699883028800599,147,43,1,191
23465,bright,main,20210930,6,0.9959294275607595,332,88,3,423
23465,bright,main,20210930,7,0.9865822741529452,275,89,5,369
23465,bright,main,20210930,8,0.995437846182045,313,93,5,411
23465,bright,main,20210930,9,0.9970631308859049,329,87,4,420
1315,dark,main,20210930,0,0.9959213808949945,269,14,112,395
1315,dark,main,20210930,1,0.9841883375626874,127,8,41,176
1315,dark,main,20210930,2,0.9924939442568788,266,31,86,383
1315,dark,main,20210930,3,0.9928073853872499,247,16,93,356
1315,dark,main,20210930,4,0.9866210889473334,145,8,38,191
1315,dark,main,20210930,5,0.980930051928886,260,19,82,361
1315,dark,main,20210930,6,0.9861394191155145,232,13,76,321
1315,dark,main,20210930,7,0.9893127348806965,223,22,89,334
1315,dark,main,20210930,8,0.9938219884177587,258,18,102,378
1315,dark,main,20210930,9,0.9923947259620672,263,17,103,383
21716,bright,main,20210930,0,0.9895732509336959,362,55,9,426
21716,bright,main,20210930,1,0.9884516971001411,137,38,4,179
21716,bright,main,20210930,2,0.9931304558002713,316,93,3,412
21716,bright,main,20210930,3,0.9944677535765463,318,55,5,378
21716,bright,main,20210930,4,0.9850404574615187,169,28,1,198
21716,bright,main,20210930,5,0.9937144450008396,324,53,4,381
21716,bright,main,20210930,6,0.9901948554684824,344,55,7,406
21716,bright,main,20210930,7,0.9923084590655112,318,42,1,361
21716,bright,main,20210930,8,0.9973380661946628,354,55,4,413
21716,bright,main,20210930,9,0.9923614561471578,344,54,1,399
6370,dark,main,20210930,0,0.9871949422247075,265,15,103,383
6370,dark,main,20210930,1,0.9847547565906842,122,12,35,169
6370,dark,main,20210930,2,0.9921726587465229,269,18,93,380
6370,dark,main,20210930,3,0.9896470412978556,250,21,74,345
6370,dark,main,20210930,4,0.9866749098303111,137,9,40,186
6370,dark,main,20210930,5,0.9936850292576709,252,13,99,364
6370,dark,main,20210930,6,0.989636933418368,279,13,90,382
6370,dark,main,20210930,7,0.9870112183734981,223,15,77,315
6370,dark,main,20210930,8,0.9949697947605123,248,21,89,358
6370,dark,main,20210930,9,0.9900275153725101,267,20,80,367
6369,dark,main,20210930,0,0.9955328834649733,280,15,91,386
6369,dark,main,20210930,1,0.9709888333300326,125,9,28,162
6369,dark,main,20210930,2,0.9938995548282364,258,16,112,386
6369,dark,main,20210930,3,0.9933031781326692,235,18,93,346
6369,dark,main,20210930,4,0.9933031781326692,235,18,93,346
6369,dark,main,20210930,5,0.9880323427380087,262,17,71,350
6369,dark,main,20210930,6,0.9897792766928157,275,18,82,375
6369,dark,main,20210930,7,0.9909636045538787,235,16,76,327
6369,dark,main,20210930,8,0.9948454742212236,265,18,97,380
6369,dark,main,20210930,9,0.9917709249546801,274,14,85,373
6569,dark,main,20211001,0,0.9900848415080958,267,18,99,384
6569,dark,main,20211001,1,0.9833133175887397,120,13,43,176
6569,dark,main,20211001,2,0.9882931780935111,274,17,84,375
6569,dark,main,20211001,3,0.9833351850933483,257,21,75,353
6569,dark,main,20211001,4,0.9895807745502538,145,7,33,185
6569,dark,main,20211001,5,0.9885407447097228,297,15,54,366
6569,dark,main,20211001,6,0.9933385275652198,310,11,47,368
6569,dark,main,20211001,7,0.9899082702088637,274,13,49,336
6569,dark,main,20211001,8,0.9902797975238649,299,11,60,370
6569,dark,main,20211001,9,0.9935819543277942,319,16,54,389
10934,dark,main,20211001,0,0.9878740373429064,263,14,110,387
10934,dark,main,20211001,1,0.9827040320586786,113,7,54,174
10934,dark,main,20211001,2,0.9946656904851371,279,12,94,385
10934,dark,main,20211001,3,0.9939973285446132,235,21,89,345
10934,dark,main,20211001,4,0.9731116767396653,123,6,50,179
10934,dark,main,20211001,5,0.9917338128950742,263,14,89,366
10934,dark,main,20211001,6,0.9926967570837386,256,22,87,365
10934,dark,main,20211001,7,0.9943588714885214,215,12,106,333
10934,dark,main,20211001,8,0.9908617902672967,266,18,93,377
10934,dark,main,20211001,9,0.9921123484694103,264,15,94,373
7806,dark,main,20211001,0,0.997495038208068,284,18,90,392
7806,dark,main,20211001,1,0.9781731581797929,114,8,51,173
7806,dark,main,20211001,2,0.989964736856057,259,16,100,375
7806,dark,main,20211001,3,0.9893726326582736,243,12,95,350
7806,dark,main,20211001,4,0.9597830320082397,133,9,49,191
7806,dark,main,20211001,5,0.9902163061946506,251,13,102,366
7806,dark,main,20211001,6,0.9928436811526085,274,13,89,376
7806,dark,main,20211001,7,0.9937618158668958,245,12,71,328
7806,dark,main,20211001,8,0.9930512839365929,273,18,89,380
7806,dark,main,20211001,9,0.9894008339531668,270,19,91,380
22237,bright,main,20211001,0,0.9947793394573082,356,72,5,433
22237,bright,main,20211001,1,0.9928662455669347,150,35,1,186
22237,bright,main,20211001,2,0.9925575793298871,341,64,13,418
22237,bright,main,20211001,3,0.9925882959611344,306,70,5,381
22237,bright,main,20211001,4,0.9943487164434361,138,60,2,200
22237,bright,main,20211001,5,0.9904824377707777,310,78,4,392
22237,bright,main,20211001,6,0.9930447975522391,351,55,3,409
22237,bright,main,20211001,7,0.9843877838604554,277,76,4,357
22237,bright,main,20211001,8,0.9947260427305203,320,70,5,395
22237,bright,main,20211001,9,0.9869468543692224,335,74,3,412
10546,dark,main,20211001,0,0.9920452177963932,252,15,113,380
10546,dark,main,20211001,1,0.9839853115802286,118,8,48,174
10546,dark,main,20211001,2,0.9932232958836641,292,15,88,395
10546,dark,main,20211001,3,0.9834934930596096,234,16,91,341
10546,dark,main,20211001,4,0.9864187064082247,134,8,46,188
10546,dark,main,20211001,5,0.9931744479582434,271,18,84,373
10546,dark,main,20211001,6,0.9930801870744198,274,14,101,389
10546,dark,main,20211001,7,0.9858391474120898,237,15,84,336
10546,dark,main,20211001,8,0.9935489025088424,258,19,110,387
10546,dark,main,20211001,9,0.9903646527705533,270,13,101,384
24011,bright,main,20211001,0,0.9867182147831904,278,149,2,429
24011,bright,main,20211001,1,0.9802909758937746,103,93,1,197
24011,bright,main,20211001,2,0.9926249226382621,271,164,2,437
24011,bright,main,20211001,3,0.9923197229540477,239,155,7,401
24011,bright,main,20211001,4,0.9828272014943497,156,52,1,209
24011,bright,main,20211001,5,0.9929463222983315,266,143,4,413
24011,bright,main,20211001,6,0.9925091048689698,291,140,3,434
24011,bright,main,20211001,7,0.99000374599916,281,89,4,374
24011,bright,main,20211001,8,0.9951350159715551,327,89,0,416
24011,bright,main,20211001,9,0.9888393649186021,283,140,4,427
10929,dark,main,20211001,0,0.9844190064856316,264,19,104,387
10929,dark,main,20211001,1,0.9839347401853596,124,8,45,177
10929,dark,main,20211001,2,0.9922462981391852,269,16,96,381
10929,dark,main,20211001,3,0.9953337047673186,242,19,101,362
10929,dark,main,20211001,4,0.9866137483254397,118,7,62,187
10929,dark,main,20211001,5,0.9933894874978172,256,13,98,367
10929,dark,main,20211001,6,0.9927862164870167,270,15,104,389
10929,dark,main,20211001,7,0.9902570377264174,220,19,89,328
10929,dark,main,20211001,8,0.9905970176488471,272,13,88,373
10929,dark,main,20211001,9,0.9854868422911391,260,18,105,383
9656,dark,main,20211001,0,0.99105269176759,262,20,85,367
9656,dark,main,20211001,1,0.9861384046517341,122,13,41,176
9656,dark,main,20211001,2,0.9864489118027112,271,16,91,378
9656,dark,main,20211001,3,0.9927951247865076,245,19,86,350
9656,dark,main,20211001,4,0.9901558848905477,114,18,53,185
9656,dark,main,20211001,5,0.9914307006141976,252,17,102,371
9656,dark,main,20211001,6,0.9896325089269709,270,23,82,375
9656,dark,main,20211001,7,0.9899327364119325,247,24,59,330
9656,dark,main,20211001,8,0.9880345695306396,280,17,53,350
9656,dark,main,20211001,9,0.9893383431954894,278,16,69,363
6364,dark,main,20211001,0,0.991375475488613,277,16,111,404
6364,dark,main,20211001,1,0.9852009885755767,113,9,51,173
6364,dark,main,20211001,2,0.9851464326299894,263,18,99,380
6364,dark,main,20211001,3,0.9947230313352505,251,16,85,352
6364,dark,main,20211001,4,0.9816135871519951,134,9,42,185
6364,dark,main,20211001,5,0.9909553822075688,259,17,91,367
6364,dark,main,20211001,6,0.9900736771918067,267,20,99,386
6364,dark,main,20211001,7,0.9827230381248688,227,16,88,331
6364,dark,main,20211001,8,0.987909744192025,260,21,96,377
6364,dark,main,20211001,9,0.9910247697169834,265,14,101,380
10531,dark,main,20211001,0,0.9898881376820222,291,14,84,389
10531,dark,main,20211001,1,0.9882490075205069,130,5,48,183
10531,dark,main,20211001,2,0.9890971187802159,275,14,95,384
10531,dark,main,20211001,3,0.9907297496875884,243,12,109,364
10531,dark,main,20211001,4,0.9860171941811229,134,5,49,188
10531,dark,main,20211001,5,0.9945502083544046,249,12,108,369
10531,dark,main,20211001,6,0.9970700980774282,290,16,80,386
10531,dark,main,20211001,7,0.9885627200714187,238,14,83,335
10531,dark,main,20211001,8,0.989783783694508,264,14,91,369
10531,dark,main,20211001,9,0.9967493833710959,263,12,104,379
7967,dark,main,20211001,0,0.9969541308279355,277,16,92,385
7967,dark,main,20211001,1,0.9671988351945106,128,6,43,177
7967,dark,main,20211001,2,0.9920656459393256,294,13,55,362
7967,dark,main,20211001,3,0.98858579126875,275,14,66,355
7967,dark,main,20211001,4,0.990645592917022,157,5,25,187
7967,dark,main,20211001,5,0.9912831651100593,301,11,51,363
7967,dark,main,20211001,6,0.9923906392033504,259,16,99,374
7967,dark,main,20211001,7,0.9890581190250731,243,22,76,341
7967,dark,main,20211001,8,0.9944785941330615,271,19,84,374
7967,dark,main,20211001,9,0.9911783627341604,275,12,93,380
4135,dark,main,20211001,0,0.9945653103419229,319,13,68,400
4135,dark,main,20211001,1,0.9793618579347358,140,7,21,168
4135,dark,main,20211001,2,0.9952172803061871,312,14,64,390
4135,dark,main,20211001,3,0.9893622164963932,272,13,70,355
4135,dark,main,20211001,4,0.9839657809541607,154,8,31,193
4135,dark,main,20211001,5,0.9954438072365913,275,13,85,373
4135,dark,main,20211001,6,0.9868545042269826,246,17,112,375
4135,dark,main,20211001,7,0.9907813831259359,244,17,71,332
4135,dark,main,20211001,8,0.9878709583276617,263,17,84,364
4135,dark,main,20211001,9,0.9942811118698767,289,16,79,384
20834,bright,main,20211001,0,0.9943318557313282,339,94,4,437
20834,bright,main,20211001,1,0.9818500209755282,154,43,1,198
20834,bright,main,20211001,2,0.9913324124122586,323,107,3,433
20834,bright,main,20211001,3,0.9945631151170131,250,150,1,401
20834,bright,main,20211001,4,0.9749407144641962,127,80,4,211
20834,bright,main,20211001,5,0.9931204613479494,290,114,4,408
20834,bright,main,20211001,6,0.990767417028019,256,175,1,432
20834,bright,main,20211001,7,0.9899671301229233,217,159,1,377
20834,bright,main,20211001,8,0.9956432951343093,234,184,1,419
20834,bright,main,20211001,9,0.9933059428257603,293,137,1,431
23958,bright,main,20211001,0,0.9927543139239314,269,165,1,435
23958,bright,main,20211001,1,0.9934055860111956,89,105,2,196
23958,bright,main,20211001,2,0.9930975956611133,205,220,1,426
23958,bright,main,20211001,3,0.9907679665909824,167,226,1,394
23958,bright,main,20211001,4,0.9952580243126411,78,129,2,209
23958,bright,main,20211001,5,0.9909766673060244,220,196,1,417
23958,bright,main,20211001,6,0.9897926694643177,178,255,0,433
23958,bright,main,20211001,7,0.9911192766096005,250,120,4,374
23958,bright,main,20211001,8,0.9862570843792806,241,182,4,427
23958,bright,main,20211001,9,0.9877603443579451,222,205,1,428
25524,bright,main,20211001,0,0.9935585485070246,174,261,1,436
25524,bright,main,20211001,1,0.987575475372823,55,137,0,192
25524,bright,main,20211001,2,0.995611672835652,236,188,4,428
25524,bright,main,20211001,3,0.9882314409355429,232,163,4,399
25524,bright,main,20211001,4,0.9889063350353398,127,81,2,210
25524,bright,main,20211001,5,0.9920904370787254,210,202,6,418
25524,bright,main,20211001,6,0.9937512708148276,238,186,3,427
25524,bright,main,20211001,7,0.9942869719331721,135,237,1,373
25524,bright,main,20211001,8,0.9946166300172596,185,238,3,426
25524,bright,main,20211001,9,0.9905803614675233,154,275,4,433
23962,bright,main,20211001,0,0.9918772582437806,281,162,3,446
23962,bright,main,20211001,1,0.9678427174781775,103,95,0,198
23962,bright,main,20211001,2,0.9967483894640659,206,219,3,428
23962,bright,main,20211001,3,0.9934343473433905,163,234,1,398
23962,bright,main,20211001,4,0.9797744629442215,130,80,1,211
23962,bright,main,20211001,5,0.9923675458540856,228,188,2,418
23962,bright,main,20211001,6,0.9925130733718992,299,132,2,433
23962,bright,main,20211001,7,0.9935357590512826,287,89,2,378
23962,bright,main,20211001,8,0.9967316611792086,298,124,3,425
23962,bright,main,20211001,9,0.9924305718794719,261,170,4,435
7957,dark,main,20211001,0,0.992602882030751,266,18,104,388
7957,dark,main,20211001,1,0.9795123946544444,121,8,47,176
7957,dark,main,20211001,2,0.9918964597463165,262,22,93,377
7957,dark,main,20211001,3,0.9870507239689037,230,16,104,350
7957,dark,main,20211001,4,0.9882646404761422,137,10,41,188
7957,dark,main,20211001,5,0.9959423143973032,255,17,89,361
7957,dark,main,20211001,6,0.9840849059733152,273,17,94,384
7957,dark,main,20211001,7,0.9913824518653668,218,19,90,327
7957,dark,main,20211001,8,0.9864949015485763,245,16,111,372
7957,dark,main,20211001,9,0.995137133959059,263,17,92,372
11896,dark,main,20211001,0,0.9906154168628565,298,13,70,381
11896,dark,main,20211001,1,0.9722738683301032,130,6,40,176
11896,dark,main,20211001,2,0.9911314297288523,294,22,66,382
11896,dark,main,20211001,3,0.9857712197589678,249,13,69,331
11896,dark,main,20211001,4,0.9775667929860954,139,9,40,188
11896,dark,main,20211001,5,0.9869455806359695,196,20,82,298
11896,dark,main,20211001,6,0.9930114525882934,244,21,64,329
11896,dark,main,20211001,7,0.9866729397261734,216,17,66,299
11896,dark,main,20211001,8,0.9878736504455554,274,19,83,376
11896,dark,main,20211001,9,0.9940146882530387,291,11,81,383
23968,bright,main,20211001,0,0.9865968101488877,294,143,0,437
23968,bright,main,20211001,1,0.9728921149905133,116,80,2,198
23968,bright,main,20211001,2,0.9959399629327021,243,195,1,439
23968,bright,main,20211001,3,0.9933990404578389,268,130,4,402
23968,bright,main,20211001,4,0.9903719411526726,92,115,3,210
23968,bright,main,20211001,5,0.9956434486812329,235,175,6,416
23968,bright,main,20211001,6,0.9891530233305114,256,173,4,433
23968,bright,main,20211001,7,0.9915800844329797,203,172,2,377
23968,bright,main,20211001,8,0.9940981684963249,189,234,2,425
23968,bright,main,20211001,9,0.9925517251150635,219,212,2,433
2739,dark,main,20211001,0,0.993649529520355,301,13,78,392
2739,dark,main,20211001,1,0.9698681805317694,128,5,47,180
2739,dark,main,20211001,2,0.995250350197317,296,15,77,388
2739,dark,main,20211001,3,0.9865103367943974,286,13,55,354
2739,dark,main,20211001,4,0.9830458607641341,140,9,45,194
2739,dark,main,20211001,5,0.9903590731129085,263,15,81,359
2739,dark,main,20211001,6,0.9918352367059071,265,13,112,390
2739,dark,main,20211001,7,0.991836082712372,232,14,76,322
2739,dark,main,20211001,8,0.9930565107881104,267,16,93,376
2739,dark,main,20211001,9,0.9913437255000007,291,13,88,392
4296,dark,main,20211001,0,0.9905282562786061,262,14,117,393
4296,dark,main,20211001,1,0.9791621294593048,127,5,42,174
4296,dark,main,20211001,2,0.9911424318802199,277,13,101,391
4296,dark,main,20211001,3,0.9886888046919947,267,16,79,362
4296,dark,main,20211001,4,0.9751532792497716,141,11,48,200
4296,dark,main,20211001,5,0.9890585458713583,270,10,105,385
4296,dark,main,20211001,6,0.9938632414008494,291,11,77,379
4296,dark,main,20211001,7,0.9901611479300269,261,12,66,339
4296,dark,main,20211001,8,0.9940849837660822,311,13,55,379
4296,dark,main,20211001,9,0.9896540479278905,259,18,109,386
7816,dark,main,20211001,0,0.9946230593257885,266,17,114,397
7816,dark,main,20211001,1,0.9830370244417109,129,3,50,182
7816,dark,main,20211001,2,0.9833203909632787,291,12,85,388
7816,dark,main,20211001,3,0.9935349823726541,266,16,79,361
7816,dark,main,20211001,4,0.9901516376590964,136,8,46,190
7816,dark,main,20211001,5,0.9843301418139506,275,17,79,371
7816,dark,main,20211001,6,0.9923864361261251,284,12,81,377
7816,dark,main,20211001,7,0.9908919278888845,246,11,85,342
7816,dark,main,20211001,8,0.9876952556178047,265,17,89,371
7816,dark,main,20211001,9,0.9866052853861862,268,15,86,369
4055,dark,main,20211001,0,0.9926527427225889,267,18,108,393
4055,dark,main,20211001,1,0.9779834239619404,131,7,31,169
4055,dark,main,20211001,2,0.9901905979515792,285,10,87,382
4055,dark,main,20211001,3,0.9945918447044225,265,17,63,345
4055,dark,main,20211001,4,0.9760849636645595,130,6,42,178
4055,dark,main,20211001,5,0.9889337228226543,279,14,71,364
4055,dark,main,20211001,6,0.9959332435111765,325,12,40,377
4055,dark,main,20211001,7,0.9908889915912962,259,15,69,343
4055,dark,main,20211001,8,0.9902599583315167,287,16,79,382
4055,dark,main,20211001,9,0.982022444125348,274,16,104,394
2750,dark,main,20211001,0,0.9922362640175081,280,10,100,390
2750,dark,main,20211001,1,0.975748785786931,133,6,41,180
2750,dark,main,20211001,2,0.9909857605153838,266,14,107,387
2750,dark,main,20211001,3,0.9866304607142731,253,14,91,358
2750,dark,main,20211001,4,0.9868541280838847,139,8,51,198
2750,dark,main,20211001,5,0.9885761720112008,288,15,77,380
2750,dark,main,20211001,6,0.9935188508399111,290,15,80,385
2750,dark,main,20211001,7,0.9858092775681548,232,21,86,339
2750,dark,main,20211001,8,0.9962443520833183,262,18,97,377
2750,dark,main,20211001,9,0.988423198167397,274,11,96,381
23959,bright,main,20211001,0,0.9953920665149463,191,250,3,444
23959,bright,main,20211001,1,0.9869348308586787,88,111,0,199
23959,bright,main,20211001,2,0.9921204882193089,268,163,1,432
23959,bright,main,20211001,3,0.9944737544751998,165,235,2,402
23959,bright,main,20211001,4,0.9873619545640817,83,125,2,210
23959,bright,main,20211001,5,0.9870335841406729,179,235,2,416
23959,bright,main,20211001,6,0.9879946691854832,240,188,3,431
23959,bright,main,20211001,7,0.9905064861201685,251,123,3,377
23959,bright,main,20211001,8,0.9884996752886106,150,275,1,426
23959,bright,main,20211001,9,0.9964679363196501,151,281,4,436
1676,dark,main,20211001,0,0.9887483750899546,252,17,100,369
1676,dark,main,20211001,1,0.9776559586146032,121,6,48,175
1676,dark,main,20211001,2,0.993929401300801,273,15,102,390
1676,dark,main,20211001,3,0.9920463013781599,243,16,102,361
1676,dark,main,20211001,4,0.9890335158144374,124,9,50,183
1676,dark,main,20211001,5,0.9938651029343504,268,11,88,367
1676,dark,main,20211001,6,0.9931344823902425,271,15,88,374
1676,dark,main,20211001,7,0.989965884347377,215,17,93,325
1676,dark,main,20211001,8,0.9901452180139076,252,15,91,358
1676,dark,main,20211001,9,0.9923003897784822,269,16,93,378
9664,dark,main,20211001,0,0.9883550474396218,294,20,82,396
9664,dark,main,20211001,1,0.9705756740621078,134,7,35,176
9664,dark,main,20211001,2,0.9877717049628008,302,21,65,388
9664,dark,main,20211001,3,0.9949773777821338,300,13,49,362
9664,dark,main,20211001,4,0.9718052143879455,158,6,16,180
9664,dark,main,20211001,5,0.989303806837917,258,15,71,344
9664,dark,main,20211001,6,0.9941275125675999,275,19,78,372
9664,dark,main,20211001,7,0.9905357764160646,213,18,90,321
9664,dark,main,20211001,8,0.9889947926360303,264,20,87,371
9664,dark,main,20211001,9,0.9907742991582831,279,14,75,368
3120,dark,main,20211001,0,0.9890999625065936,267,13,103,383
3120,dark,main,20211001,1,0.9864447397504349,123,8,47,178
3120,dark,main,20211001,2,0.9924567698700435,311,14,65,390
3120,dark,main,20211001,3,0.9941582864270668,294,12,62,368
3120,dark,main,20211001,4,0.9894554957025109,137,6,39,182
3120,dark,main,20211001,5,0.9881429096098605,285,26,55,366
3120,dark,main,20211001,6,0.9921374963687123,298,12,73,383
3120,dark,main,20211001,7,0.9888221468169331,247,18,65,330
3120,dark,main,20211001,8,0.9927198359598456,254,16,100,370
3120,dark,main,20211001,9,0.9959579296287053,259,14,99,372
7814,dark,main,20211001,0,0.9928773874868116,265,18,103,386
7814,dark,main,20211001,1,0.9792718585883516,130,11,37,178
7814,dark,main,20211001,2,0.9923545781966412,266,16,89,371
7814,dark,main,20211001,3,0.9946485739431917,253,9,81,343
7814,dark,main,20211001,4,0.9757385169497698,139,5,48,192
7814,dark,main,20211001,5,0.9961005706934128,269,13,80,362
7814,dark,main,20211001,6,0.9960487686274482,262,15,102,379
7814,dark,main,20211001,7,0.9916943765140546,234,12,90,336
7814,dark,main,20211001,8,0.9964756569547097,269,12,101,382
7814,dark,main,20211001,9,0.9896922443421606,271,21,83,375
11893,dark,main,20211001,0,0.9914841072689379,299,14,82,395
11893,dark,main,20211001,1,0.9768282231304339,126,5,36,167
11893,dark,main,20211001,2,0.9909762500756675,291,15,93,399
11893,dark,main,20211001,3,0.9874120564620346,246,12,82,340
11893,dark,main,20211001,4,0.9795757123532897,124,6,28,158
11893,dark,main,20211001,5,0.9839732728415456,247,14,76,337
11893,dark,main,20211001,6,0.9893137864443885,294,12,78,384
11893,dark,main,20211001,7,0.9942360035833693,234,16,81,331
11893,dark,main,20211001,8,0.9937484159677483,277,14,97,388
11893,dark,main,20211001,9,0.9932287127952611,270,13,104,387
1680,dark,main,20211001,0,0.9920398644398376,267,20,103,390
1680,dark,main,20211001,1,0.9780591116719274,130,7,34,171
1680,dark,main,20211001,2,0.9895722273083372,307,17,74,398
1680,dark,main,20211001,3,0.9957010373446802,253,17,76,346
1680,dark,main,20211001,4,0.9891899841871147,133,7,38,178
1680,dark,main,20211001,5,0.9910004471788536,284,16,64,364
1680,dark,main,20211001,6,0.9916668113520026,289,13,85,387
1680,dark,main,20211001,7,0.9844759710199917,238,17,72,327
1680,dark,main,20211001,8,0.9909536728879804,255,14,115,384
1680,dark,main,20211001,9,0.9927049693094276,269,14,101,384
3113,dark,main,20211001,0,0.9954397680235725,277,14,99,390
3113,dark,main,20211001,1,0.9893199407565277,129,6,44,179
3113,dark,main,20211001,2,0.9910970283970433,287,13,92,392
3113,dark,main,20211001,3,0.9859574919374219,261,16,90,367
3113,dark,main,20211001,4,0.961799054115211,129,5,53,187
3113,dark,main,20211001,5,0.9924210447991534,256,12,101,369
3113,dark,main,20211001,6,0.9929539642973907,302,15,79,396
3113,dark,main,20211001,7,0.9906739277229799,256,17,74,347
3113,dark,main,20211001,8,0.9867744764503539,283,20,73,376
3113,dark,main,20211001,9,0.9935435650703329,263,15,103,381
5700,dark,main,20211001,0,0.9924160956980556,291,22,78,391
5700,dark,main,20211001,1,0.9742671461006116,128,5,43,176
5700,dark,main,20211001,2,0.9891495102533042,286,20,83,389
5700,dark,main,20211001,3,0.991694109987807,250,14,86,350
5700,dark,main,20211001,4,0.97450226205427,153,5,29,187
5700,dark,main,20211001,5,0.9912103355570455,311,14,51,376
5700,dark,main,20211001,6,0.9943909869929667,304,13,66,383
5700,dark,main,20211001,7,0.9922164331671779,263,14,56,333
5700,dark,main,20211001,8,0.9937185167763133,277,15,68,360
5700,dark,main,20211001,9,0.9925368317519121,303,12,74,389
6560,dark,main,20211001,0,0.9888247932359131,298,19,58,375
6560,dark,main,20211001,1,0.9902779868318022,150,6,20,176
6560,dark,main,20211001,2,0.9870180502799561,287,13,70,370
6560,dark,main,20211001,3,0.9912561351920822,290,15,41,346
6560,dark,main,20211001,4,0.9772535679573416,150,7,33,190
6560,dark,main,20211001,5,0.9919301642856673,262,16,87,365
6560,dark,main,20211001,6,0.9953290365098935,285,14,91,390
6560,dark,main,20211001,7,0.9948157105641577,235,13,87,335
6560,dark,main,20211001,8,0.9909918375054141,262,17,96,375
6560,dark,main,20211001,9,0.9929461315731675,271,13,76,360
26262,bright,main,20211002,0,0.9944707843109081,241,184,5,430
26262,bright,main,20211002,1,0.9805912030430144,93,103,2,198
26262,bright,main,20211002,2,0.9924432316888775,201,230,2,433
26262,bright,main,20211002,3,0.9857997760758884,210,184,3,397
26262,bright,main,20211002,4,0.9859437121081182,117,89,2,208
26262,bright,main,20211002,5,0.9908196536385152,332,81,4,417
26262,bright,main,20211002,6,0.9895191724672436,337,95,2,434
26262,bright,main,20211002,7,0.9928146747515347,229,146,0,375
26262,bright,main,20211002,8,0.9949711796460134,243,172,4,419
26262,bright,main,20211002,9,0.9939201582810323,229,201,3,433
9510,dark,main,20211002,0,0.9936494222484472,322,15,53,390
9510,dark,main,20211002,1,0.9910544693857799,148,7,15,170
9510,dark,main,20211002,2,0.9947837923329175,327,12,49,388
9510,dark,main,20211002,3,0.9916029324570325,297,18,39,354
9510,dark,main,20211002,4,0.9871865260985546,155,11,24,190
9510,dark,main,20211002,5,0.9955615407935796,275,14,81,370
9510,dark,main,20211002,6,0.9911836429897763,296,11,74,381
9510,dark,main,20211002,7,0.9873819136714963,254,11,73,338
9510,dark,main,20211002,8,0.9935083334796104,265,19,82,366
9510,dark,main,20211002,9,0.9925613079191321,292,14,70,376
2749,dark,main,20211002,0,0.9907866467199963,274,14,93,381
2749,dark,main,20211002,1,0.981189534859901,130,10,38,178
2749,dark,main,20211002,2,0.9899291859423374,275,20,97,392
2749,dark,main,20211002,3,0.9932992511312088,264,17,75,356
2749,dark,main,20211002,4,0.992143347770899,143,11,35,189
2749,dark,main,20211002,5,0.9939543085244892,302,14,64,380
2749,dark,main,20211002,6,0.995461482235587,295,12,65,372
2749,dark,main,20211002,7,0.9910591637051684,247,15,75,337
2749,dark,main,20211002,8,0.9946752442158244,270,11,91,372
2749,dark,main,20211002,9,0.9943454042296187,302,14,66,382
2048,dark,main,20211002,0,0.9887101092399985,320,11,59,390
2048,dark,main,20211002,1,0.9757170412273605,142,6,25,173
2048,dark,main,20211002,2,0.993767410472719,316,12,59,387
2048,dark,main,20211002,3,0.9923536321028539,291,12,60,363
2048,dark,main,20211002,4,0.9849431844747664,124,9,57,190
2048,dark,main,20211002,5,0.9856923141198862,269,12,89,370
2048,dark,main,20211002,6,0.9854661910675802,283,12,91,386
2048,dark,main,20211002,7,0.9956866228862808,261,14,68,343
2048,dark,main,20211002,8,0.9856592992404051,277,12,83,372
2048,dark,main,20211002,9,0.9920887692566542,325,11,50,386
1855,dark,main,20211002,0,0.9896243283929612,324,12,58,394
1855,dark,main,20211002,1,0.9829357029763807,121,14,29,164
1855,dark,main,20211002,2,0.9948238144408371,305,16,62,383
1855,dark,main,20211002,3,0.9905835585960698,271,19,69,359
1855,dark,main,20211002,4,0.9883472716130436,119,11,46,176
1855,dark,main,20211002,5,0.9905276272994685,241,13,85,339
1855,dark,main,20211002,6,0.9893977877569059,268,19,98,385
1855,dark,main,20211002,7,0.9945448110083954,259,15,69,343
1855,dark,main,20211002,8,0.9917100368836728,298,14,57,369
1855,dark,main,20211002,9,0.9898846581297528,308,18,52,378
23047,bright,main,20211002,0,0.9931631439716505,381,55,2,438
23047,bright,main,20211002,1,0.9843320921068438,159,32,0,191
23047,bright,main,20211002,2,0.9936184857830912,322,108,6,436
23047,bright,main,20211002,3,0.9903807672160905,272,123,1,396
23047,bright,main,20211002,4,0.976177002238795,146,60,1,207
23047,bright,main,20211002,5,0.9939604793819432,306,103,3,412
23047,bright,main,20211002,6,0.9922124755317795,324,103,5,432
23047,bright,main,20211002,7,0.9892106145740773,265,107,4,376
23047,bright,main,20211002,8,0.9959938504728546,337,88,5,430
23047,bright,main,20211002,9,0.9918040374599979,353,77,0,430
11055,dark,main,20211002,0,0.9929570495817315,283,16,87,386
11055,dark,main,20211002,1,0.9561757900000152,148,7,24,179
11055,dark,main,20211002,2,0.9898325654690068,313,13,65,391
11055,dark,main,20211002,3,0.9887593115865242,284,10,53,347
11055,dark,main,20211002,4,0.9887616700576729,151,5,31,187
11055,dark,main,20211002,5,0.9941684890065714,277,20,73,370
11055,dark,main,20211002,6,0.9930627167727974,256,15,94,365
11055,dark,main,20211002,7,0.9854609267007651,250,16,63,329
11055,dark,main,20211002,8,0.9948298255972362,276,14,85,375
11055,dark,main,20211002,9,0.9893395454724011,243,21,106,370
7455,dark,main,20211002,0,0.9938642883511585,282,11,94,387
7455,dark,main,20211002,1,0.985504352049725,130,9,33,172
7455,dark,main,20211002,2,0.9933437193141313,343,13,43,399
7455,dark,main,20211002,3,0.9913036921312854,278,10,58,346
7455,dark,main,20211002,4,0.9859236535089917,149,4,31,184
7455,dark,main,20211002,5,0.9928241652519124,294,14,61,369
7455,dark,main,20211002,6,0.9930559816204932,282,14,76,372
7455,dark,main,20211002,7,0.9890808381431977,284,11,50,345
7455,dark,main,20211002,8,0.9918731001919852,311,14,64,389
7455,dark,main,20211002,9,0.9955109495543711,283,13,87,383
3811,dark,main,20211002,0,0.9940894660132589,272,12,105,389
3811,dark,main,20211002,1,0.9918746579071327,122,4,48,174
3811,dark,main,20211002,2,0.9907821728348202,293,10,85,388
3811,dark,main,20211002,3,0.9891571854571545,260,11,83,354
3811,dark,main,20211002,4,0.9752335604247705,132,10,45,187
3811,dark,main,20211002,5,0.9839820315407134,260,11,100,371
3811,dark,main,20211002,6,0.9919009329063133,299,10,82,391
3811,dark,main,20211002,7,0.9912118046672905,247,17,70,334
3811,dark,main,20211002,8,0.9872268777700143,258,12,97,367
3811,dark,main,20211002,9,0.9907962319548957,290,15,75,380
6758,dark,main,20211002,0,0.9892478214724895,323,13,57,393
6758,dark,main,20211002,1,0.991357706214961,124,8,43,175
6758,dark,main,20211002,2,0.9913478695361331,267,18,103,388
6758,dark,main,20211002,3,0.9945006993677064,251,13,110,374
6758,dark,main,20211002,4,0.9804218220859683,121,5,71,197
6758,dark,main,20211002,5,0.9861874731468511,271,17,92,380
6758,dark,main,20211002,6,0.9934120712993472,266,14,107,387
6758,dark,main,20211002,7,0.992943513952913,265,16,52,333
6758,dark,main,20211002,8,0.9809225262062102,293,13,59,365
6758,dark,main,20211002,9,0.9802799271897854,291,11,72,374
9617,dark,main,20211002,0,0.9886967007042943,265,24,87,376
9617,dark,main,20211002,1,0.9850055236136215,109,12,53,174
9617,dark,main,20211002,2,0.9885011659953972,282,24,77,383
9617,dark,main,20211002,3,0.9941286031066084,236,24,94,354
9617,dark,main,20211002,4,0.9853292992993462,118,17,49,184
9617,dark,main,20211002,5,0.9899911952690568,270,18,84,372
9617,dark,main,20211002,6,0.9957525475342198,301,16,66,383
9617,dark,main,20211002,7,0.9927580962074776,250,19,48,317
9617,dark,main,20211002,8,0.9940380804481489,281,23,67,371
9617,dark,main,20211002,9,0.9971919654979353,251,22,91,364
8126,dark,main,20211002,0,0.9957737116302705,319,12,43,374
8126,dark,main,20211002,1,0.9943021314469244,145,6,23,174
8126,dark,main,20211002,2,0.992437483019787,323,14,48,385
8126,dark,main,20211002,3,0.9912150331018678,269,11,77,357
8126,dark,main,20211002,4,0.9843751841985279,131,9,46,186
8126,dark,main,20211002,5,0.9963457871608149,269,13,87,369
8126,dark,main,20211002,6,0.9948481438734685,271,13,96,380
8126,dark,main,20211002,7,0.9933269895218758,236,18,85,339
8126,dark,main,20211002,8,0.991277289804866,274,23,61,358
8126,dark,main,20211002,9,0.9909961430850649,307,15,52,374
25380,bright,main,20211002,0,0.9935737064787221,364,53,4,421
25380,bright,main,20211002,1,0.9660681193223357,156,25,1,182
25380,bright,main,20211002,2,0.9942603008015899,357,64,4,425
25380,bright,main,20211002,3,0.9949638104407141,337,48,0,385
25380,bright,main,20211002,4,0.9706796778621005,164,41,1,206
25380,bright,main,20211002,5,0.9958756365921428,331,66,6,403
25380,bright,main,20211002,6,0.9963408334063408,348,64,5,417
25380,bright,main,20211002,7,0.9858975270489457,285,71,2,358
25380,bright,main,20211002,8,0.9907773285871514,328,74,3,405
25380,bright,main,20211002,9,0.9955457690174881,336,69,7,412
22442,bright,main,20211002,0,0.992688859050921,233,200,3,436
22442,bright,main,20211002,1,0.9920701334212009,99,98,1,198
22442,bright,main,20211002,2,0.9922615137605602,259,169,5,433
22442,bright,main,20211002,3,0.9946996677928481,265,127,7,399
22442,bright,main,20211002,4,0.9756473009868755,136,72,2,210
22442,bright,main,20211002,5,0.992324303423406,296,120,2,418
22442,bright,main,20211002,6,0.9943431417498365,294,135,1,430
22442,bright,main,20211002,7,0.992120625601852,262,111,4,377
22442,bright,main,20211002,8,0.9950260240817781,271,144,2,417
22442,bright,main,20211002,9,0.9937657860456889,250,173,6,429
9631,dark,main,20211002,0,0.9879756942632071,273,34,56,363
9631,dark,main,20211002,1,0.9716039112736553,121,13,25,159
9631,dark,main,20211002,2,0.9886655446749225,281,26,49,356
9631,dark,main,20211002,3,0.9932489692165781,264,30,42,336
9631,dark,main,20211002,4,0.9792850497514005,130,26,17,173
9631,dark,main,20211002,5,0.9871880814049997,277,26,56,359
9631,dark,main,20211002,6,0.9929786099427268,242,46,75,363
9631,dark,main,20211002,7,0.9840791800327909,220,31,52,303
9631,dark,main,20211002,8,0.9941341264175924,228,66,67,361
9631,dark,main,20211002,9,0.9911639731814802,221,75,68,364
11054,dark,main,20211002,0,0.991664085119334,274,17,85,376
11054,dark,main,20211002,1,0.9770868827085848,126,7,42,175
11054,dark,main,20211002,2,0.992676631704892,308,11,58,377
11054,dark,main,20211002,3,0.9886054973893894,278,14,64,356
11054,dark,main,20211002,4,0.979624415582454,146,12,31,189
11054,dark,main,20211002,5,0.987920654111241,288,11,63,362
11054,dark,main,20211002,6,0.985949856036297,287,14,75,376
11054,dark,main,20211002,7,0.9891205511130017,249,13,67,329
11054,dark,main,20211002,8,0.9946897183761965,264,16,84,364
11054,dark,main,20211002,9,0.9933564160960587,275,17,81,373
1536,dark,main,20211002,0,0.9933903573842622,269,17,99,385
1536,dark,main,20211002,1,0.9773437250810211,129,9,38,176
1536,dark,main,20211002,2,0.991948837991261,282,17,84,383
1536,dark,main,20211002,3,0.9930908067675079,277,15,61,353
1536,dark,main,20211002,4,0.9896910147955518,144,6,38,188
1536,dark,main,20211002,5,0.9923853138655953,295,13,60,368
1536,dark,main,20211002,6,0.9921724096413084,309,14,61,384
1536,dark,main,20211002,7,0.9937346524168637,262,14,56,332
1536,dark,main,20211002,8,0.9955802406722528,274,16,80,370
1536,dark,main,20211002,9,0.996069403900986,264,15,98,377
3390,dark,main,20211002,0,0.9901601315046031,295,23,60,378
3390,dark,main,20211002,1,0.9765849902701755,144,9,19,172
3390,dark,main,20211002,2,0.9930674409745851,269,22,69,360
3390,dark,main,20211002,3,0.9822707251990193,276,24,44,344
3390,dark,main,20211002,4,0.9895108019901651,148,16,20,184
3390,dark,main,20211002,5,0.9909773410902325,297,14,36,347
3390,dark,main,20211002,6,0.9930765315150538,313,17,44,374
3390,dark,main,20211002,7,0.9945974267498159,247,26,63,336
3390,dark,main,20211002,8,0.9887658055037756,268,23,69,360
3390,dark,main,20211002,9,0.9886936319199376,293,22,48,363
7402,dark,main,20211002,0,0.9961920732615789,278,13,89,380
7402,dark,main,20211002,1,0.9759396638381564,132,4,37,173
7402,dark,main,20211002,2,0.9879114595303963,269,12,84,365
7402,dark,main,20211002,3,0.9877908620492901,247,12,102,361
7402,dark,main,20211002,4,0.9877908620492901,247,12,102,361
7402,dark,main,20211002,5,0.9890368471412984,265,12,92,369
7402,dark,main,20211002,6,0.992222094954063,272,16,97,385
7402,dark,main,20211002,7,0.9938923123841851,227,17,79,323
7402,dark,main,20211002,8,0.9939272020485183,270,14,96,380
7402,dark,main,20211002,9,0.9895028372306706,256,13,106,375
6933,dark,main,20211002,0,0.9897913786032705,294,12,80,386
6933,dark,main,20211002,1,0.9827856770292346,125,9,42,176
6933,dark,main,20211002,2,0.9936778216373852,295,16,89,400
6933,dark,main,20211002,3,0.9882254397938391,261,13,88,362
6933,dark,main,20211002,4,0.9890256603572763,138,4,45,187
6933,dark,main,20211002,5,0.9859279037106625,263,12,84,359
6933,dark,main,20211002,6,0.9879511415902484,310,12,74,396
6933,dark,main,20211002,7,0.9919234512152738,266,12,50,328
6933,dark,main,20211002,8,0.9959348526211992,304,17,56,377
6933,dark,main,20211002,9,0.9949993277185043,296,11,71,378
2262,dark,main,20211002,0,0.991752575194137,279,17,97,393
2262,dark,main,20211002,1,0.9763020264081751,130,7,37,174
2262,dark,main,20211002,2,0.9899924796760867,278,14,92,384
2262,dark,main,20211002,3,0.9875219701577344,273,16,66,355
2262,dark,main,20211002,4,0.9854721028650758,139,13,40,192
2262,dark,main,20211002,5,0.9924301357238452,277,11,75,363
2262,dark,main,20211002,6,0.9852424208261612,298,15,61,374
2262,dark,main,20211002,7,0.9940168532831336,255,13,66,334
2262,dark,main,20211002,8,0.9948926267646774,297,12,66,375
2262,dark,main,20211002,9,0.9950858693253887,287,15,82,384
1864,dark,main,20211002,0,0.9916955758065052,334,11,60,405
1864,dark,main,20211002,1,0.9932873442778909,146,4,21,171
1864,dark,main,20211002,2,0.9948347595686395,311,15,48,374
1864,dark,main,20211002,3,0.9913432858594595,287,15,49,351
1864,dark,main,20211002,4,0.986138878311914,136,10,43,189
1864,dark,main,20211002,5,0.9939458272213503,286,14,79,379
1864,dark,main,20211002,6,0.9911090232573,277,21,87,385
1864,dark,main,20211002,7,0.9897981787141942,239,18,66,323
1864,dark,main,20211002,8,0.9904609608710644,275,18,79,372
1864,dark,main,20211002,9,0.9916884581497444,298,14,63,375
6029,dark,main,20211002,0,0.9928888154794484,296,13,75,384
6029,dark,main,20211002,1,0.979584054634732,127,8,33,168
6029,dark,main,20211002,2,0.9923666223420009,303,13,59,375
6029,dark,main,20211002,3,0.985386557504459,281,15,53,349
6029,dark,main,20211002,4,0.9848024309530075,163,7,13,183
6029,dark,main,20211002,5,0.9888898924250041,290,11,62,363
6029,dark,main,20211002,6,0.9923205984170654,326,10,53,389
6029,dark,main,20211002,7,0.9920312585627228,267,13,57,337
6029,dark,main,20211002,8,0.9943010393399343,293,16,63,372
6029,dark,main,20211002,9,0.9942670423475382,308,17,67,392
8966,dark,main,20211002,0,0.9916144895181518,279,11,91,381
8966,dark,main,20211002,1,0.975989029420299,135,3,36,174
8966,dark,main,20211002,2,0.9893261774755829,276,12,99,387
8966,dark,main,20211002,3,0.9966641373066423,247,16,101,364
8966,dark,main,20211002,4,0.984175595102146,137,9,48,194
8966,dark,main,20211002,5,0.9883525769738194,278,12,81,371
8966,dark,main,20211002,6,0.9904666435429734,266,14,105,385
8966,dark,main,20211002,7,0.9858428156552251,234,15,85,334
8966,dark,main,20211002,8,0.993116322279438,272,12,94,378
8966,dark,main,20211002,9,0.9914375200125092,261,15,96,372
11205,dark,main,20211002,0,0.9885581201154723,287,23,61,371
11205,dark,main,20211002,1,0.9761703199775005,124,11,28,163
11205,dark,main,20211002,2,0.9924719027690013,308,21,53,382
11205,dark,main,20211002,3,0.9891688148491055,264,23,61,348
11205,dark,main,20211002,4,0.9816614874291716,154,11,19,184
11205,dark,main,20211002,5,0.9951121444067232,303,15,37,355
11205,dark,main,20211002,6,0.9946579524902117,305,18,58,381
11205,dark,main,20211002,7,0.9913411737617578,272,24,34,330
11205,dark,main,20211002,8,0.9924889143525052,305,19,46,370
11205,dark,main,20211002,9,0.9918588457372177,262,25,85,372
25569,bright,main,20211003,0,0.990683427462429,249,179,4,432
25569,bright,main,20211003,1,0.9911743435173509,112,82,3,197
25569,bright,main,20211003,2,0.9915664180068946,325,101,5,431
25569,bright,main,20211003,3,0.9930058647465141,260,120,6,386
25569,bright,main,20211003,4,0.9851589071473037,126,76,2,204
25569,bright,main,20211003,5,0.9926361792281443,273,132,3,408
25569,bright,main,20211003,6,0.9915747602719572,251,167,3,421
25569,bright,main,20211003,7,0.9947971859295122,202,168,2,372
25569,bright,main,20211003,8,0.9906592740120553,222,191,4,417
25569,bright,main,20211003,9,0.9910712015010807,280,149,1,430
20536,bright,main,20211003,0,0.9900638600488519,284,138,4,426
20536,bright,main,20211003,1,0.989619097858437,145,44,2,191
20536,bright,main,20211003,2,0.9892807462997413,297,125,3,425
20536,bright,main,20211003,3,0.9943786445407383,229,154,4,387
20536,bright,main,20211003,4,0.9807258253260186,124,82,2,208
20536,bright,main,20211003,5,0.9885505991004373,198,204,2,404
20536,bright,main,20211003,6,0.9928633966356679,259,150,8,417
20536,bright,main,20211003,7,0.9908755550055193,229,127,8,364
20536,bright,main,20211003,8,0.9916688509999914,309,97,10,416
20536,bright,main,20211003,9,0.9916684434949976,324,91,4,419
4817,dark,main,20211003,0,0.989971350208084,287,13,93,393
4817,dark,main,20211003,1,0.9782729918642952,138,6,28,172
4817,dark,main,20211003,2,0.9907903527106132,300,14,75,389
4817,dark,main,20211003,3,0.9922549928185327,271,13,66,350
4817,dark,main,20211003,4,0.9827553346861977,127,7,51,185
4817,dark,main,20211003,5,0.9909729312363549,278,19,58,355
4817,dark,main,20211003,6,0.9962083924225958,307,15,48,370
4817,dark,main,20211003,7,0.9875731926853547,254,11,67,332
4817,dark,main,20211003,8,0.9918303682332519,297,12,60,369
4817,dark,main,20211003,9,0.995173671718644,299,16,59,374
82259,bright,special,20211003,0,0.9924744773530052,351,85,2,438
82259,bright,special,20211003,1,0.9884331345136007,147,47,1,195
82259,bright,special,20211003,2,0.9916984246204404,325,102,4,431
82259,bright,special,20211003,3,0.9897140173941295,298,98,3,399
82259,bright,special,20211003,4,0.9570614822840399,163,45,0,208
82259,bright,special,20211003,5,0.9909788829531171,290,119,6,415
82259,bright,special,20211003,6,0.9888530051763981,258,108,1,367
82259,bright,special,20211003,7,0.9893342973295051,257,111,3,371
82259,bright,special,20211003,8,0.9910802133388071,326,88,5,419
82259,bright,special,20211003,9,0.9913570361953102,321,102,5,428
9512,dark,main,20211003,0,0.9921848587757739,280,12,100,392
9512,dark,main,20211003,1,0.98152942229492,119,9,40,168
9512,dark,main,20211003,2,0.9920917212284969,266,16,102,384
9512,dark,main,20211003,3,0.9860308535073684,242,13,86,341
9512,dark,main,20211003,4,0.9890224472555528,136,9,41,186
9512,dark,main,20211003,5,0.9921007910880376,241,19,96,356
9512,dark,main,20211003,6,0.9942560021196477,279,16,87,382
9512,dark,main,20211003,7,0.9842888217080175,244,14,69,327
9512,dark,main,20211003,8,0.9943467102525028,262,15,88,365
9512,dark,main,20211003,9,0.9919432253107602,286,27,83,396
24700,bright,main,20211003,0,0.9971847807675193,309,118,3,430
24700,bright,main,20211003,1,0.9773551160713968,153,39,2,194
24700,bright,main,20211003,2,0.9911984845331399,283,133,9,425
24700,bright,main,20211003,3,0.9945606253139382,197,181,5,383
24700,bright,main,20211003,4,0.9847486563882386,94,108,5,207
24700,bright,main,20211003,5,0.9896343593176476,197,210,4,411
24700,bright,main,20211003,6,0.9928664458494251,252,164,5,421
24700,bright,main,20211003,7,0.986613249990574,150,216,2,368
24700,bright,main,20211003,8,0.9944854263571047,237,175,2,414
24700,bright,main,20211003,9,0.994251996736946,260,152,8,420
22234,bright,main,20211003,0,0.9900227148776194,360,55,4,419
22234,bright,main,20211003,1,0.9841932746862073,157,25,2,184
22234,bright,main,20211003,2,0.9866568446795856,353,63,2,418
22234,bright,main,20211003,3,0.9963798852786928,308,63,3,374
22234,bright,main,20211003,4,0.9926562169917535,140,53,2,195
22234,bright,main,20211003,5,0.9914540071808876,281,89,7,377
22234,bright,main,20211003,6,0.9870853931201189,287,107,6,400
22234,bright,main,20211003,7,0.9905632696937748,302,56,6,364
22234,bright,main,20211003,8,0.9927095936392065,358,42,2,402
22234,bright,main,20211003,9,0.9916206927438881,358,53,3,414
82263,bright,special,20211003,0,0.9928156136416263,231,201,0,432
82263,bright,special,20211003,1,0.9883099331766763,111,84,1,196
82263,bright,special,20211003,2,0.9953636335681947,249,182,2,433
82263,bright,special,20211003,3,0.9926138873558968,205,189,2,396
82263,bright,special,20211003,4,0.9833625625724078,81,128,2,211
82263,bright,special,20211003,5,0.9954246477927914,200,202,1,403
82263,bright,special,20211003,6,0.9926521542247267,136,229,1,366
82263,bright,special,20211003,7,0.989103122168981,169,195,3,367
82263,bright,special,20211003,8,0.9938663293988474,198,216,2,416
82263,bright,special,20211003,9,0.9915425979339566,256,162,5,423
21288,bright,main,20211003,0,0.9857746386539841,346,80,7,433
21288,bright,main,20211003,1,0.9835862183214388,138,54,1,193
21288,bright,main,20211003,2,0.9962302589902723,346,86,4,436
21288,bright,main,20211003,3,0.9943048613623561,324,72,3,399
21288,bright,main,20211003,4,0.9794645512168446,175,30,2,207
21288,bright,main,20211003,5,0.9940040992004784,345,64,4,413
21288,bright,main,20211003,6,0.9940801944673102,350,71,3,424
21288,bright,main,20211003,7,0.9888309263030426,314,60,1,375
21288,bright,main,20211003,8,0.9915952250054424,367,48,6,421
21288,bright,main,20211003,9,0.9929173050746356,339,76,5,420
4047,dark,main,20211005,0,0.993281564621161,273,15,115,403
4047,dark,main,20211005,1,0.9797830487528416,122,5,47,174
4047,dark,main,20211005,2,0.991077113643318,279,22,84,385
4047,dark,main,20211005,3,0.9880031488652472,267,15,78,360
4047,dark,main,20211005,4,0.9802741721499479,127,9,40,176
4047,dark,main,20211005,5,0.9867355735212283,267,19,92,378
4047,dark,main,20211005,6,0.9969734784340482,285,20,84,389
4047,dark,main,20211005,7,0.9926630115569195,238,20,78,336
4047,dark,main,20211005,8,0.9907394967342248,282,15,91,388
4047,dark,main,20211005,9,0.9941778150847569,262,24,92,378
6745,dark,main,20211005,0,0.9926072906685707,325,13,57,395
6745,dark,main,20211005,1,0.9840312668497354,121,9,35,165
6745,dark,main,20211005,2,0.9912647586905428,286,17,75,378
6745,dark,main,20211005,3,0.9963167106532688,282,11,60,353
6745,dark,main,20211005,4,0.9829076711507307,130,6,49,185
6745,dark,main,20211005,5,0.9968398507338356,263,12,86,361
6745,dark,main,20211005,6,0.9943284058921038,310,16,61,387
6745,dark,main,20211005,7,0.9925307590320311,270,11,53,334
6745,dark,main,20211005,8,0.9903427057479443,306,13,62,381
6745,dark,main,20211005,9,0.9859970330364197,301,10,55,366
2053,dark,main,20211005,0,0.9922411385988211,271,14,114,399
2053,dark,main,20211005,1,0.9888110793206153,122,5,47,174
2053,dark,main,20211005,2,0.9939840576649196,253,13,109,375
2053,dark,main,20211005,3,0.9867581727218415,240,14,90,344
2053,dark,main,20211005,4,0.980398073487152,146,8,27,181
2053,dark,main,20211005,5,0.9929529027463229,279,12,69,360
2053,dark,main,20211005,6,0.9917886759026624,319,11,64,394
2053,dark,main,20211005,7,0.9926161230467742,283,11,51,345
2053,dark,main,20211005,8,0.9864996165122955,307,13,63,383
2053,dark,main,20211005,9,0.9875655373470463,271,15,99,385
2490,dark,main,20211005,0,0.9914592929601654,321,10,61,392
2490,dark,main,20211005,1,0.9727786534375256,141,6,22,169
2490,dark,main,20211005,2,0.9869639774647988,287,15,58,360
2490,dark,main,20211005,3,0.9938999489240303,278,12,58,348
2490,dark,main,20211005,4,0.9831761118192562,168,3,15,186
2490,dark,main,20211005,5,0.9902757393038537,280,10,52,342
2490,dark,main,20211005,6,0.9939247540653464,302,15,57,374
2490,dark,main,20211005,7,0.9876745930055585,254,18,72,344
2490,dark,main,20211005,8,0.9932311274130484,284,18,77,379
2490,dark,main,20211005,9,0.9918373231472285,280,21,71,372
25986,bright,main,20211005,0,0.9922087979857626,201,219,3,423
25986,bright,main,20211005,1,0.9873998171836744,90,104,3,197
25986,bright,main,20211005,2,0.9941351751735883,298,127,3,428
25986,bright,main,20211005,3,0.992151206863364,265,127,5,397
25986,bright,main,20211005,4,0.9894645509422325,100,106,1,207
25986,bright,main,20211005,5,0.993327373750223,222,179,10,411
25986,bright,main,20211005,6,0.9927008361186425,175,238,5,418
25986,bright,main,20211005,7,0.992874392061193,140,231,2,373
25986,bright,main,20211005,8,0.9909682755036332,203,214,3,420
25986,bright,main,20211005,9,0.9942416877288092,179,240,2,421
4706,dark,main,20211005,0,0.9894601531383945,270,22,89,381
4706,dark,main,20211005,1,0.9885996207535293,130,10,35,175
4706,dark,main,20211005,2,0.9934337602958707,269,26,92,387
4706,dark,main,20211005,3,0.9889924596664207,261,21,74,356
4706,dark,main,20211005,4,0.9864855924448148,137,9,44,190
4706,dark,main,20211005,5,0.99280779310021,258,16,82,356
4706,dark,main,20211005,6,0.9936287660912109,256,15,107,378
4706,dark,main,20211005,7,0.9885108640054322,216,20,95,331
4706,dark,main,20211005,8,0.9902312656540596,261,23,86,370
4706,dark,main,20211005,9,0.9955497790253232,266,21,83,370
1670,dark,main,20211005,0,0.9908661760838677,263,19,96,378
1670,dark,main,20211005,1,0.9768850992676885,125,9,35,169
1670,dark,main,20211005,2,0.9840999646331183,297,11,70,378
1670,dark,main,20211005,3,0.9944632492646506,289,13,44,346
1670,dark,main,20211005,4,0.9732719471521916,157,5,21,183
1670,dark,main,20211005,5,0.984889454459691,315,12,29,356
1670,dark,main,20211005,6,0.9955014737389875,322,12,44,378
1670,dark,main,20211005,7,0.9937932862602685,272,11,47,330
1670,dark,main,20211005,8,0.9869707129629959,257,16,86,359
1670,dark,main,20211005,9,0.9909422985659913,250,19,101,370
11197,dark,main,20211005,0,0.9954220003300368,300,44,34,378
11197,dark,main,20211005,1,0.9855503836983892,141,17,18,176
11197,dark,main,20211005,2,0.9927233048969927,275,34,72,381
11197,dark,main,20211005,3,0.9903757415138712,252,44,57,353
11197,dark,main,20211005,4,0.9777557185446902,131,15,30,176
11197,dark,main,20211005,5,0.9942668022523623,265,19,69,353
11197,dark,main,20211005,6,0.9894722739937315,270,30,67,367
11197,dark,main,20211005,7,0.9857522003001323,247,24,67,338
11197,dark,main,20211005,8,0.9878559653048566,275,26,63,364
11197,dark,main,20211005,9,0.9829207652756824,313,26,37,376
2507,dark,main,20211005,0,0.9913803900060952,300,15,85,400
2507,dark,main,20211005,1,0.9848228584255598,127,5,49,181
2507,dark,main,20211005,2,0.9894783064670801,276,13,104,393
2507,dark,main,20211005,3,0.995274331160186,274,13,73,360
2507,dark,main,20211005,4,0.9658065493839746,131,7,42,180
2507,dark,main,20211005,5,0.9925506504054922,237,12,95,344
2507,dark,main,20211005,6,0.9917899373761657,283,14,83,380
2507,dark,main,20211005,7,0.9897027255143289,234,11,80,325
2507,dark,main,20211005,8,0.9941625888637756,277,11,109,397
2507,dark,main,20211005,9,0.99164302016601,291,13,88,392
6413,dark,main,20211005,0,0.9962287805875083,251,27,99,377
6413,dark,main,20211005,1,0.9816971391867124,113,9,49,171
6413,dark,main,20211005,2,0.9928713939461539,264,16,88,368
6413,dark,main,20211005,3,0.9932535015198813,249,17,87,353
6413,dark,main,20211005,4,0.9886839594538985,127,9,46,182
6413,dark,main,20211005,5,0.9929307751937225,247,15,90,352
6413,dark,main,20211005,6,0.9924215170100928,273,23,77,373
6413,dark,main,20211005,7,0.9932584181186179,225,15,77,317
6413,dark,main,20211005,8,0.9830051083516282,253,18,94,365
6413,dark,main,20211005,9,0.9858511300726729,257,18,98,373
9488,dark,main,20211005,0,0.9858985882075185,318,10,53,381
9488,dark,main,20211005,1,0.9859681545972879,140,5,26,171
9488,dark,main,20211005,2,0.986233796117813,310,11,70,391
9488,dark,main,20211005,3,0.9945241937360046,278,12,50,340
9488,dark,main,20211005,4,0.9813393821479234,137,11,37,185
9488,dark,main,20211005,5,0.9908367063670565,279,18,69,366
9488,dark,main,20211005,6,0.9891236216133183,281,12,89,382
9488,dark,main,20211005,7,0.9944112292739201,239,17,79,335
9488,dark,main,20211005,8,0.9937140971517614,252,12,90,354
9488,dark,main,20211005,9,0.9907627247621833,286,16,55,357
8090,dark,main,20211005,0,0.9914700821165631,279,28,89,396
8090,dark,main,20211005,1,0.9807660102623913,122,16,39,177
8090,dark,main,20211005,2,0.9914770540859811,264,18,89,371
8090,dark,main,20211005,3,0.9933327484049224,303,14,48,365
8090,dark,main,20211005,4,0.9756291945421478,154,6,18,178
8090,dark,main,20211005,5,0.991590378371323,286,16,46,348
8090,dark,main,20211005,6,0.9917674322451081,304,17,52,373
8090,dark,main,20211005,7,0.991747118447266,269,12,44,325
8090,dark,main,20211005,8,0.9946017297155499,300,15,45,360
8090,dark,main,20211005,9,0.992917714610428,271,22,80,373
7440,dark,main,20211005,0,0.9955935854268003,309,13,74,396
7440,dark,main,20211005,1,0.969552011622941,127,8,44,179
7440,dark,main,20211005,2,0.9906073796187499,298,22,68,388
7440,dark,main,20211005,3,0.9882557094584618,289,12,68,369
7440,dark,main,20211005,4,0.9809229627232767,127,5,44,176
7440,dark,main,20211005,5,0.9922345391426756,275,18,78,371
7440,dark,main,20211005,6,0.9926751243440132,301,14,59,374
7440,dark,main,20211005,7,0.9930837739844702,263,14,50,327
7440,dark,main,20211005,8,0.9957623263166414,313,13,58,384
7440,dark,main,20211005,9,0.9925337409055427,327,14,51,392
23703,bright,main,20211005,0,0.9952615834807893,341,80,4,425
23703,bright,main,20211005,1,0.9892998322787712,151,37,2,190
23703,bright,main,20211005,2,0.9915405208028907,349,68,7,424
23703,bright,main,20211005,3,0.9940844777226516,292,86,8,386
23703,bright,main,20211005,4,0.9708466530358425,149,48,5,202
23703,bright,main,20211005,5,0.9910050834087365,315,80,5,400
23703,bright,main,20211005,6,0.9953746239000564,355,54,8,417
23703,bright,main,20211005,7,0.9884391163730291,290,71,8,369
23703,bright,main,20211005,8,0.989752331650917,330,83,6,419
23703,bright,main,20211005,9,0.9897587543104925,352,63,5,420
9356,dark,main,20211005,0,0.989613110476378,307,12,58,377
9356,dark,main,20211005,1,0.9852473565542679,141,4,31,176
9356,dark,main,20211005,2,0.994092479580158,290,13,79,382
9356,dark,main,20211005,3,0.9856283616005247,276,10,58,344
9356,dark,main,20211005,4,0.9797205584142256,147,8,28,183
9356,dark,main,20211005,5,0.9907025983121609,303,13,54,370
9356,dark,main,20211005,6,0.9875692799303257,281,12,76,369
9356,dark,main,20211005,7,0.9818514348440962,254,13,68,335
9356,dark,main,20211005,8,0.9788042427023592,301,13,58,372
9356,dark,main,20211005,9,0.9909028397275949,313,12,47,372
11059,dark,main,20211005,0,0.9883099739191363,308,16,65,389
11059,dark,main,20211005,1,0.9843909204317467,117,9,50,176
11059,dark,main,20211005,2,0.9929124188372401,271,19,106,396
11059,dark,main,20211005,3,0.9884871801455172,259,13,77,349
11059,dark,main,20211005,4,0.9872690115653072,123,7,52,182
11059,dark,main,20211005,5,0.9901518846522651,245,13,96,354
11059,dark,main,20211005,6,0.9951107624984376,276,17,77,370
11059,dark,main,20211005,7,0.9934446725207348,237,15,81,333
11059,dark,main,20211005,8,0.9884793864687352,253,19,97,369
11059,dark,main,20211005,9,0.9877567551499846,260,18,82,360
20832,bright,main,20211005,0,0.9952651634362546,242,190,3,435
20832,bright,main,20211005,1,0.9726223693477112,106,92,1,199
20832,bright,main,20211005,2,0.9905101543721557,295,135,3,433
20832,bright,main,20211005,3,0.9946562393458059,285,107,6,398
20832,bright,main,20211005,4,0.9847009148259476,142,65,3,210
20832,bright,main,20211005,5,0.9917378876606294,339,68,3,410
20832,bright,main,20211005,6,0.9897549947091043,300,126,5,431
20832,bright,main,20211005,7,0.9832865064428525,256,119,2,377
20832,bright,main,20211005,8,0.9921698013226282,215,210,3,428
20832,bright,main,20211005,9,0.9958187559661984,203,222,4,429
9371,dark,main,20211005,0,0.9905421527730767,282,11,91,384
9371,dark,main,20211005,1,0.9774177452323122,140,4,24,168
9371,dark,main,20211005,2,0.9879224764765799,317,13,49,379
9371,dark,main,20211005,3,0.981251923845315,284,18,43,345
9371,dark,main,20211005,4,0.9754158040222961,159,6,27,192
9371,dark,main,20211005,5,0.9889666703825029,270,16,68,354
9371,dark,main,20211005,6,0.9912629540659674,284,13,84,381
9371,dark,main,20211005,7,0.9814380740494171,236,11,95,342
9371,dark,main,20211005,8,0.9921082472972375,251,14,107,372
9371,dark,main,20211005,9,0.9923411763813695,259,11,99,369
6382,dark,main,20211005,0,0.9863395993175499,286,19,105,410
6382,dark,main,20211005,1,0.9881214581473927,142,2,38,182
6382,dark,main,20211005,2,0.9941068146779355,300,16,88,404
6382,dark,main,20211005,3,0.9917614942602787,276,16,65,357
6382,dark,main,20211005,4,0.984437114511768,134,9,47,190
6382,dark,main,20211005,5,0.9869819861700926,294,12,77,383
6382,dark,main,20211005,6,0.9894379247318782,233,26,72,331
6382,dark,main,20211005,7,0.9856146678753299,159,13,59,231
6382,dark,main,20211005,8,0.992682367168535,282,15,94,391
6382,dark,main,20211005,9,0.9867561833350603,275,10,91,376
1155,dark,main,20211005,0,0.9950062980634012,273,13,96,382
1155,dark,main,20211005,1,0.984880255245687,111,5,54,170
1155,dark,main,20211005,2,0.9876742991186246,286,13,82,381
1155,dark,main,20211005,3,0.991787760202661,287,13,62,362
1155,dark,main,20211005,4,0.984235310279685,141,6,34,181
1155,dark,main,20211005,5,0.9934026545960385,288,15,59,362
1155,dark,main,20211005,6,0.9922852955926991,303,14,68,385
1155,dark,main,20211005,7,0.9928835114057473,261,13,66,340
1155,dark,main,20211005,8,0.9816462385977979,235,13,61,309
1155,dark,main,20211005,9,0.9876512311259189,302,14,66,382
10548,dark,main,20211005,0,0.9935381960201416,276,16,89,381
10548,dark,main,20211005,1,0.9803457213017099,106,12,44,162
10548,dark,main,20211005,2,0.9847335679210086,264,21,104,389
10548,dark,main,20211005,3,0.9866058476390305,249,23,74,346
10548,dark,main,20211005,4,0.9782829324980812,110,10,66,186
10548,dark,main,20211005,5,0.9836742892605029,266,17,85,368
10548,dark,main,20211005,6,0.9898235259171517,274,21,78,373
10548,dark,main,20211005,7,0.9931002621563191,236,23,72,331
10548,dark,main,20211005,8,0.9952922394302222,257,15,93,365
10548,dark,main,20211005,9,0.991090326890657,273,15,93,381
11530,dark,main,20211005,0,0.9908442232457086,287,23,90,400
11530,dark,main,20211005,1,0.9516717878610147,112,12,39,163
11530,dark,main,20211005,2,0.9904817563578273,278,41,78,397
11530,dark,main,20211005,3,0.9922143332441349,250,30,78,358
11530,dark,main,20211005,4,0.9901915423936499,132,9,49,190
11530,dark,main,20211005,5,0.9912231771582418,267,16,90,373
11530,dark,main,20211005,6,0.9875537513658115,263,22,91,376
11530,dark,main,20211005,7,0.9950835315623661,223,39,75,337
11530,dark,main,20211005,8,0.9877988121256623,241,22,110,373
11530,dark,main,20211005,9,0.9928528386371723,273,27,80,380
11064,dark,main,20211005,0,0.9932070262375818,311,15,70,396
11064,dark,main,20211005,1,0.9770284107443543,138,7,25,170
11064,dark,main,20211005,2,0.9929491873168614,311,14,66,391
11064,dark,main,20211005,3,0.9922014455485945,276,11,59,346
11064,dark,main,20211005,4,0.9854779943280244,131,9,40,180
11064,dark,main,20211005,5,0.9926749075879158,283,20,65,368
11064,dark,main,20211005,6,0.9889975470155601,305,10,67,382
11064,dark,main,20211005,7,0.9865913864367851,223,12,104,339
11064,dark,main,20211005,8,0.995598202121987,265,20,89,374
11064,dark,main,20211005,9,0.9937750464041121,267,22,78,367
4949,dark,main,20211005,0,0.9912807507212699,266,25,88,379
4949,dark,main,20211005,1,0.9778107838649207,120,10,36,166
4949,dark,main,20211005,2,0.9906514274623546,309,15,50,374
4949,dark,main,20211005,3,0.9904919755429968,250,20,55,325
4949,dark,main,20211005,4,0.957162872255377,153,9,24,186
4949,dark,main,20211005,5,0.9951575291804517,299,14,58,371
4949,dark,main,20211005,6,0.990504656752674,323,11,41,375
4949,dark,main,20211005,7,0.994847034627368,266,14,45,325
4949,dark,main,20211005,8,0.9859440793324515,293,15,57,365
4949,dark,main,20211005,9,0.9953943443654015,295,11,62,368
9360,dark,main,20211006,0,0.9882582616597612,294,13,87,394
9360,dark,main,20211006,1,0.9636355808657959,113,6,40,159
9360,dark,main,20211006,2,0.9910585346708918,265,18,101,384
9360,dark,main,20211006,3,0.9825553520905849,217,14,66,297
9360,dark,main,20211006,4,0.9714188838317463,152,5,35,192
9360,dark,main,20211006,5,0.9895335309558903,301,15,60,376
9360,dark,main,20211006,6,0.9834593721588735,222,12,69,303
9360,dark,main,20211006,7,0.987363271587229,165,12,57,234
9360,dark,main,20211006,8,0.9927578955510474,256,21,90,367
9360,dark,main,20211006,9,0.9878574450606858,277,13,88,378
82265,bright,special,20211006,0,0.9865539303799004,348,61,5,414
82265,bright,special,20211006,1,0.9810811193401335,157,29,0,186
82265,bright,special,20211006,2,0.9878653124957228,371,43,6,420
82265,bright,special,20211006,3,0.9905400293873906,337,40,2,379
82265,bright,special,20211006,4,0.9708971097855222,171,27,2,200
82265,bright,special,20211006,5,0.9919073450208477,330,49,4,383
82265,bright,special,20211006,6,0.9911645100828422,290,46,2,338
82265,bright,special,20211006,7,0.9887665911458995,323,37,3,363
82265,bright,special,20211006,8,0.9930857740393322,350,54,2,406
82265,bright,special,20211006,9,0.9948634302132083,342,65,1,408
4283,dark,main,20211006,0,0.9898279521152472,293,14,93,400
4283,dark,main,20211006,1,0.9759161306112211,123,10,36,169
4283,dark,main,20211006,2,0.9929735026323435,287,22,81,390
4283,dark,main,20211006,3,0.9901332623279482,294,12,52,358
4283,dark,main,20211006,4,0.9835121414774117,156,7,23,186
4283,dark,main,20211006,5,0.9926461908699562,301,12,42,355
4283,dark,main,20211006,6,0.991897669785308,319,12,44,375
4283,dark,main,20211006,7,0.9838238443008286,266,14,44,324
4283,dark,main,20211006,8,0.9837765896652169,305,11,58,374
4283,dark,main,20211006,9,0.9911942294778603,280,17,75,372
11238,dark,main,20211006,0,0.9900893050281108,290,42,39,371
11238,dark,main,20211006,1,0.9781342223883092,127,19,22,168
11238,dark,main,20211006,2,0.9872198373241705,261,50,50,361
11238,dark,main,20211006,3,0.9940516164564328,206,83,50,339
11238,dark,main,20211006,4,0.9878247604340978,103,41,42,186
11238,dark,main,20211006,5,0.989077569482344,235,45,76,356
11238,dark,main,20211006,6,0.9943111350223393,233,60,75,368
11238,dark,main,20211006,7,0.9917866686905492,226,40,57,323
11238,dark,main,20211006,8,0.9825187774524544,290,25,45,360
11238,dark,main,20211006,9,0.9932701365206387,275,33,47,355
25946,bright,main,20211006,0,0.9904519860009493,352,70,3,425
25946,bright,main,20211006,1,0.9701431684194108,152,35,1,188
25946,bright,main,20211006,2,0.9960388742926128,315,89,4,408
25946,bright,main,20211006,3,0.988600355526639,297,70,4,371
25946,bright,main,20211006,4,0.9942964301587308,164,36,4,204
25946,bright,main,20211006,5,0.9891746044577033,314,77,2,393
25946,bright,main,20211006,6,0.9945361544353758,348,67,5,420
25946,bright,main,20211006,7,0.9900544264130317,304,58,1,363
25946,bright,main,20211006,8,0.9880080536028701,299,102,3,404
25946,bright,main,20211006,9,0.9912461242542422,345,70,4,419
9629,dark,main,20211006,0,0.9840727814834401,290,36,56,382
9629,dark,main,20211006,1,0.9887743534664882,119,17,31,167
9629,dark,main,20211006,2,0.9928772841159198,282,24,61,367
9629,dark,main,20211006,3,0.9941966225058713,254,26,55,335
9629,dark,main,20211006,4,0.9736190722151665,127,21,35,183
9629,dark,main,20211006,5,0.9905764775748972,252,42,52,346
9629,dark,main,20211006,6,0.9920404353677652,275,36,54,365
9629,dark,main,20211006,7,0.983205500763771,235,42,50,327
9629,dark,main,20211006,8,0.9951333811009779,286,26,61,373
9629,dark,main,20211006,9,0.9947568733864616,267,42,62,371
11232,dark,main,20211006,0,0.9916200723835421,302,21,53,376
11232,dark,main,20211006,1,0.9802418670544734,134,7,32,173
11232,dark,main,20211006,2,0.9924981019290822,270,16,100,386
11232,dark,main,20211006,3,0.9885896681953248,282,13,58,353
11232,dark,main,20211006,4,0.9882083396460862,153,10,21,184
11232,dark,main,20211006,5,0.9950113557580497,298,13,54,365
11232,dark,main,20211006,6,0.9935839021651078,296,26,62,384
11232,dark,main,20211006,7,0.9900784556394644,252,22,64,338
11232,dark,main,20211006,8,0.9882353078202263,309,15,52,376
11232,dark,main,20211006,9,0.985250100563823,281,21,63,365
11204,dark,main,20211006,0,0.9929470908591487,273,18,69,360
11204,dark,main,20211006,1,0.9851431529240654,138,9,27,174
11204,dark,main,20211006,2,0.9952628530598535,326,16,49,391
11204,dark,main,20211006,3,0.9904065307538561,297,19,48,364
11204,dark,main,20211006,4,0.9843761406703593,136,9,38,183
11204,dark,main,20211006,5,0.9921822005010029,270,26,55,351
11204,dark,main,20211006,6,0.9924424723410689,276,20,75,371
11204,dark,main,20211006,7,0.9910644115185169,252,28,48,328
11204,dark,main,20211006,8,0.9913577617633675,285,27,56,368
11204,dark,main,20211006,9,0.9919831384497467,274,23,70,367
11224,dark,main,20211006,0,0.9900661327334882,320,23,38,381
11224,dark,main,20211006,1,0.977410296164967,143,8,26,177
11224,dark,main,20211006,2,0.9919972057072629,317,18,55,390
11224,dark,main,20211006,3,0.9895155743785597,281,14,54,349
11224,dark,main,20211006,4,0.9868790669662068,153,12,30,195
11224,dark,main,20211006,5,0.9949647889136218,280,16,76,372
11224,dark,main,20211006,6,0.9914937224064136,275,13,108,396
11224,dark,main,20211006,7,0.9857607551933428,249,15,70,334
11224,dark,main,20211006,8,0.9869400561873701,301,11,60,372
11224,dark,main,20211006,9,0.9943203548948549,316,15,40,371
9627,dark,main,20211006,0,0.9887208934050902,327,12,39,378
9627,dark,main,20211006,1,0.9679789772326243,135,28,11,174
9627,dark,main,20211006,2,0.9929114142639528,304,19,39,362
9627,dark,main,20211006,3,0.9908498512228276,256,32,38,326
9627,dark,main,20211006,4,0.9748336836421234,141,16,21,178
9627,dark,main,20211006,5,0.9937771366576077,290,24,51,365
9627,dark,main,20211006,6,0.9909180212083868,326,21,40,387
9627,dark,main,20211006,7,0.9861919427192691,258,26,47,331
9627,dark,main,20211006,8,0.9892167558397241,282,29,69,380
9627,dark,main,20211006,9,0.9891378929103815,303,28,35,366
3436,dark,main,20211006,0,0.9924596459088496,298,18,90,406
3436,dark,main,20211006,1,0.9752537221909656,133,5,36,174
3436,dark,main,20211006,2,0.9910370063255599,311,17,54,382
3436,dark,main,20211006,3,0.9941489444228364,279,13,48,340
3436,dark,main,20211006,4,0.9874070840637288,158,5,26,189
3436,dark,main,20211006,5,0.9941207314849605,299,13,50,362
3436,dark,main,20211006,6,0.9900932627533896,316,10,53,379
3436,dark,main,20211006,7,0.9916524775545343,283,14,51,348
3436,dark,main,20211006,8,0.9908538260856448,285,19,60,364
3436,dark,main,20211006,9,0.9944167238524968,274,14,79,367
5415,dark,main,20211006,0,0.9881568035108979,316,10,55,381
5415,dark,main,20211006,1,0.9834618127726743,140,3,26,169
5415,dark,main,20211006,2,0.9937378204605651,322,14,64,400
5415,dark,main,20211006,3,0.9892606374069034,280,13,58,351
5415,dark,main,20211006,4,0.9848266076177262,145,7,42,194
5415,dark,main,20211006,5,0.9908555996129254,298,12,58,368
5415,dark,main,20211006,6,0.9881462334761855,324,26,32,382
5415,dark,main,20211006,7,0.9953739399018446,269,10,54,333
5415,dark,main,20211006,8,0.98331463683545,315,11,56,382
5415,dark,main,20211006,9,0.9935391230566463,299,13,56,368
24002,bright,main,20211006,0,0.9903268420202909,347,84,5,436
24002,bright,main,20211006,1,0.9887802339581607,140,56,2,198
24002,bright,main,20211006,2,0.9918283719526879,307,121,2,430
24002,bright,main,20211006,3,0.990060358960198,236,163,1,400
24002,bright,main,20211006,4,0.9858065747406101,90,116,0,206
24002,bright,main,20211006,5,0.9900307227667563,144,255,3,402
24002,bright,main,20211006,6,0.995575939091852,174,256,3,433
24002,bright,main,20211006,7,0.984139840731568,169,200,10,379
24002,bright,main,20211006,8,0.9948377766738297,309,113,3,425
24002,bright,main,20211006,9,0.9924950497463906,258,172,2,432
5182,dark,main,20211006,0,0.993893966103928,330,13,56,399
5182,dark,main,20211006,1,0.9779582289129715,151,7,18,176
5182,dark,main,20211006,2,0.9927704117757952,317,10,56,383
5182,dark,main,20211006,3,0.9833709673901462,283,12,68,363
5182,dark,main,20211006,4,0.9693600472502758,150,5,31,186
5182,dark,main,20211006,5,0.9892114958271143,303,11,49,363
5182,dark,main,20211006,6,0.9923916169094184,285,18,82,385
5182,dark,main,20211006,7,0.991118342656063,232,12,84,328
5182,dark,main,20211006,8,0.993275329865157,257,11,100,368
5182,dark,main,20211006,9,0.9943594261081105,285,13,85,383
4307,dark,main,20211006,0,0.9917979089555746,306,12,80,398
4307,dark,main,20211006,1,0.9854474954770338,126,9,32,167
4307,dark,main,20211006,2,0.98748877350545,311,19,63,393
4307,dark,main,20211006,3,0.9901237131120871,289,12,48,349
4307,dark,main,20211006,4,0.9730363024641902,163,5,23,191
4307,dark,main,20211006,5,0.9936213637461658,306,11,51,368
4307,dark,main,20211006,6,0.9938668482618928,323,10,49,382
4307,dark,main,20211006,7,0.9882337780044718,266,11,38,315
4307,dark,main,20211006,8,0.9932750749751075,299,13,63,375
4307,dark,main,20211006,9,0.990062829026967,290,25,71,386
2580,dark,main,20211006,0,0.9872791936213721,328,11,43,382
2580,dark,main,20211006,1,0.9882839524789548,143,7,28,178
2580,dark,main,20211006,2,0.994042400546082,305,14,76,395
2580,dark,main,20211006,3,0.9898836289803166,264,16,87,367
2580,dark,main,20211006,4,0.987805593588344,120,7,53,180
2580,dark,main,20211006,5,0.9891670032074495,288,13,76,377
2580,dark,main,20211006,6,0.9944414355803043,288,16,78,382
2580,dark,main,20211006,7,0.9903432095997569,262,13,62,337
2580,dark,main,20211006,8,0.9861871706978508,300,19,51,370
2580,dark,main,20211006,9,0.9889507597576017,306,13,48,367
9361,dark,main,20211006,0,0.988474309677515,333,11,55,399
9361,dark,main,20211006,1,0.9926263500515156,149,5,17,171
9361,dark,main,20211006,2,0.9918885885066918,309,13,57,379
9361,dark,main,20211006,3,0.9906863440694016,266,16,68,350
9361,dark,main,20211006,4,0.9890053536536947,145,4,37,186
9361,dark,main,20211006,5,0.9894949024056205,275,11,70,356
9361,dark,main,20211006,6,0.9847129063533664,291,19,65,375
9361,dark,main,20211006,7,0.9871032494835077,273,15,52,340
9361,dark,main,20211006,8,0.9921738013533287,300,12,67,379
9361,dark,main,20211006,9,0.9935372883785575,304,17,56,377
10685,dark,main,20211006,0,0.9867361740137757,218,76,63,357
10685,dark,main,20211006,1,0.9764100675735822,103,32,30,165
10685,dark,main,20211006,2,0.9905264217594317,140,73,48,261
10685,dark,main,20211006,3,0.9787473686735709,118,50,36,204
10685,dark,main,20211006,4,0.9844389511934976,105,42,22,169
10685,dark,main,20211006,5,0.9938352648732761,258,38,54,350
10685,dark,main,20211006,6,0.9950504304873931,275,38,50,363
10685,dark,main,20211006,7,0.9937587478478994,231,52,43,326
10685,dark,main,20211006,8,0.9875889770634328,233,52,73,358
10685,dark,main,20211006,9,0.9895650180807326,237,49,79,365
4330,dark,main,20211006,0,0.9893981086748179,316,10,57,383
4330,dark,main,20211006,1,0.9743973478559245,139,3,27,169
4330,dark,main,20211006,2,0.9801526790392644,307,10,53,370
4330,dark,main,20211006,3,0.9887275168058366,295,12,53,360
4330,dark,main,20211006,4,0.9877831368784071,160,6,29,195
4330,dark,main,20211006,5,0.9945091602875328,285,13,65,363
4330,dark,main,20211006,6,0.9876503893189484,287,11,89,387
4330,dark,main,20211006,7,0.9945846085997591,270,12,60,342
4330,dark,main,20211006,8,0.991965678444774,275,13,93,381
4330,dark,main,20211006,9,0.980433683457688,320,9,49,378
6367,dark,main,20211007,0,0.9935753949911784,294,11,90,395
6367,dark,main,20211007,1,0.9776633116616991,134,8,40,182
6367,dark,main,20211007,2,0.9809384824253553,271,16,82,369
6367,dark,main,20211007,3,0.992535925345022,271,21,59,351
6367,dark,main,20211007,4,0.9780697675211233,146,6,37,189
6367,dark,main,20211007,5,0.9888266282571703,244,18,96,358
6367,dark,main,20211007,6,0.9897321003215784,274,15,91,380
6367,dark,main,20211007,7,0.980070111777284,241,17,76,334
6367,dark,main,20211007,8,0.98845655474129,248,14,105,367
6367,dark,main,20211007,9,0.9871275039811283,278,17,83,378
2062,dark,main,20211007,0,0.9933657361813782,315,9,43,367
2062,dark,main,20211007,1,0.9797247651558711,135,6,26,167
2062,dark,main,20211007,2,0.9857051639374768,313,10,54,377
2062,dark,main,20211007,3,0.9942754786451073,267,15,66,348
2062,dark,main,20211007,4,0.9881787382281367,153,7,28,188
2062,dark,main,20211007,5,0.9864552432358286,284,13,84,381
2062,dark,main,20211007,6,0.9861445910716033,274,12,83,369
2062,dark,main,20211007,7,0.9953997130208316,229,15,79,323
2062,dark,main,20211007,8,0.9914774982416671,293,12,62,367
2062,dark,main,20211007,9,0.9873867955749464,306,18,41,365
4317,dark,main,20211007,0,0.9915310461480888,261,19,105,385
4317,dark,main,20211007,1,0.9931942175428754,121,9,40,170
4317,dark,main,20211007,2,0.9890321733192463,271,18,100,389
4317,dark,main,20211007,3,0.9829729617783199,260,17,77,354
4317,dark,main,20211007,4,0.9845991645659189,120,3,58,181
4317,dark,main,20211007,5,0.9866886501591456,290,12,69,371
4317,dark,main,20211007,6,0.9917276890706375,309,13,65,387
4317,dark,main,20211007,7,0.9931728800442658,235,14,81,330
4317,dark,main,20211007,8,0.9838921114662487,269,19,80,368
4317,dark,main,20211007,9,0.9964721523954316,296,15,67,378
4814,dark,main,20211007,0,0.9873066509450747,319,16,61,396
4814,dark,main,20211007,1,0.973672416027299,151,4,25,180
4814,dark,main,20211007,2,0.9956006485413852,330,13,50,393
4814,dark,main,20211007,3,0.9852529984892169,277,11,58,346
4814,dark,main,20211007,4,0.9783628854529393,127,8,46,181
4814,dark,main,20211007,5,0.9954072972116427,250,18,99,367
4814,dark,main,20211007,6,0.994359549699934,268,18,97,383
4814,dark,main,20211007,7,0.9864769801766178,252,15,63,330
4814,dark,main,20211007,8,0.9925829375603795,289,13,68,370
4814,dark,main,20211007,9,0.9921730413044335,297,16,61,374
1006,dark,main,20211007,0,0.992492725536186,256,12,44,312
1006,dark,main,20211007,1,0.9835535312529222,123,8,24,155
1006,dark,main,20211007,2,0.9863195521202454,254,18,57,329
1006,dark,main,20211007,3,0.9845779919992524,226,14,70,310
1006,dark,main,20211007,4,0.9860385374198646,122,6,31,159
1006,dark,main,20211007,5,0.992668980268613,237,12,49,298
1006,dark,main,20211007,6,0.9917734439824833,258,12,58,328
1006,dark,main,20211007,7,0.99039577271527,221,11,44,276
1006,dark,main,20211007,8,0.9930030029022012,237,21,48,306
1006,dark,main,20211007,9,0.989030108165186,217,12,51,280
82264,bright,special,20211007,0,0.9877831584161232,330,95,5,430
82264,bright,special,20211007,1,0.9883418800584973,133,52,1,186
82264,bright,special,20211007,2,0.9888398264591934,191,76,2,269
82264,bright,special,20211007,3,0.9939035279027251,256,132,5,393
82264,bright,special,20211007,4,0.9809773457808166,138,61,5,204
82264,bright,special,20211007,5,0.9913680969219243,279,103,4,386
82264,bright,special,20211007,6,0.9858843375183037,279,74,4,357
82264,bright,special,20211007,7,0.9888894671394756,273,83,4,360
82264,bright,special,20211007,8,0.9854365468058491,219,86,3,308
82264,bright,special,20211007,9,0.9915225193699545,235,106,1,342
1188,dark,main,20211007,0,0.9938180383587047,313,14,56,383
1188,dark,main,20211007,1,0.967934358646362,143,6,21,170
1188,dark,main,20211007,2,0.9901550052036602,291,12,70,373
1188,dark,main,20211007,3,0.9914795156842465,272,12,59,343
1188,dark,main,20211007,4,0.9784758238899302,131,10,45,186
1188,dark,main,20211007,5,0.992204370034311,269,12,80,361
1188,dark,main,20211007,6,0.9935935237936692,299,13,65,377
1188,dark,main,20211007,7,0.9948674570446292,277,11,50,338
1188,dark,main,20211007,8,0.9926792815264626,308,12,55,375
1188,dark,main,20211007,9,0.991109576132249,281,13,80,374
7265,dark,main,20211007,0,0.9880975808673751,288,14,86,388
7265,dark,main,20211007,1,0.9866226041152953,125,7,33,165
7265,dark,main,20211007,2,0.9903498212397074,287,15,96,398
7265,dark,main,20211007,3,0.9915486569539713,256,15,97,368
7265,dark,main,20211007,4,0.9852331244239981,139,9,41,189
7265,dark,main,20211007,5,0.9901680198067565,250,19,97,366
7265,dark,main,20211007,6,0.992707495955779,277,18,96,391
7265,dark,main,20211007,7,0.9912135659027129,231,19,89,339
7265,dark,main,20211007,8,0.9940105342142291,271,12,95,378
7265,dark,main,20211007,9,0.9941414036276158,265,16,94,375
10541,dark,main,20211007,0,0.9956215775447431,275,21,98,394
10541,dark,main,20211007,1,0.9697533552481105,123,4,41,168
10541,dark,main,20211007,2,0.9885809916341121,294,13,75,382
10541,dark,main,20211007,3,0.9846911812870078,268,13,66,347
10541,dark,main,20211007,4,0.9836158777183724,150,5,27,182
10541,dark,main,20211007,5,0.988357507362774,287,10,67,364
10541,dark,main,20211007,6,0.9849778747893958,314,11,55,380
10541,dark,main,20211007,7,0.9840244793254547,273,13,52,338
10541,dark,main,20211007,8,0.9921666351464784,279,16,78,373
10541,dark,main,20211007,9,0.9913903724143824,283,17,88,388
6535,dark,main,20211008,0,0.9891882989059082,310,21,43,374
6535,dark,main,20211008,1,0.9802282433877975,144,8,18,170
6535,dark,main,20211008,2,0.9935377911141234,321,22,36,379
6535,dark,main,20211008,3,0.9924941959913716,270,20,51,341
6535,dark,main,20211008,4,0.9827090274910119,129,17,28,174
6535,dark,main,20211008,5,0.9939633923149771,288,22,52,362
6535,dark,main,20211008,6,0.9895439325536384,292,30,54,376
6535,dark,main,20211008,7,0.991763043847793,241,19,61,321
6535,dark,main,20211008,8,0.9934108200826861,255,26,78,359
6535,dark,main,20211008,9,0.9894232881895549,286,22,61,369
9355,dark,main,20211008,0,0.9906912886489172,290,11,86,387
9355,dark,main,20211008,1,0.9834174060620877,112,7,46,165
9355,dark,main,20211008,2,0.9950210379143516,284,13,76,373
9355,dark,main,20211008,3,0.982483293510192,269,13,54,336
9355,dark,main,20211008,4,0.9753067352563031,142,9,21,172
9355,dark,main,20211008,5,0.990605517639144,263,18,88,369
9355,dark,main,20211008,6,0.9908073527342939,262,17,102,381
9355,dark,main,20211008,7,0.9914181721051182,241,15,76,332
9355,dark,main,20211008,8,0.996072687035144,256,14,97,367
9355,dark,main,20211008,9,0.9870263336222824,271,17,91,379
8982,dark,main,20211008,0,0.9918255482734145,293,12,86,391
8982,dark,main,20211008,1,0.9814007426567446,139,9,23,171
8982,dark,main,20211008,2,0.9906932033311419,306,13,47,366
8982,dark,main,20211008,3,0.9879353290518649,279,12,44,335
8982,dark,main,20211008,4,0.9613150432320916,144,6,34,184
8982,dark,main,20211008,5,0.9943171993020208,296,10,67,373
8982,dark,main,20211008,6,0.9917054195760246,305,11,67,383
8982,dark,main,20211008,7,0.9960828138679685,280,10,41,331
8982,dark,main,20211008,8,0.9904446256600816,308,14,47,369
8982,dark,main,20211008,9,0.9906461611229741,297,12,68,377
3121,dark,main,20211008,0,0.9932908421125798,320,16,46,382
3121,dark,main,20211008,1,0.9792005308866042,130,7,34,171
3121,dark,main,20211008,2,0.990405906648552,281,18,81,380
3121,dark,main,20211008,3,0.9909065534554469,249,11,80,340
3121,dark,main,20211008,4,0.9871076698555001,128,7,52,187
3121,dark,main,20211008,5,0.9870946149635481,232,13,91,336
3121,dark,main,20211008,6,0.9948707737050793,295,13,61,369
3121,dark,main,20211008,7,0.9914420448980575,268,13,40,321
3121,dark,main,20211008,8,0.989498343355804,311,13,42,366
3121,dark,main,20211008,9,0.9933541591307241,311,12,45,368
10331,dark,main,20211008,0,0.9893775226702017,311,11,66,388
10331,dark,main,20211008,1,0.9849823639529611,120,6,28,154
10331,dark,main,20211008,2,0.986550725477145,293,20,71,384
10331,dark,main,20211008,3,0.98952735066891,284,9,62,355
10331,dark,main,20211008,4,0.9721034717108501,141,11,25,177
10331,dark,main,20211008,5,0.9893603021928146,280,16,57,353
10331,dark,main,20211008,6,0.9893912088807201,287,14,57,358
10331,dark,main,20211008,7,0.9867553633905395,267,14,50,331
10331,dark,main,20211008,8,0.9923957068132363,286,20,57,363
10331,dark,main,20211008,9,0.9942688854271701,293,13,72,378
10306,dark,main,20211008,0,0.980358336305097,312,14,70,396
10306,dark,main,20211008,1,0.9752444774625734,134,10,22,166
10306,dark,main,20211008,2,0.9946730528559133,311,13,67,391
10306,dark,main,20211008,3,0.9900012484716543,271,16,75,362
10306,dark,main,20211008,4,0.9899195823480708,148,10,33,191
10306,dark,main,20211008,5,0.9927914882408356,296,18,63,377
10306,dark,main,20211008,6,0.9886066689452897,272,19,91,382
10306,dark,main,20211008,7,0.9881007662350854,259,19,55,333
10306,dark,main,20211008,8,0.9907607890291096,294,21,60,375
10306,dark,main,20211008,9,0.991056727410375,294,17,76,387
6405,dark,main,20211008,0,0.9900714602344716,305,11,51,367
6405,dark,main,20211008,1,0.988123709322251,153,3,17,173
6405,dark,main,20211008,2,0.9911609342646727,309,15,49,373
6405,dark,main,20211008,3,0.9951705328932452,287,14,46,347
6405,dark,main,20211008,4,0.9908140264876641,139,5,32,176
6405,dark,main,20211008,5,0.9875497985513961,274,12,83,369
6405,dark,main,20211008,6,0.9867022560464307,287,11,85,383
6405,dark,main,20211008,7,0.9887959597157671,224,17,83,324
6405,dark,main,20211008,8,0.9878596327178109,257,20,90,367
6405,dark,main,20211008,9,0.9887541839886199,277,16,78,371
7439,dark,main,20211008,0,0.9931062777603558,276,20,88,384
7439,dark,main,20211008,1,0.988248791018084,111,11,45,167
7439,dark,main,20211008,2,0.9911665678786682,293,13,73,379
7439,dark,main,20211008,3,0.9954049224322927,253,14,73,340
7439,dark,main,20211008,4,0.9871054177171371,129,14,42,185
7439,dark,main,20211008,5,0.9934520709092333,248,20,81,349
7439,dark,main,20211008,6,0.9898542444191889,267,19,92,378
7439,dark,main,20211008,7,0.9907394922207106,231,19,76,326
7439,dark,main,20211008,8,0.9894179063596562,243,17,96,356
7439,dark,main,20211008,9,0.9885442319711356,258,14,102,374
6265,dark,main,20211008,0,0.9937895944527126,286,21,77,384
6265,dark,main,20211008,1,0.9931402229466506,124,13,47,184
6265,dark,main,20211008,2,0.9907234510257725,258,25,99,382
6265,dark,main,20211008,3,0.9937983684417165,260,18,84,362
6265,dark,main,20211008,4,0.9833468146259315,124,9,47,180
6265,dark,main,20211008,5,0.9948309260127898,260,27,86,373
6265,dark,main,20211008,6,0.9906230595962492,257,51,80,388
6265,dark,main,20211008,7,0.9925264919635567,229,25,73,327
6265,dark,main,20211008,8,0.9910733935678552,264,19,86,369
6265,dark,main,20211008,9,0.9882485521396428,275,21,92,388
8075,dark,main,20211008,0,0.9812152047348235,328,15,38,381
8075,dark,main,20211008,1,0.9795106720871878,136,14,24,174
8075,dark,main,20211008,2,0.991976564658089,275,28,73,376
8075,dark,main,20211008,3,0.9935126935529613,264,26,64,354
8075,dark,main,20211008,4,0.9884766165650518,145,15,28,188
8075,dark,main,20211008,5,0.9844138006214351,285,14,57,356
8075,dark,main,20211008,6,0.988875927356838,286,24,69,379
8075,dark,main,20211008,7,0.9898033555776454,254,17,52,323
8075,dark,main,20211008,8,0.9920039052110969,276,26,57,359
8075,dark,main,20211008,9,0.9955455614350823,293,21,41,355
11223,dark,main,20211008,0,0.9889048182927963,262,20,93,375
11223,dark,main,20211008,1,0.9900944176893024,118,9,47,174
11223,dark,main,20211008,2,0.9946118151875043,287,15,77,379
11223,dark,main,20211008,3,0.9930015212237694,271,12,56,339
11223,dark,main,20211008,4,0.9790693084218,149,6,20,175
11223,dark,main,20211008,5,0.9857546136625684,294,16,44,354
11223,dark,main,20211008,6,0.9926415839389761,308,14,34,356
11223,dark,main,20211008,7,0.9904447694058651,249,13,65,327
11223,dark,main,20211008,8,0.9872960452463918,237,18,96,351
11223,dark,main,20211008,9,0.9926419530019313,260,18,94,372
10542,dark,main,20211008,0,0.9947631080929573,304,12,61,377
10542,dark,main,20211008,1,0.9909890327756559,146,3,22,171
10542,dark,main,20211008,2,0.9880013718712721,303,15,46,364
10542,dark,main,20211008,3,0.992435476008071,290,13,32,335
10542,dark,main,20211008,4,0.9757146034551839,144,9,31,184
10542,dark,main,20211008,5,0.9923576027289157,277,9,66,352
10542,dark,main,20211008,6,0.9858338595066233,306,13,48,367
10542,dark,main,20211008,7,0.9891515772977103,272,10,55,337
10542,dark,main,20211008,8,0.9919519443098533,310,15,49,374
10542,dark,main,20211008,9,0.996626513866392,311,14,43,368
10311,dark,main,20211008,0,0.9905356382868087,271,27,82,380
10311,dark,main,20211008,1,0.9837519732268821,137,2,31,170
10311,dark,main,20211008,2,0.9913741947133448,329,14,39,382
10311,dark,main,20211008,3,0.9934185990465803,293,11,38,342
10311,dark,main,20211008,4,0.9856798212968102,154,8,19,181
10311,dark,main,20211008,5,0.9911057568674685,322,9,37,368
10311,dark,main,20211008,6,0.995570702323057,305,15,58,378
10311,dark,main,20211008,7,0.9861937133726989,245,18,64,327
10311,dark,main,20211008,8,0.9925117523677328,276,11,85,372
10311,dark,main,20211008,9,0.9910884254527141,288,15,83,386
6528,dark,main,20211008,0,0.9856817433755014,302,13,40,355
6528,dark,main,20211008,1,0.971973249410864,121,11,17,149
6528,dark,main,20211008,2,0.9873477553929956,288,25,62,375
6528,dark,main,20211008,3,0.9934464004612189,278,17,49,344
6528,dark,main,20211008,4,0.9831188770279745,146,7,28,181
6528,dark,main,20211008,5,0.9923481881118537,284,10,56,350
6528,dark,main,20211008,6,0.9948253603487841,318,10,60,388
6528,dark,main,20211008,7,0.9951451242021591,256,15,50,321
6528,dark,main,20211008,8,0.992888224257962,310,18,42,370
6528,dark,main,20211008,9,0.9933534837086574,284,17,51,352
6400,dark,main,20211008,0,0.989999240600865,285,15,74,374
6400,dark,main,20211008,1,0.9794479944914305,140,2,25,167
6400,dark,main,20211008,2,0.9909591868338348,331,11,44,386
6400,dark,main,20211008,3,0.9917866917198852,289,12,38,339
6400,dark,main,20211008,4,0.973138655870747,147,6,29,182
6400,dark,main,20211008,5,0.9922526916888713,288,12,56,356
6400,dark,main,20211008,6,0.9921259053545997,312,11,48,371
6400,dark,main,20211008,7,0.9956984550343493,243,13,61,317
6400,dark,main,20211008,8,0.9941210149711149,259,18,102,379
6400,dark,main,20211008,9,0.9943074626060572,260,16,84,360
1154,dark,main,20211008,0,0.990359610361957,292,11,79,382
1154,dark,main,20211008,1,0.9717456625009747,120,6,44,170
1154,dark,main,20211008,2,0.9882716410435706,295,12,85,392
1154,dark,main,20211008,3,0.994288250400201,269,17,64,350
1154,dark,main,20211008,4,0.9918996638084883,150,7,34,191
1154,dark,main,20211008,5,0.9979451852978113,297,11,47,355
1154,dark,main,20211008,6,0.9922917623049736,292,15,77,384
1154,dark,main,20211008,7,0.9925289145988729,234,14,83,331
1154,dark,main,20211008,8,0.9915522531179712,276,13,88,377
1154,dark,main,20211008,9,0.9947851361052458,279,12,91,382
6746,dark,main,20211008,0,0.9913104433257129,314,13,53,380
6746,dark,main,20211008,1,0.9890642899059072,150,4,17,171
6746,dark,main,20211008,2,0.9931083206776727,296,12,55,363
6746,dark,main,20211008,3,0.9876332309203699,239,15,96,350
6746,dark,main,20211008,4,0.986144708045783,119,9,52,180
6746,dark,main,20211008,5,0.9961451999750567,242,17,99,358
6746,dark,main,20211008,6,0.9881050910511637,254,14,109,377
6746,dark,main,20211008,7,0.9878543552207787,237,13,90,340
6746,dark,main,20211008,8,0.9921144462926772,284,11,76,371
6746,dark,main,20211008,9,0.9957424203220154,316,10,48,374
8989,dark,main,20211008,0,0.990803857536587,289,12,88,389
8989,dark,main,20211008,1,0.9762264614262924,127,3,36,166
8989,dark,main,20211008,2,0.9896792698208509,312,11,56,379
8989,dark,main,20211008,3,0.9894668600928196,291,12,43,346
8989,dark,main,20211008,4,0.9865885888711534,144,6,32,182
8989,dark,main,20211008,5,0.9944610106282982,306,11,51,368
8989,dark,main,20211008,6,0.9881633016758168,295,13,57,365
8989,dark,main,20211008,7,0.992882501717512,250,12,58,320
8989,dark,main,20211008,8,0.9885342965160507,303,12,59,374
8989,dark,main,20211008,9,0.9946100342415548,296,17,50,363
4815,dark,main,20211008,0,0.9905979122912498,301,13,73,387
4815,dark,main,20211008,1,0.9813597648873197,145,5,25,175
4815,dark,main,20211008,2,0.994021821735517,319,13,55,387
4815,dark,main,20211008,3,0.9935033527307446,304,16,42,362
4815,dark,main,20211008,4,0.9772094407279915,143,11,28,182
4815,dark,main,20211008,5,0.9871795510291517,258,14,79,351
4815,dark,main,20211008,6,0.9850566300065021,295,17,68,380
4815,dark,main,20211008,7,0.9862645783377635,288,12,43,343
4815,dark,main,20211008,8,0.9896057270652803,313,15,57,385
4815,dark,main,20211008,9,0.9910202622546235,326,10,60,396
22391,bright,main,20211008,0,0.9888441851730655,155,279,1,435
22391,bright,main,20211008,1,0.9851109389697211,61,137,0,198
22391,bright,main,20211008,2,0.9914862015397479,127,297,2,426
22391,bright,main,20211008,3,0.9952975276522557,175,223,2,400
22391,bright,main,20211008,4,0.9676789259413459,83,122,3,208
22391,bright,main,20211008,5,0.9916013534412186,172,235,1,408
22391,bright,main,20211008,6,0.9917702732494195,283,143,2,428
22391,bright,main,20211008,7,0.991200864805329,246,126,5,377
22391,bright,main,20211008,8,0.9935050310559179,239,188,1,428
22391,bright,main,20211008,9,0.9946850690774225,202,219,3,424
4991,dark,main,20211008,0,0.9950124453382242,329,13,50,392
4991,dark,main,20211008,1,0.9650299600644876,130,5,21,156
4991,dark,main,20211008,2,0.985664688524603,324,12,38,374
4991,dark,main,20211008,3,0.9924625789087955,271,13,55,339
4991,dark,main,20211008,4,0.9798410470910826,154,7,28,189
4991,dark,main,20211008,5,0.9872367225435451,287,14,65,366
4991,dark,main,20211008,6,0.9960053941389098,298,14,53,365
4991,dark,main,20211008,7,0.9892609679608829,272,14,38,324
4991,dark,main,20211008,8,0.99271085599329,288,17,46,351
4991,dark,main,20211008,9,0.9882268312873729,328,14,37,379
8074,dark,main,20211008,0,0.9878478622266554,313,16,46,375
8074,dark,main,20211008,1,0.9815409990168095,137,10,28,175
8074,dark,main,20211008,2,0.9911196347539271,289,23,58,370
8074,dark,main,20211008,3,0.9884834931605259,274,18,58,350
8074,dark,main,20211008,4,0.9918253237127672,125,9,44,178
8074,dark,main,20211008,5,0.9843544364135182,258,24,80,362
8074,dark,main,20211008,6,0.991400602327689,288,25,70,383
8074,dark,main,20211008,7,0.9893730066969266,245,18,66,329
8074,dark,main,20211008,8,0.9913368204957861,311,15,43,369
8074,dark,main,20211008,9,0.9832944294004414,313,14,36,363
11220,dark,main,20211008,0,0.9889564421009425,307,11,58,376
11220,dark,main,20211008,1,0.9770762176166659,146,5,23,174
11220,dark,main,20211008,2,0.9903429963840169,328,14,42,384
11220,dark,main,20211008,3,0.9933780871761355,310,13,37,360
11220,dark,main,20211008,4,0.9586523270702823,139,8,30,177
11220,dark,main,20211008,5,0.9855939070173227,284,12,79,375
11220,dark,main,20211008,6,0.989623302973779,279,14,74,367
11220,dark,main,20211008,7,0.985504523285794,255,13,57,325
11220,dark,main,20211008,8,0.9877137197015671,296,14,49,359
11220,dark,main,20211008,9,0.99531037915334,298,12,48,358
9359,dark,main,20211008,0,0.9913397823045569,295,16,66,377
9359,dark,main,20211008,1,0.9793025031313584,134,9,23,166
9359,dark,main,20211008,2,0.9921270823810084,286,16,87,389
9359,dark,main,20211008,3,0.9908143155513636,252,13,79,344
9359,dark,main,20211008,4,0.9910948744527966,146,8,24,178
9359,dark,main,20211008,5,0.9924388430112547,284,13,65,362
9359,dark,main,20211008,6,0.9922971547423972,311,15,60,386
9359,dark,main,20211008,7,0.988631381082281,261,11,59,331
9359,dark,main,20211008,8,0.9912035654240408,309,14,48,371
9359,dark,main,20211008,9,0.9913079898066864,317,10,42,369
9366,dark,main,20211008,0,0.9889548142875094,296,12,79,387
9366,dark,main,20211008,1,0.967407877783306,134,10,26,170
9366,dark,main,20211008,2,0.9931674925100579,328,15,50,393
9366,dark,main,20211008,3,0.9895037322273404,287,15,58,360
9366,dark,main,20211008,4,0.978564056330803,145,13,25,183
9366,dark,main,20211008,5,0.9908391000499792,274,14,73,361
9366,dark,main,20211008,6,0.990620589611026,302,13,64,379
9366,dark,main,20211008,7,0.993210485598183,273,11,54,338
9366,dark,main,20211008,8,0.9931239605810788,313,10,42,365
9366,dark,main,20211008,9,0.9865549565057437,307,10,65,382
23215,bright,main,20211008,0,0.9942217319719105,210,221,2,433
23215,bright,main,20211008,1,0.986082359399097,101,94,3,198
23215,bright,main,20211008,2,0.9902359277602711,304,116,3,423
23215,bright,main,20211008,3,0.9918932091019405,270,127,3,400
23215,bright,main,20211008,4,0.9893179413379556,143,64,0,207
23215,bright,main,20211008,5,0.9914091511400375,264,140,3,407
23215,bright,main,20211008,6,0.9944826296276226,259,163,3,425
23215,bright,main,20211008,7,0.9914136889983223,189,185,2,376
23215,bright,main,20211008,8,0.9924285924037823,177,240,2,419
23215,bright,main,20211008,9,0.9960719682113871,144,270,5,419
8980,dark,main,20211008,0,0.9934680025664678,320,11,51,382
8980,dark,main,20211008,1,0.9836760667819265,139,11,24,174
8980,dark,main,20211008,2,0.9914427029592524,313,10,50,373
8980,dark,main,20211008,3,0.9865919984135875,301,12,39,352
8980,dark,main,20211008,4,0.987740315476529,153,6,32,191
8980,dark,main,20211008,5,0.9864419351363853,308,11,49,368
8980,dark,main,20211008,6,0.9960345415434543,317,12,57,386
8980,dark,main,20211008,7,0.9881799373242917,269,11,37,317
8980,dark,main,20211008,8,0.9950009601808106,306,10,45,361
8980,dark,main,20211008,9,0.9897832451780444,286,11,48,345
6540,dark,main,20211008,0,0.9931560724805218,286,33,48,367
6540,dark,main,20211008,1,0.9849657024994218,115,23,24,162
6540,dark,main,20211008,2,0.9866483164614351,274,31,55,360
6540,dark,main,20211008,3,0.9896618034812736,254,40,46,340
6540,dark,main,20211008,4,0.989410073383896,145,9,15,169
6540,dark,main,20211008,5,0.9874569123086275,272,42,33,347
6540,dark,main,20211008,6,0.9929073640030569,284,22,44,350
6540,dark,main,20211008,7,0.9909248754887263,260,31,43,334
6540,dark,main,20211008,8,0.9824474841734078,267,26,48,341
6540,dark,main,20211008,9,0.9951350076974808,259,26,55,340
6387,dark,main,20211008,0,0.9922164875153715,320,12,73,405
6387,dark,main,20211008,1,0.9829949578929247,142,10,23,175
6387,dark,main,20211008,2,0.9921726489047829,303,13,58,374
6387,dark,main,20211008,3,0.9848527811698812,274,13,55,342
6387,dark,main,20211008,4,0.9776450955794326,155,5,26,186
6387,dark,main,20211008,5,0.9872050537997495,257,17,87,361
6387,dark,main,20211008,6,0.9935628479845912,260,19,90,369
6387,dark,main,20211008,7,0.9921996163583808,226,17,87,330
6387,dark,main,20211008,8,0.9894168424248314,289,11,61,361
6387,dark,main,20211008,9,0.9946405765760405,278,18,72,368
9630,dark,main,20211008,0,0.987684580029937,292,31,39,362
9630,dark,main,20211008,1,0.968089318450104,121,28,19,168
9630,dark,main,20211008,2,0.9918648711310262,227,80,59,366
9630,dark,main,20211008,3,0.992183961771984,200,85,61,346
9630,dark,main,20211008,4,0.9857472980346106,103,37,36,176
9630,dark,main,20211008,5,0.988947537599141,232,61,70,363
9630,dark,main,20211008,6,0.9944025920650481,218,61,70,349
9630,dark,main,20211008,7,0.9949034321352856,212,38,63,313
9630,dark,main,20211008,8,0.993385495311675,249,44,52,345
9630,dark,main,20211008,9,0.9929787360639107,285,28,47,360
3608,dark,main,20211008,0,0.9917093343878708,298,14,73,385
3608,dark,main,20211008,1,0.9843301545679666,121,8,46,175
3608,dark,main,20211008,2,0.9899967851008491,271,13,94,378
3608,dark,main,20211008,3,0.9883565460935693,240,16,90,346
3608,dark,main,20211008,4,0.9803930941124865,126,9,53,188
3608,dark,main,20211008,5,0.9929877584043776,246,12,110,368
3608,dark,main,20211008,6,0.9899464602529069,263,12,111,386
3608,dark,main,20211008,7,0.9829623833236248,236,12,84,332
3608,dark,main,20211008,8,0.9951014319129112,291,16,75,382
3608,dark,main,20211008,9,0.9948511722629779,290,12,77,379
23842,bright,main,20211009,0,0.9927974999735719,380,49,4,433
23842,bright,main,20211009,1,0.97618901204898,154,34,2,190
23842,bright,main,20211009,2,0.9929328255101783,345,69,5,419
23842,bright,main,20211009,3,0.9931442990895446,294,78,3,375
23842,bright,main,20211009,4,0.9797904950062769,174,26,2,202
23842,bright,main,20211009,5,0.9872541969828877,319,62,5,386
23842,bright,main,20211009,6,0.9929726223686608,363,50,6,419
23842,bright,main,20211009,7,0.98644545863495,302,52,4,358
23842,bright,main,20211009,8,0.9966675470246393,339,60,5,404
23842,bright,main,20211009,9,0.9925826316908527,366,45,3,414
25405,bright,main,20211009,0,0.9970502637071941,295,110,10,415
25405,bright,main,20211009,1,0.9851229624406528,136,49,0,185
25405,bright,main,20211009,2,0.9932016416812213,317,92,4,413
25405,bright,main,20211009,3,0.9913328290041092,284,103,3,390
25405,bright,main,20211009,4,0.9753634741255053,153,42,3,198
25405,bright,main,20211009,5,0.990632982953884,305,90,5,400
25405,bright,main,20211009,6,0.9941739396804663,277,130,6,413
25405,bright,main,20211009,7,0.9911318294978577,199,153,8,360
25405,bright,main,20211009,8,0.9930235484395635,306,98,5,409
25405,bright,main,20211009,9,0.9919212286215512,308,102,2,412
8077,dark,main,20211009,0,0.9925204286775454,306,22,52,380
8077,dark,main,20211009,1,0.9774713621182437,143,7,18,168
8077,dark,main,20211009,2,0.992876236538837,304,21,42,367
8077,dark,main,20211009,3,0.9890957289931429,255,34,51,340
8077,dark,main,20211009,4,0.9800211229282996,134,15,26,175
8077,dark,main,20211009,5,0.9962117569021012,282,33,56,371
8077,dark,main,20211009,6,0.9907947536148055,283,27,57,367
8077,dark,main,20211009,7,0.9904606037553596,252,23,51,326
8077,dark,main,20211009,8,0.9917482230641717,304,27,37,368
8077,dark,main,20211009,9,0.995065573259808,298,16,58,372
23808,bright,main,20211009,0,0.992974554746476,342,75,5,422
23808,bright,main,20211009,1,0.9900592100837949,144,43,1,188
23808,bright,main,20211009,2,0.9889346275655905,348,69,3,420
23808,bright,main,20211009,3,0.9945438071770322,298,78,5,381
23808,bright,main,20211009,4,0.9763095279687113,165,34,2,201
23808,bright,main,20211009,5,0.9897422555140836,341,55,1,397
23808,bright,main,20211009,6,0.9925315260015306,330,83,5,418
23808,bright,main,20211009,7,0.9816109352433359,312,53,2,367
23808,bright,main,20211009,8,0.9926154419885437,303,85,3,391
23808,bright,main,20211009,9,0.996001659628778,322,78,6,406
25762,bright,main,20211009,0,0.9909769860913923,304,102,3,409
25762,bright,main,20211009,1,0.9948306757237029,119,57,4,180
25762,bright,main,20211009,2,0.9966471429586802,318,94,5,417
25762,bright,main,20211009,3,0.9963710983646976,304,73,3,380
25762,bright,main,20211009,4,0.9755689189364414,149,47,5,201
25762,bright,main,20211009,5,0.9904138596660713,320,69,2,391
25762,bright,main,20211009,6,0.9885528535504933,289,85,7,381
25762,bright,main,20211009,7,0.9921893358376307,255,99,3,357
25762,bright,main,20211009,8,0.9914999941807373,313,80,4,397
25762,bright,main,20211009,9,0.9902811154598348,296,106,3,405
8102,dark,main,20211009,0,0.9941743753562142,327,13,47,387
8102,dark,main,20211009,1,0.9724571499190435,145,3,23,171
8102,dark,main,20211009,2,0.9924634154516376,306,15,50,371
8102,dark,main,20211009,3,0.9875659123857209,286,13,65,364
8102,dark,main,20211009,4,0.9775817715427847,136,9,50,195
8102,dark,main,20211009,5,0.989204191981438,280,12,67,359
8102,dark,main,20211009,6,0.9924130823165254,305,15,59,379
8102,dark,main,20211009,7,0.9856768566328443,267,12,42,321
8102,dark,main,20211009,8,0.9890567402251006,320,12,46,378
8102,dark,main,20211009,9,0.9937024868957812,316,14,41,371
4139,dark,main,20211009,0,0.987900718991354,306,13,58,377
4139,dark,main,20211009,1,0.9836958530696587,133,6,28,167
4139,dark,main,20211009,2,0.9918770812044844,320,14,52,386
4139,dark,main,20211009,3,0.9879273089804708,275,16,58,349
4139,dark,main,20211009,4,0.9895471743245837,155,7,31,193
4139,dark,main,20211009,5,0.9905571787678699,293,13,55,361
4139,dark,main,20211009,6,0.9898800816481106,310,16,57,383
4139,dark,main,20211009,7,0.9923906562529143,267,9,41,317
4139,dark,main,20211009,8,0.9885271903746417,312,14,38,364
4139,dark,main,20211009,9,0.9899308026068301,299,21,51,371
25750,bright,main,20211009,0,0.9917786517824685,273,142,6,421
25750,bright,main,20211009,1,0.9673905423266589,137,47,1,185
25750,bright,main,20211009,2,0.9933506970251571,352,70,3,425
25750,bright,main,20211009,3,0.9868895283847143,331,51,2,384
25750,bright,main,20211009,4,0.9868895283847143,331,51,2,384
25750,bright,main,20211009,5,0.98909961404457,320,78,4,402
25750,bright,main,20211009,6,0.9898607916187816,333,78,3,414
25750,bright,main,20211009,7,0.9882154132715877,269,86,7,362
25750,bright,main,20211009,8,0.9950877037876568,290,119,4,413
25750,bright,main,20211009,9,0.9956714627901866,269,144,6,419
3140,dark,main,20211009,0,0.9945470154784619,286,24,86,396
3140,dark,main,20211009,1,0.9677332389555348,129,9,36,174
3140,dark,main,20211009,2,0.9956361179224827,303,23,61,387
3140,dark,main,20211009,3,0.9893909171792381,276,16,52,344
3140,dark,main,20211009,4,0.9856292102456462,159,9,26,194
3140,dark,main,20211009,5,0.9905617504830624,281,27,62,370
3140,dark,main,20211009,6,0.986400782514923,310,13,66,389
3140,dark,main,20211009,7,0.9890887053656225,260,20,51,331
3140,dark,main,20211009,8,0.9859774966545116,285,18,55,358
3140,dark,main,20211009,9,0.9902896820283105,273,12,89,374
25746,bright,main,20211009,0,0.9949493164044554,328,86,4,418
25746,bright,main,20211009,1,0.9781907243152456,143,38,2,183
25746,bright,main,20211009,2,0.9931356285936624,369,57,6,432
25746,bright,main,20211009,3,0.9889286720644601,332,50,4,386
25746,bright,main,20211009,4,0.990173917231197,152,38,4,194
25746,bright,main,20211009,5,0.9907722162341923,329,60,6,395
25746,bright,main,20211009,6,0.9940045471794219,333,67,8,408
25746,bright,main,20211009,7,0.9906251494256475,297,65,6,368
25746,bright,main,20211009,8,0.9958801198734867,355,52,4,411
25746,bright,main,20211009,9,0.9936572047423577,360,47,4,411
23833,bright,main,20211009,0,0.997015852353283,351,75,5,431
23833,bright,main,20211009,1,0.9894824534544012,156,30,1,187
23833,bright,main,20211009,2,0.994249202576773,380,44,5,429
23833,bright,main,20211009,3,0.992948478579007,285,90,2,377
23833,bright,main,20211009,4,0.9884748451972206,146,55,3,204
23833,bright,main,20211009,5,0.9877597772142077,287,101,6,394
23833,bright,main,20211009,6,0.9890007622181117,303,99,1,403
23833,bright,main,20211009,7,0.9948465675615717,260,93,5,358
23833,bright,main,20211009,8,0.9894349615117782,273,114,7,394
23833,bright,main,20211009,9,0.9939111756930117,287,115,7,409
23802,bright,main,20211009,0,0.9905759809972489,324,88,4,416
23802,bright,main,20211009,1,0.9754658797836635,134,50,2,186
23802,bright,main,20211009,2,0.9896815185678585,358,60,2,420
23802,bright,main,20211009,3,0.9911034097817855,306,78,3,387
23802,bright,main,20211009,4,0.9814287309146295,149,48,2,199
23802,bright,main,20211009,5,0.9864796503916903,246,140,7,393
23802,bright,main,20211009,6,0.994287705531448,240,124,5,369
23802,bright,main,20211009,7,0.9921512688503442,265,88,3,356
23802,bright,main,20211009,8,0.9919335054875952,319,86,2,407
23802,bright,main,20211009,9,0.9964852146871991,296,114,7,417
25748,bright,main,20211009,0,0.988873586592894,347,76,2,425
25748,bright,main,20211009,1,0.9853960729110565,147,34,1,182
25748,bright,main,20211009,2,0.9952272289905802,303,99,6,408
25748,bright,main,20211009,3,0.9913220984963641,288,93,2,383
25748,bright,main,20211009,4,0.9880427325229941,162,41,1,204
25748,bright,main,20211009,5,0.9899737737606608,322,64,5,391
25748,bright,main,20211009,6,0.9945798805459729,300,105,12,417
25748,bright,main,20211009,7,0.9920471098554674,267,84,2,353
25748,bright,main,20211009,8,0.9834917209360785,319,76,6,401
25748,bright,main,20211009,9,0.9966530559609247,330,80,3,413
22394,bright,main,20211009,0,0.9930408075926493,260,176,2,438
22394,bright,main,20211009,1,0.9827244324421074,115,77,0,192
22394,bright,main,20211009,2,0.9942220332639862,283,144,1,428
22394,bright,main,20211009,3,0.9879350831471487,166,229,2,397
22394,bright,main,20211009,4,0.9831696964634056,54,157,0,211
22394,bright,main,20211009,5,0.9909785144684924,125,288,3,416
22394,bright,main,20211009,6,0.9955225279380101,172,259,4,435
22394,bright,main,20211009,7,0.9922604622768344,247,128,2,377
22394,bright,main,20211009,8,0.9962065232757717,255,171,1,427
22394,bright,main,20211009,9,0.9862992865390225,297,134,3,434
4946,dark,main,20211009,0,0.9956959348381867,298,17,68,383
4946,dark,main,20211009,1,0.9883845090443754,134,8,23,165
4946,dark,main,20211009,2,0.9874296666457372,300,17,58,375
4946,dark,main,20211009,3,0.9965320758526641,275,18,60,353
4946,dark,main,20211009,4,0.9821687565987948,133,16,41,190
4946,dark,main,20211009,5,0.9920594893661127,255,18,84,357
4946,dark,main,20211009,6,0.9873513031360245,278,15,77,370
4946,dark,main,20211009,7,0.9856229990840145,271,16,47,334
4946,dark,main,20211009,8,0.9943078444636219,323,17,40,380
4946,dark,main,20211009,9,0.9922940220278383,298,19,55,372
11837,dark,main,20211009,0,0.9874948355182709,294,15,93,402
11837,dark,main,20211009,1,0.9727686952318749,130,8,39,177
11837,dark,main,20211009,2,0.9964093671275843,311,11,87,409
11837,dark,main,20211009,3,0.9883187791249124,262,14,84,360
11837,dark,main,20211009,4,0.9768090726740317,140,8,32,180
11837,dark,main,20211009,5,0.9920162386484168,296,13,47,356
11837,dark,main,20211009,6,0.9903605858244349,326,9,56,391
11837,dark,main,20211009,7,0.986980737663778,284,15,44,343
11837,dark,main,20211009,8,0.9880639266872363,300,10,70,380
11837,dark,main,20211009,9,0.9920679633916367,281,13,93,387
23439,bright,main,20211009,0,0.9955422221730877,222,215,2,439
23439,bright,main,20211009,1,0.9927865419071255,149,48,0,197
23439,bright,main,20211009,2,0.9931875868154048,340,82,2,424
23439,bright,main,20211009,3,0.9935272249518611,245,125,5,375
23439,bright,main,20211009,4,0.9772255505521984,164,42,2,208
23439,bright,main,20211009,5,0.9923622361391389,311,100,3,414
23439,bright,main,20211009,6,0.9869989962599373,303,127,3,433
23439,bright,main,20211009,7,0.9896629878945256,261,114,0,375
23439,bright,main,20211009,8,0.9933668712716366,260,162,5,427
23439,bright,main,20211009,9,0.9914275499156159,228,198,3,429
6538,dark,main,20211009,0,0.9929194209941333,235,44,76,355
6538,dark,main,20211009,1,0.9682520776868956,138,11,19,168
6538,dark,main,20211009,2,0.9906834681210064,254,46,75,375
6538,dark,main,20211009,3,0.9899441905656255,245,51,50,346
6538,dark,main,20211009,4,0.9825074982761081,151,9,16,176
6538,dark,main,20211009,5,0.9928812205617926,279,20,56,355
6538,dark,main,20211009,6,0.9910692584678941,291,17,45,353
6538,dark,main,20211009,7,0.9907188649604315,240,22,46,308
6538,dark,main,20211009,8,0.9893059444146246,290,24,43,357
6538,dark,main,20211009,9,0.9926362592740261,278,25,61,364
9365,dark,main,20211009,0,0.9963774003310064,317,14,53,384
9365,dark,main,20211009,1,0.9904440006468193,148,6,25,179
9365,dark,main,20211009,2,0.9942368104192837,301,16,86,403
9365,dark,main,20211009,3,0.9928351679652159,259,14,83,356
9365,dark,main,20211009,4,0.9796676916477894,143,7,38,188
9365,dark,main,20211009,5,0.9882675605372397,238,14,68,320
9365,dark,main,20211009,6,0.9961978212012974,251,12,92,355
9365,dark,main,20211009,7,0.9925010048620385,261,12,55,328
9365,dark,main,20211009,8,0.9860019613313896,292,14,56,362
9365,dark,main,20211009,9,0.9900611136814715,279,13,70,362
8068,dark,main,20211009,0,0.9938839468259703,331,14,34,379
8068,dark,main,20211009,1,0.972493857123702,135,6,22,163
8068,dark,main,20211009,2,0.9874721921982157,310,15,47,372
8068,dark,main,20211009,3,0.9939659002811597,285,19,42,346
8068,dark,main,20211009,4,0.9858830396391288,148,11,28,187
8068,dark,main,20211009,5,0.9892057325786968,268,13,73,354
8068,dark,main,20211009,6,0.991631506358508,279,16,71,366
8068,dark,main,20211009,7,0.9908979545990759,272,13,45,330
8068,dark,main,20211009,8,0.988630006450123,309,13,52,374
8068,dark,main,20211009,9,0.9914856449351268,311,14,46,371
23135,bright,main,20211009,0,0.9942335692471655,327,88,2,417
23135,bright,main,20211009,1,0.9709393059175873,136,47,3,186
23135,bright,main,20211009,2,0.993257395738482,332,80,6,418
23135,bright,main,20211009,3,0.9951588726342931,272,93,6,371
23135,bright,main,20211009,4,0.9889535742103175,149,47,2,198
23135,bright,main,20211009,5,0.9909372153902508,292,90,4,386
23135,bright,main,20211009,6,0.9925681383320889,299,106,6,411
23135,bright,main,20211009,7,0.9916513495313355,253,98,3,354
23135,bright,main,20211009,8,0.9941392883548597,308,98,1,407
23135,bright,main,20211009,9,0.9914661703040886,320,92,5,417
7941,dark,main,20211010,0,0.9964034651923803,306,12,69,387
7941,dark,main,20211010,1,0.976634489698919,146,4,27,177
7941,dark,main,20211010,2,0.9945829004419319,268,16,88,372
7941,dark,main,20211010,3,0.9888575078866122,264,14,76,354
7941,dark,main,20211010,4,0.9784572740152737,130,14,39,183
7941,dark,main,20211010,5,0.9889165406671381,261,14,89,364
7941,dark,main,20211010,6,0.9924927639671599,276,14,86,376
7941,dark,main,20211010,7,0.9925282243025675,224,14,83,321
7941,dark,main,20211010,8,0.9922205818859093,283,15,73,371
7941,dark,main,20211010,9,0.9943396088510206,321,20,45,386
8767,dark,main,20211010,0,0.9922823276098622,319,10,55,384
8767,dark,main,20211010,1,0.9818571713138449,144,6,21,171
8767,dark,main,20211010,2,0.9920034505025698,290,20,72,382
8767,dark,main,20211010,3,0.9905419065340451,272,15,44,331
8767,dark,main,20211010,4,0.9823733116383639,140,9,34,183
8767,dark,main,20211010,5,0.9847935946315951,292,14,55,361
8767,dark,main,20211010,6,0.9941087566121817,296,15,67,378
8767,dark,main,20211010,7,0.9922713745635865,266,16,51,333
8767,dark,main,20211010,8,0.9950428919875285,279,14,55,348
8767,dark,main,20211010,9,0.9952471962221012,301,14,43,358
6736,dark,main,20211010,0,0.9907358205376976,296,12,84,392
6736,dark,main,20211010,1,0.9775898672655589,117,7,48,172
6736,dark,main,20211010,2,0.9881522182753536,282,12,83,377
6736,dark,main,20211010,3,0.9935006073092641,251,14,80,345
6736,dark,main,20211010,4,0.9803906118319744,130,6,44,180
6736,dark,main,20211010,5,0.9960842547509747,272,14,87,373
6736,dark,main,20211010,6,0.9941144391049351,282,14,71,367
6736,dark,main,20211010,7,0.9947580162680811,225,17,86,328
6736,dark,main,20211010,8,0.9934828597360891,253,16,97,366
6736,dark,main,20211010,9,0.9940989937490127,280,18,82,380
9354,dark,main,20211010,0,0.9949101934364968,276,17,105,398
9354,dark,main,20211010,1,0.9735806847843907,121,6,50,177
9354,dark,main,20211010,2,0.9903921027887792,266,13,86,365
9354,dark,main,20211010,3,0.9948770971495405,290,15,48,353
9354,dark,main,20211010,4,0.9811305009887535,150,9,29,188
9354,dark,main,20211010,5,0.9886111436403889,293,16,51,360
9354,dark,main,20211010,6,0.9961989910420381,311,12,63,386
9354,dark,main,20211010,7,0.9868580614182829,275,13,45,333
9354,dark,main,20211010,8,0.9941115785680944,283,17,69,369
9354,dark,main,20211010,9,0.9886795907141256,258,20,95,373
2374,dark,main,20211010,0,0.9934264397750037,273,18,98,389
2374,dark,main,20211010,1,0.9817358480120794,129,8,36,173
2374,dark,main,20211010,2,0.9913011967902812,263,15,97,375
2374,dark,main,20211010,3,0.9919493674877117,250,23,83,356
2374,dark,main,20211010,4,0.9766400851757789,122,15,56,193
2374,dark,main,20211010,5,0.9913454941135788,251,25,84,360
2374,dark,main,20211010,6,0.9830113369490154,276,18,91,385
2374,dark,main,20211010,7,0.9937558617826067,236,19,76,331
2374,dark,main,20211010,8,0.9816465290916534,231,21,84,336
2374,dark,main,20211010,9,0.989539752592261,258,16,99,373
7933,dark,main,20211010,0,0.9964261383783685,305,16,66,387
7933,dark,main,20211010,1,0.984954786891643,132,10,31,173
7933,dark,main,20211010,2,0.9898372220450604,269,24,73,366
7933,dark,main,20211010,3,0.9943175313990159,224,19,101,344
7933,dark,main,20211010,4,0.9833483535859091,133,10,49,192
7933,dark,main,20211010,5,0.9930839774142171,249,21,85,355
7933,dark,main,20211010,6,0.9898827554666506,263,18,84,365
7933,dark,main,20211010,7,0.9892543062071891,260,10,60,330
7933,dark,main,20211010,8,0.9871060641205376,259,10,76,345
7933,dark,main,20211010,9,0.9891179017316313,288,11,65,364
1690,dark,main,20211010,0,0.9932407575762594,276,15,101,392
1690,dark,main,20211010,1,0.9725597919418766,108,12,49,169
1690,dark,main,20211010,2,0.992590793246467,261,24,92,377
1690,dark,main,20211010,3,0.99021824589698,265,13,86,364
1690,dark,main,20211010,4,0.9742236789684666,128,6,43,177
1690,dark,main,20211010,5,0.9904739222968559,266,14,87,367
1690,dark,main,20211010,6,0.9956849304462523,291,12,77,380
1690,dark,main,20211010,7,0.9910173051000885,231,17,82,330
1690,dark,main,20211010,8,0.9883521661058144,252,17,93,362
1690,dark,main,20211010,9,0.9924795476108541,287,15,58,360
1993,dark,main,20211010,0,0.9918089748101113,246,56,93,395
1993,dark,main,20211010,1,0.9731005794454196,122,10,46,178
1993,dark,main,20211010,2,0.9915809931137546,260,22,72,354
1993,dark,main,20211010,3,0.9933817081245268,234,21,96,351
1993,dark,main,20211010,4,0.9793945862448546,134,14,47,195
1993,dark,main,20211010,5,0.9917447304127094,280,23,69,372
1993,dark,main,20211010,6,0.9921608009734807,262,36,82,380
1993,dark,main,20211010,7,0.9892172740118792,213,33,88,334
1993,dark,main,20211010,8,0.9930074366208539,275,20,72,367
1993,dark,main,20211010,9,0.9967245564180042,264,23,91,378
4835,dark,main,20211010,0,0.9949673310067065,335,10,55,400
4835,dark,main,20211010,1,0.9836614769045359,127,7,34,168
4835,dark,main,20211010,2,0.9943854051838305,273,16,75,364
4835,dark,main,20211010,3,0.9934040549786696,247,13,88,348
4835,dark,main,20211010,4,0.9897932192822199,143,8,44,195
4835,dark,main,20211010,5,0.9911498691063937,246,17,94,357
4835,dark,main,20211010,6,0.9933241850720911,270,13,86,369
4835,dark,main,20211010,7,0.9916904856342095,238,14,83,335
4835,dark,main,20211010,8,0.9891841950874195,285,12,66,363
4835,dark,main,20211010,9,0.986419570313444,308,14,54,376
10947,dark,main,20211010,0,0.9918580275471434,323,13,58,394
10947,dark,main,20211010,1,0.9916199141240173,147,5,19,171
10947,dark,main,20211010,2,0.9936602302347802,312,13,52,377
10947,dark,main,20211010,3,0.9906561147395709,279,11,65,355
10947,dark,main,20211010,4,0.9817379983417824,112,7,65,184
10947,dark,main,20211010,5,0.9862382490044517,244,13,109,366
10947,dark,main,20211010,6,0.9928032204473273,269,12,93,374
10947,dark,main,20211010,7,0.9948843954057354,255,12,86,353
10947,dark,main,20211010,8,0.9936586217216653,268,14,90,372
10947,dark,main,20211010,9,0.9885041558854105,270,19,79,368
6747,dark,main,20211010,0,0.9897133822330412,276,12,101,389
6747,dark,main,20211010,1,0.9860506279129376,125,7,45,177
6747,dark,main,20211010,2,0.9859064131416698,251,12,113,376
6747,dark,main,20211010,3,0.9935356620496643,254,15,93,362
6747,dark,main,20211010,4,0.9749408976756808,129,3,50,182
6747,dark,main,20211010,5,0.9923887375802951,260,15,94,369
6747,dark,main,20211010,6,0.9919956375995714,267,13,92,372
6747,dark,main,20211010,7,0.9878200890731713,223,13,87,323
6747,dark,main,20211010,8,0.9936696493830591,283,12,73,368
6747,dark,main,20211010,9,0.993843676895988,258,17,97,372
9616,dark,main,20211010,0,0.9893045918451319,301,17,43,361
9616,dark,main,20211010,1,0.9649013821928445,143,6,20,169
9616,dark,main,20211010,2,0.9961149645087124,290,18,46,354
9616,dark,main,20211010,3,0.9887687391501542,272,14,52,338
9616,dark,main,20211010,4,0.9840193956991977,144,11,29,184
9616,dark,main,20211010,5,0.992771126186478,258,24,82,364
9616,dark,main,20211010,6,0.9921104157459026,289,24,69,382
9616,dark,main,20211010,7,0.9867305511176899,256,13,59,328
9616,dark,main,20211010,8,0.9904437323675908,285,26,51,362
9616,dark,main,20211010,9,0.9946034017089826,312,15,37,364
8115,dark,main,20211010,0,0.9860872726866945,288,16,79,383
8115,dark,main,20211010,1,0.9824975798438232,129,8,32,169
8115,dark,main,20211010,2,0.9910489688258177,267,18,78,363
8115,dark,main,20211010,3,0.9917712728015936,287,14,52,353
8115,dark,main,20211010,4,0.9851767255984651,157,9,15,181
8115,dark,main,20211010,5,0.990020160005446,304,11,42,357
8115,dark,main,20211010,6,0.9938482980697184,296,25,43,364
8115,dark,main,20211010,7,0.9943782476088651,265,19,38,322
8115,dark,main,20211010,8,0.9902574091441299,284,16,64,364
8115,dark,main,20211010,9,0.9916390928576714,255,20,74,349
3373,dark,main,20211010,0,0.9895990662191454,284,21,72,377
3373,dark,main,20211010,1,0.973531072955582,126,10,38,174
3373,dark,main,20211010,2,0.9953776629648363,228,29,86,343
3373,dark,main,20211010,3,0.9875092297216272,247,24,86,357
3373,dark,main,20211010,4,0.9813029628518656,126,22,40,188
3373,dark,main,20211010,5,0.9862432874629243,253,27,59,339
3373,dark,main,20211010,6,0.9889918910564107,241,23,100,364
3373,dark,main,20211010,7,0.985816008885359,230,21,75,326
3373,dark,main,20211010,8,0.9939765202521748,256,24,75,355
3373,dark,main,20211010,9,0.9937101093843779,258,21,89,368
25553,bright,main,20211010,0,0.9949883749465284,314,125,0,439
25553,bright,main,20211010,1,0.9812869713104739,118,77,2,197
25553,bright,main,20211010,2,0.9926135944266454,274,138,3,415
25553,bright,main,20211010,3,0.9897843191103091,246,145,5,396
25553,bright,main,20211010,4,0.9795225314271049,141,67,1,209
25553,bright,main,20211010,5,0.9939135752034273,253,150,6,409
25553,bright,main,20211010,6,0.992779800036731,262,166,0,428
25553,bright,main,20211010,7,0.9954413725618936,241,130,1,372
25553,bright,main,20211010,8,0.9913597407381813,319,99,5,423
25553,bright,main,20211010,9,0.9912771762591728,299,129,4,432
4982,dark,main,20211010,0,0.9942127167338238,316,16,51,383
4982,dark,main,20211010,1,0.973694561926896,139,5,14,158
4982,dark,main,20211010,2,0.9958612030472042,282,12,30,324
4982,dark,main,20211010,3,0.9897107236941257,295,12,43,350
4982,dark,main,20211010,4,0.9823912559302386,131,15,36,182
4982,dark,main,20211010,5,0.9894618333956394,184,17,45,246
4982,dark,main,20211010,6,0.9933293022953078,290,16,74,380
4982,dark,main,20211010,7,0.9846542425429041,290,13,35,338
4982,dark,main,20211010,8,0.9898188895261646,302,12,53,367
4982,dark,main,20211010,9,0.9941447377292025,307,15,45,367
2061,dark,main,20211010,0,0.9948909840805937,305,13,80,398
2061,dark,main,20211010,1,0.9760129823903885,122,5,49,176
2061,dark,main,20211010,2,0.9919660426366542,284,17,89,390
2061,dark,main,20211010,3,0.9884246164582537,242,13,91,346
2061,dark,main,20211010,4,0.9836951827503352,142,4,45,191
2061,dark,main,20211010,5,0.9955163516784911,260,16,99,375
2061,dark,main,20211010,6,0.9921936317935275,278,12,88,378
2061,dark,main,20211010,7,0.9930989434227802,216,13,93,322
2061,dark,main,20211010,8,0.9891653421807419,263,13,90,366
2061,dark,main,20211010,9,0.9848458005258158,289,12,90,391
5173,dark,main,20211010,0,0.9956185871760321,310,10,66,386
5173,dark,main,20211010,1,0.985036925697767,138,5,25,168
5173,dark,main,20211010,2,0.9936872072319585,283,12,81,376
5173,dark,main,20211010,3,0.9879618748164146,259,13,73,345
5173,dark,main,20211010,4,0.9882797136908156,141,6,39,186
5173,dark,main,20211010,5,0.9939413005101287,289,16,59,364
5173,dark,main,20211010,6,0.993018964605668,308,12,67,387
5173,dark,main,20211010,7,0.9872333894524299,278,11,42,331
5173,dark,main,20211010,8,0.9876475659580753,294,11,62,367
5173,dark,main,20211010,9,0.9899975669240125,310,10,50,370
6946,dark,main,20211010,0,0.9892723382025819,275,13,107,395
6946,dark,main,20211010,1,0.987804770185055,131,7,31,169
6946,dark,main,20211010,2,0.9931490261999294,292,11,52,355
6946,dark,main,20211010,3,0.99377673326946,281,10,53,344
6946,dark,main,20211010,4,0.9769692872408132,159,8,20,187
6946,dark,main,20211010,5,0.9946931996194726,281,15,55,351
6946,dark,main,20211010,6,0.9917170249331999,305,14,48,367
6946,dark,main,20211010,7,0.9903330097511736,269,17,36,322
6946,dark,main,20211010,8,0.9937361085736233,318,11,34,363
6946,dark,main,20211010,9,0.9964540911122124,297,9,72,378
4989,dark,main,20211010,0,0.9952606460648228,284,14,89,387
4989,dark,main,20211010,1,0.9875869741731629,130,8,32,170
4989,dark,main,20211010,2,0.9908073394399891,280,12,78,370
4989,dark,main,20211010,3,0.9942774796993412,288,14,52,354
4989,dark,main,20211010,4,0.9831252372872855,144,7,21,172
4989,dark,main,20211010,5,0.9939607556682056,300,13,43,356
4989,dark,main,20211010,6,0.9918746339519736,314,13,48,375
4989,dark,main,20211010,7,0.9912121991592274,286,12,42,340
4989,dark,main,20211010,8,0.9903774615770219,297,15,49,361
4989,dark,main,20211010,9,0.9935694582214075,274,11,75,360
11878,dark,main,20211010,0,0.9910053819338037,302,18,81,401
11878,dark,main,20211010,1,0.9848746660769305,117,7,41,165
11878,dark,main,20211010,2,0.9908648761771799,282,19,63,364
11878,dark,main,20211010,3,0.9957301375338556,299,18,44,361
11878,dark,main,20211010,4,0.9790430198107741,158,9,18,185
11878,dark,main,20211010,5,0.9852388468218867,297,15,52,364
11878,dark,main,20211010,6,0.9950179235003532,312,18,40,370
11878,dark,main,20211010,7,0.9933321340656583,265,22,49,336
11878,dark,main,20211010,8,0.9864777261420047,291,14,47,352
11878,dark,main,20211010,9,0.9891769288993489,316,15,52,383
7932,dark,main,20211010,0,0.9874648766948646,315,11,68,394
7932,dark,main,20211010,1,0.9886420206786598,133,7,31,171
7932,dark,main,20211010,2,0.994088984486329,323,14,41,378
7932,dark,main,20211010,3,0.9925545425577487,276,13,61,350
7932,dark,main,20211010,4,0.9681483915293636,144,4,32,180
7932,dark,main,20211010,5,0.995221335438895,306,16,36,358
7932,dark,main,20211010,6,0.9907697498648692,309,12,57,378
7932,dark,main,20211010,7,0.9956150768778407,264,10,45,319
7932,dark,main,20211010,8,0.9896559480456812,289,14,43,346
7932,dark,main,20211010,9,0.9918802273096163,315,15,57,387
9362,dark,main,20211010,0,0.9843159956916538,325,14,51,390
9362,dark,main,20211010,1,0.9739575702307313,127,7,30,164
9362,dark,main,20211010,2,0.9809625669121,259,13,83,355
9362,dark,main,20211010,3,0.9901167763876316,245,15,90,350
9362,dark,main,20211010,4,0.9807485444776745,125,8,51,184
9362,dark,main,20211010,5,0.9925489079132807,291,15,70,376
9362,dark,main,20211010,6,0.9924920035177676,260,11,83,354
9362,dark,main,20211010,7,0.9925902736402221,262,13,62,337
9362,dark,main,20211010,8,0.9957098816195639,283,18,54,355
9362,dark,main,20211010,9,0.9898692237765058,296,15,58,369
6410,dark,main,20211010,0,0.9811167909557603,279,18,93,390
6410,dark,main,20211010,1,0.9801431049524919,123,5,42,170
6410,dark,main,20211010,2,0.9810392505672435,265,10,86,361
6410,dark,main,20211010,3,0.9912709635978109,257,14,76,347
6410,dark,main,20211010,4,0.9850172063271712,125,7,48,180
6410,dark,main,20211010,5,0.9962470379933288,253,15,92,360
6410,dark,main,20211010,6,0.9898440909993341,247,29,89,365
6410,dark,main,20211010,7,0.9882451425722041,231,20,74,325
6410,dark,main,20211010,8,0.9815269998986859,249,13,98,360
6410,dark,main,20211010,9,0.9960831796621568,266,12,83,361
2234,dark,main,20211010,0,0.9880105965608617,310,16,56,382
2234,dark,main,20211010,1,0.9797881857197713,130,7,32,169
2234,dark,main,20211010,2,0.9870087009465018,308,12,51,371
2234,dark,main,20211010,3,0.9950333154061001,276,13,55,344
2234,dark,main,20211010,4,0.9801450865990033,141,8,42,191
2234,dark,main,20211010,5,0.9909011734129575,264,18,71,353
2234,dark,main,20211010,6,0.9893681205159685,279,11,79,369
2234,dark,main,20211010,7,0.9918528005740281,244,14,72,330
2234,dark,main,20211010,8,0.9913726921829149,275,13,86,374
2234,dark,main,20211010,9,0.996075409385041,267,11,81,359
9852,dark,main,20211010,0,0.9889127194373839,286,12,91,389
9852,dark,main,20211010,1,0.9799278603156595,114,6,46,166
9852,dark,main,20211010,2,0.9946875154182041,254,14,103,371
9852,dark,main,20211010,3,0.9911338741431567,259,13,69,341
9852,dark,main,20211010,4,0.9819643401384182,143,6,40,189
9852,dark,main,20211010,5,0.9943433694197188,263,12,95,370
9852,dark,main,20211010,6,0.9912748655631887,269,13,91,373
9852,dark,main,20211010,7,0.9863321751898934,234,11,75,320
9852,dark,main,20211010,8,0.9928022968334956,265,11,87,363
9852,dark,main,20211010,9,0.9873246581332182,247,16,100,363
2047,dark,main,20211010,0,0.9915280557770931,258,15,90,363
2047,dark,main,20211010,1,0.9887511476641152,125,6,43,174
2047,dark,main,20211010,2,0.9927208304001565,267,12,104,383
2047,dark,main,20211010,3,0.993619692237634,264,15,75,354
2047,dark,main,20211010,4,0.9651489208906613,130,7,49,186
2047,dark,main,20211010,5,0.9948837868385355,262,12,92,366
2047,dark,main,20211010,6,0.9930591310538611,260,15,105,380
2047,dark,main,20211010,7,0.9932323839181897,252,14,74,340
2047,dark,main,20211010,8,0.991281236049475,258,12,99,369
2047,dark,main,20211010,9,0.9792185626332574,279,12,89,380
10569,dark,main,20211010,0,0.9902708246214537,278,14,100,392
10569,dark,main,20211010,1,0.9651765691395148,116,6,42,164
10569,dark,main,20211010,2,0.9825952313267531,267,17,86,370
10569,dark,main,20211010,3,0.9918007803543306,249,11,100,360
10569,dark,main,20211010,4,0.9950170678877646,123,10,48,181
10569,dark,main,20211010,5,0.989564715744698,232,14,115,361
10569,dark,main,20211010,6,0.992788799929921,274,11,101,386
10569,dark,main,20211010,7,0.992673673955393,242,14,83,339
10569,dark,main,20211010,8,0.99459010360807,256,14,94,364
10569,dark,main,20211010,9,0.9957661473881271,285,16,86,387
8291,dark,main,20211010,0,0.996915565071784,262,13,113,388
8291,dark,main,20211010,1,0.9786753969168331,127,4,35,166
8291,dark,main,20211010,2,0.9914045197612849,287,15,70,372
8291,dark,main,20211010,3,0.992490686916769,256,11,71,338
8291,dark,main,20211010,4,0.9879006385931172,133,7,48,188
8291,dark,main,20211010,5,0.9917349748293954,280,10,78,368
8291,dark,main,20211010,6,0.9931035466119937,275,15,91,381
8291,dark,main,20211010,7,0.9907358482649804,226,16,84,326
8291,dark,main,20211010,8,0.9918115227290561,255,11,106,372
8291,dark,main,20211010,9,0.9877159922409438,261,15,108,384
2360,dark,main,20211013,0,0.9915166834681086,287,22,72,381
2360,dark,main,20211013,1,0.9589192624188533,118,15,39,172
2360,dark,main,20211013,2,0.9840230535546239,290,18,87,395
2360,dark,main,20211013,3,0.9828585932793888,257,17,84,358
2360,dark,main,20211013,4,0.9777471838243348,111,11,59,181
2360,dark,main,20211013,5,0.9968533326806087,278,16,85,379
2360,dark,main,20211013,6,0.9865367864116891,277,14,90,381
2360,dark,main,20211013,7,0.993582709726131,251,16,71,338
2360,dark,main,20211013,8,0.9895420138782048,258,23,84,365
2360,dark,main,20211013,9,0.9910386240540817,266,21,87,374
9501,dark,main,20211013,0,0.9916032248634052,259,23,93,375
9501,dark,main,20211013,1,0.9689828740749927,118,8,40,166
9501,dark,main,20211013,2,0.9965556465032611,279,14,91,384
9501,dark,main,20211013,3,0.9807365805193261,252,19,83,354
9501,dark,main,20211013,4,0.978190394349013,137,8,39,184
9501,dark,main,20211013,5,0.9883818847188409,255,12,87,354
9501,dark,main,20211013,6,0.9901326909153544,273,17,98,388
9501,dark,main,20211013,7,0.9902136901846063,238,14,69,321
9501,dark,main,20211013,8,0.9934107587153225,252,11,84,347
9501,dark,main,20211013,9,0.9953499962676525,284,18,84,386
3268,dark,main,20211013,0,0.9952068661909609,290,18,86,394
3268,dark,main,20211013,1,0.9673135271511757,122,6,46,174
3268,dark,main,20211013,2,0.9924700051604622,277,15,91,383
3268,dark,main,20211013,3,0.9848605422072125,244,20,84,348
3268,dark,main,20211013,4,0.9860913676889873,135,5,46,186
3268,dark,main,20211013,5,0.9962686358754019,257,12,89,358
3268,dark,main,20211013,6,0.994777104241089,286,13,81,380
3268,dark,main,20211013,7,0.9918376199586448,235,13,90,338
3268,dark,main,20211013,8,0.992756507075385,269,15,88,372
3268,dark,main,20211013,9,0.9920240416488582,271,17,88,376
6709,dark,main,20211013,0,0.9902403496480137,264,24,104,392
6709,dark,main,20211013,1,0.9804050181598724,120,11,49,180
6709,dark,main,20211013,2,0.9880434476285508,278,12,95,385
6709,dark,main,20211013,3,0.9934964706896778,265,16,74,355
6709,dark,main,20211013,4,0.9731250581574127,132,8,45,185
6709,dark,main,20211013,5,0.9910635423632717,264,13,84,361
6709,dark,main,20211013,6,0.9853482837094665,247,18,88,353
6709,dark,main,20211013,7,0.9924547015383262,238,14,83,335
6709,dark,main,20211013,8,0.9932117972589519,263,22,95,380
6709,dark,main,20211013,9,0.9784853798051583,259,15,96,370
2225,dark,main,20211013,0,0.9929016393879783,295,16,85,396
2225,dark,main,20211013,1,0.9880937454972581,133,9,39,181
2225,dark,main,20211013,2,0.9879056148095052,286,18,82,386
2225,dark,main,20211013,3,0.9955242483851892,249,17,93,359
2225,dark,main,20211013,4,0.9844078562350939,132,10,55,197
2225,dark,main,20211013,5,0.9961600828454495,272,16,83,371
2225,dark,main,20211013,6,0.9919785282041877,273,11,100,384
2225,dark,main,20211013,7,0.9916167967677394,231,14,85,330
2225,dark,main,20211013,8,0.9906699969025641,279,17,74,370
2225,dark,main,20211013,9,0.9930194609757375,287,15,82,384
2280,dark,main,20211013,0,0.9881230704994445,268,19,90,377
2280,dark,main,20211013,1,0.9635560874089203,132,11,34,177
2280,dark,main,20211013,2,0.9926370685594077,268,33,81,382
2280,dark,main,20211013,3,0.9941369041213451,250,20,81,351
2280,dark,main,20211013,4,0.9847805556515262,149,7,34,190
2280,dark,main,20211013,5,0.9902313931028895,247,29,84,360
2280,dark,main,20211013,6,0.9868594790951125,268,23,92,383
2280,dark,main,20211013,7,0.9944429806553077,249,18,70,337
2280,dark,main,20211013,8,0.9914537795241437,256,26,81,363
2280,dark,main,20211013,9,0.9918264050802436,276,21,69,366
11669,dark,main,20211013,0,0.9920764352258752,285,14,89,388
11669,dark,main,20211013,1,0.9773503129429089,129,6,43,178
11669,dark,main,20211013,2,0.9854920911201037,307,10,90,407
11669,dark,main,20211013,3,0.9808166089774504,246,13,78,337
11669,dark,main,20211013,4,0.9764177157949292,127,4,35,166
11669,dark,main,20211013,5,0.9942629332104663,274,13,72,359
11669,dark,main,20211013,6,0.9884918764387756,286,14,76,376
11669,dark,main,20211013,7,0.9858435244661417,250,16,85,351
11669,dark,main,20211013,8,0.9916723279015585,286,14,73,373
11669,dark,main,20211013,9,0.9951384357225475,278,12,92,382
5514,dark,main,20211013,0,0.9785957410687465,174,13,63,250
5514,dark,main,20211013,1,0.9787169946816496,80,8,21,109
5514,dark,main,20211013,2,0.9894225968143592,221,12,88,321
5514,dark,main,20211013,3,0.9930208103746262,189,15,70,274
5514,dark,main,20211013,4,0.9720159695764404,104,5,30,139
5514,dark,main,20211013,5,0.9927013483938544,185,13,100,298
5514,dark,main,20211013,6,0.9855366301350998,200,10,75,285
5514,dark,main,20211013,7,0.9894600017962059,171,17,52,240
5514,dark,main,20211013,8,0.9789680975951334,169,14,66,249
5514,dark,main,20211013,9,0.9941095906365762,186,12,101,299
23461,bright,main,20211013,0,0.994460863379702,322,111,6,439
23461,bright,main,20211013,1,0.9909339503198318,158,35,2,195
23461,bright,main,20211013,2,0.9927619329945715,328,105,1,434
23461,bright,main,20211013,3,0.9929637234036247,313,83,4,400
23461,bright,main,20211013,4,0.9955847996150886,163,45,3,211
23461,bright,main,20211013,5,0.9963858073883962,312,98,1,411
23461,bright,main,20211013,6,0.9940441896207174,296,131,5,432
23461,bright,main,20211013,7,0.9866316806078814,291,79,6,376
23461,bright,main,20211013,8,0.9905407178437095,306,111,4,421
23461,bright,main,20211013,9,0.9905782855427231,324,105,4,433
2259,dark,main,20211013,0,0.9924060920267502,287,14,90,391
2259,dark,main,20211013,1,0.9753876812863898,128,7,42,177
2259,dark,main,20211013,2,0.9943352931932193,286,13,90,389
2259,dark,main,20211013,3,0.9925480602846715,261,11,87,359
2259,dark,main,20211013,4,0.9867056918454328,132,10,41,183
2259,dark,main,20211013,5,0.987268404330778,266,10,93,369
2259,dark,main,20211013,6,0.997263596866735,268,13,88,369
2259,dark,main,20211013,7,0.986786681288329,223,13,93,329
2259,dark,main,20211013,8,0.9952556630120033,279,12,91,382
2259,dark,main,20211013,9,0.9945340473979116,287,12,83,382
2267,dark,main,20211013,0,0.9944115991303677,289,19,87,395
2267,dark,main,20211013,1,0.9769560179969261,122,5,49,176
2267,dark,main,20211013,2,0.9898713086608452,283,15,90,388
2267,dark,main,20211013,3,0.9907604343565736,264,16,77,357
2267,dark,main,20211013,4,0.9696805829212573,138,6,44,188
2267,dark,main,20211013,5,0.9890114170915291,262,14,94,370
2267,dark,main,20211013,6,0.9890556222201401,268,21,83,372
2267,dark,main,20211013,7,0.9895117724153492,259,17,69,345
2267,dark,main,20211013,8,0.9902883990734503,267,22,89,378
2267,dark,main,20211013,9,0.9879653504804811,277,14,84,375
24409,bright,main,20211013,0,0.996405455920323,353,88,3,444
24409,bright,main,20211013,1,0.981097792692993,153,44,0,197
24409,bright,main,20211013,2,0.9942200684620217,330,101,8,439
24409,bright,main,20211013,3,0.9933110752681509,308,85,2,395
24409,bright,main,20211013,4,0.9866679472590572,151,57,2,210
24409,bright,main,20211013,5,0.9937660881507736,243,164,4,411
24409,bright,main,20211013,6,0.9909590454983087,298,124,6,428
24409,bright,main,20211013,7,0.9918679721061657,284,86,1,371
24409,bright,main,20211013,8,0.9914388775412586,324,90,3,417
24409,bright,main,20211013,9,0.9925647695407026,329,92,4,425
24413,bright,main,20211013,0,0.9913042796517246,342,90,4,436
24413,bright,main,20211013,1,0.9822960415521,155,36,1,192
24413,bright,main,20211013,2,0.994245926232578,321,115,2,438
24413,bright,main,20211013,3,0.9923898492679998,311,82,6,399
24413,bright,main,20211013,4,0.9843083747560147,167,42,1,210
24413,bright,main,20211013,5,0.9958884501765419,292,122,6,420
24413,bright,main,20211013,6,0.9940562606709201,333,93,5,431
24413,bright,main,20211013,7,0.9931415546042762,293,76,5,374
24413,bright,main,20211013,8,0.9942455558993987,318,100,4,422
24413,bright,main,20211013,9,0.9893256042890247,321,105,5,431
7950,dark,main,20211013,0,0.9931140355052824,292,15,94,401
7950,dark,main,20211013,1,0.9644864473303935,125,7,45,177
7950,dark,main,20211013,2,0.9944327260167286,289,15,100,404
7950,dark,main,20211013,3,0.9860057575781787,238,11,107,356
7950,dark,main,20211013,4,0.9832234578026141,132,8,46,186
7950,dark,main,20211013,5,0.9957473289659488,261,11,100,372
7950,dark,main,20211013,6,0.9926644580219184,288,16,82,386
7950,dark,main,20211013,7,0.992516839601284,232,18,83,333
7950,dark,main,20211013,8,0.993048279037901,268,14,93,375
7950,dark,main,20211013,9,0.995123400539124,269,13,90,372
26268,bright,main,20211013,0,0.99199567677289,376,63,5,444
26268,bright,main,20211013,1,0.9808619970568733,164,29,2,195
26268,bright,main,20211013,2,0.997309634661178,329,100,6,435
26268,bright,main,20211013,3,0.9949280195315227,282,106,5,393
26268,bright,main,20211013,4,0.9901956783273586,168,38,1,207
26268,bright,main,20211013,5,0.9882461378202244,312,98,4,414
26268,bright,main,20211013,6,0.9948707277973938,332,90,9,431
26268,bright,main,20211013,7,0.9870413052822568,281,88,5,374
26268,bright,main,20211013,8,0.9945382446188302,323,100,4,427
26268,bright,main,20211013,9,0.98610131320916,318,103,4,425
9844,dark,main,20211013,0,0.9929533544016569,261,25,92,378
9844,dark,main,20211013,1,0.9872284763607505,126,5,38,169
9844,dark,main,20211013,2,0.9912472225573762,301,14,92,407
9844,dark,main,20211013,3,0.9918528613433677,262,15,69,346
9844,dark,main,20211013,4,0.9753943573544982,133,8,41,182
9844,dark,main,20211013,5,0.9934291928569954,251,15,90,356
9844,dark,main,20211013,6,0.9953462846517493,268,14,108,390
9844,dark,main,20211013,7,0.9937015113314493,233,10,85,328
9844,dark,main,20211013,8,0.9895585515831208,272,14,95,381
9844,dark,main,20211013,9,0.9934698910164557,264,15,101,380
2414,dark,main,20211013,0,0.9909102558650245,283,31,79,393
2414,dark,main,20211013,1,0.9748544767767675,119,10,34,163
2414,dark,main,20211013,2,0.9916261521941963,285,23,93,401
2414,dark,main,20211013,3,0.989806396666646,255,16,84,355
2414,dark,main,20211013,4,0.9793378086346998,124,9,49,182
2414,dark,main,20211013,5,0.9870127258174739,271,25,66,362
2414,dark,main,20211013,6,0.9920029838339541,273,25,80,378
2414,dark,main,20211013,7,0.9913050551455974,222,40,72,334
2414,dark,main,20211013,8,0.994799124185916,245,23,82,350
2414,dark,main,20211013,9,0.9944319192937419,264,20,92,376
7948,dark,main,20211013,0,0.9924284749092261,282,14,99,395
7948,dark,main,20211013,1,0.9886510298943213,135,8,40,183
7948,dark,main,20211013,2,0.9903602947350342,301,15,77,393
7948,dark,main,20211013,3,0.9925092178783959,269,15,83,367
7948,dark,main,20211013,4,0.9794351332245225,143,6,48,197
7948,dark,main,20211013,5,0.9892651565003171,259,11,89,359
7948,dark,main,20211013,6,0.9878474636168331,261,13,100,374
7948,dark,main,20211013,7,0.9918782441512106,238,12,86,336
7948,dark,main,20211013,8,0.993262990445164,254,14,112,380
7948,dark,main,20211013,9,0.9925009917155225,276,15,93,384
2041,dark,main,20211013,0,0.9948760131299714,292,18,87,397
2041,dark,main,20211013,1,0.9834021152578408,131,6,41,178
2041,dark,main,20211013,2,0.9938028340241364,265,12,113,390
2041,dark,main,20211013,3,0.9925400090079728,262,18,91,371
2041,dark,main,20211013,4,0.9744506401281974,125,7,54,186
2041,dark,main,20211013,5,0.9888394330010665,261,12,83,356
2041,dark,main,20211013,6,0.9919386170567025,263,18,93,374
2041,dark,main,20211013,7,0.9919258355458489,232,16,81,329
2041,dark,main,20211013,8,0.98599970385093,279,16,83,378
2041,dark,main,20211013,9,0.9896123092552633,254,12,97,363
23463,bright,main,20211013,0,0.9960122693715501,326,110,1,437
23463,bright,main,20211013,1,0.9847799527163005,146,51,0,197
23463,bright,main,20211013,2,0.9960169749773758,306,124,2,432
23463,bright,main,20211013,3,0.9957296183302382,254,139,4,397
23463,bright,main,20211013,4,0.9873393411305067,163,43,2,208
23463,bright,main,20211013,5,0.9947874475217465,297,115,3,415
23463,bright,main,20211013,6,0.9942753826706596,319,111,7,437
23463,bright,main,20211013,7,0.9870694456223273,270,102,2,374
23463,bright,main,20211013,8,0.9934255020965388,292,130,4,426
23463,bright,main,20211013,9,0.992891593135004,314,111,3,428
24414,bright,main,20211013,0,0.9859280446153535,339,95,5,439
24414,bright,main,20211013,1,0.9853659379435554,151,47,0,198
24414,bright,main,20211013,2,0.9890206128821578,301,135,2,438
24414,bright,main,20211013,3,0.9928869468665462,300,97,3,400
24414,bright,main,20211013,4,0.9857943454957545,183,23,2,208
24414,bright,main,20211013,5,0.9937564549500959,300,113,6,419
24414,bright,main,20211013,6,0.9915661487265796,330,100,2,432
24414,bright,main,20211013,7,0.9956824620973018,283,89,1,373
24414,bright,main,20211013,8,0.994404806527731,325,99,3,427
24414,bright,main,20211013,9,0.996800898428526,338,91,4,433
11871,dark,main,20211013,0,0.9907386345922022,290,10,88,388
11871,dark,main,20211013,1,0.9860574112402191,126,5,47,178
11871,dark,main,20211013,2,0.9900882186019528,299,12,96,407
11871,dark,main,20211013,3,0.9900464279227374,242,17,84,343
11871,dark,main,20211013,4,0.9780935403176956,144,9,33,186
11871,dark,main,20211013,5,0.9950781705800481,248,19,97,364
11871,dark,main,20211013,6,0.9950066574436399,288,17,93,398
11871,dark,main,20211013,7,0.9938531413239647,248,15,81,344
11871,dark,main,20211013,8,0.9938028827921853,271,12,87,370
11871,dark,main,20211013,9,0.9948093048343649,285,13,90,388
6705,dark,main,20211013,0,0.9929007542473134,289,14,86,389
6705,dark,main,20211013,1,0.9791341113343346,107,6,53,166
6705,dark,main,20211013,2,0.9889122927647958,278,17,89,384
6705,dark,main,20211013,3,0.990717798317175,238,14,97,349
6705,dark,main,20211013,4,0.9913484628277451,122,10,44,176
6705,dark,main,20211013,5,0.9918560951311689,290,13,81,384
6705,dark,main,20211013,6,0.993463230246833,283,14,91,388
6705,dark,main,20211013,7,0.9902317637029667,233,13,75,321
6705,dark,main,20211013,8,0.9950106277559172,253,18,102,373
6705,dark,main,20211013,9,0.9931869349456798,272,13,81,366
23217,bright,main,20211013,0,0.9917794071414547,358,71,8,437
23217,bright,main,20211013,1,0.9826162284186875,140,48,4,192
23217,bright,main,20211013,2,0.9934078638683139,340,92,6,438
23217,bright,main,20211013,3,0.9865665101794414,306,87,5,398
23217,bright,main,20211013,4,0.987385957127998,159,48,3,210
23217,bright,main,20211013,5,0.995322238666573,308,106,6,420
23217,bright,main,20211013,6,0.989276688463089,325,107,1,433
23217,bright,main,20211013,7,0.99130624272194,275,97,3,375
23217,bright,main,20211013,8,0.9904904774764102,266,118,2,386
23217,bright,main,20211013,9,0.992228365658527,312,112,1,425
6735,dark,main,20211013,0,0.9898324140057702,277,11,96,384
6735,dark,main,20211013,1,0.9763079239797807,114,7,35,156
6735,dark,main,20211013,2,0.9918776334412127,283,12,89,384
6735,dark,main,20211013,3,0.9876930598902778,256,16,89,361
6735,dark,main,20211013,4,0.9691394537650121,143,10,42,195
6735,dark,main,20211013,5,0.995705305649965,261,12,96,369
6735,dark,main,20211013,6,0.9913036388592835,282,17,93,392
6735,dark,main,20211013,7,0.9897241963126326,242,19,63,324
6735,dark,main,20211013,8,0.9930778854187157,263,14,95,372
6735,dark,main,20211013,9,0.9935692904354232,273,15,85,373
4050,dark,main,20211013,0,0.993958660364505,286,15,98,399
4050,dark,main,20211013,1,0.993958660364505,286,15,98,399
4050,dark,main,20211013,2,0.9935924953937804,287,20,85,392
4050,dark,main,20211013,3,0.9916193178196557,258,10,88,356
4050,dark,main,20211013,4,0.9813862879887156,145,3,39,187
4050,dark,main,20211013,5,0.986898122269117,262,12,85,359
4050,dark,main,20211013,6,0.9929788047153921,284,14,87,385
4050,dark,main,20211013,7,0.9902492846882739,221,12,87,320
4050,dark,main,20211013,8,0.990019129228758,271,20,101,392
4050,dark,main,20211013,9,0.9909201859685888,258,17,76,351
6365,dark,main,20211014,0,0.9960189388516923,266,14,106,386
6365,dark,main,20211014,1,0.9860297606400105,135,4,40,179
6365,dark,main,20211014,2,0.993089211790138,285,12,92,389
6365,dark,main,20211014,3,0.9891277178580701,248,17,74,339
6365,dark,main,20211014,4,0.9859277811545969,131,10,46,187
6365,dark,main,20211014,5,0.9944365316335765,238,15,105,358
6365,dark,main,20211014,6,0.9931323375184898,279,16,91,386
6365,dark,main,20211014,7,0.9943940268540375,237,23,76,336
6365,dark,main,20211014,8,0.9926967242020326,242,13,90,345
6365,dark,main,20211014,9,0.9931906721567039,272,12,90,374
25261,bright,main,20211014,0,0.9942261585911931,343,94,2,439
25261,bright,main,20211014,1,0.9752414081835539,146,45,2,193
25261,bright,main,20211014,2,0.9928585613410672,326,114,0,440
25261,bright,main,20211014,3,0.9951760088525781,285,111,3,399
25261,bright,main,20211014,4,0.9837161188095531,139,67,5,211
25261,bright,main,20211014,5,0.9931687721398185,299,120,2,421
25261,bright,main,20211014,6,0.9963369636615167,331,100,3,434
25261,bright,main,20211014,7,0.9942610479918149,280,95,0,375
25261,bright,main,20211014,8,0.9913737193997985,314,67,4,385
25261,bright,main,20211014,9,0.99114818394361,325,96,3,424
4048,dark,main,20211014,0,0.987262680832519,289,14,89,392
4048,dark,main,20211014,1,0.977396964637029,137,6,37,180
4048,dark,main,20211014,2,0.9934726221923519,301,16,82,399
4048,dark,main,20211014,3,0.9914038351329224,262,14,72,348
4048,dark,main,20211014,4,0.9905644622928839,120,8,54,182
4048,dark,main,20211014,5,0.992359515230861,256,14,88,358
4048,dark,main,20211014,6,0.996095489212613,276,16,95,387
4048,dark,main,20211014,7,0.989115865039628,244,12,74,330
4048,dark,main,20211014,8,0.988110399217363,277,7,63,347
4048,dark,main,20211014,9,0.9976080129372927,284,18,88,390
24357,bright,main,20211014,0,0.9876083681130174,350,84,2,436
24357,bright,main,20211014,1,0.9730873559486278,149,41,0,190
24357,bright,main,20211014,2,0.9936593082931602,363,65,4,432
24357,bright,main,20211014,3,0.9895996037002958,304,79,4,387
24357,bright,main,20211014,4,0.9891841347668898,162,41,3,206
24357,bright,main,20211014,5,0.9910798352178508,302,97,1,400
24357,bright,main,20211014,6,0.9876701965793355,344,77,5,426
24357,bright,main,20211014,7,0.9850884096035664,298,71,3,372
24357,bright,main,20211014,8,0.9889942788107753,288,76,6,370
24357,bright,main,20211014,9,0.9941429969624318,331,79,6,416
24355,bright,main,20211014,0,0.9954585696649008,357,70,4,431
24355,bright,main,20211014,1,0.9690678800753332,159,33,1,193
24355,bright,main,20211014,2,0.9925268787935626,343,80,2,425
24355,bright,main,20211014,3,0.9907973865421369,308,67,6,381
24355,bright,main,20211014,4,0.9917408579016475,178,27,2,207
24355,bright,main,20211014,5,0.9908029487641037,329,74,7,410
24355,bright,main,20211014,6,0.995157952529573,331,78,2,411
24355,bright,main,20211014,7,0.9902593258142135,283,78,4,365
24355,bright,main,20211014,8,0.9878964388196543,311,67,2,380
24355,bright,main,20211014,9,0.9949980796615653,347,64,3,414
25747,bright,main,20211014,0,0.9920340297633262,377,48,3,428
25747,bright,main,20211014,1,0.9857687528482131,148,38,1,187
25747,bright,main,20211014,2,0.9905549693716152,349,58,4,411
25747,bright,main,20211014,3,0.9834945779456766,325,56,3,384
25747,bright,main,20211014,4,0.9861266066378411,160,40,2,202
25747,bright,main,20211014,5,0.9955026616905491,326,61,3,390
25747,bright,main,20211014,6,0.9921634344840187,324,80,4,408
25747,bright,main,20211014,7,0.99582465112728,278,68,4,350
25747,bright,main,20211014,8,0.9886836097386607,276,79,7,362
25747,bright,main,20211014,9,0.9895273236263902,327,69,8,404
21043,bright,main,20211014,0,0.9938794753142286,379,54,1,434
21043,bright,main,20211014,1,0.9878734204794191,169,14,4,187
21043,bright,main,20211014,2,0.9961237741226122,362,56,5,423
21043,bright,main,20211014,3,0.9904463825983619,318,61,4,383
21043,bright,main,20211014,4,0.9850944941783959,175,25,1,201
21043,bright,main,20211014,5,0.9871747576902185,329,58,8,395
21043,bright,main,20211014,6,0.9943847922647788,331,70,9,410
21043,bright,main,20211014,7,0.9917408195910673,303,50,7,360
21043,bright,main,20211014,8,0.9927734755743791,337,40,1,378
21043,bright,main,20211014,9,0.9924406093736413,363,51,5,419
21044,bright,main,20211014,0,0.9918238019344291,363,65,3,431
21044,bright,main,20211014,1,0.9805972562767786,166,20,3,189
21044,bright,main,20211014,2,0.9880361033848218,352,64,6,422
21044,bright,main,20211014,3,0.9894907861549388,333,46,4,383
21044,bright,main,20211014,4,0.9829862498873843,152,39,4,195
21044,bright,main,20211014,5,0.9945311459038035,283,98,4,385
21044,bright,main,20211014,6,0.9877539114010621,307,99,6,412
21044,bright,main,20211014,7,0.9925065544254273,258,86,8,352
21044,bright,main,20211014,8,0.9841497386813594,300,63,6,369
21044,bright,main,20211014,9,0.9935105268009017,329,72,3,404
9328,dark,main,20211014,0,0.9919216405254886,292,25,66,383
9328,dark,main,20211014,1,0.9717073487632687,119,24,28,171
9328,dark,main,20211014,2,0.9907070121921208,259,30,95,384
9328,dark,main,20211014,3,0.9874049067393269,245,34,70,349
9328,dark,main,20211014,4,0.9826954487452716,141,13,30,184
9328,dark,main,20211014,5,0.9927697277995844,263,32,64,359
9328,dark,main,20211014,6,0.9897776373344865,265,42,71,378
9328,dark,main,20211014,7,0.9924018452311361,221,48,71,340
9328,dark,main,20211014,8,0.9897694143127918,267,35,65,367
9328,dark,main,20211014,9,0.9888649882240729,262,32,69,363
11637,dark,main,20211014,0,0.9924350012728101,256,11,85,352
11637,dark,main,20211014,1,0.9835068383849996,130,9,20,159
11637,dark,main,20211014,2,0.9923573085469573,284,25,84,393
11637,dark,main,20211014,3,0.9878494891079967,244,17,84,345
11637,dark,main,20211014,4,0.9857459443557135,133,13,33,179
11637,dark,main,20211014,5,0.9958553356957676,281,17,75,373
11637,dark,main,20211014,6,0.9937198508972347,265,26,84,375
11637,dark,main,20211014,7,0.9922057994739738,247,16,62,325
11637,dark,main,20211014,8,0.9930246615900318,243,15,77,335
11637,dark,main,20211014,9,0.9924628256209367,277,15,83,375
22800,bright,main,20211014,0,0.9938115395414071,372,64,5,441
22800,bright,main,20211014,1,0.9897812790314456,153,40,2,195
22800,bright,main,20211014,2,0.9927903230845935,351,79,3,433
22800,bright,main,20211014,3,0.9812036849046365,310,80,7,397
22800,bright,main,20211014,4,0.9852774311011889,177,29,2,208
22800,bright,main,20211014,5,0.9936713433449754,337,71,3,411
22800,bright,main,20211014,6,0.9920540579515563,335,90,2,427
22800,bright,main,20211014,7,0.990546842403068,313,51,3,367
22800,bright,main,20211014,8,0.9801205554223994,308,68,3,379
22800,bright,main,20211014,9,0.9878439369974547,364,59,3,426
1298,dark,main,20211014,0,0.9923856153755979,274,30,80,384
1298,dark,main,20211014,1,0.9830460613495298,119,17,34,170
1298,dark,main,20211014,2,0.9869438864842691,265,28,85,378
1298,dark,main,20211014,3,0.9927771620146666,245,37,66,348
1298,dark,main,20211014,4,0.959779938931837,117,33,36,186
1298,dark,main,20211014,5,0.9923435578520164,238,47,76,361
1298,dark,main,20211014,6,0.993588583886778,282,32,65,379
1298,dark,main,20211014,7,0.9874974034531893,219,33,78,330
1298,dark,main,20211014,8,0.9937529138831929,241,25,79,345
1298,dark,main,20211014,9,0.9925510243501386,270,21,92,383
7577,dark,main,20211014,0,0.9935104613258178,258,35,89,382
7577,dark,main,20211014,1,0.9933679512770315,126,9,37,172
7577,dark,main,20211014,2,0.989702703003854,216,62,86,364
7577,dark,main,20211014,3,0.9926520613531438,232,35,81,348
7577,dark,main,20211014,4,0.9884294484766127,113,25,50,188
7577,dark,main,20211014,5,0.9908858783837624,250,26,91,367
7577,dark,main,20211014,6,0.990072436972752,264,22,91,377
7577,dark,main,20211014,7,0.9910040945251387,243,29,68,340
7577,dark,main,20211014,8,0.989753913031823,251,37,81,369
7577,dark,main,20211014,9,0.9810794923726921,276,23,77,376
20039,bright,main,20211014,0,0.9945920337902154,342,92,4,438
20039,bright,main,20211014,1,0.9799141415926467,145,47,2,194
20039,bright,main,20211014,2,0.9953990987405297,338,95,0,433
20039,bright,main,20211014,3,0.9941372378750477,303,88,4,395
20039,bright,main,20211014,4,0.9913045369425372,160,49,0,209
20039,bright,main,20211014,5,0.9960424632116901,292,114,3,409
20039,bright,main,20211014,6,0.9914027211930786,316,104,6,426
20039,bright,main,20211014,7,0.9903159758128904,305,69,1,375
20039,bright,main,20211014,8,0.9889122121123131,318,98,3,419
20039,bright,main,20211014,9,0.990769361672834,351,73,2,426
6699,dark,main,20211014,0,0.9843251215828831,287,12,99,398
6699,dark,main,20211014,1,0.9611979658361703,127,4,33,164
6699,dark,main,20211014,2,0.9898716350914539,284,13,83,380
6699,dark,main,20211014,3,0.992720359692619,248,17,90,355
6699,dark,main,20211014,4,0.9898143191083487,126,6,55,187
6699,dark,main,20211014,5,0.9935262956709172,255,12,101,368
6699,dark,main,20211014,6,0.9903358145975434,283,15,96,394
6699,dark,main,20211014,7,0.9897355591255564,233,11,81,325
6699,dark,main,20211014,8,0.9827312327487987,248,12,68,328
6699,dark,main,20211014,9,0.9947693133292124,273,14,92,379
23460,bright,main,20211014,0,0.9928531994339153,310,126,5,441
23460,bright,main,20211014,1,0.9815596309492486,129,62,1,192
23460,bright,main,20211014,2,0.992623741275934,280,153,4,437
23460,bright,main,20211014,3,0.9897513278916932,293,99,5,397
23460,bright,main,20211014,4,0.9778134007888197,162,45,1,208
23460,bright,main,20211014,5,0.9867149009772664,324,89,4,417
23460,bright,main,20211014,6,0.9909642488974713,351,77,5,433
23460,bright,main,20211014,7,0.9920620893158764,270,97,5,372
23460,bright,main,20211014,8,0.9884950613555554,324,95,6,425
23460,bright,main,20211014,9,0.9932078038595163,321,107,1,429
22801,bright,main,20211014,0,0.9932321483726699,350,83,4,437
22801,bright,main,20211014,1,0.9690345243373055,160,28,0,188
22801,bright,main,20211014,2,0.9904970882015796,346,80,8,434
22801,bright,main,20211014,3,0.9936756243836397,311,77,2,390
22801,bright,main,20211014,4,0.9908775700215415,165,40,2,207
22801,bright,main,20211014,5,0.9954024656628324,316,82,3,401
22801,bright,main,20211014,6,0.9956476483518296,331,85,6,422
22801,bright,main,20211014,7,0.9964755995027906,277,87,5,369
22801,bright,main,20211014,8,0.9942056177528497,284,85,1,370
22801,bright,main,20211014,9,0.9873120376598801,323,94,4,421
21240,bright,main,20211014,0,0.9951314948593515,359,67,5,431
21240,bright,main,20211014,1,0.9776863043720109,142,40,2,184
21240,bright,main,20211014,2,0.9962375598999382,337,78,3,418
21240,bright,main,20211014,3,0.9930555299511066,317,67,7,391
21240,bright,main,20211014,4,0.9879952705645549,172,35,3,210
21240,bright,main,20211014,5,0.9909823277156327,338,72,2,412
21240,bright,main,20211014,6,0.9873783074671116,354,65,9,428
21240,bright,main,20211014,7,0.9929741784358638,306,60,4,370
21240,bright,main,20211014,8,0.9931533650158632,298,73,3,374
21240,bright,main,20211014,9,0.9930561988297174,313,101,2,416
7951,dark,main,20211014,0,0.9894188577324229,287,15,97,399
7951,dark,main,20211014,1,0.9810361987978282,119,6,43,168
7951,dark,main,20211014,2,0.9933293535926275,279,12,101,392
7951,dark,main,20211014,3,0.9930290766503201,256,12,86,354
7951,dark,main,20211014,4,0.9864500484859993,146,7,38,191
7951,dark,main,20211014,5,0.9857271178278573,278,11,83,372
7951,dark,main,20211014,6,0.9900285046916236,290,13,89,392
7951,dark,main,20211014,7,0.987011434425473,254,15,70,339
7951,dark,main,20211014,8,0.9944430322182406,280,8,76,364
7951,dark,main,20211014,9,0.9860412491900923,297,14,71,382
25749,bright,main,20211014,0,0.9924972535016359,356,64,4,424
25749,bright,main,20211014,1,0.9821886730209058,144,34,3,181
25749,bright,main,20211014,2,0.9897425718697436,340,82,2,424
25749,bright,main,20211014,3,0.9948070950158506,309,66,5,380
25749,bright,main,20211014,4,0.9857166960387721,174,25,1,200
25749,bright,main,20211014,5,0.9966345880618721,328,67,1,396
25749,bright,main,20211014,6,0.9937973736056158,321,87,6,414
25749,bright,main,20211014,7,0.9939425351171938,297,57,3,357
25749,bright,main,20211014,8,0.9934727737631435,295,55,4,354
25749,bright,main,20211014,9,0.9919834634440122,352,57,3,412
22602,bright,main,20211014,0,0.9894947982228758,359,54,5,418
22602,bright,main,20211014,1,0.993445343274672,137,43,2,182
22602,bright,main,20211014,2,0.9923455281438538,337,82,6,425
22602,bright,main,20211014,3,0.9874921166572577,296,70,9,375
22602,bright,main,20211014,4,0.9746762934630735,159,36,0,195
22602,bright,main,20211014,5,0.9906370618719901,321,65,4,390
22602,bright,main,20211014,6,0.9908037712781196,319,77,3,399
22602,bright,main,20211014,7,0.9928716776840023,282,72,6,360
22602,bright,main,20211014,8,0.990210113708724,317,47,4,368
22602,bright,main,20211014,9,0.9923642548890435,357,48,6,411
24389,bright,main,20211014,0,0.9880339156362014,344,81,2,427
24389,bright,main,20211014,1,0.9828940776116681,135,48,4,187
24389,bright,main,20211014,2,0.9912243905680671,291,106,8,405
24389,bright,main,20211014,3,0.9929050647180936,311,73,6,390
24389,bright,main,20211014,4,0.9868097877730785,161,39,2,202
24389,bright,main,20211014,5,0.9880616498399692,299,83,9,391
24389,bright,main,20211014,6,0.9927803475260145,339,64,6,409
24389,bright,main,20211014,7,0.9931061206886299,295,63,2,360
24389,bright,main,20211014,8,0.991897815523039,329,39,5,373
24389,bright,main,20211014,9,0.9852605268718777,329,78,6,413
25757,bright,main,20211015,0,0.9964598276536119,355,80,2,437
25757,bright,main,20211015,1,0.9925386482173373,276,94,3,373
25757,bright,main,20211015,2,0.9940413649186554,330,96,8,434
25757,bright,main,20211015,3,0.9892799184256623,296,88,9,393
25757,bright,main,20211015,4,0.986868773530829,314,81,5,400
25757,bright,main,20211015,5,0.9921454115427574,316,79,3,398
25757,bright,main,20211015,6,0.9947821274305525,339,83,3,425
25757,bright,main,20211015,7,0.9923802024663089,280,88,4,372
25757,bright,main,20211015,8,0.9858624957880918,332,83,5,420
25757,bright,main,20211015,9,0.9943553054382205,332,93,1,426
25495,bright,main,20211015,0,0.9938266220901079,311,103,3,417
25495,bright,main,20211015,1,0.9952331363233239,270,102,4,376
25495,bright,main,20211015,2,0.9949288978007582,315,110,4,429
25495,bright,main,20211015,3,0.9932917992005609,267,127,1,395
25495,bright,main,20211015,4,0.9917877455346344,245,151,2,398
25495,bright,main,20211015,5,0.9941701711794904,249,156,3,408
25495,bright,main,20211015,6,0.9891944162697799,258,166,5,429
25495,bright,main,20211015,7,0.9861035953178585,245,122,6,373
25495,bright,main,20211015,8,0.9841334517193291,327,91,5,423
25495,bright,main,20211015,9,0.9896902786347477,333,76,6,415
25736,bright,main,20211015,0,0.9923244735694221,333,87,2,422
25736,bright,main,20211015,1,0.9922657324859753,318,39,4,361
25736,bright,main,20211015,2,0.9899217344156493,332,76,4,412
25736,bright,main,20211015,3,0.9883434809506788,288,79,3,370
25736,bright,main,20211015,4,0.9832125371950897,302,74,6,382
25736,bright,main,20211015,5,0.9938822247055232,339,59,5,403
25736,bright,main,20211015,6,0.9921822666561969,313,95,5,413
25736,bright,main,20211015,7,0.9936306655332598,267,82,3,352
25736,bright,main,20211015,8,0.9906063972640909,326,77,7,410
25736,bright,main,20211015,9,0.9941894549157447,328,75,5,408
22577,bright,main,20211015,0,0.9901999514532304,317,109,7,433
22577,bright,main,20211015,1,0.9918843423072599,290,77,6,373
22577,bright,main,20211015,2,0.9943261040708858,351,73,3,427
22577,bright,main,20211015,3,0.9915095258372906,296,76,7,379
22577,bright,main,20211015,4,0.9824245762313424,299,95,2,396
22577,bright,main,20211015,5,0.995690458830523,307,89,10,406
22577,bright,main,20211015,6,0.9950216153448076,338,79,4,421
22577,bright,main,20211015,7,0.9942195485614667,279,89,2,370
22577,bright,main,20211015,8,0.9901684873596224,286,129,6,421
22577,bright,main,20211015,9,0.9925173378037991,290,122,7,419
24134,bright,main,20211015,0,0.9946113848307877,322,94,8,424
24134,bright,main,20211015,1,0.9913078397858783,285,77,3,365
24134,bright,main,20211015,2,0.9937303025264834,315,97,4,416
24134,bright,main,20211015,3,0.9874868024712693,304,75,4,383
24134,bright,main,20211015,4,0.994902388381778,328,64,2,394
24134,bright,main,20211015,5,0.9905801819171622,319,77,9,405
24134,bright,main,20211015,6,0.9907839695737392,324,89,3,416
24134,bright,main,20211015,7,0.9938726817857982,274,87,0,361
24134,bright,main,20211015,8,0.9936374312407886,314,93,2,409
24134,bright,main,20211015,9,0.9915741979394335,328,80,7,415
25494,bright,main,20211015,0,0.9940716310405635,338,82,2,422
25494,bright,main,20211015,1,0.9911716191145903,273,76,8,357
25494,bright,main,20211015,2,0.9901879035644676,357,70,4,431
25494,bright,main,20211015,3,0.991462509985838,312,76,1,389
25494,bright,main,20211015,4,0.99453536474544,297,96,6,399
25494,bright,main,20211015,5,0.9922650250477826,316,85,8,409
25494,bright,main,20211015,6,0.9897019538748556,335,85,3,423
25494,bright,main,20211015,7,0.9920534636972064,304,66,1,371
25494,bright,main,20211015,8,0.9921097192247519,359,57,7,423
25494,bright,main,20211015,9,0.9950193333635052,352,70,5,427
24128,bright,main,20211015,0,0.9907046166802438,362,70,2,434
24128,bright,main,20211015,1,0.9930561009713378,281,64,5,350
24128,bright,main,20211015,2,0.9917015565817309,318,91,2,411
24128,bright,main,20211015,3,0.9952962039495229,305,67,7,379
24128,bright,main,20211015,4,0.9890126241093614,299,74,2,375
24128,bright,main,20211015,5,0.9925109902795878,351,47,3,401
24128,bright,main,20211015,6,0.9920250216598193,325,81,1,407
24128,bright,main,20211015,7,0.995419178137504,278,69,4,351
24128,bright,main,20211015,8,0.9970729910530708,315,89,4,408
24128,bright,main,20211015,9,0.9947577359146562,341,66,3,410
22575,bright,main,20211015,0,0.9914681093424242,343,92,6,441
22575,bright,main,20211015,1,0.9922316480271905,308,59,4,371
22575,bright,main,20211015,2,0.9902995837137425,364,64,7,435
22575,bright,main,20211015,3,0.9898536580520638,325,69,3,397
22575,bright,main,20211015,4,0.9898726051651491,301,96,6,403
22575,bright,main,20211015,5,0.9936559822397985,333,72,6,411
22575,bright,main,20211015,6,0.9920844726265965,355,71,1,427
22575,bright,main,20211015,7,0.9939423638075662,306,63,4,373
22575,bright,main,20211015,8,0.9970683321213125,389,30,5,424
22575,bright,main,20211015,9,0.9972969872574265,339,79,2,420
24133,bright,main,20211015,0,0.9899497071418752,375,54,8,437
24133,bright,main,20211015,1,0.9917820302850703,312,53,2,367
24133,bright,main,20211015,2,0.9939462102036591,346,82,5,433
24133,bright,main,20211015,3,0.9897964883527375,288,93,6,387
24133,bright,main,20211015,4,0.9952171267990843,285,96,3,384
24133,bright,main,20211015,5,0.9945000777475984,284,97,6,387
24133,bright,main,20211015,6,0.9884454342080994,313,97,6,416
24133,bright,main,20211015,7,0.9926322457211028,307,54,3,364
24133,bright,main,20211015,8,0.9886811031915257,331,73,7,411
24133,bright,main,20211015,9,0.9898313690960545,341,67,3,411
22270,bright,main,20211015,0,0.9870228048054281,326,84,4,414
22270,bright,main,20211015,1,0.9928799211931654,248,90,3,341
22270,bright,main,20211015,2,0.9902393518706615,338,69,7,414
22270,bright,main,20211015,3,0.9925596492878974,301,69,3,373
22270,bright,main,20211015,4,0.9901511263437703,282,90,4,376
22270,bright,main,20211015,5,0.9927982390488533,336,50,7,393
22270,bright,main,20211015,6,0.9947798727644995,328,73,3,404
22270,bright,main,20211015,7,0.9910209059955699,297,61,0,358
22270,bright,main,20211015,8,0.9958068576023658,345,69,2,416
22270,bright,main,20211015,9,0.9936713119441917,326,75,5,406
20071,bright,main,20211015,0,0.9934063972405117,353,82,4,439
20071,bright,main,20211015,1,0.9898562406532292,309,65,4,378
20071,bright,main,20211015,2,0.9928639866129892,363,67,4,434
20071,bright,main,20211015,3,0.9907857040760001,305,74,8,387
20071,bright,main,20211015,4,0.9805632386834231,331,67,6,404
20071,bright,main,20211015,5,0.9822253205832798,334,72,3,409
20071,bright,main,20211015,6,0.9933551555980946,331,97,3,431
20071,bright,main,20211015,7,0.9969987585164838,258,108,2,368
20071,bright,main,20211015,8,0.9906068134473937,321,98,3,422
20071,bright,main,20211015,9,0.9935658402880411,345,78,4,427
22807,bright,main,20211015,0,0.9927763361433999,363,67,7,437
22807,bright,main,20211015,1,0.9912290530174426,300,69,3,372
22807,bright,main,20211015,2,0.9923411174956447,325,96,7,428
22807,bright,main,20211015,3,0.9927304480976754,322,75,3,400
22807,bright,main,20211015,4,0.9946171099200476,306,95,6,407
22807,bright,main,20211015,5,0.9952726478742384,333,77,4,414
22807,bright,main,20211015,6,0.9900826021830614,333,92,4,429
22807,bright,main,20211015,7,0.9968055495817847,309,60,4,373
22807,bright,main,20211015,8,0.9935790444184814,326,93,1,420
22807,bright,main,20211015,9,0.9891819623585306,344,83,5,432
24691,bright,main,20211015,0,0.9944851027808075,366,60,9,435
24691,bright,main,20211015,1,0.9918961030617555,259,94,3,356
24691,bright,main,20211015,2,0.9852215457607855,345,82,5,432
24691,bright,main,20211015,3,0.989205975610352,316,72,4,392
24691,bright,main,20211015,4,0.9927393951720349,337,63,3,403
24691,bright,main,20211015,5,0.9875170910706885,339,73,3,415
24691,bright,main,20211015,6,0.9937826848913724,343,75,7,425
24691,bright,main,20211015,7,0.9903480974018278,286,75,5,366
24691,bright,main,20211015,8,0.9964555107521317,330,84,4,418
24691,bright,main,20211015,9,0.9945053075241173,330,85,4,419
20314,bright,main,20211015,0,0.9901400450729042,354,82,0,436
20314,bright,main,20211015,1,0.9827784146076792,285,86,3,374
20314,bright,main,20211015,2,0.9930909046228822,332,100,4,436
20314,bright,main,20211015,3,0.9934835759222107,310,80,6,396
20314,bright,main,20211015,4,0.9937405036282785,319,81,3,403
20314,bright,main,20211015,5,0.9970694083611457,345,60,4,409
20314,bright,main,20211015,6,0.9913731507413943,332,89,2,423
20314,bright,main,20211015,7,0.9866795317042849,287,81,6,374
20314,bright,main,20211015,8,0.8965581139830233,37,17,0,54
20314,bright,main,20211015,9,0.9911894945291622,351,57,2,410
25496,bright,main,20211015,0,0.9921107085233537,347,86,3,436
25496,bright,main,20211015,1,0.992670261558431,283,82,5,370
25496,bright,main,20211015,2,0.9964458484344499,339,94,2,435
25496,bright,main,20211015,3,0.9938316457653725,325,65,3,393
25496,bright,main,20211015,4,0.9925205614768168,288,114,0,402
25496,bright,main,20211015,5,0.9940074937017771,335,69,5,409
25496,bright,main,20211015,6,0.9962283847562251,338,81,5,424
25496,bright,main,20211015,7,0.9913588727549413,308,62,1,371
25496,bright,main,20211015,8,0.9923366935194875,330,88,8,426
25496,bright,main,20211015,9,0.9933343438530211,332,84,4,420
24125,bright,main,20211015,0,0.9949219635733455,342,82,5,429
24125,bright,main,20211015,1,0.9948793596120441,306,54,7,367
24125,bright,main,20211015,2,0.9953314028316981,359,58,4,421
24125,bright,main,20211015,3,0.9884607671994171,297,82,9,388
24125,bright,main,20211015,4,0.9921912399611257,312,76,3,391
24125,bright,main,20211015,5,0.9907547000628024,333,67,4,404
24125,bright,main,20211015,6,0.9918723596513676,344,76,3,423
24125,bright,main,20211015,7,0.9969186358812052,271,85,3,359
24125,bright,main,20211015,8,0.9880208291477091,307,94,6,407
24125,bright,main,20211015,9,0.991634471793021,317,82,5,404
22572,bright,main,20211015,0,0.9876628698184692,365,64,7,436
22572,bright,main,20211015,1,0.9924122793977858,279,87,2,368
22572,bright,main,20211015,2,0.9935762834485782,350,70,2,422
22572,bright,main,20211015,3,0.9923815597369797,285,86,1,372
22572,bright,main,20211015,4,0.9905119903603901,312,69,8,389
22572,bright,main,20211015,5,0.9939586979834792,309,84,10,403
22572,bright,main,20211015,6,0.9830822601318986,343,72,4,419
22572,bright,main,20211015,7,0.994426969216237,292,69,5,366
22572,bright,main,20211015,8,0.9929576007046892,326,86,6,418
22572,bright,main,20211015,9,0.992967890821518,287,82,6,375
24627,bright,main,20211015,0,0.987397247104135,373,62,4,439
24627,bright,main,20211015,1,0.9875477838276406,317,54,6,377
24627,bright,main,20211015,2,0.9934020994595969,359,69,5,433
24627,bright,main,20211015,3,0.9946752090560087,308,77,4,389
24627,bright,main,20211015,4,0.9915307983006982,316,86,1,403
24627,bright,main,20211015,5,0.9901032795542406,323,84,4,411
24627,bright,main,20211015,6,0.9869156410110631,345,72,5,422
24627,bright,main,20211015,7,0.9871412053734829,299,72,3,374
24627,bright,main,20211015,8,0.9960275014349623,362,53,7,422
24627,bright,main,20211015,9,0.9957486157815724,359,66,1,426
24124,bright,main,20211015,0,0.9922809457560638,372,49,7,428
24124,bright,main,20211015,1,0.986033838025305,292,61,6,359
24124,bright,main,20211015,2,0.9921289280906671,360,55,3,418
24124,bright,main,20211015,3,0.9930559161990626,343,45,0,388
24124,bright,main,20211015,4,0.9902099996739229,297,79,5,381
24124,bright,main,20211015,5,0.9938009223921009,320,80,3,403
24124,bright,main,20211015,6,0.9908001566300949,292,109,5,406
24124,bright,main,20211015,7,0.9938567547454468,264,82,6,352
24124,bright,main,20211015,8,0.9950519634745345,345,58,5,408
24124,bright,main,20211015,9,0.9842082292682769,347,66,4,417
6266,dark,main,20211015,0,0.9952979335705183,269,18,102,389
6266,dark,main,20211015,1,0.9869144499525582,238,19,78,335
6266,dark,main,20211015,2,0.9948472349775219,279,24,84,387
6266,dark,main,20211015,3,0.986388595413811,259,24,88,371
6266,dark,main,20211015,4,0.9901945852935687,246,33,68,347
6266,dark,main,20211015,5,0.995596493068297,266,23,74,363
6266,dark,main,20211015,6,0.9928377182968984,260,27,88,375
6266,dark,main,20211015,7,0.9892486327420266,221,23,82,326
6266,dark,main,20211015,8,0.9790527672099576,237,22,96,355
6266,dark,main,20211015,9,0.9953112553874728,253,21,92,366
22806,bright,main,20211015,0,0.991061123572835,335,105,1,441
22806,bright,main,20211015,1,0.9920596380891855,284,78,5,367
22806,bright,main,20211015,2,0.9917972670824678,353,85,1,439
22806,bright,main,20211015,3,0.9933539577982137,328,66,3,397
22806,bright,main,20211015,4,0.9905387858188331,327,72,6,405
22806,bright,main,20211015,5,0.995253305326729,320,85,5,410
22806,bright,main,20211015,6,0.9926124859968669,364,63,5,432
22806,bright,main,20211015,7,0.9890382797198795,295,74,4,373
22806,bright,main,20211015,8,0.9904154914610728,321,91,5,417
22806,bright,main,20211015,9,0.9919023570790771,330,90,4,424
24127,bright,main,20211015,0,0.9906379597030184,297,83,3,383
24127,bright,main,20211015,1,0.9937633231407217,303,51,4,358
24127,bright,main,20211015,2,0.9906798650628399,372,51,4,427
24127,bright,main,20211015,3,0.9894334978017998,314,62,5,381
24127,bright,main,20211015,4,0.9900856531345383,316,47,6,369
24127,bright,main,20211015,5,0.9907397245506884,220,50,5,275
24127,bright,main,20211015,6,0.9884890037929938,305,55,6,366
24127,bright,main,20211015,7,0.9862294057657769,248,42,4,294
24127,bright,main,20211015,8,0.9934511471532588,268,71,0,339
24127,bright,main,20211015,9,0.9948558462950731,288,85,3,376
22573,bright,main,20211015,0,0.9877795251708051,356,77,3,436
22573,bright,main,20211015,1,0.988687164613736,303,65,1,369
22573,bright,main,20211015,2,0.9906650868094968,345,74,2,421
22573,bright,main,20211015,3,0.9958736262613809,316,71,5,392
22573,bright,main,20211015,4,0.9893875226079775,331,68,4,403
22573,bright,main,20211015,5,0.9942448820844952,347,56,2,405
22573,bright,main,20211015,6,0.9923531947118222,351,70,3,424
22573,bright,main,20211015,7,0.9887214313112177,305,59,2,366
22573,bright,main,20211015,8,0.9940794201577028,349,66,6,421
22573,bright,main,20211015,9,0.989494891585877,340,81,2,423
25499,bright,main,20211015,0,0.997141475180978,349,80,4,433
25499,bright,main,20211015,1,0.9907233615598293,292,74,3,369
25499,bright,main,20211015,2,0.9972247747419238,381,50,1,432
25499,bright,main,20211015,3,0.9956682522022027,314,72,5,391
25499,bright,main,20211015,4,0.9910373468736169,318,74,3,395
25499,bright,main,20211015,5,0.9946953400671424,323,78,7,408
25499,bright,main,20211015,6,0.9848932823413302,322,101,3,426
25499,bright,main,20211015,7,0.9940564527974847,282,78,6,366
25499,bright,main,20211015,8,0.9934787939817563,348,65,6,419
25499,bright,main,20211015,9,0.9933371167324875,355,65,4,424
25410,bright,main,20211015,0,0.9950674121265388,376,53,3,432
25410,bright,main,20211015,1,0.9929423548612966,289,59,2,350
25410,bright,main,20211015,2,0.9929123376926693,339,73,3,415
25410,bright,main,20211015,3,0.9932497645463785,305,63,3,371
25410,bright,main,20211015,4,0.9915555630690364,316,65,4,385
25410,bright,main,20211015,5,0.9916564660058649,304,80,3,387
25410,bright,main,20211015,6,0.9911267460771097,352,60,1,413
25410,bright,main,20211015,7,0.9810737167348029,284,70,5,359
25410,bright,main,20211015,8,0.9946375812222262,337,66,2,405
25410,bright,main,20211015,9,0.9923004217393079,348,60,3,411
3135,dark,main,20211015,0,0.9894017127756429,274,22,88,384
3135,dark,main,20211015,1,0.984418235056231,228,23,86,337
3135,dark,main,20211015,2,0.9922005866903941,277,27,83,387
3135,dark,main,20211015,3,0.9873698398537102,251,20,82,353
3135,dark,main,20211015,4,0.9882296865491351,224,31,77,332
3135,dark,main,20211015,5,0.9859220027170134,259,26,71,356
3135,dark,main,20211015,6,0.9838826482293035,272,27,75,374
3135,dark,main,20211015,7,0.9905860250403894,226,20,89,335
3135,dark,main,20211015,8,0.9930305580300455,262,17,89,368
3135,dark,main,20211015,9,0.9897955920700537,249,24,83,356
24126,bright,main,20211015,0,0.9959226325461272,340,79,5,424
24126,bright,main,20211015,1,0.9934025421394368,277,74,6,357
24126,bright,main,20211015,2,0.9888000152293841,337,73,3,413
24126,bright,main,20211015,3,0.9929752744663204,310,62,3,375
24126,bright,main,20211015,4,0.9924863749706041,319,65,6,390
24126,bright,main,20211015,5,0.9904420025881399,331,57,5,393
24126,bright,main,20211015,6,0.9882780730851008,330,86,2,418
24126,bright,main,20211015,7,0.9926188690170115,285,74,6,365
24126,bright,main,20211015,8,0.9952825987074417,346,59,6,411
24126,bright,main,20211015,9,0.9914449644512797,332,71,5,408
24137,bright,main,20211015,0,0.9933796544035235,350,68,4,422
24137,bright,main,20211015,1,0.9897192715617233,286,76,3,365
24137,bright,main,20211015,2,0.9926038491465095,383,46,1,430
24137,bright,main,20211015,3,0.9959375855967602,319,66,6,391
24137,bright,main,20211015,4,0.9940360372579349,346,50,5,401
24137,bright,main,20211015,5,0.9895633186575463,353,57,2,412
24137,bright,main,20211015,6,0.9953629474560103,337,82,4,423
24137,bright,main,20211015,7,0.9913588771865165,295,67,7,369
24137,bright,main,20211015,8,0.9895902706341226,354,64,2,420
24137,bright,main,20211015,9,0.9930994658552638,335,85,3,423
25404,bright,main,20211015,0,0.9944332794227013,334,83,6,423
25404,bright,main,20211015,1,0.9920229632953612,300,59,6,365
25404,bright,main,20211015,2,0.9942873929866399,320,86,6,412
25404,bright,main,20211015,3,0.9881527629631613,285,81,3,369
25404,bright,main,20211015,4,0.9958126705554372,309,61,9,379
25404,bright,main,20211015,5,0.9939658279452606,337,64,6,407
25404,bright,main,20211015,6,0.9885329027421721,350,62,5,417
25404,bright,main,20211015,7,0.9896799756687897,294,63,5,362
25404,bright,main,20211015,8,0.9901181562237007,304,94,5,403
25404,bright,main,20211015,9,0.9955726444456798,331,78,6,415
22576,bright,main,20211015,0,0.9898494943767521,327,96,6,429
22576,bright,main,20211015,1,0.9883499836019476,290,71,5,366
22576,bright,main,20211015,2,0.9849907495246267,318,97,4,419
22576,bright,main,20211015,3,0.9949509243625073,323,71,1,395
22576,bright,main,20211015,4,0.991173917545582,334,66,3,403
22576,bright,main,20211015,5,0.9920322081257136,338,68,7,413
22576,bright,main,20211015,6,0.9927991087994718,342,76,6,424
22576,bright,main,20211015,7,0.9890297974323342,300,59,6,365
22576,bright,main,20211015,8,0.9863798890028486,322,83,6,411
22576,bright,main,20211015,9,0.9902290481902529,324,93,8,425
22363,bright,main,20211016,0,0.9913739690666835,325,110,5,440
22363,bright,main,20211016,1,0.9921501562501949,249,120,5,374
22363,bright,main,20211016,2,0.988250461084449,324,101,3,428
22363,bright,main,20211016,3,0.9899743868831746,287,100,1,388
22363,bright,main,20211016,4,0.994659763453446,331,64,3,398
22363,bright,main,20211016,5,0.9904514387647012,326,91,4,421
22363,bright,main,20211016,6,0.9919889249977512,340,81,6,427
22363,bright,main,20211016,7,0.9910518070424015,262,95,6,363
22363,bright,main,20211016,8,0.9889226463230175,346,68,3,417
22363,bright,main,20211016,9,0.9923467543575955,300,121,4,425
25512,bright,main,20211016,0,0.990091464716819,375,59,3,437
25512,bright,main,20211016,1,0.9916694065020204,313,54,5,372
25512,bright,main,20211016,2,0.9920823596618734,342,84,6,432
25512,bright,main,20211016,3,0.991270722509162,305,79,2,386
25512,bright,main,20211016,4,0.9936369308178908,284,103,5,392
25512,bright,main,20211016,5,0.9960240404684618,318,84,4,406
25512,bright,main,20211016,6,0.9926925628684186,310,87,3,400
25512,bright,main,20211016,7,0.9888551680676472,274,87,0,361
25512,bright,main,20211016,8,0.9913829050130879,341,76,0,417
25512,bright,main,20211016,9,0.9929469230794633,344,73,3,420
20806,bright,main,20211016,0,0.9883969803775285,348,91,3,442
20806,bright,main,20211016,1,0.996283572993351,262,111,3,376
20806,bright,main,20211016,2,0.9930640974379414,332,92,6,430
20806,bright,main,20211016,3,0.9949225342803725,297,93,5,395
20806,bright,main,20211016,4,0.9888002724772309,317,80,7,404
20806,bright,main,20211016,5,0.9855228296621492,337,64,2,403
20806,bright,main,20211016,6,0.9928847962244619,336,90,4,430
20806,bright,main,20211016,7,0.9939443498368966,305,65,3,373
20806,bright,main,20211016,8,0.9944246111011541,317,91,3,411
20806,bright,main,20211016,9,0.9933390059795102,352,73,5,430
25502,bright,main,20211016,0,0.9872929456115558,304,117,4,425
25502,bright,main,20211016,1,0.9932436136735197,234,131,5,370
25502,bright,main,20211016,2,0.9922571498009097,278,146,4,428
25502,bright,main,20211016,3,0.993285650646134,279,97,7,383
25502,bright,main,20211016,4,0.9900929227092438,281,108,3,392
25502,bright,main,20211016,5,0.9938278804592379,307,97,3,407
25502,bright,main,20211016,6,0.9958179273633432,342,80,5,427
25502,bright,main,20211016,7,0.9932900913184953,271,85,7,363
25502,bright,main,20211016,8,0.9920928371215864,298,116,4,418
25502,bright,main,20211016,9,0.9971821201132963,340,78,5,423
23926,bright,main,20211016,0,0.9915797904323379,326,104,4,434
23926,bright,main,20211016,1,0.9938772699568067,264,101,7,372
23926,bright,main,20211016,2,0.9932038315225132,322,101,7,430
23926,bright,main,20211016,3,0.9930123809829736,268,123,0,391
23926,bright,main,20211016,4,0.9947650175292874,243,131,8,382
23926,bright,main,20211016,5,0.9951560110674476,252,126,4,382
23926,bright,main,20211016,6,0.9841961056144305,228,147,3,378
23926,bright,main,20211016,7,0.992696065665247,262,94,3,359
23926,bright,main,20211016,8,0.9965236527838184,323,83,11,417
23926,bright,main,20211016,9,0.9844814838389598,296,127,2,425
11881,dark,main,20211016,0,0.9927275689802152,284,15,80,379
11881,dark,main,20211016,1,0.9924734503946258,236,10,90,336
11881,dark,main,20211016,2,0.9833176216507498,285,17,91,393
11881,dark,main,20211016,3,0.9910355164048207,283,13,70,366
11881,dark,main,20211016,4,0.9903971475817825,264,20,78,362
11881,dark,main,20211016,5,0.992948724496024,257,18,104,379
11881,dark,main,20211016,6,0.9852157806674404,297,12,87,396
11881,dark,main,20211016,7,0.9908729563895986,260,16,71,347
11881,dark,main,20211016,8,0.9878709399323721,280,13,77,370
11881,dark,main,20211016,9,0.9881330433520388,268,12,91,371
5609,dark,main,20211016,0,0.9965500847617456,265,16,105,386
5609,dark,main,20211016,1,0.9934358151245173,246,15,75,336
5609,dark,main,20211016,2,0.9944163526287934,289,13,87,389
5609,dark,main,20211016,3,0.9922393948397654,270,13,79,362
5609,dark,main,20211016,4,0.9913306362437955,257,13,87,357
5609,dark,main,20211016,5,0.9883508557511318,261,14,91,366
5609,dark,main,20211016,6,0.9885598157292809,284,18,84,386
5609,dark,main,20211016,7,0.9893207152947828,250,13,72,335
5609,dark,main,20211016,8,0.9918189809168493,276,20,79,375
5609,dark,main,20211016,9,0.9918976690721094,263,20,105,388
22243,bright,main,20211016,0,0.9937903838417619,327,88,5,420
22243,bright,main,20211016,1,0.9939117269160732,287,76,2,365
22243,bright,main,20211016,2,0.9883849731279485,325,84,4,413
22243,bright,main,20211016,3,0.9873446801395049,308,74,9,391
22243,bright,main,20211016,4,0.9870461876568571,293,82,2,377
22243,bright,main,20211016,5,0.9952865788830502,324,80,2,406
22243,bright,main,20211016,6,0.9933182445148235,349,63,4,416
22243,bright,main,20211016,7,0.9929749135776634,282,68,2,352
22243,bright,main,20211016,8,0.9921288193739567,352,57,5,414
22243,bright,main,20211016,9,0.9924223324259076,317,87,7,411
5113,dark,main,20211016,0,0.9873684514824469,264,31,85,380
5113,dark,main,20211016,1,0.9870344871914125,239,15,70,324
5113,dark,main,20211016,2,0.9913470720336878,278,19,83,380
5113,dark,main,20211016,3,0.9880960568121528,248,23,75,346
5113,dark,main,20211016,4,0.9884580083442104,267,12,71,350
5113,dark,main,20211016,5,0.9861968360791219,255,14,87,356
5113,dark,main,20211016,6,0.9895575795151277,264,31,86,381
5113,dark,main,20211016,7,0.9914832195715754,252,24,55,331
5113,dark,main,20211016,8,0.9879665362635406,251,20,83,354
5113,dark,main,20211016,9,0.9944994126172317,285,17,77,379
5545,dark,main,20211016,0,0.9917779770008248,292,17,80,389
5545,dark,main,20211016,1,0.9894227870474462,256,15,60,331
5545,dark,main,20211016,2,0.9954447183370895,292,18,80,390
5545,dark,main,20211016,3,0.9835722801636905,250,21,82,353
5545,dark,main,20211016,4,0.9882164367835925,230,16,90,336
5545,dark,main,20211016,5,0.9919087826315236,254,18,83,355
5545,dark,main,20211016,6,0.9905052574645318,279,19,81,379
5545,dark,main,20211016,7,0.9876029358502543,239,13,68,320
5545,dark,main,20211016,8,0.9862237508882102,261,23,82,366
5545,dark,main,20211016,9,0.993998774070449,282,18,87,387
20565,bright,main,20211016,0,0.9955059466277897,371,58,7,436
20565,bright,main,20211016,1,0.9923425899967291,310,61,3,374
20565,bright,main,20211016,2,0.9916809902165652,350,69,4,423
20565,bright,main,20211016,3,0.9889200000052587,309,70,3,382
20565,bright,main,20211016,4,0.9922757968222193,329,56,1,386
20565,bright,main,20211016,5,0.9910924110451366,339,63,6,408
20565,bright,main,20211016,6,0.994053080405792,322,81,7,410
20565,bright,main,20211016,7,0.9893546027795855,279,80,3,362
20565,bright,main,20211016,8,0.9943910818760102,281,109,5,395
20565,bright,main,20211016,9,0.994035386481894,342,71,4,417
2361,dark,main,20211016,0,0.9929492185759046,273,20,95,388
2361,dark,main,20211016,1,0.9916708068649893,244,14,70,328
2361,dark,main,20211016,2,0.9937721552129049,266,16,97,379
2361,dark,main,20211016,3,0.9893555111828565,255,23,75,353
2361,dark,main,20211016,4,0.9851371703808949,252,15,82,349
2361,dark,main,20211016,5,0.98851354124934,251,16,89,356
2361,dark,main,20211016,6,0.9904905374797438,291,15,85,391
2361,dark,main,20211016,7,0.9925296668545153,237,14,72,323
2361,dark,main,20211016,8,0.9912419079583411,261,17,101,379
2361,dark,main,20211016,9,0.9960294720510833,271,19,88,378
23936,bright,main,20211016,0,0.9923443041142853,341,94,7,442
23936,bright,main,20211016,1,0.989392689960442,308,57,4,369
23936,bright,main,20211016,2,0.9935113911371418,363,66,3,432
23936,bright,main,20211016,3,0.9946222371473672,318,69,4,391
23936,bright,main,20211016,4,0.9888057828371398,319,75,5,399
23936,bright,main,20211016,5,0.9903032818185,312,94,4,410
23936,bright,main,20211016,6,0.9930786248805887,318,104,5,427
23936,bright,main,20211016,7,0.9852600485122327,281,75,4,360
23936,bright,main,20211016,8,0.9932403347350813,326,92,4,422
23936,bright,main,20211016,9,0.9931461313205652,352,70,3,425
22277,bright,main,20211016,0,0.9873853301347539,323,93,2,418
22277,bright,main,20211016,1,0.996585620512087,315,52,6,373
22277,bright,main,20211016,2,0.994159221524676,338,86,7,431
22277,bright,main,20211016,3,0.994900471248719,304,71,6,381
22277,bright,main,20211016,4,0.9937774371627173,310,72,4,386
22277,bright,main,20211016,5,0.9921274935334045,317,79,7,403
22277,bright,main,20211016,6,0.9910620197782282,377,42,4,423
22277,bright,main,20211016,7,0.9962461087178753,301,49,3,353
22277,bright,main,20211016,8,0.9939911649287205,320,70,8,398
22277,bright,main,20211016,9,0.9950521670578076,331,70,1,402
25513,bright,main,20211016,0,0.990672525032205,352,81,5,438
25513,bright,main,20211016,1,0.9850668713346269,291,73,4,368
25513,bright,main,20211016,2,0.9947607503415806,328,95,5,428
25513,bright,main,20211016,3,0.9969579691943489,301,84,5,390
25513,bright,main,20211016,4,0.9956149239826092,284,106,0,390
25513,bright,main,20211016,5,0.9955992423857989,313,81,2,396
25513,bright,main,20211016,6,0.9914725787868867,301,116,3,420
25513,bright,main,20211016,7,0.9870652019931596,265,91,4,360
25513,bright,main,20211016,8,0.9938569930743945,328,76,3,407
25513,bright,main,20211016,9,0.9929336522975749,306,112,3,421
25411,bright,main,20211016,0,0.99411798895902,320,97,5,422
25411,bright,main,20211016,1,0.9881484443000372,284,66,8,358
25411,bright,main,20211016,2,0.9974249048425086,369,51,4,424
25411,bright,main,20211016,3,0.9932214478918611,310,68,9,387
25411,bright,main,20211016,4,0.9924729234069376,323,58,6,387
25411,bright,main,20211016,5,0.9962190290449298,298,85,8,391
25411,bright,main,20211016,6,0.9940386039620033,323,80,5,408
25411,bright,main,20211016,7,0.9947590464492326,299,54,3,356
25411,bright,main,20211016,8,0.9893285177913859,329,72,10,411
25411,bright,main,20211016,9,0.9845622584054796,313,97,5,415
25760,bright,main,20211016,0,0.9886635224781032,365,53,7,425
25760,bright,main,20211016,1,0.9948796499915179,300,66,2,368
25760,bright,main,20211016,2,0.9955321160127845,371,59,1,431
25760,bright,main,20211016,3,0.9904846182418735,287,91,2,380
25760,bright,main,20211016,4,0.9905969597543572,282,103,1,386
25760,bright,main,20211016,5,0.993567015213036,295,91,4,390
25760,bright,main,20211016,6,0.9963173244266539,320,88,7,415
25760,bright,main,20211016,7,0.9789443367464935,278,71,3,352
25760,bright,main,20211016,8,0.9926297466821632,352,66,3,421
25760,bright,main,20211016,9,0.9913951570615241,344,69,5,418
22252,bright,main,20211016,0,0.9976669529032453,342,74,6,422
22252,bright,main,20211016,1,0.9923125412558558,309,50,6,365
22252,bright,main,20211016,2,0.9921637323913665,323,81,8,412
22252,bright,main,20211016,3,0.9934586969921722,275,94,2,371
22252,bright,main,20211016,4,0.9946585235604738,318,61,5,384
22252,bright,main,20211016,5,0.99084984505065,342,55,2,399
22252,bright,main,20211016,6,0.9924792526511962,335,76,7,418
22252,bright,main,20211016,7,0.9911537429412282,282,73,3,358
22252,bright,main,20211016,8,0.9941398441865048,341,73,2,416
22252,bright,main,20211016,9,0.995005360095805,355,58,8,421
22594,bright,main,20211016,0,0.9892919754124921,346,87,3,436
22594,bright,main,20211016,1,0.9943144358286194,282,88,2,372
22594,bright,main,20211016,2,0.9930236358845417,314,114,2,430
22594,bright,main,20211016,3,0.9873748250495032,306,71,6,383
22594,bright,main,20211016,4,0.9901751116990235,303,88,3,394
22594,bright,main,20211016,5,0.9954012421208929,332,76,3,411
22594,bright,main,20211016,6,0.9910217364443953,285,130,5,420
22594,bright,main,20211016,7,0.9871100797539121,259,100,4,363
22594,bright,main,20211016,8,0.9944487748468341,306,97,4,407
22594,bright,main,20211016,9,0.9956631464725533,358,72,3,433
25418,bright,main,20211016,0,0.9937140911241308,379,55,3,437
25418,bright,main,20211016,1,0.9890281036090539,330,42,2,374
25418,bright,main,20211016,2,0.991334643853135,347,75,3,425
25418,bright,main,20211016,3,0.9873620108295433,323,54,6,383
25418,bright,main,20211016,4,0.992048037080455,315,76,3,394
25418,bright,main,20211016,5,0.9893388159001667,285,102,4,391
25418,bright,main,20211016,6,0.9967265200008437,327,85,3,415
25418,bright,main,20211016,7,0.9876408667590135,265,69,3,337
25418,bright,main,20211016,8,0.996470578306303,313,83,6,402
25418,bright,main,20211016,9,0.9924622020025733,341,72,6,419
24007,bright,main,20211019,0,0.9952296862740749,377,57,1,435
24007,bright,main,20211019,1,0.9938502928511513,254,123,3,380
24007,bright,main,20211019,2,0.9907076277103288,285,148,3,436
24007,bright,main,20211019,3,0.9919763847088113,286,106,7,399
24007,bright,main,20211019,4,0.9900984574546822,268,129,3,400
24007,bright,main,20211019,5,0.9981466229330117,284,130,3,417
24007,bright,main,20211019,6,0.9924968242158067,320,104,3,427
24007,bright,main,20211019,7,0.9919622293352636,287,79,3,369
24007,bright,main,20211019,8,0.9851864523068625,335,85,4,424
24007,bright,main,20211019,9,0.9935781865378217,372,44,4,420
25021,bright,main,20211019,0,0.9877047133100527,357,69,4,430
25021,bright,main,20211019,1,0.9907832924968786,284,80,6,370
25021,bright,main,20211019,2,0.9936726925382725,334,95,4,433
25021,bright,main,20211019,3,0.9935532466012594,325,68,3,396
25021,bright,main,20211019,4,0.99035289057978,306,91,7,404
25021,bright,main,20211019,5,0.9965821085450159,333,81,2,416
25021,bright,main,20211019,6,0.9946650926600549,333,90,5,428
25021,bright,main,20211019,7,0.9968332699234091,287,83,4,374
25021,bright,main,20211019,8,0.9953695424614123,315,107,2,424
25021,bright,main,20211019,9,0.9941273541512013,328,95,9,432
23044,bright,main,20211019,0,0.9906245611455902,324,102,4,430
23044,bright,main,20211019,1,0.9886861893712404,280,79,4,363
23044,bright,main,20211019,2,0.9923434581105941,331,84,5,420
23044,bright,main,20211019,3,0.990006968159249,293,84,9,386
23044,bright,main,20211019,4,0.9929855087068028,307,82,5,394
23044,bright,main,20211019,5,0.9860527880643396,326,80,5,411
23044,bright,main,20211019,6,0.9806075878312311,345,70,5,420
23044,bright,main,20211019,7,0.9947314426243347,280,71,5,356
23044,bright,main,20211019,8,0.9926462840755145,334,72,1,407
23044,bright,main,20211019,9,0.9905059048514495,312,102,1,415
22816,bright,main,20211019,0,0.9907054738682685,355,82,6,443
22816,bright,main,20211019,1,0.9887674907263864,288,77,5,370
22816,bright,main,20211019,2,0.9934535543968962,323,95,8,426
22816,bright,main,20211019,3,0.9929246530239527,292,96,4,392
22816,bright,main,20211019,4,0.9917099206851371,285,113,4,402
22816,bright,main,20211019,5,0.9935339259844049,269,140,4,413
22816,bright,main,20211019,6,0.9913389013836984,318,100,1,419
22816,bright,main,20211019,7,0.9953844069121977,269,89,5,363
22816,bright,main,20211019,8,0.9949100550900934,337,68,8,413
22816,bright,main,20211019,9,0.9921061185754205,323,91,8,422
25019,bright,main,20211019,0,0.9918963331249273,373,59,3,435
25019,bright,main,20211019,1,0.9858424523867231,288,81,4,373
25019,bright,main,20211019,2,0.9943969277500438,306,115,10,431
25019,bright,main,20211019,3,0.9903218607901227,288,74,8,370
25019,bright,main,20211019,4,0.9893425401989066,294,61,1,356
25019,bright,main,20211019,5,0.9949827499822399,340,61,5,406
25019,bright,main,20211019,6,0.9927275711755359,346,73,3,422
25019,bright,main,20211019,7,0.9959664498497868,301,64,6,371
25019,bright,main,20211019,8,0.9957386239247885,317,102,3,422
25019,bright,main,20211019,9,0.9963416096302953,348,71,2,421
24080,bright,main,20211019,0,0.9926420981817873,368,70,3,441
24080,bright,main,20211019,1,0.9935938688336563,302,70,4,376
24080,bright,main,20211019,2,0.9927856811614855,322,106,4,432
24080,bright,main,20211019,3,0.9958029528231613,268,120,5,393
24080,bright,main,20211019,4,0.9917013083909795,302,101,2,405
24080,bright,main,20211019,5,0.9938600181956762,316,91,3,410
24080,bright,main,20211019,6,0.9894871328866714,331,82,7,420
24080,bright,main,20211019,7,0.9971749604092318,314,50,1,365
24080,bright,main,20211019,8,0.9912593563659309,349,56,5,410
24080,bright,main,20211019,9,0.9915193327272201,345,74,2,421
24565,bright,main,20211019,0,0.9911259295070076,365,61,5,431
24565,bright,main,20211019,1,0.9928727373173797,313,48,5,366
24565,bright,main,20211019,2,0.9929178372833092,347,75,7,429
24565,bright,main,20211019,3,0.9936964111136979,281,93,4,378
24565,bright,main,20211019,4,0.9855568289344064,297,81,4,382
24565,bright,main,20211019,5,0.9949674167653962,276,119,7,402
24565,bright,main,20211019,6,0.9890618391375213,315,94,6,415
24565,bright,main,20211019,7,0.9889208179582821,264,84,4,352
24565,bright,main,20211019,8,0.9936136411551457,337,69,2,408
24565,bright,main,20211019,9,0.9957176792673873,343,63,5,411
21312,bright,main,20211019,0,0.9942371750003514,330,96,8,434
21312,bright,main,20211019,1,0.9913143942458169,280,93,4,377
21312,bright,main,20211019,2,0.9953071337602358,313,114,3,430
21312,bright,main,20211019,3,0.9895210379960374,268,117,8,393
21312,bright,main,20211019,4,0.990946230788099,263,132,3,398
21312,bright,main,20211019,5,0.9861219198775123,313,99,1,413
21312,bright,main,20211019,6,0.9947978869804784,308,114,7,429
21312,bright,main,20211019,7,0.9906199232237763,261,103,6,370
21312,bright,main,20211019,8,0.9919812732240403,324,75,7,406
21312,bright,main,20211019,9,0.9836031542100878,321,99,7,427
26178,bright,main,20211019,0,0.9910907847024447,361,71,4,436
26178,bright,main,20211019,1,0.9918907966641429,316,53,2,371
26178,bright,main,20211019,2,0.9952559351901527,378,49,5,432
26178,bright,main,20211019,3,0.9906050342480621,328,55,7,390
26178,bright,main,20211019,4,0.9936989773599103,329,66,1,396
26178,bright,main,20211019,5,0.9889673150209773,328,80,4,412
26178,bright,main,20211019,6,0.9936272268697862,355,63,3,421
26178,bright,main,20211019,7,0.9889929246045907,305,57,6,368
26178,bright,main,20211019,8,0.9963479721300375,335,77,3,415
26178,bright,main,20211019,9,0.9920890062492845,365,56,7,428
24562,bright,main,20211019,0,0.9941531677716363,375,51,2,428
24562,bright,main,20211019,1,0.9930318752509256,305,43,2,350
24562,bright,main,20211019,2,0.9949875345019229,345,61,7,413
24562,bright,main,20211019,3,0.9915631652745021,313,47,7,367
24562,bright,main,20211019,4,0.9891187578481845,310,61,2,373
24562,bright,main,20211019,5,0.9903075558468826,297,90,9,396
24562,bright,main,20211019,6,0.9942144379948824,345,55,4,404
24562,bright,main,20211019,7,0.9951964481568746,297,49,4,350
24562,bright,main,20211019,8,0.9938837492365186,353,52,3,408
24562,bright,main,20211019,9,0.9949747414490148,381,37,4,422
26264,bright,main,20211019,0,0.9937897101741376,322,114,6,442
26264,bright,main,20211019,1,0.9806019166161795,292,70,3,365
26264,bright,main,20211019,2,0.9932335697878122,307,122,3,432
26264,bright,main,20211019,3,0.992905216933841,289,104,2,395
26264,bright,main,20211019,4,0.9930837494572111,303,91,4,398
26264,bright,main,20211019,5,0.9908309114493231,284,123,7,414
26264,bright,main,20211019,6,0.9872919871782679,335,85,5,425
26264,bright,main,20211019,7,0.9818312200377219,279,84,7,370
26264,bright,main,20211019,8,0.9929695238533448,334,84,5,423
26264,bright,main,20211019,9,0.9849427339358909,352,64,4,420
22510,bright,main,20211019,0,0.9936462047029517,352,78,2,432
22510,bright,main,20211019,1,0.9941506967148444,291,83,0,374
22510,bright,main,20211019,2,0.9910199879909235,354,81,4,439
22510,bright,main,20211019,3,0.9881877981676631,302,82,4,388
22510,bright,main,20211019,4,0.9914627331942483,333,62,4,399
22510,bright,main,20211019,5,0.9862682760544026,333,78,3,414
22510,bright,main,20211019,6,0.9907153395799397,313,103,6,422
22510,bright,main,20211019,7,0.9912669454959088,268,89,6,363
22510,bright,main,20211019,8,0.9866388143285819,325,87,10,422
22510,bright,main,20211019,9,0.9953625460833556,331,86,8,425
22373,bright,main,20211020,0,0.9860093012061695,337,97,1,435
22373,bright,main,20211020,1,0.9892776353641045,283,88,6,377
22373,bright,main,20211020,2,0.994622566708893,293,141,4,438
22373,bright,main,20211020,3,0.9967798021921772,268,120,7,395
22373,bright,main,20211020,4,0.9964355116440109,287,119,3,409
22373,bright,main,20211020,5,0.9960318181400805,331,80,4,415
22373,bright,main,20211020,6,0.991252867750707,318,109,4,431
22373,bright,main,20211020,7,0.9874876573727687,222,151,2,375
22373,bright,main,20211020,8,0.9910702973352337,269,154,2,425
22373,bright,main,20211020,9,0.9914897279594856,291,131,7,429
21241,bright,main,20211020,0,0.993433180300561,365,72,2,439
21241,bright,main,20211020,1,0.985465623837886,313,59,2,374
21241,bright,main,20211020,2,0.9873514054934688,373,51,5,429
21241,bright,main,20211020,3,0.9908853012335815,332,57,2,391
21241,bright,main,20211020,4,0.9882446875283621,326,71,8,405
21241,bright,main,20211020,5,0.9935861905643129,340,62,5,407
21241,bright,main,20211020,6,0.9957358974058197,362,60,2,424
21241,bright,main,20211020,7,0.9858334631198864,286,75,4,365
21241,bright,main,20211020,8,0.9926965078924368,316,96,3,415
21241,bright,main,20211020,9,0.9942794113587674,324,92,5,421
25543,bright,main,20211020,0,0.9945034381228662,384,53,4,441
25543,bright,main,20211020,1,0.9889797634386689,317,60,1,378
25543,bright,main,20211020,2,0.9915511432392844,355,77,5,437
25543,bright,main,20211020,3,0.989291231422331,305,88,4,397
25543,bright,main,20211020,4,0.9860386252817039,312,89,9,410
25543,bright,main,20211020,5,0.9943142098302571,311,99,5,415
25543,bright,main,20211020,6,0.9948507234908048,296,128,3,427
25543,bright,main,20211020,7,0.9921862475495827,265,103,4,372
25543,bright,main,20211020,8,0.9952040841378409,333,90,4,427
25543,bright,main,20211020,9,0.9939550826325639,335,91,5,431
22143,bright,main,20211020,0,0.997808112826752,331,103,2,436
22143,bright,main,20211020,1,0.9949042881978485,281,92,4,377
22143,bright,main,20211020,2,0.9945398160532205,336,94,3,433
22143,bright,main,20211020,3,0.995308289654401,289,107,2,398
22143,bright,main,20211020,4,0.9873193137184414,284,123,3,410
22143,bright,main,20211020,5,0.9912052568371459,285,130,5,420
22143,bright,main,20211020,6,0.9909516529435476,334,95,4,433
22143,bright,main,20211020,7,0.9900368572225237,274,88,6,368
22143,bright,main,20211020,8,0.9946011111158478,302,114,7,423
22143,bright,main,20211020,9,0.9966666635877743,335,88,4,427
22715,bright,main,20211020,0,0.9909197853254343,361,78,2,441
22715,bright,main,20211020,1,0.9933955864853541,264,100,8,372
22715,bright,main,20211020,2,0.9960447418118272,338,101,2,441
22715,bright,main,20211020,3,0.9945823789276954,316,80,3,399
22715,bright,main,20211020,4,0.9906224262604414,328,80,3,411
22715,bright,main,20211020,5,0.9939151783788589,286,123,7,416
22715,bright,main,20211020,6,0.9883134951730765,283,145,3,431
22715,bright,main,20211020,7,0.987535130077632,248,125,2,375
22715,bright,main,20211020,8,0.9919558870147496,310,110,6,426
22715,bright,main,20211020,9,0.9966470544975415,322,106,4,432
26082,bright,main,20211020,0,0.9942628032843004,319,116,6,441
26082,bright,main,20211020,1,0.987917677226379,290,83,5,378
26082,bright,main,20211020,2,0.9892582166920629,343,89,4,436
26082,bright,main,20211020,3,0.9875756377510007,331,60,5,396
26082,bright,main,20211020,4,0.9890014127095025,297,103,3,403
26082,bright,main,20211020,5,0.9930283401075443,312,100,7,419
26082,bright,main,20211020,6,0.9952037713001912,285,141,5,431
26082,bright,main,20211020,7,0.9936983376701793,265,105,2,372
26082,bright,main,20211020,8,0.9961731598354137,293,122,6,421
26082,bright,main,20211020,9,0.9900785113116088,323,100,2,425
23204,bright,main,20211020,0,0.9917978882320396,304,120,5,429
23204,bright,main,20211020,1,0.9899806695257221,236,137,2,375
23204,bright,main,20211020,2,0.9943114190062274,191,87,2,280
23204,bright,main,20211020,3,0.9902983897322956,275,96,1,372
23204,bright,main,20211020,4,0.9890572850214948,311,85,8,404
23204,bright,main,20211020,5,0.9923077369596581,320,79,4,403
23204,bright,main,20211020,6,0.9901386384577072,318,101,3,422
23204,bright,main,20211020,7,0.9908732467603526,263,107,3,373
23204,bright,main,20211020,8,0.9953757218572394,304,114,3,421
23204,bright,main,20211020,9,0.9940013253245784,310,112,3,425
24274,bright,main,20211020,0,0.995404363906334,334,89,4,427
24274,bright,main,20211020,1,0.9906346530818366,270,99,4,373
24274,bright,main,20211020,2,0.9901009861469984,322,107,3,432
24274,bright,main,20211020,3,0.9900204221058665,308,78,7,393
24274,bright,main,20211020,4,0.9941788150098811,343,57,4,404
24274,bright,main,20211020,5,0.9946944545493035,339,66,3,408
24274,bright,main,20211020,6,0.9940189162364477,352,75,4,431
24274,bright,main,20211020,7,0.9942851963224262,305,64,6,375
24274,bright,main,20211020,8,0.9924427887212485,334,83,6,423
24274,bright,main,20211020,9,0.9921616064812497,316,105,3,424
25690,bright,main,20211020,0,0.9929966205790896,392,39,3,434
25690,bright,main,20211020,1,0.988155012095286,317,51,7,375
25690,bright,main,20211020,2,0.9904566320651919,342,78,3,423
25690,bright,main,20211020,3,0.9955904128641506,323,67,6,396
25690,bright,main,20211020,4,0.9926790759293278,339,66,6,411
25690,bright,main,20211020,5,0.9914032311996541,366,46,0,412
25690,bright,main,20211020,6,0.9939896336422667,319,97,8,424
25690,bright,main,20211020,7,0.9932191483738205,287,88,2,377
25690,bright,main,20211020,8,0.992167917890122,306,113,5,424
25690,bright,main,20211020,9,0.9937294295443103,342,80,4,426
21309,bright,main,20211020,0,0.9926158667965387,317,108,5,430
21309,bright,main,20211020,1,0.9934199543763352,287,83,2,372
21309,bright,main,20211020,2,0.9939274335883416,338,83,4,425
21309,bright,main,20211020,3,0.9954037891833033,295,95,4,394
21309,bright,main,20211020,4,0.9929859262629834,308,97,2,407
21309,bright,main,20211020,5,0.9914610188844497,310,98,3,411
21309,bright,main,20211020,6,0.994495857969001,324,99,5,428
21309,bright,main,20211020,7,0.9875620708927735,259,106,5,370
21309,bright,main,20211020,8,0.9919736533683613,304,109,7,420
21309,bright,main,20211020,9,0.9960538501830181,312,110,3,425
25849,bright,main,20211020,0,0.9940142340463503,357,73,5,435
25849,bright,main,20211020,1,0.9907473721274016,263,103,5,371
25849,bright,main,20211020,2,0.9922663341466879,310,122,1,433
25849,bright,main,20211020,3,0.9858885714533634,315,78,7,400
25849,bright,main,20211020,4,0.9932618527077058,338,64,4,406
25849,bright,main,20211020,5,0.9928621314704438,334,71,2,407
25849,bright,main,20211020,6,0.9960600514477959,347,78,4,429
25849,bright,main,20211020,7,0.9886952328811658,303,60,3,366
25849,bright,main,20211020,8,0.9900442881368243,345,70,5,420
25849,bright,main,20211020,9,0.9950666271832785,341,76,5,422
24766,bright,main,20211020,0,0.9934988208379782,264,165,8,437
24766,bright,main,20211020,1,0.9945494928547756,224,153,2,379
24766,bright,main,20211020,2,0.9919496305952452,288,141,2,431
24766,bright,main,20211020,3,0.9957562085940975,306,85,2,393
24766,bright,main,20211020,4,0.9872866249869287,332,69,3,404
24766,bright,main,20211020,5,0.9883126503080634,301,103,3,407
24766,bright,main,20211020,6,0.9938624503129351,250,163,10,423
24766,bright,main,20211020,7,0.9946780833492561,250,118,7,375
24766,bright,main,20211020,8,0.9932277050551046,265,159,5,429
24766,bright,main,20211020,9,0.9910586237079391,312,108,3,423
21411,bright,main,20211020,0,0.9938665020863751,348,84,4,436
21411,bright,main,20211020,1,0.9939067748323384,288,84,5,377
21411,bright,main,20211020,2,0.9860240293665905,344,89,5,438
21411,bright,main,20211020,3,0.9968132399850437,310,84,6,400
21411,bright,main,20211020,4,0.9938545488231109,315,87,5,407
21411,bright,main,20211020,5,0.9926820478682236,310,91,8,409
21411,bright,main,20211020,6,0.9954532169777267,344,84,4,432
21411,bright,main,20211020,7,0.993973566932289,304,68,3,375
21411,bright,main,20211020,8,0.9930915600321837,352,62,8,422
21411,bright,main,20211020,9,0.991429039321058,351,67,3,421
25687,bright,main,20211020,0,0.9864757271233743,367,71,2,440
25687,bright,main,20211020,1,0.9909627422534981,333,43,2,378
25687,bright,main,20211020,2,0.9954960635131571,340,86,3,429
25687,bright,main,20211020,3,0.9857870264979949,325,64,7,396
25687,bright,main,20211020,4,0.9908935270688086,321,79,7,407
25687,bright,main,20211020,5,0.9908571031458854,347,59,9,415
25687,bright,main,20211020,6,0.9916081850069258,334,86,6,426
25687,bright,main,20211020,7,0.9908627192341789,310,61,4,375
25687,bright,main,20211020,8,0.9945142043417112,341,76,5,422
25687,bright,main,20211020,9,0.99363989854353,363,64,2,429
20865,bright,main,20211020,0,0.9931652348866492,312,113,7,432
20865,bright,main,20211020,1,0.9870811170111131,298,72,4,374
20865,bright,main,20211020,2,0.9939938423499255,321,103,7,431
20865,bright,main,20211020,3,0.993145888826511,295,101,1,397
20865,bright,main,20211020,4,0.990243037877103,318,83,3,404
20865,bright,main,20211020,5,0.9946481322148533,337,77,4,418
20865,bright,main,20211020,6,0.9937787331188621,334,92,3,429
20865,bright,main,20211020,7,0.9942988472729177,279,89,4,372
20865,bright,main,20211020,8,0.9877223667031126,323,92,2,417
20865,bright,main,20211020,9,0.9917994663649097,295,124,1,420
22375,bright,main,20211020,0,0.992764545749412,240,196,4,440
22375,bright,main,20211020,1,0.9896987595410742,267,99,9,375
22375,bright,main,20211020,2,0.9980111893601605,312,120,5,437
22375,bright,main,20211020,3,0.9944988725582439,299,96,3,398
22375,bright,main,20211020,4,0.9885053481187329,314,89,4,407
22375,bright,main,20211020,5,0.9937104925345807,295,113,7,415
22375,bright,main,20211020,6,0.9952831978596708,304,127,1,432
22375,bright,main,20211020,7,0.9937764349013912,290,82,2,374
22375,bright,main,20211020,8,0.997199654403738,319,101,2,422
22375,bright,main,20211020,9,0.9948684856890494,220,200,5,425
22982,bright,main,20211020,0,0.9872784446013974,323,110,4,437
22982,bright,main,20211020,1,0.9913700048946372,298,89,1,388
22982,bright,main,20211020,2,0.9847860535652285,339,91,5,435
22982,bright,main,20211020,3,0.9934942908917228,339,57,3,399
22982,bright,main,20211020,4,0.9888137722263007,347,66,3,416
22982,bright,main,20211020,5,0.9929186987559495,349,68,3,420
22982,bright,main,20211020,6,0.9925976287050229,355,75,5,435
22982,bright,main,20211020,7,0.9965827329655642,299,73,5,377
22982,bright,main,20211020,8,0.9896757797262122,315,108,3,426
22982,bright,main,20211020,9,0.9923963708945659,347,82,4,433
21233,bright,main,20211020,0,0.9948457338929884,309,109,9,427
21233,bright,main,20211020,1,0.9884277229170015,271,80,3,354
21233,bright,main,20211020,2,0.9910346120406861,358,75,3,436
21233,bright,main,20211020,3,0.9932067850620468,308,70,6,384
21233,bright,main,20211020,4,0.9933759813666053,330,56,8,394
21233,bright,main,20211020,5,0.9961487273998882,313,86,3,402
21233,bright,main,20211020,6,0.9908658213573585,323,85,3,411
21233,bright,main,20211020,7,0.9889200512809013,260,100,0,360
21233,bright,main,20211020,8,0.9907336555572732,272,124,7,403
21233,bright,main,20211020,9,0.9890386704191811,293,108,8,409
21270,bright,main,20211020,0,0.9937590582589015,317,113,5,435
21270,bright,main,20211020,1,0.9862292757780188,297,70,2,369
21270,bright,main,20211020,2,0.9947589208647329,373,58,2,433
21270,bright,main,20211020,3,0.990246403451013,343,45,7,395
21270,bright,main,20211020,4,0.9886319122700933,303,87,10,400
21270,bright,main,20211020,5,0.9906472184334495,322,84,4,410
21270,bright,main,20211020,6,0.991951348673655,372,48,5,425
21270,bright,main,20211020,7,0.9955382032917381,288,81,2,371
21270,bright,main,20211020,8,0.9894464431458264,354,66,4,424
21270,bright,main,20211020,9,0.9927063193499489,323,101,1,425
22786,bright,main,20211020,0,0.9916547799915252,335,88,4,427
22786,bright,main,20211020,1,0.9932189947917752,287,69,3,359
22786,bright,main,20211020,2,0.9956112033376677,338,75,7,420
22786,bright,main,20211020,3,0.992754885778218,290,100,4,394
22786,bright,main,20211020,4,0.9917231967914402,293,99,2,394
22786,bright,main,20211020,5,0.9902728357136811,296,105,6,407
22786,bright,main,20211020,6,0.9948088636245046,332,79,4,415
22786,bright,main,20211020,7,0.9859616662024956,282,73,6,361
22786,bright,main,20211020,8,0.9903705806353132,310,95,5,410
22786,bright,main,20211020,9,0.9893875829978616,302,94,7,403
22116,bright,main,20211020,0,0.9911722757194311,344,72,3,419
22116,bright,main,20211020,1,0.9945541084950345,296,55,5,356
22116,bright,main,20211020,2,0.9940289791479651,330,80,8,418
22116,bright,main,20211020,3,0.9928101659033224,317,53,6,376
22116,bright,main,20211020,4,0.9927127120770902,325,57,6,388
22116,bright,main,20211020,5,0.9909113371449497,335,53,4,392
22116,bright,main,20211020,6,0.9893720450599933,351,56,6,413
22116,bright,main,20211020,7,0.9924453207084241,304,49,6,359
22116,bright,main,20211020,8,0.994872615666667,326,63,4,393
22116,bright,main,20211020,9,0.9949158394496133,320,66,3,389
25848,bright,main,20211020,0,0.9950103512152014,367,51,8,426
25848,bright,main,20211020,1,0.9874864807113267,284,88,3,375
25848,bright,main,20211020,2,0.9957659599852658,314,115,3,432
25848,bright,main,20211020,3,0.9836795729563323,333,60,4,397
25848,bright,main,20211020,4,0.993093860976907,323,77,2,402
25848,bright,main,20211020,5,0.9917867570873536,351,52,5,408
25848,bright,main,20211020,6,0.9925056524312502,345,78,4,427
25848,bright,main,20211020,7,0.9934573612939054,316,55,5,376
25848,bright,main,20211020,8,0.9956443740427133,359,64,5,428
25848,bright,main,20211020,9,0.9950454642680986,345,66,4,415
23669,bright,main,20211020,0,0.9927601467659769,332,77,7,416
23669,bright,main,20211020,1,0.9944977042331666,287,58,10,355
23669,bright,main,20211020,2,0.9965947346003653,361,61,3,425
23669,bright,main,20211020,3,0.9928948915318392,287,85,6,378
23669,bright,main,20211020,4,0.9928848446981644,312,72,2,386
23669,bright,main,20211020,5,0.9941074593291163,332,69,4,405
23669,bright,main,20211020,6,0.991372983061633,315,85,5,405
23669,bright,main,20211020,7,0.9918751593997442,291,62,1,354
23669,bright,main,20211020,8,0.9889920284366233,324,69,6,399
23669,bright,main,20211020,9,0.9950739800949444,346,61,5,412
22835,bright,main,20211020,0,0.9934726675139351,334,90,4,428
22835,bright,main,20211020,1,0.9918681890857625,263,102,4,369
22835,bright,main,20211020,2,0.9865269237141897,340,93,1,434
22835,bright,main,20211020,3,0.9949296721200996,311,81,1,393
22835,bright,main,20211020,4,0.9923718229493687,329,68,6,403
22835,bright,main,20211020,5,0.9858365024520902,312,89,5,406
22835,bright,main,20211020,6,0.995137525488596,334,80,7,421
22835,bright,main,20211020,7,0.9964241314628645,280,80,4,364
22835,bright,main,20211020,8,0.9975372751894337,320,83,6,409
22835,bright,main,20211020,9,0.9870705792681295,346,71,10,427
26253,bright,main,20211020,0,0.9889821253196986,309,124,4,437
26253,bright,main,20211020,1,0.9934003601448228,285,88,5,378
26253,bright,main,20211020,2,0.9888640602294108,336,103,4,443
26253,bright,main,20211020,3,0.9916550649091891,320,71,7,398
26253,bright,main,20211020,4,0.9909137213628492,321,86,2,409
26253,bright,main,20211020,5,0.9934142440171835,344,70,3,417
26253,bright,main,20211020,6,0.9911123857786015,350,84,2,436
26253,bright,main,20211020,7,0.9890691696049304,292,75,7,374
26253,bright,main,20211020,8,0.9950380547183583,280,143,5,428
26253,bright,main,20211020,9,0.9853623398365042,339,86,5,430
22545,bright,main,20211021,0,0.9926222890437835,370,53,5,428
22545,bright,main,20211021,1,0.9909586535636625,308,69,2,379
22545,bright,main,20211021,2,0.9920478396734325,356,73,9,438
22545,bright,main,20211021,3,0.989021680660821,337,50,4,391
22545,bright,main,20211021,4,0.9939470746039719,332,61,5,398
22545,bright,main,20211021,5,0.9936687759748459,343,64,3,410
22545,bright,main,20211021,6,0.9906446942084272,361,64,3,428
22545,bright,main,20211021,7,0.98596325455881,278,82,5,365
22545,bright,main,20211021,8,0.9936940946053334,355,66,1,422
22545,bright,main,20211021,9,0.9913639939278966,358,68,2,428
25656,bright,main,20211021,0,0.9934645668476348,376,53,3,432
25656,bright,main,20211021,1,0.9877445408583007,290,75,4,369
25656,bright,main,20211021,2,0.9938314329701465,324,100,6,430
25656,bright,main,20211021,3,0.983394557303033,278,107,3,388
25656,bright,main,20211021,4,0.9961892171301088,304,97,6,407
25656,bright,main,20211021,5,0.9929503601874525,305,97,5,407
25656,bright,main,20211021,6,0.9881541350740617,291,137,3,431
25656,bright,main,20211021,7,0.9908926361882285,262,111,3,376
25656,bright,main,20211021,8,0.9896785250386844,292,122,3,417
25656,bright,main,20211021,9,0.9914510521823331,362,63,3,428
24365,bright,main,20211021,0,0.9931474515096181,341,89,6,436
24365,bright,main,20211021,1,0.9944584572006243,265,101,2,368
24365,bright,main,20211021,2,0.991273656958163,357,72,3,432
24365,bright,main,20211021,3,0.9925689551385879,303,77,6,386
24365,bright,main,20211021,4,0.9895900233490744,328,68,4,400
24365,bright,main,20211021,5,0.9928287822136692,334,67,1,402
24365,bright,main,20211021,6,0.9937435821706866,314,105,5,424
24365,bright,main,20211021,7,0.9938154713113334,295,62,12,369
24365,bright,main,20211021,8,0.9905272178191086,346,66,6,418
24365,bright,main,20211021,9,0.9931591242937302,348,59,7,414
25547,bright,main,20211021,0,0.9941201219130461,368,60,1,429
25547,bright,main,20211021,1,0.9919666621880758,271,104,3,378
25547,bright,main,20211021,2,0.9926808155457597,329,101,6,436
25547,bright,main,20211021,3,0.9885441353402674,318,78,4,400
25547,bright,main,20211021,4,0.9925247302216582,278,121,9,408
25547,bright,main,20211021,5,0.991269782102837,293,115,5,413
25547,bright,main,20211021,6,0.9906204250814818,342,86,4,432
25547,bright,main,20211021,7,0.9911058189971971,286,88,5,379
25547,bright,main,20211021,8,0.9900647784027302,333,76,5,414
25547,bright,main,20211021,9,0.9930013760893652,339,73,4,416
23668,bright,main,20211021,0,0.9919174877662666,338,66,9,413
23668,bright,main,20211021,1,0.9916237171476068,298,52,7,357
23668,bright,main,20211021,2,0.9928164964186444,338,77,6,421
23668,bright,main,20211021,3,0.9926496675002792,287,78,7,372
23668,bright,main,20211021,4,0.9902093703301148,294,80,3,377
23668,bright,main,20211021,5,0.9939652381965195,327,61,5,393
23668,bright,main,20211021,6,0.9881873867691648,341,66,5,412
23668,bright,main,20211021,7,0.9920199495236977,288,70,2,360
23668,bright,main,20211021,8,0.9907149099889059,359,56,2,417
23668,bright,main,20211021,9,0.9913522223077834,317,80,3,400
21246,bright,main,20211021,0,0.9922609340611088,344,74,3,421
21246,bright,main,20211021,1,0.993187144550903,282,71,2,355
21246,bright,main,20211021,2,0.9887690338952534,354,66,7,427
21246,bright,main,20211021,3,0.9885715620085883,286,81,4,371
21246,bright,main,20211021,4,0.9884090581067383,305,78,4,387
21246,bright,main,20211021,5,0.9916715516819442,325,75,1,401
21246,bright,main,20211021,6,0.9946999066414394,302,84,12,398
21246,bright,main,20211021,7,0.9933537113251873,293,58,6,357
21246,bright,main,20211021,8,0.9920251371360517,303,86,6,395
21246,bright,main,20211021,9,0.9936176394816923,308,96,2,406
22532,bright,main,20211021,0,0.9956551188943823,319,104,8,431
22532,bright,main,20211021,1,0.9906215620262949,287,82,4,373
22532,bright,main,20211021,2,0.9916884714543546,325,105,3,433
22532,bright,main,20211021,3,0.987993783421133,277,111,7,395
22532,bright,main,20211021,4,0.9910591300508573,313,89,2,404
22532,bright,main,20211021,5,0.99270039622661,319,92,6,417
22532,bright,main,20211021,6,0.9934967825016248,321,106,3,430
22532,bright,main,20211021,7,0.9933554198222936,311,61,3,375
22532,bright,main,20211021,8,0.9911900662519885,361,62,3,426
22532,bright,main,20211021,9,0.9889299372181322,341,78,2,421
25242,bright,main,20211021,0,0.9952977232788724,340,83,4,427
25242,bright,main,20211021,1,0.9913869612477225,307,52,7,366
25242,bright,main,20211021,2,0.9948524521346389,346,76,4,426
25242,bright,main,20211021,3,0.9894654793050061,300,70,7,377
25242,bright,main,20211021,4,0.9949939010021267,316,72,3,391
25242,bright,main,20211021,5,0.9856489394178812,319,71,5,395
25242,bright,main,20211021,6,0.9893681317744772,354,67,6,427
25242,bright,main,20211021,7,0.9900332933764913,298,50,5,353
25242,bright,main,20211021,8,0.9971715852497878,336,67,9,412
25242,bright,main,20211021,9,0.9914538634690979,354,65,4,423
24071,bright,main,20211021,0,0.9923514133538328,325,102,10,437
24071,bright,main,20211021,1,0.990433124408222,284,81,2,367
24071,bright,main,20211021,2,0.9901749700829421,348,82,6,436
24071,bright,main,20211021,3,0.987888255055489,292,93,4,389
24071,bright,main,20211021,4,0.9934765969231358,293,106,5,404
24071,bright,main,20211021,5,0.9928946140012772,306,103,5,414
24071,bright,main,20211021,6,0.9953168506078016,315,113,3,431
24071,bright,main,20211021,7,0.9871666238053486,259,107,2,368
24071,bright,main,20211021,8,0.9897779563771854,330,84,7,421
24071,bright,main,20211021,9,0.9885771136704138,312,101,8,421
22932,bright,main,20211021,0,0.9922335576455318,340,90,4,434
22932,bright,main,20211021,1,0.9915750214082681,274,91,6,371
22932,bright,main,20211021,2,0.9882462192484587,362,71,5,438
22932,bright,main,20211021,3,0.9965989039788752,332,57,5,394
22932,bright,main,20211021,4,0.9920388490196076,338,63,3,404
22932,bright,main,20211021,5,0.9944630476832165,369,38,6,413
22932,bright,main,20211021,6,0.9940260787533919,356,64,7,427
22932,bright,main,20211021,7,0.9816053806251551,302,62,3,367
22932,bright,main,20211021,8,0.9928892673953768,319,95,3,417
22932,bright,main,20211021,9,0.9922615358699017,295,124,3,422
22929,bright,main,20211021,0,0.9873139617257709,337,96,5,438
22929,bright,main,20211021,1,0.9898261654983073,304,70,1,375
22929,bright,main,20211021,2,0.9857363181306272,327,105,2,434
22929,bright,main,20211021,3,0.9944036731556025,297,89,7,393
22929,bright,main,20211021,4,0.9894241459861811,291,104,3,398
22929,bright,main,20211021,5,0.9908298009680373,348,66,2,416
22929,bright,main,20211021,6,0.9951398903857426,345,82,6,433
22929,bright,main,20211021,7,0.9964485103645323,300,57,6,363
22929,bright,main,20211021,8,0.9931879362234889,327,94,7,428
22929,bright,main,20211021,9,0.994064095821998,315,100,9,424
25686,bright,main,20211021,0,0.9944271159951097,390,48,3,441
25686,bright,main,20211021,1,0.9919171976946731,324,48,4,376
25686,bright,main,20211021,2,0.9950819046178635,363,64,3,430
25686,bright,main,20211021,3,0.9935261530479951,319,75,2,396
25686,bright,main,20211021,4,0.9931950417660282,303,93,9,405
25686,bright,main,20211021,5,0.9959236184197084,338,73,4,415
25686,bright,main,20211021,6,0.9941764828499666,329,101,5,435
25686,bright,main,20211021,7,0.9917357627568543,271,96,3,370
25686,bright,main,20211021,8,0.9926987524540387,346,76,4,426
25686,bright,main,20211021,9,0.9938855897078508,336,82,8,426
24481,bright,main,20211021,0,0.9933143326824624,325,109,4,438
24481,bright,main,20211021,1,0.9922600463577962,287,89,5,381
24481,bright,main,20211021,2,0.9918877322659199,351,78,4,433
24481,bright,main,20211021,3,0.9924978844059734,290,97,7,394
24481,bright,main,20211021,4,0.9929807167109926,280,115,3,398
24481,bright,main,20211021,5,0.9905523827579962,339,74,3,416
24481,bright,main,20211021,6,0.992032574162382,313,105,5,423
24481,bright,main,20211021,7,0.9874393190009458,257,100,5,362
24481,bright,main,20211021,8,0.9924555303574116,321,86,7,414
24481,bright,main,20211021,9,0.9907353065052644,316,103,3,422
21310,bright,main,20211021,0,0.9921899007149216,343,93,4,440
21310,bright,main,20211021,1,0.9906538568426699,308,59,8,375
21310,bright,main,20211021,2,0.9898386374059682,359,71,3,433
21310,bright,main,20211021,3,0.9943085866203505,301,84,2,387
21310,bright,main,20211021,4,0.9918361845977605,321,82,5,408
21310,bright,main,20211021,5,0.9939257989138789,333,78,1,412
21310,bright,main,20211021,6,0.990756082122311,335,93,3,431
21310,bright,main,20211021,7,0.9891022617953397,278,88,7,373
21310,bright,main,20211021,8,0.9932171174866496,291,120,2,413
21310,bright,main,20211021,9,0.9952337574542068,313,108,3,424
22088,bright,main,20211021,0,0.9860842293605747,355,65,5,425
22088,bright,main,20211021,1,0.9904240617511177,305,55,11,371
22088,bright,main,20211021,2,0.9833950326397503,340,85,5,430
22088,bright,main,20211021,3,0.9887786197085667,304,70,7,381
22088,bright,main,20211021,4,0.9920857714836632,324,63,2,389
22088,bright,main,20211021,5,0.9857766290442626,312,79,6,397
22088,bright,main,20211021,6,0.9892112221913045,348,63,7,418
22088,bright,main,20211021,7,0.9890153352988494,301,59,4,364
22088,bright,main,20211021,8,0.986279036256786,337,67,3,407
22088,bright,main,20211021,9,0.9944567268245461,348,65,5,418
25236,bright,main,20211021,0,0.9936258680020944,321,93,5,419
25236,bright,main,20211021,1,0.9908546923372294,281,78,7,366
25236,bright,main,20211021,2,0.9922953603226755,323,89,8,420
25236,bright,main,20211021,3,0.9916074285840691,290,81,2,373
25236,bright,main,20211021,4,0.9908628519068395,304,83,8,395
25236,bright,main,20211021,5,0.9934021967141936,324,71,7,402
25236,bright,main,20211021,6,0.9959685655514368,339,75,8,422
25236,bright,main,20211021,7,0.9951937599977738,299,62,5,366
25236,bright,main,20211021,8,0.9923946220885302,328,74,6,408
25236,bright,main,20211021,9,0.9941162906032563,322,87,5,414
22544,bright,main,20211021,0,0.9946141074458589,362,75,2,439
22544,bright,main,20211021,1,0.986019068229981,318,50,7,375
22544,bright,main,20211021,2,0.9927038210371032,341,90,6,437
22544,bright,main,20211021,3,0.9918583264806567,322,76,0,398
22544,bright,main,20211021,4,0.9883046979881916,318,81,3,402
22544,bright,main,20211021,5,0.9929352300662975,322,89,6,417
22544,bright,main,20211021,6,0.9942492778153417,318,71,3,392
22544,bright,main,20211021,7,0.9877265128206685,281,90,4,375
22544,bright,main,20211021,8,0.9911900382691964,310,105,8,423
22544,bright,main,20211021,9,0.9907457213429902,329,92,6,427
25568,bright,main,20211021,0,0.9920542196160012,365,69,4,438
25568,bright,main,20211021,1,0.9927537889659339,261,107,2,370
25568,bright,main,20211021,2,0.987300060114017,358,73,4,435
25568,bright,main,20211021,3,0.9862098252550507,313,76,3,392
25568,bright,main,20211021,4,0.9920950487323524,331,70,4,405
25568,bright,main,20211021,5,0.991935585027896,334,75,3,412
25568,bright,main,20211021,6,0.9927003289623633,349,73,7,429
25568,bright,main,20211021,7,0.9940289808500529,282,80,5,367
25568,bright,main,20211021,8,0.9903332768619599,324,86,8,418
25568,bright,main,20211021,9,0.990932117473894,303,114,5,422
25562,bright,main,20211021,0,0.9898062453327818,330,104,4,438
25562,bright,main,20211021,1,0.9910081552741045,280,86,5,371
25562,bright,main,20211021,2,0.9945867497275509,344,92,5,441
25562,bright,main,20211021,3,0.990649960472566,312,77,6,395
25562,bright,main,20211021,4,0.993591579365579,329,70,3,402
25562,bright,main,20211021,5,0.9910613663321572,295,115,4,414
25562,bright,main,20211021,6,0.9938480664697195,306,121,3,430
25562,bright,main,20211021,7,0.9952495872044175,273,87,4,364
25562,bright,main,20211021,8,0.989284685385324,325,97,2,424
25562,bright,main,20211021,9,0.9936973602564552,328,91,5,424
25691,bright,main,20211021,0,0.9902047900008626,375,57,2,434
25691,bright,main,20211021,1,0.9959591366218403,300,72,3,375
25691,bright,main,20211021,2,0.9864279488977159,332,99,4,435
25691,bright,main,20211021,3,0.9924681314655964,304,88,1,393
25691,bright,main,20211021,4,0.9907455350820868,358,44,2,404
25691,bright,main,20211021,5,0.9934811143557074,320,92,3,415
25691,bright,main,20211021,6,0.9932879143227619,358,73,2,433
25691,bright,main,20211021,7,0.9886579958204674,299,68,2,369
25691,bright,main,20211021,8,0.9949510609560335,339,83,7,429
25691,bright,main,20211021,9,0.9842245524478516,348,74,5,427
22417,bright,main,20211021,0,0.9940802033165116,372,64,4,440
22417,bright,main,20211021,1,0.991655531895997,313,62,4,379
22417,bright,main,20211021,2,0.9912734724709075,318,113,5,436
22417,bright,main,20211021,3,0.9917184459594744,280,111,6,397
22417,bright,main,20211021,4,0.9875677613542209,314,90,3,407
22417,bright,main,20211021,5,0.9895638262552997,286,127,3,416
22417,bright,main,20211021,6,0.9944646063391387,284,146,3,433
22417,bright,main,20211021,7,0.9911350305008707,289,80,5,374
22417,bright,main,20211021,8,0.9910867201633659,344,74,5,423
22417,bright,main,20211021,9,0.9905604581156523,333,87,5,425
25230,bright,main,20211021,0,0.9936805157506974,338,78,7,423
25230,bright,main,20211021,1,0.9939428434786038,293,67,4,364
25230,bright,main,20211021,2,0.9932358930809483,339,88,2,429
25230,bright,main,20211021,3,0.9872163812276763,324,64,4,392
25230,bright,main,20211021,4,0.9923024816289613,351,39,6,396
25230,bright,main,20211021,5,0.9850568861907372,328,72,2,402
25230,bright,main,20211021,6,0.9891455072730784,339,67,6,412
25230,bright,main,20211021,7,0.986751398105743,294,64,4,362
25230,bright,main,20211021,8,0.9935084807722113,341,65,5,411
25230,bright,main,20211021,9,0.990378996472705,349,58,5,412
20528,bright,main,20211021,0,0.9922070056351566,347,82,4,433
20528,bright,main,20211021,1,0.9875728601494898,273,92,3,368
20528,bright,main,20211021,2,0.9830857861507691,353,72,6,431
20528,bright,main,20211021,3,0.9916621822645031,309,70,8,387
20528,bright,main,20211021,4,0.9857709024991449,317,71,5,393
20528,bright,main,20211021,5,0.9874374033441583,339,66,2,407
20528,bright,main,20211021,6,0.9930129885185255,340,81,7,428
20528,bright,main,20211021,7,0.9920137817754292,281,83,5,369
20528,bright,main,20211021,8,0.9904719174470586,304,103,2,409
20528,bright,main,20211021,9,0.9920115640432575,315,104,3,422
25932,bright,main,20211021,0,0.9910025302400038,347,72,6,425
25932,bright,main,20211021,1,0.9932596899553893,279,73,5,357
25932,bright,main,20211021,2,0.9916047473300796,357,63,6,426
25932,bright,main,20211021,3,0.9914795751662473,306,60,9,375
25932,bright,main,20211021,4,0.9940802370800185,302,74,11,387
25932,bright,main,20211021,5,0.9885545526113318,335,64,4,403
25932,bright,main,20211021,6,0.990308696840851,338,65,3,406
25932,bright,main,20211021,7,0.9923166826964873,297,59,3,359
25932,bright,main,20211021,8,0.9924736542604029,346,63,3,412
25932,bright,main,20211021,9,0.9940814946896053,320,82,6,408
24515,bright,main,20211021,0,0.9869995883822507,356,71,9,436
24515,bright,main,20211021,1,0.9953197671782349,320,55,2,377
24515,bright,main,20211021,2,0.9862274056694621,322,107,3,432
24515,bright,main,20211021,3,0.9955076518270399,255,136,5,396
24515,bright,main,20211021,4,0.9900274856793232,321,73,5,399
24515,bright,main,20211021,5,0.9941257545291201,327,81,3,411
24515,bright,main,20211021,6,0.993171193467685,361,63,1,425
24515,bright,main,20211021,7,0.988801850790386,263,104,5,372
24515,bright,main,20211021,8,0.9946236004251777,272,144,6,422
24515,bright,main,20211021,9,0.9948890191371511,323,97,4,424
23677,bright,main,20211021,0,0.9949656970637304,321,90,2,413
23677,bright,main,20211021,1,0.9832612819420523,291,63,2,356
23677,bright,main,20211021,2,0.9937404728816988,345,78,2,425
23677,bright,main,20211021,3,0.9940275048241562,278,91,1,370
23677,bright,main,20211021,4,0.996908110835739,321,65,3,389
23677,bright,main,20211021,5,0.9906977847345236,325,59,4,388
23677,bright,main,20211021,6,0.9886690412811944,328,82,2,412
23677,bright,main,20211021,7,0.9841872167532787,278,71,5,354
23677,bright,main,20211021,8,0.9944562141180163,320,74,4,398
23677,bright,main,20211021,9,0.9942060365462811,300,92,6,398
20971,bright,main,20211022,0,0.9916987608409469,354,78,3,435
20971,bright,main,20211022,1,0.9956512651998534,301,59,5,365
20971,bright,main,20211022,2,0.9847564125856034,329,85,4,418
20971,bright,main,20211022,3,0.9829253005561139,268,104,7,379
20971,bright,main,20211022,4,0.9932589194559032,272,104,6,382
20971,bright,main,20211022,5,0.9961534367763407,300,97,4,401
20971,bright,main,20211022,6,0.9939153683367672,310,99,6,415
20971,bright,main,20211022,7,0.9825506018044905,255,92,0,347
20971,bright,main,20211022,8,0.9923478655544342,307,98,3,408
20971,bright,main,20211022,9,0.9933589682604296,326,81,2,409
20170,bright,main,20211022,0,0.9941833215226487,363,67,2,432
20170,bright,main,20211022,1,0.9902459587337609,312,42,7,361
20170,bright,main,20211022,2,0.9957580386467261,347,61,6,414
20170,bright,main,20211022,3,0.9918664851845453,299,65,5,369
20170,bright,main,20211022,4,0.9907861616644698,326,49,5,380
20170,bright,main,20211022,5,0.9923082019619806,301,80,1,382
20170,bright,main,20211022,6,0.9950212413183951,343,62,2,407
20170,bright,main,20211022,7,0.9875725656484748,294,51,7,352
20170,bright,main,20211022,8,0.9945727469140074,334,62,7,403
20170,bright,main,20211022,9,0.9898390830460345,318,71,6,395
20169,bright,main,20211022,0,0.9908244723825961,359,64,3,426
20169,bright,main,20211022,1,0.9911896927942123,292,56,5,353
20169,bright,main,20211022,2,0.9941962107043739,344,61,8,413
20169,bright,main,20211022,3,0.9918950322900388,318,55,2,375
20169,bright,main,20211022,4,0.9913807068747992,338,45,6,389
20169,bright,main,20211022,5,0.9880946864650069,343,39,7,389
20169,bright,main,20211022,6,0.9924496175053071,331,60,3,394
20169,bright,main,20211022,7,0.9949345517742518,287,67,3,357
20169,bright,main,20211022,8,0.9898881340849672,333,66,4,403
20169,bright,main,20211022,9,0.9881219667123838,348,50,2,400
26004,bright,main,20211022,0,0.9929509999330154,346,87,0,433
26004,bright,main,20211022,1,0.9869925521351992,298,65,9,372
26004,bright,main,20211022,2,0.9946602737108126,294,139,5,438
26004,bright,main,20211022,3,0.9903108174840669,296,86,9,391
26004,bright,main,20211022,4,0.9916161940722164,299,98,5,402
26004,bright,main,20211022,5,0.9953613159692007,325,84,2,411
26004,bright,main,20211022,6,0.9925171068278552,316,109,4,429
26004,bright,main,20211022,7,0.9918544584203781,282,85,3,370
26004,bright,main,20211022,8,0.9955329240131636,331,86,5,422
26004,bright,main,20211022,9,0.9913766010041773,322,101,4,427
20935,bright,main,20211022,0,0.9866839296405091,332,88,3,423
20935,bright,main,20211022,1,0.989472322601157,284,76,8,368
20935,bright,main,20211022,2,0.9925931491799603,340,83,3,426
20935,bright,main,20211022,3,0.9919768978191077,313,66,6,385
20935,bright,main,20211022,4,0.9941242062652882,318,75,2,395
20935,bright,main,20211022,5,0.9917763551029773,301,96,3,400
20935,bright,main,20211022,6,0.9952547947927093,339,77,2,418
20935,bright,main,20211022,7,0.9937300570119947,281,73,5,359
20935,bright,main,20211022,8,0.9938219279898399,302,100,6,408
20935,bright,main,20211022,9,0.9897952260179504,288,114,3,405
21307,bright,main,20211022,0,0.9901758763257674,357,72,10,439
21307,bright,main,20211022,1,0.9880651775133658,280,74,5,359
21307,bright,main,20211022,2,0.9940538296248141,339,75,3,417
21307,bright,main,20211022,3,0.9932612863950493,301,94,3,398
21307,bright,main,20211022,4,0.9889764452617932,330,73,4,407
21307,bright,main,20211022,5,0.994256125318327,318,95,3,416
21307,bright,main,20211022,6,0.9916162900839909,341,79,6,426
21307,bright,main,20211022,7,0.9932882207538262,287,79,6,372
21307,bright,main,20211022,8,0.9923039986250246,330,80,4,414
21307,bright,main,20211022,9,0.9922450358740225,325,95,3,423
26003,bright,main,20211022,0,0.9945501993709381,301,133,5,439
26003,bright,main,20211022,1,0.9921856708718416,266,105,6,377
26003,bright,main,20211022,2,0.9927533269955084,310,118,7,435
26003,bright,main,20211022,3,0.9932637932923327,327,66,3,396
26003,bright,main,20211022,4,0.9930762552715625,304,94,4,402
26003,bright,main,20211022,5,0.9906383280932118,296,115,4,415
26003,bright,main,20211022,6,0.9921301066160413,316,113,2,431
26003,bright,main,20211022,7,0.9824812123635862,284,85,2,371
26003,bright,main,20211022,8,0.9876524441758113,320,99,9,428
26003,bright,main,20211022,9,0.9914555680189615,318,108,2,428
21294,bright,main,20211022,0,0.9952266604517501,363,73,4,440
21294,bright,main,20211022,1,0.9942922349710096,291,82,4,377
21294,bright,main,20211022,2,0.9940387642244328,336,92,4,432
21294,bright,main,20211022,3,0.9921812332653792,311,82,4,397
21294,bright,main,20211022,4,0.9882725572082037,331,70,1,402
21294,bright,main,20211022,5,0.9938414479285835,351,61,1,413
21294,bright,main,20211022,6,0.9935190217650443,336,90,2,428
21294,bright,main,20211022,7,0.9956623153071513,299,74,2,375
21294,bright,main,20211022,8,0.9909029710957126,313,104,2,419
21294,bright,main,20211022,9,0.9852163107619246,309,103,7,419
21308,bright,main,20211022,0,0.9889724707398254,337,96,2,435
21308,bright,main,20211022,1,0.9963277085718383,280,93,1,374
21308,bright,main,20211022,2,0.9866213029752895,320,109,6,435
21308,bright,main,20211022,3,0.9960050098030286,306,87,3,396
21308,bright,main,20211022,4,0.9934249878901671,327,76,3,406
21308,bright,main,20211022,5,0.9926418859990049,299,113,2,414
21308,bright,main,20211022,6,0.9964507082715366,326,96,8,430
21308,bright,main,20211022,7,0.9949602380014991,285,81,6,372
21308,bright,main,20211022,8,0.985687633442001,336,82,8,426
21308,bright,main,20211022,9,0.9875018392418395,335,88,3,426
22553,bright,main,20211022,0,0.9909797997617437,388,47,4,439
22553,bright,main,20211022,1,0.9917141194552213,317,61,1,379
22553,bright,main,20211022,2,0.9952337174746136,354,76,7,437
22553,bright,main,20211022,3,0.9864992939015915,320,73,1,394
22553,bright,main,20211022,4,0.9956260245971315,335,66,4,405
22553,bright,main,20211022,5,0.9968262319374466,299,112,4,415
22553,bright,main,20211022,6,0.9887710423117367,297,124,6,427
22553,bright,main,20211022,7,0.9906449479438436,278,90,2,370
22553,bright,main,20211022,8,0.9934393012834619,324,90,6,420
22553,bright,main,20211022,9,0.9960125634875311,333,82,4,419
24451,bright,main,20211022,0,0.9872948137140457,328,105,6,439
24451,bright,main,20211022,1,0.9898202131311025,255,113,8,376
24451,bright,main,20211022,2,0.9920313139484809,321,109,6,436
24451,bright,main,20211022,3,0.9953841320610063,276,110,8,394
24451,bright,main,20211022,4,0.9926740978692301,311,90,4,405
24451,bright,main,20211022,5,0.989147771273597,326,85,3,414
24451,bright,main,20211022,6,0.9932632032753177,333,86,8,427
24451,bright,main,20211022,7,0.9946860825380825,251,111,5,367
24451,bright,main,20211022,8,0.994535385379913,330,92,3,425
24451,bright,main,20211022,9,0.991388554261146,328,85,6,419
25638,bright,main,20211022,0,0.9907855249271317,361,70,4,435
25638,bright,main,20211022,1,0.9934983494234892,298,62,3,363
25638,bright,main,20211022,2,0.9905005010180454,382,47,4,433
25638,bright,main,20211022,3,0.9968099797646667,327,61,3,391
25638,bright,main,20211022,4,0.9919633289623481,348,47,6,401
25638,bright,main,20211022,5,0.9877367554373451,350,45,3,398
25638,bright,main,20211022,6,0.9925143653030883,383,36,4,423
25638,bright,main,20211022,7,0.9969447357996731,317,46,7,370
25638,bright,main,20211022,8,0.9918652093247297,319,88,5,412
25638,bright,main,20211022,9,0.9903998245827981,346,66,4,416
21400,bright,main,20211023,0,0.9949215759715455,338,89,4,431
21400,bright,main,20211023,1,0.990433710829725,319,49,5,373
21400,bright,main,20211023,2,0.9811579338125259,366,60,2,428
21400,bright,main,20211023,3,0.991727128294255,310,75,4,389
21400,bright,main,20211023,4,0.9889554825204494,317,74,3,394
21400,bright,main,20211023,5,0.9915781941585097,341,58,6,405
21400,bright,main,20211023,6,0.9875735083696449,335,83,1,419
21400,bright,main,20211023,7,0.993111802325944,289,69,2,360
21400,bright,main,20211023,8,0.989567553332078,291,110,3,404
21400,bright,main,20211023,9,0.9946368246925869,334,82,4,420
25015,bright,main,20211023,0,0.9945530063960106,247,183,6,436
25015,bright,main,20211023,1,0.9884677493699671,209,169,5,383
25015,bright,main,20211023,2,0.9870036118818136,266,165,6,437
25015,bright,main,20211023,3,0.9943197494814568,274,122,3,399
25015,bright,main,20211023,4,0.989876868058471,270,137,0,407
25015,bright,main,20211023,5,0.9938537035330413,267,146,4,417
25015,bright,main,20211023,6,0.9919107768983881,230,205,2,437
25015,bright,main,20211023,7,0.9930648204274389,228,144,3,375
25015,bright,main,20211023,8,0.9951393276831503,226,200,3,429
25015,bright,main,20211023,9,0.9881720925432829,216,217,1,434
20009,bright,main,20211023,0,0.9963070556727012,355,75,5,435
20009,bright,main,20211023,1,0.9929059679006818,295,70,5,370
20009,bright,main,20211023,2,0.9920439441686889,370,50,4,424
20009,bright,main,20211023,3,0.9962818972821307,326,54,4,384
20009,bright,main,20211023,4,0.9941327981769679,337,55,5,397
20009,bright,main,20211023,5,0.9936863063745389,339,58,8,405
20009,bright,main,20211023,6,0.9914982381176245,327,85,8,420
20009,bright,main,20211023,7,0.9933342153667799,288,66,4,358
20009,bright,main,20211023,8,0.9905256264653606,352,55,5,412
20009,bright,main,20211023,9,0.9950642852887108,356,58,3,417
11196,dark,main,20211023,0,0.9920814748913447,274,30,62,366
11196,dark,main,20211023,1,0.9928958928502317,269,28,31,328
11196,dark,main,20211023,2,0.9832532208696438,262,46,70,378
11196,dark,main,20211023,3,0.9928498915456685,214,45,70,329
11196,dark,main,20211023,4,0.9921387422757111,249,34,51,334
11196,dark,main,20211023,5,0.9845928528931048,251,35,68,354
11196,dark,main,20211023,6,0.9927366899527574,261,54,58,373
11196,dark,main,20211023,7,0.9877870250301966,245,16,47,308
11196,dark,main,20211023,8,0.992299603547694,273,28,57,358
11196,dark,main,20211023,9,0.9902998293659939,257,27,68,352
22072,bright,main,20211023,0,0.9944409038930234,284,148,5,437
22072,bright,main,20211023,1,0.9913248235557928,260,119,2,381
22072,bright,main,20211023,2,0.99657155191474,334,94,2,430
22072,bright,main,20211023,3,0.992571128713291,295,100,4,399
22072,bright,main,20211023,4,0.9944047676419782,317,92,1,410
22072,bright,main,20211023,5,0.9870866292041882,351,62,4,417
22072,bright,main,20211023,6,0.9916244352301974,308,115,2,425
22072,bright,main,20211023,7,0.9907700802266345,265,104,3,372
22072,bright,main,20211023,8,0.99146093704412,328,85,2,415
22072,bright,main,20211023,9,0.989506927759442,271,154,4,429
20933,bright,main,20211023,0,0.9911008195457081,349,79,4,432
20933,bright,main,20211023,1,0.9902356000739292,320,45,6,371
20933,bright,main,20211023,2,0.9879855865110055,343,85,6,434
20933,bright,main,20211023,3,0.9879855865110055,343,85,6,434
20933,bright,main,20211023,4,0.9912010305914352,309,80,3,392
20933,bright,main,20211023,5,0.9883083729036661,333,71,3,407
20933,bright,main,20211023,6,0.9961716007276828,349,74,3,426
20933,bright,main,20211023,7,0.9916978334774286,305,56,5,366
20933,bright,main,20211023,8,0.9938370160627831,336,77,3,416
20933,bright,main,20211023,9,0.9933591132105118,338,69,6,413
25006,bright,main,20211023,0,0.9962506178082569,330,109,4,443
25006,bright,main,20211023,1,0.9919558719203657,267,112,2,381
25006,bright,main,20211023,2,0.9907344726156218,284,148,2,434
25006,bright,main,20211023,3,0.9915328487767234,256,144,0,400
25006,bright,main,20211023,4,0.9898173532233905,251,155,2,408
25006,bright,main,20211023,5,0.9930644583311318,249,153,4,406
25006,bright,main,20211023,6,0.9830190584229501,267,164,1,432
25006,bright,main,20211023,7,0.9934647796328773,254,120,0,374
25006,bright,main,20211023,8,0.9893388221804086,267,159,2,428
25006,bright,main,20211023,9,0.9953714068242986,294,134,0,428
25005,bright,main,20211023,0,0.9921965490646862,336,102,2,440
25005,bright,main,20211023,1,0.9842082849312215,258,119,5,382
25005,bright,main,20211023,2,0.9890767556498018,296,131,1,428
25005,bright,main,20211023,3,0.9927345429465481,264,130,6,400
25005,bright,main,20211023,4,0.9940515530627908,294,111,3,408
25005,bright,main,20211023,5,0.9906355699114796,291,119,1,411
25005,bright,main,20211023,6,0.9945981446595189,332,90,3,425
25005,bright,main,20211023,7,0.9910919795229776,267,99,4,370
25005,bright,main,20211023,8,0.987268952289732,309,112,6,427
25005,bright,main,20211023,9,0.994355250617273,314,110,4,428
20980,bright,main,20211023,0,0.9933593977206594,352,77,4,433
20980,bright,main,20211023,1,0.9882578353731476,310,65,2,377
20980,bright,main,20211023,2,0.9940851479215539,329,90,13,432
20980,bright,main,20211023,3,0.9892492815035849,311,67,6,384
20980,bright,main,20211023,4,0.9885608647068087,348,48,3,399
20980,bright,main,20211023,5,0.9960036105920816,320,82,7,409
20980,bright,main,20211023,6,0.9964272461631452,336,76,5,417
20980,bright,main,20211023,7,0.9898406344629357,283,70,6,359
20980,bright,main,20211023,8,0.9910917125033138,316,94,5,415
20980,bright,main,20211023,9,0.9930832244707719,323,79,8,410
22404,bright,main,20211023,0,0.9914261794847352,340,99,1,440
22404,bright,main,20211023,1,0.99351441333557,267,111,0,378
22404,bright,main,20211023,2,0.9875170723505131,301,133,4,438
22404,bright,main,20211023,3,0.992289360785463,267,127,3,397
22404,bright,main,20211023,4,0.993288027334168,286,120,4,410
22404,bright,main,20211023,5,0.9927489219159321,338,71,4,413
22404,bright,main,20211023,6,0.9879971122960757,322,107,2,431
22404,bright,main,20211023,7,0.992752984444824,310,58,2,370
22404,bright,main,20211023,8,0.988748421901722,344,77,1,422
22404,bright,main,20211023,9,0.991583175532601,326,91,4,421
24049,bright,main,20211023,0,0.9947940191351275,286,149,1,436
24049,bright,main,20211023,1,0.994225854222061,216,163,4,383
24049,bright,main,20211023,2,0.9902909977042204,284,147,5,436
24049,bright,main,20211023,3,0.9956926443686518,259,132,4,395
24049,bright,main,20211023,4,0.9914943049122027,272,132,4,408
24049,bright,main,20211023,5,0.9949039765616745,264,145,3,412
24049,bright,main,20211023,6,0.9932585866328391,272,153,5,430
24049,bright,main,20211023,7,0.9947974434949525,280,89,1,370
24049,bright,main,20211023,8,0.9924609133032581,282,134,3,419
24049,bright,main,20211023,9,0.9943263575823282,256,164,6,426
22076,bright,main,20211023,0,0.9916003219490764,324,111,3,438
22076,bright,main,20211023,1,0.9856898945366526,220,160,2,382
22076,bright,main,20211023,2,0.9923371109655506,307,125,4,436
22076,bright,main,20211023,3,0.9909013352680114,267,133,1,401
22076,bright,main,20211023,4,0.991396010161628,253,147,3,403
22076,bright,main,20211023,5,0.9889139901442707,261,155,2,418
22076,bright,main,20211023,6,0.9915386108962522,300,125,3,428
22076,bright,main,20211023,7,0.9884066278051197,252,118,2,372
22076,bright,main,20211023,8,0.9959464527863705,295,130,3,428
22076,bright,main,20211023,9,0.9950968382556448,305,122,4,431
25008,bright,main,20211023,0,0.9895981385431384,320,118,5,443
25008,bright,main,20211023,1,0.9923714654559238,266,115,4,385
25008,bright,main,20211023,2,0.9896078412120862,271,158,3,432
25008,bright,main,20211023,3,0.9883315635034738,271,122,5,398
25008,bright,main,20211023,4,0.995809602049829,256,140,10,406
25008,bright,main,20211023,5,0.9922065849138799,226,186,3,415
25008,bright,main,20211023,6,0.9902579724859903,251,178,3,432
25008,bright,main,20211023,7,0.979993616483888,247,126,1,374
25008,bright,main,20211023,8,0.9951743970233518,238,184,5,427
25008,bright,main,20211023,9,0.9964239257716657,220,206,5,431
22522,bright,main,20211023,0,0.994450872525271,339,84,7,430
22522,bright,main,20211023,1,0.9899366732035811,301,66,4,371
22522,bright,main,20211023,2,0.9881049963412101,338,89,6,433
22522,bright,main,20211023,3,0.9921718121917117,318,68,6,392
22522,bright,main,20211023,4,0.9914755644292503,335,60,2,397
22522,bright,main,20211023,5,0.9931197917101718,336,65,1,402
22522,bright,main,20211023,6,0.9949254278848148,342,76,9,427
22522,bright,main,20211023,7,0.9890972190318775,291,70,4,365
22522,bright,main,20211023,8,0.9896934960406476,344,75,4,423
22522,bright,main,20211023,9,0.9952275016578102,324,93,3,420
20941,bright,main,20211023,0,0.9938579907483968,335,95,4,434
20941,bright,main,20211023,1,0.9935221815968741,281,91,3,375
20941,bright,main,20211023,2,0.994151783926897,306,115,2,423
20941,bright,main,20211023,3,0.9917007019722925,304,77,6,387
20941,bright,main,20211023,4,0.993879722765424,337,63,2,402
20941,bright,main,20211023,5,0.9927660183761529,324,78,5,407
20941,bright,main,20211023,6,0.9864830463757293,333,82,5,420
20941,bright,main,20211023,7,0.989434436644431,307,61,2,370
20941,bright,main,20211023,8,0.9844948378045851,323,73,7,403
20941,bright,main,20211023,9,0.9810791738994006,336,79,3,418
21401,bright,main,20211023,0,0.9914717087680679,374,61,4,439
21401,bright,main,20211023,1,0.9910633480572727,335,40,2,377
21401,bright,main,20211023,2,0.9912106817489376,340,84,5,429
21401,bright,main,20211023,3,0.9954865215403683,328,59,2,389
21401,bright,main,20211023,4,0.9965854709182558,304,91,4,399
21401,bright,main,20211023,5,0.9951484831279243,326,81,3,410
21401,bright,main,20211023,6,0.9956995068308021,334,77,7,418
21401,bright,main,20211023,7,0.9930444155206436,302,60,2,364
21401,bright,main,20211023,8,0.9942777220117822,342,72,3,417
21401,bright,main,20211023,9,0.9894386792795752,324,83,5,412
25022,bright,main,20211023,0,0.9904697733867087,336,104,4,444
25022,bright,main,20211023,1,0.9970381690612006,300,71,7,378
25022,bright,main,20211023,2,0.9934646252129509,320,112,2,434
25022,bright,main,20211023,3,0.989783439600723,312,78,3,393
25022,bright,main,20211023,4,0.9936739262114996,331,76,1,408
25022,bright,main,20211023,5,0.9900906168115282,337,69,5,411
25022,bright,main,20211023,6,0.9922616806616406,343,82,7,432
25022,bright,main,20211023,7,0.9932503992781296,285,81,2,368
25022,bright,main,20211023,8,0.9935533812186267,349,70,2,421
25022,bright,main,20211023,9,0.9965096683372608,326,88,5,419
24445,bright,main,20211023,0,0.9953075161405661,322,103,6,431
24445,bright,main,20211023,1,0.9934653719606207,301,71,3,375
24445,bright,main,20211023,2,0.9916050163916982,341,85,5,431
24445,bright,main,20211023,3,0.9955858591191926,338,53,2,393
24445,bright,main,20211023,4,0.9974416760790173,323,75,3,401
24445,bright,main,20211023,5,0.9901337772494169,325,87,2,414
24445,bright,main,20211023,6,0.9805020357391125,330,81,9,420
24445,bright,main,20211023,7,0.9851500068543324,285,78,0,363
24445,bright,main,20211023,8,0.9925067734899775,318,86,2,406
24445,bright,main,20211023,9,0.9926826523691831,319,95,4,418
8319,dark,main,20211023,0,0.9931813683489447,273,34,75,382
8319,dark,main,20211023,1,0.9817405733804925,248,25,59,332
8319,dark,main,20211023,2,0.9865454904751814,274,32,80,386
8319,dark,main,20211023,3,0.993862146478862,245,30,74,349
8319,dark,main,20211023,4,0.9911453897211747,253,26,63,342
8319,dark,main,20211023,5,0.9954432355091688,280,26,65,371
8319,dark,main,20211023,6,0.9912277314460418,265,27,83,375
8319,dark,main,20211023,7,0.9936444414664688,217,24,76,317
8319,dark,main,20211023,8,0.9888323610796483,262,28,74,364
8319,dark,main,20211023,9,0.9927202096137805,272,29,77,378
24419,bright,main,20211023,0,0.9919867687471743,362,74,2,438
24419,bright,main,20211023,1,0.9933787715343664,309,69,1,379
24419,bright,main,20211023,2,0.9915566018553094,351,78,6,435
24419,bright,main,20211023,3,0.9905861410947866,314,77,6,397
24419,bright,main,20211023,4,0.9927769565753215,291,101,7,399
24419,bright,main,20211023,5,0.9924886619411304,325,79,6,410
24419,bright,main,20211023,6,0.9942998377616622,293,126,3,422
24419,bright,main,20211023,7,0.9905835710187887,280,79,4,363
24419,bright,main,20211023,8,0.993829171653494,324,85,3,412
24419,bright,main,20211023,9,0.9914745311403768,320,97,5,422
24425,bright,main,20211023,0,0.9939337352404547,342,94,1,437
24425,bright,main,20211023,1,0.992221600298465,260,112,4,376
24425,bright,main,20211023,2,0.9931797314959643,332,100,3,435
24425,bright,main,20211023,3,0.9899206301943732,311,87,1,399
24425,bright,main,20211023,4,0.9906494539566184,314,86,2,402
24425,bright,main,20211023,5,0.9925955114522892,305,99,5,409
24425,bright,main,20211023,6,0.9916969442410718,328,91,4,423
24425,bright,main,20211023,7,0.9901674354218754,279,86,3,368
24425,bright,main,20211023,8,0.994204726450719,312,98,5,415
24425,bright,main,20211023,9,0.9893535483120731,293,109,7,409
4306,dark,main,20211024,0,0.9867766589431652,298,12,83,393
4306,dark,main,20211024,1,0.9882742108408802,239,12,72,323
4306,dark,main,20211024,2,0.9942018645066796,271,13,88,372
4306,dark,main,20211024,3,0.9918638311761255,245,17,94,356
4306,dark,main,20211024,4,0.9865253779041557,257,11,94,362
4306,dark,main,20211024,5,0.9811509177889076,262,12,84,358
4306,dark,main,20211024,6,0.9897063501830704,286,17,66,369
4306,dark,main,20211024,7,0.99072932555219,238,9,69,316
4306,dark,main,20211024,8,0.9903761935683401,273,14,76,363
4306,dark,main,20211024,9,0.9935557799862618,270,13,91,374
4294,dark,main,20211024,0,0.9913879955723813,267,13,100,380
4294,dark,main,20211024,1,0.9928259024716648,232,12,94,338
4294,dark,main,20211024,2,0.9957646557377858,290,13,92,395
4294,dark,main,20211024,3,0.9847730368386292,279,14,73,366
4294,dark,main,20211024,4,0.9910728658148616,261,15,83,359
4294,dark,main,20211024,5,0.9886726493732582,240,14,114,368
4294,dark,main,20211024,6,0.9944197652170678,297,10,80,387
4294,dark,main,20211024,7,0.995824111012979,236,14,84,334
4294,dark,main,20211024,8,0.9939210947632343,284,13,79,376
4294,dark,main,20211024,9,0.9884891669577207,281,9,97,387
22262,bright,main,20211024,0,0.9919193709150029,375,46,4,425
22262,bright,main,20211024,1,0.9854788099990319,338,34,2,374
22262,bright,main,20211024,2,0.9902188801797605,370,44,2,416
22262,bright,main,20211024,3,0.9860069385994209,311,53,6,370
22262,bright,main,20211024,4,0.9924787463470556,327,59,7,393
22262,bright,main,20211024,5,0.9950477569403392,340,53,5,398
22262,bright,main,20211024,6,0.9877135064961364,336,63,3,402
22262,bright,main,20211024,7,0.9850119125202922,290,54,3,347
22262,bright,main,20211024,8,0.9941641249327092,351,44,5,400
22262,bright,main,20211024,9,0.99568217012436,356,54,1,411
26220,bright,main,20211024,0,0.9935749291722035,340,99,5,444
26220,bright,main,20211024,1,0.9908850253698003,305,74,3,382
26220,bright,main,20211024,2,0.9977045859897143,353,83,0,436
26220,bright,main,20211024,3,0.9935419617624918,326,64,9,399
26220,bright,main,20211024,4,0.9926326371057729,294,107,3,404
26220,bright,main,20211024,5,0.9924819045124805,338,73,4,415
26220,bright,main,20211024,6,0.992602669892391,353,80,1,434
26220,bright,main,20211024,7,0.9917725785715172,280,89,1,370
26220,bright,main,20211024,8,0.9924970281191765,323,93,7,423
26220,bright,main,20211024,9,0.9956366851999879,326,97,2,425
20694,bright,main,20211024,0,0.9894701709084457,334,64,3,401
20694,bright,main,20211024,1,0.9903650989329637,265,79,5,349
20694,bright,main,20211024,2,0.9960574245473214,327,81,4,412
20694,bright,main,20211024,3,0.9858679756494186,303,64,9,376
20694,bright,main,20211024,4,0.9891190579312782,299,75,5,379
20694,bright,main,20211024,5,0.9927225775788279,299,85,1,385
20694,bright,main,20211024,6,0.994036356024124,305,90,8,403
20694,bright,main,20211024,7,0.9941441870570865,278,68,6,352
20694,bright,main,20211024,8,0.9926946539804221,342,60,7,409
20694,bright,main,20211024,9,0.9909827432040058,327,79,5,411
11666,dark,main,20211024,0,0.9919726949563668,263,25,89,377
11666,dark,main,20211024,1,0.9915103054113571,242,17,77,336
11666,dark,main,20211024,2,0.9856077088588349,289,26,74,389
11666,dark,main,20211024,3,0.9935677198381812,260,19,76,355
11666,dark,main,20211024,4,0.990880304163312,255,19,90,364
11666,dark,main,20211024,5,0.991776880173726,259,16,86,361
11666,dark,main,20211024,6,0.992591434271044,271,16,73,360
11666,dark,main,20211024,7,0.9936804634438007,232,15,67,314
11666,dark,main,20211024,8,0.9880792040285292,276,16,79,371
11666,dark,main,20211024,9,0.9908191386677536,298,17,67,382
23998,bright,main,20211024,0,0.9931599821648055,318,118,2,438
23998,bright,main,20211024,1,0.9960045771319065,247,127,2,376
23998,bright,main,20211024,2,0.9949598044581935,282,149,6,437
23998,bright,main,20211024,3,0.9882295281833575,275,118,7,400
23998,bright,main,20211024,4,0.9956365505136616,230,171,1,402
23998,bright,main,20211024,5,0.9919339937327419,256,156,2,414
23998,bright,main,20211024,6,0.9924475844533879,249,177,3,429
23998,bright,main,20211024,7,0.9914044588155505,250,121,2,373
23998,bright,main,20211024,8,0.9935716483598036,345,73,4,422
23998,bright,main,20211024,9,0.9911627904005943,333,92,3,428
26139,bright,main,20211024,0,0.9937794801249806,324,80,6,410
26139,bright,main,20211024,1,0.9934198548462719,300,61,3,364
26139,bright,main,20211024,2,0.9917199413406325,295,107,6,408
26139,bright,main,20211024,3,0.9888878905404122,275,84,7,366
26139,bright,main,20211024,4,0.9902231069804746,289,85,3,377
26139,bright,main,20211024,5,0.9949717445309537,327,67,5,399
26139,bright,main,20211024,6,0.9960824059574179,348,60,6,414
26139,bright,main,20211024,7,0.9922431883733968,285,72,5,362
26139,bright,main,20211024,8,0.9938850250245466,362,48,2,412
26139,bright,main,20211024,9,0.9897632549815396,349,56,3,408
4445,dark,main,20211024,0,0.9872697406984682,269,19,55,343
4445,dark,main,20211024,1,0.9899902376962428,244,40,43,327
4445,dark,main,20211024,2,0.9889080083787445,295,34,45,374
4445,dark,main,20211024,3,0.9926013258396452,241,30,68,339
4445,dark,main,20211024,4,0.9927102806784224,215,14,96,325
4445,dark,main,20211024,5,0.9958264618394846,260,29,83,372
4445,dark,main,20211024,6,0.9890509714548835,272,31,68,371
4445,dark,main,20211024,7,0.9895989056611898,231,23,76,330
4445,dark,main,20211024,8,0.9893953647985431,250,27,92,369
4445,dark,main,20211024,9,0.9950796701792023,242,23,73,338
23803,bright,main,20211024,0,0.9883939862962475,374,46,7,427
23803,bright,main,20211024,1,0.9885984798110798,300,56,0,356
23803,bright,main,20211024,2,0.9930748718228544,377,45,3,425
23803,bright,main,20211024,3,0.9959495003616573,307,64,9,380
23803,bright,main,20211024,4,0.9886534039061347,339,44,2,385
23803,bright,main,20211024,5,0.9917986107027836,353,42,0,395
23803,bright,main,20211024,6,0.9927441698341727,361,53,2,416
23803,bright,main,20211024,7,0.9958331157357904,282,66,5,353
23803,bright,main,20211024,8,0.9895425447459909,330,62,6,398
23803,bright,main,20211024,9,0.9931824595689466,370,45,3,418
26219,bright,main,20211024,0,0.9871649113278524,355,81,2,438
26219,bright,main,20211024,1,0.9904369919972839,293,86,3,382
26219,bright,main,20211024,2,0.9933095693924815,310,109,7,426
26219,bright,main,20211024,3,0.9872367188153626,319,76,4,399
26219,bright,main,20211024,4,0.9952077612924046,325,77,7,409
26219,bright,main,20211024,5,0.9832569440961872,313,94,3,410
26219,bright,main,20211024,6,0.9897997461134319,336,90,3,429
26219,bright,main,20211024,7,0.9896207017983206,307,61,5,373
26219,bright,main,20211024,8,0.9869022097252336,330,89,4,423
26219,bright,main,20211024,9,0.99633369042872,338,79,5,422
25493,bright,main,20211024,0,0.9851272107109856,367,69,2,438
25493,bright,main,20211024,1,0.9866669563915225,312,59,4,375
25493,bright,main,20211024,2,0.9968407926339464,337,93,4,434
25493,bright,main,20211024,3,0.9955379908846982,329,64,1,394
25493,bright,main,20211024,4,0.9967436995832111,331,54,3,388
25493,bright,main,20211024,5,0.9926326428353885,269,139,2,410
25493,bright,main,20211024,6,0.9954305939000114,296,131,0,427
25493,bright,main,20211024,7,0.9948859953490519,297,65,6,368
25493,bright,main,20211024,8,0.9898713915568068,313,104,6,423
25493,bright,main,20211024,9,0.9891413591689544,311,107,3,421
23801,bright,main,20211024,0,0.9892288438979553,373,54,8,435
23801,bright,main,20211024,1,0.9951752282895463,317,46,6,369
23801,bright,main,20211024,2,0.9891971969993708,359,68,3,430
23801,bright,main,20211024,3,0.9923823505093434,300,72,4,376
23801,bright,main,20211024,4,0.9942166210365233,333,52,6,391
23801,bright,main,20211024,5,0.9948168990064598,351,45,5,401
23801,bright,main,20211024,6,0.9926748968277541,357,54,2,413
23801,bright,main,20211024,7,0.9944251917663331,325,39,1,365
23801,bright,main,20211024,8,0.9957061353150712,332,70,6,408
23801,bright,main,20211024,9,0.9943390011835089,326,62,8,396
11433,dark,main,20211024,0,0.9920832100457861,275,39,73,387
11433,dark,main,20211024,1,0.9901856292210308,227,29,63,319
11433,dark,main,20211024,2,0.990161862715203,280,24,51,355
11433,dark,main,20211024,3,0.9906235104174284,250,23,64,337
11433,dark,main,20211024,4,0.9934261178395607,255,30,58,343
11433,dark,main,20211024,5,0.9913157826876754,268,29,59,356
11433,dark,main,20211024,6,0.9923629285240282,250,30,82,362
11433,dark,main,20211024,7,0.9835345397224793,197,36,82,315
11433,dark,main,20211024,8,0.9939053113561768,241,42,78,361
11433,dark,main,20211024,9,0.9919052931926088,240,42,84,366
1307,dark,main,20211024,0,0.9921085723649653,269,27,88,384
1307,dark,main,20211024,1,0.9916704794076211,221,24,74,319
1307,dark,main,20211024,2,0.9931483918359445,268,24,98,390
1307,dark,main,20211024,3,0.9919811370383589,253,17,73,343
1307,dark,main,20211024,4,0.9939485367774458,258,23,75,356
1307,dark,main,20211024,5,0.9872827508854257,255,30,84,369
1307,dark,main,20211024,6,0.9894934255077495,252,24,80,356
1307,dark,main,20211024,7,0.988386187792948,218,17,84,319
1307,dark,main,20211024,8,0.9934377449807243,260,22,92,374
1307,dark,main,20211024,9,0.9923675213798459,270,19,76,365
25009,bright,main,20211024,0,0.9897139739404851,327,102,7,436
25009,bright,main,20211024,1,0.9890255006731938,256,120,2,378
25009,bright,main,20211024,2,0.9927267020152706,288,142,7,437
25009,bright,main,20211024,3,0.9941827770019362,290,107,3,400
25009,bright,main,20211024,4,0.99195290143125,256,146,3,405
25009,bright,main,20211024,5,0.9956661998357106,288,126,3,417
25009,bright,main,20211024,6,0.9918277059285583,294,133,4,431
25009,bright,main,20211024,7,0.9924479165976162,265,104,6,375
25009,bright,main,20211024,8,0.9889337104524107,287,132,3,422
25009,bright,main,20211024,9,0.9898929557940037,314,113,4,431
22242,bright,main,20211024,0,0.9919496523708214,359,49,9,417
22242,bright,main,20211024,1,0.9927452058026915,298,53,7,358
22242,bright,main,20211024,2,0.9946206768878033,336,61,7,404
22242,bright,main,20211024,3,0.9864418587576751,317,52,5,374
22242,bright,main,20211024,4,0.9921992233956777,353,32,5,390
22242,bright,main,20211024,5,0.993759418446609,362,37,5,404
22242,bright,main,20211024,6,0.992440527883694,356,61,4,421
22242,bright,main,20211024,7,0.9911571039971966,285,58,4,347
22242,bright,main,20211024,8,0.9960274510891781,314,78,1,393
22242,bright,main,20211024,9,0.992806470539649,338,64,6,408
23970,bright,main,20211024,0,0.9948527065118804,345,90,0,435
23970,bright,main,20211024,1,0.9890333395019669,261,121,2,384
23970,bright,main,20211024,2,0.9914221097527467,324,106,5,435
23970,bright,main,20211024,3,0.990512202909463,306,93,3,402
23970,bright,main,20211024,4,0.993438320774599,304,92,10,406
23970,bright,main,20211024,5,0.990314650441231,314,94,6,414
23970,bright,main,20211024,6,0.994985674969069,330,88,8,426
23970,bright,main,20211024,7,0.989785152386338,277,91,3,371
23970,bright,main,20211024,8,0.9951936231283134,281,140,5,426
23970,bright,main,20211024,9,0.9904209904401644,306,117,3,426
11234,dark,main,20211024,0,0.9942501375761547,289,24,63,376
11234,dark,main,20211024,1,0.9889992543600723,242,18,62,322
11234,dark,main,20211024,2,0.9959554966482993,277,19,71,367
11234,dark,main,20211024,3,0.9914064259697349,269,16,52,337
11234,dark,main,20211024,4,0.9875462598811211,273,17,51,341
11234,dark,main,20211024,5,0.9962035003779234,259,25,73,357
11234,dark,main,20211024,6,0.99336196974262,257,19,84,360
11234,dark,main,20211024,7,0.9919607634076637,246,19,52,317
11234,dark,main,20211024,8,0.9881703319805112,276,27,65,368
11234,dark,main,20211024,9,0.9918413003019628,279,27,67,373
23037,bright,main,20211024,0,0.9910873617940521,385,35,9,429
23037,bright,main,20211024,1,0.9890387970336397,321,40,2,363
23037,bright,main,20211024,2,0.9938096989234202,346,65,4,415
23037,bright,main,20211024,3,0.9942648091598435,308,53,7,368
23037,bright,main,20211024,4,0.9942723179497046,317,64,5,386
23037,bright,main,20211024,5,0.9913538851403758,328,60,6,394
23037,bright,main,20211024,6,0.993033579123594,338,76,3,417
23037,bright,main,20211024,7,0.9903704875095065,288,61,3,352
23037,bright,main,20211024,8,0.9925832454051626,339,63,3,405
23037,bright,main,20211024,9,0.9902950745249544,366,40,4,410
23856,bright,main,20211024,0,0.9935923996635195,354,85,3,442
23856,bright,main,20211024,1,0.9905922664858343,307,72,0,379
23856,bright,main,20211024,2,0.9943757091823604,328,109,1,438
23856,bright,main,20211024,3,0.9956742164552342,296,102,3,401
23856,bright,main,20211024,4,0.9888479195069573,308,96,3,407
23856,bright,main,20211024,5,0.9925067916999047,353,60,3,416
23856,bright,main,20211024,6,0.9951139788382106,359,68,2,429
23856,bright,main,20211024,7,0.989840313123678,299,66,6,371
23856,bright,main,20211024,8,0.9958661090661929,335,90,3,428
23856,bright,main,20211024,9,0.9891158726688354,333,91,5,429
22077,bright,main,20211025,0,0.9933360611185885,330,106,6,442
22077,bright,main,20211025,1,0.991716873487604,252,122,7,381
22077,bright,main,20211025,2,0.9931122519411412,322,106,2,430
22077,bright,main,20211025,3,0.9948399821264176,274,128,0,402
22077,bright,main,20211025,4,0.9924950165797712,279,120,7,406
22077,bright,main,20211025,5,0.9918267907567596,272,135,3,410
22077,bright,main,20211025,6,0.9908201814920508,286,145,2,433
22077,bright,main,20211025,7,0.9903748387826976,249,121,3,373
22077,bright,main,20211025,8,0.994194314910157,286,134,5,425
22077,bright,main,20211025,9,0.9945916960348643,314,107,5,426
22071,bright,main,20211025,0,0.9977129097065117,269,164,4,437
22071,bright,main,20211025,1,0.9947086543156205,243,131,4,378
22071,bright,main,20211025,2,0.9900006000141773,302,129,1,432
22071,bright,main,20211025,3,0.9951884968276928,260,134,4,398
22071,bright,main,20211025,4,0.9915533834307859,293,108,3,404
22071,bright,main,20211025,5,0.9957036983026953,294,123,4,421
22071,bright,main,20211025,6,0.9922277724929791,340,85,2,427
22071,bright,main,20211025,7,0.9830203677295302,255,116,3,374
22071,bright,main,20211025,8,0.9915530290746162,298,120,1,419
22071,bright,main,20211025,9,0.9918068643294994,305,119,4,428
22074,bright,main,20211025,0,0.9933646415039519,265,175,4,444
22074,bright,main,20211025,1,0.9885399168514611,219,163,1,383
22074,bright,main,20211025,2,0.9842507898869102,275,150,4,429
22074,bright,main,20211025,3,0.9915257398185917,249,144,5,398
22074,bright,main,20211025,4,0.991363356072853,300,109,1,410
22074,bright,main,20211025,5,0.9935974582858501,289,130,1,420
22074,bright,main,20211025,6,0.9890709562319081,340,87,5,432
22074,bright,main,20211025,7,0.9925149362008132,219,154,0,373
22074,bright,main,20211025,8,0.9966091801563937,280,141,5,426
22074,bright,main,20211025,9,0.9881311206010448,256,172,1,429
3072,dark,main,20211025,0,0.9900832973187526,244,27,92,363
3072,dark,main,20211025,1,0.9928982123400953,246,30,67,343
3072,dark,main,20211025,2,0.9827138822799328,248,38,78,364
3072,dark,main,20211025,3,0.986049600770763,268,38,57,363
3072,dark,main,20211025,4,0.9882535282274132,261,28,80,369
3072,dark,main,20211025,5,0.9918031493506715,254,38,68,360
3072,dark,main,20211025,6,0.9947815166647512,247,51,76,374
3072,dark,main,20211025,7,0.9912961826170091,238,25,55,318
3072,dark,main,20211025,8,0.9907877098131688,268,42,58,368
3072,dark,main,20211025,9,0.99265627858881,268,32,69,369
21054,bright,main,20211026,0,0.988386528956004,327,50,2,379
21054,bright,main,20211026,1,0.9915592787475247,126,36,2,164
21054,bright,main,20211026,2,0.9911371441768022,233,58,1,292
21054,bright,main,20211026,3,0.9890444679814816,292,59,4,355
21054,bright,main,20211026,4,0.9916980540963991,288,66,5,359
21054,bright,main,20211026,5,0.9918033749995526,272,53,3,328
21054,bright,main,20211026,6,0.9908359250585574,328,72,4,404
21054,bright,main,20211026,7,0.9909668550557402,299,58,3,360
21054,bright,main,20211026,8,0.9889211738933356,342,59,4,405
21054,bright,main,20211026,9,0.9916444277859983,320,80,2,402
24404,bright,main,20211026,0,0.984771358544332,189,58,2,249
24404,bright,main,20211026,1,0.9706048392597303,150,52,2,204
24404,bright,main,20211026,2,0.9911205876235712,305,124,2,431
24404,bright,main,20211026,3,0.9906429829382617,237,83,4,324
24404,bright,main,20211026,4,0.987061464470918,208,55,2,265
24404,bright,main,20211026,5,0.996371199157782,326,40,1,367
24404,bright,main,20211026,6,0.9948506234782005,354,52,1,407
24404,bright,main,20211026,7,0.9903586109867984,319,49,4,372
24404,bright,main,20211026,8,0.990186716822906,355,63,6,424
24404,bright,main,20211026,9,0.991883368482279,292,91,6,389
23005,bright,main,20211026,0,0.9909453624647668,357,71,3,431
23005,bright,main,20211026,1,0.9839936364971701,103,29,0,132
23005,bright,main,20211026,2,0.9918619500532916,155,33,2,190
23005,bright,main,20211026,3,0.9909422296996963,290,65,6,361
23005,bright,main,20211026,4,0.9949328028299483,327,52,3,382
23005,bright,main,20211026,5,0.9913917029057758,332,54,8,394
23005,bright,main,20211026,6,0.9964042892426186,338,65,4,407
23005,bright,main,20211026,7,0.9902195227770805,270,76,2,348
23005,bright,main,20211026,8,0.9967498648866097,302,86,2,390
23005,bright,main,20211026,9,0.9925928396834396,298,81,6,385
24360,bright,main,20211026,0,0.9959030165637734,387,44,5,436
24360,bright,main,20211026,1,0.9898415958480099,280,51,4,335
24360,bright,main,20211026,2,0.996869691821029,366,65,0,431
24360,bright,main,20211026,3,0.9932820164817947,278,81,3,362
24360,bright,main,20211026,4,0.995058227484204,307,53,1,361
24360,bright,main,20211026,5,0.9905601997434872,347,53,4,404
24360,bright,main,20211026,6,0.9919984279277552,352,69,1,422
24360,bright,main,20211026,7,0.9886839407060831,301,52,4,357
24360,bright,main,20211026,8,0.9858823259210765,283,41,5,329
24360,bright,main,20211026,9,0.9932806226449439,348,72,2,422
21503,bright,main,20211026,0,0.992343168588737,360,67,9,436
21503,bright,main,20211026,1,0.9898690849845161,286,78,5,369
21503,bright,main,20211026,2,0.9907582266279226,255,109,2,366
21503,bright,main,20211026,3,0.99055461593476,292,80,5,377
21503,bright,main,20211026,4,0.9931336974799851,314,73,4,391
21503,bright,main,20211026,5,0.9913429697972443,311,81,5,397
21503,bright,main,20211026,6,0.9945794457245365,284,101,2,387
21503,bright,main,20211026,7,0.991760404450458,263,96,4,363
21503,bright,main,20211026,8,0.9869196036892592,258,94,3,355
21503,bright,main,20211026,9,0.995994813006682,327,90,5,422
24564,bright,main,20211026,0,0.9951762726413478,341,87,6,434
24564,bright,main,20211026,1,0.9931516736330261,301,55,5,361
24564,bright,main,20211026,2,0.995278608534632,320,93,1,414
24564,bright,main,20211026,3,0.9923019046317694,297,82,1,380
24564,bright,main,20211026,4,0.9961728807333574,330,56,4,390
24564,bright,main,20211026,5,0.9919641137641168,323,69,4,396
24564,bright,main,20211026,6,0.9950419603654219,327,88,3,418
24564,bright,main,20211026,7,0.9974315473958583,286,68,5,359
24564,bright,main,20211026,8,0.9938290723563449,328,79,7,414
24564,bright,main,20211026,9,0.9885447058122676,324,84,3,411
25412,bright,main,20211026,0,0.9872753350605952,336,87,3,426
25412,bright,main,20211026,1,0.9827329419984749,222,42,3,267
25412,bright,main,20211026,2,0.9944862040416622,321,79,1,401
25412,bright,main,20211026,3,0.991931566244036,309,66,3,378
25412,bright,main,20211026,4,0.9923662319770177,306,75,2,383
25412,bright,main,20211026,5,0.9903543720215092,346,55,2,403
25412,bright,main,20211026,6,0.9892724296129569,341,68,2,411
25412,bright,main,20211026,7,0.9870758615627506,283,60,2,345
25412,bright,main,20211026,8,0.9885413788888193,342,63,3,408
25412,bright,main,20211026,9,0.9918215050921552,334,75,4,413
21047,bright,main,20211026,0,0.9792170293720914,356,54,6,416
21047,bright,main,20211026,1,0.9858257222266599,322,43,1,366
21047,bright,main,20211026,2,0.9925382788086422,340,58,5,403
21047,bright,main,20211026,3,0.9957412021474797,278,70,4,352
21047,bright,main,20211026,4,0.9641577854133102,56,11,1,68
21047,bright,main,20211026,5,0.9635220675145026,196,26,3,225
21047,bright,main,20211026,6,0.9911720521039772,358,52,3,413
21047,bright,main,20211026,7,0.9896116692584057,302,50,3,355
21047,bright,main,20211026,8,0.9948675598592006,339,67,2,408
21047,bright,main,20211026,9,0.985845393620067,363,46,4,413
22383,bright,main,20211026,0,0.9909441878428878,338,92,2,432
22383,bright,main,20211026,1,0.9917394723229798,281,88,1,370
22383,bright,main,20211026,2,0.9891867427910173,321,110,0,431
22383,bright,main,20211026,3,0.98712365031424,255,61,2,318
22383,bright,main,20211026,4,0.9855988183489546,158,29,1,188
22383,bright,main,20211026,5,0.9694289039459936,89,22,0,111
22383,bright,main,20211026,6,0.9926075415340351,140,36,3,179
22383,bright,main,20211026,7,0.9860630910322131,205,66,1,272
22383,bright,main,20211026,8,0.9914334698955077,301,116,7,424
22383,bright,main,20211026,9,0.9886544676719409,302,127,1,430
25991,bright,main,20211026,0,0.9930153979573045,352,84,2,438
25991,bright,main,20211026,1,0.9866664760823417,311,56,4,371
25991,bright,main,20211026,2,0.9935508878803454,352,80,1,433
25991,bright,main,20211026,3,0.9936751835271704,313,78,4,395
25991,bright,main,20211026,4,0.9916797656598958,331,64,8,403
25991,bright,main,20211026,5,0.991384168480146,327,72,7,406
25991,bright,main,20211026,6,0.9938398604254055,335,82,4,421
25991,bright,main,20211026,7,0.9922774956741091,308,53,3,364
25991,bright,main,20211026,8,0.99025417679333,339,70,6,415
25991,bright,main,20211026,9,0.9968696746991712,316,101,5,422
22251,bright,main,20211026,0,0.9964177646257742,339,82,7,428
22251,bright,main,20211026,1,0.9954659565148287,290,65,3,358
22251,bright,main,20211026,2,0.9954744338560532,373,50,6,429
22251,bright,main,20211026,3,0.9940594347621724,315,67,2,384
22251,bright,main,20211026,4,0.9891270842960554,342,53,3,398
22251,bright,main,20211026,5,0.9910148684960202,333,58,2,393
22251,bright,main,20211026,6,0.9878687447041284,334,72,2,408
22251,bright,main,20211026,7,0.9956797785522237,290,63,5,358
22251,bright,main,20211026,8,0.9838075157471472,286,47,6,339
22251,bright,main,20211026,9,0.9879369845374827,326,68,0,394
24161,bright,main,20211026,0,0.9928459137669523,343,76,2,421
24161,bright,main,20211026,1,0.9913772390947441,300,59,3,362
24161,bright,main,20211026,2,0.9887926510014224,319,88,8,415
24161,bright,main,20211026,3,0.9942106124627564,307,69,4,380
24161,bright,main,20211026,4,0.9868908802224018,295,86,4,385
24161,bright,main,20211026,5,0.9894872260242706,292,89,1,382
24161,bright,main,20211026,6,0.990415583057079,297,95,3,395
24161,bright,main,20211026,7,0.9854951522743671,273,74,2,349
24161,bright,main,20211026,8,0.995881399037313,332,61,9,402
24161,bright,main,20211026,9,0.9954327016208159,320,79,6,405
21652,bright,main,20211026,0,0.9948671778264266,310,117,3,430
21652,bright,main,20211026,1,0.9936882450761858,235,144,2,381
21652,bright,main,20211026,2,0.9913955303658842,282,150,2,434
21652,bright,main,20211026,3,0.9861062121540577,301,96,1,398
21652,bright,main,20211026,4,0.9939967641969621,324,75,5,404
21652,bright,main,20211026,5,0.9947701134850536,304,108,5,417
21652,bright,main,20211026,6,0.9933193826243271,310,108,2,420
21652,bright,main,20211026,7,0.9967957936168406,275,95,2,372
21652,bright,main,20211026,8,0.990082929804082,305,112,2,419
21652,bright,main,20211026,9,0.9946969692497737,294,123,3,420
21012,bright,main,20211026,0,0.9917800462202705,362,58,5,425
21012,bright,main,20211026,1,0.9916096422315451,299,63,5,367
21012,bright,main,20211026,2,0.9881462529531152,268,64,6,338
21012,bright,main,20211026,3,0.9915658751935228,306,69,5,380
21012,bright,main,20211026,4,0.9744940670431418,118,23,1,142
21012,bright,main,20211026,5,0.9928755470974278,258,40,6,304
21012,bright,main,20211026,6,0.9902984592283378,309,73,4,386
21012,bright,main,20211026,7,0.994567728161124,270,76,9,355
21012,bright,main,20211026,8,0.9894266953020928,327,76,5,408
21012,bright,main,20211026,9,0.9924484002433643,333,75,4,412
25990,bright,main,20211026,0,0.9948084034865912,348,81,5,434
25990,bright,main,20211026,1,0.9932977362945542,270,98,5,373
25990,bright,main,20211026,2,0.9902068512408203,312,114,2,428
25990,bright,main,20211026,3,0.9924305218822371,280,105,3,388
25990,bright,main,20211026,4,0.9956998682657058,300,92,2,394
25990,bright,main,20211026,5,0.9945199502119391,316,90,4,410
25990,bright,main,20211026,6,0.9945407158553933,359,60,3,422
25990,bright,main,20211026,7,0.9930034408187758,319,45,4,368
25990,bright,main,20211026,8,0.9918923727903848,354,56,5,415
25990,bright,main,20211026,9,0.9960747150713624,352,66,2,420
21231,bright,main,20211026,0,0.994915597035669,370,62,4,436
21231,bright,main,20211026,1,0.985210340012484,330,46,1,377
21231,bright,main,20211026,2,0.9924973921119044,361,67,4,432
21231,bright,main,20211026,3,0.9920632234736103,332,63,1,396
21231,bright,main,20211026,4,0.992287007145402,352,49,2,403
21231,bright,main,20211026,5,0.9939173748726305,349,58,3,410
21231,bright,main,20211026,6,0.9895162594407881,347,71,5,423
21231,bright,main,20211026,7,0.9847405578254331,303,62,5,370
21231,bright,main,20211026,8,0.9939847786242171,339,71,7,417
21231,bright,main,20211026,9,0.9927921032665641,350,76,5,431
24773,bright,main,20211026,0,0.9931688162159108,326,94,4,424
24773,bright,main,20211026,1,0.9873598221736894,184,140,4,328
24773,bright,main,20211026,2,0.9854379412469298,254,94,1,349
24773,bright,main,20211026,3,0.9785363517886413,234,81,1,316
24773,bright,main,20211026,4,0.9793965440620022,94,26,0,120
24773,bright,main,20211026,5,0.9720408125177227,131,30,4,165
24773,bright,main,20211026,6,0.990886713487353,176,31,1,208
24773,bright,main,20211026,7,0.9807931231453328,195,54,1,250
24773,bright,main,20211026,8,0.9954390456621228,196,48,1,245
24773,bright,main,20211026,9,0.9932423535841974,257,81,5,343
11231,dark,main,20211027,0,0.990425215715231,255,16,98,369
11231,dark,main,20211027,1,0.9903266480656038,226,17,87,330
11231,dark,main,20211027,2,0.9893596174481063,247,18,106,371
11231,dark,main,20211027,3,0.9945378915676961,255,16,78,349
11231,dark,main,20211027,4,0.9905555131900281,249,15,90,354
11231,dark,main,20211027,5,0.9862377182222065,255,16,92,363
11231,dark,main,20211027,6,0.9920429319087684,260,19,78,357
11231,dark,main,20211027,7,0.9877096899492396,231,14,84,329
11231,dark,main,20211027,8,0.9918997823625764,262,18,100,380
11231,dark,main,20211027,9,0.9841648611200419,258,21,87,366
4670,dark,main,20211027,0,0.9920501660790977,287,13,91,391
4670,dark,main,20211027,1,0.9904359515111228,240,14,71,325
4670,dark,main,20211027,2,0.9942221178729667,279,13,94,386
4670,dark,main,20211027,3,0.9936253026122938,251,18,92,361
4670,dark,main,20211027,4,0.9879890778048941,268,15,87,370
4670,dark,main,20211027,5,0.9925982647459712,259,12,87,358
4670,dark,main,20211027,6,0.983418261016571,264,16,97,377
4670,dark,main,20211027,7,0.9935633636763995,247,10,66,323
4670,dark,main,20211027,8,0.9885523924782023,272,13,102,387
4670,dark,main,20211027,9,0.9958158954300769,282,16,89,387
9368,dark,main,20211027,0,0.9940517991605915,251,15,104,370
9368,dark,main,20211027,1,0.986750376381063,234,14,86,334
9368,dark,main,20211027,2,0.986486939146031,278,19,100,397
9368,dark,main,20211027,3,0.9900883225860673,246,17,90,353
9368,dark,main,20211027,4,0.99099886448074,264,14,82,360
9368,dark,main,20211027,5,0.988548249799476,269,17,81,367
9368,dark,main,20211027,6,0.9910164728953106,265,11,87,363
9368,dark,main,20211027,7,0.9915183941813438,213,17,102,332
9368,dark,main,20211027,8,0.9876821396252022,258,11,94,363
9368,dark,main,20211027,9,0.9903868403604729,252,22,99,373
7393,dark,main,20211027,0,0.9924102548536045,288,15,87,390
7393,dark,main,20211027,1,0.990230821839967,230,11,92,333
7393,dark,main,20211027,2,0.9893654431137838,289,16,100,405
7393,dark,main,20211027,3,0.989340269413952,253,14,94,361
7393,dark,main,20211027,4,0.9898816404059023,250,16,99,365
7393,dark,main,20211027,5,0.9939637843341653,270,12,87,369
7393,dark,main,20211027,6,0.9946452924224329,278,17,85,380
7393,dark,main,20211027,7,0.9908927068560613,225,11,88,324
7393,dark,main,20211027,8,0.9878756795883684,246,18,86,350
7393,dark,main,20211027,9,0.9916817730484764,263,16,87,366
4677,dark,main,20211027,0,0.9885269221525924,286,15,83,384
4677,dark,main,20211027,1,0.9906879579875147,247,15,73,335
4677,dark,main,20211027,2,0.9940142412981031,280,16,92,388
4677,dark,main,20211027,3,0.9860894135011202,240,15,91,346
4677,dark,main,20211027,4,0.9918717166701736,249,14,88,351
4677,dark,main,20211027,5,0.9872927394218131,263,16,81,360
4677,dark,main,20211027,6,0.9941602101550484,273,17,92,382
4677,dark,main,20211027,7,0.99455851187828,237,17,89,343
4677,dark,main,20211027,8,0.9964007145077712,251,13,108,372
4677,dark,main,20211027,9,0.9884855051035214,279,14,81,374
3835,dark,main,20211027,0,0.9888744897031029,266,17,95,378
3835,dark,main,20211027,1,0.9822949368626622,223,16,86,325
3835,dark,main,20211027,2,0.9899273387355281,262,22,103,387
3835,dark,main,20211027,3,0.9891878037510489,239,15,90,344
3835,dark,main,20211027,4,0.9927191320839608,260,18,82,360
3835,dark,main,20211027,5,0.9948476946571659,259,16,93,368
3835,dark,main,20211027,6,0.9962765333746735,276,16,87,379
3835,dark,main,20211027,7,0.9791545904967278,228,13,85,326
3835,dark,main,20211027,8,0.9949284285411407,266,19,94,379
3835,dark,main,20211027,9,0.9945215132441613,275,14,82,371
6373,dark,main,20211027,0,0.98503768182228,292,14,88,394
6373,dark,main,20211027,1,0.9885188238597433,237,11,86,334
6373,dark,main,20211027,2,0.9967604353189753,293,15,81,389
6373,dark,main,20211027,3,0.9922697277537721,234,13,105,352
6373,dark,main,20211027,4,0.9912137657052436,270,11,79,360
6373,dark,main,20211027,5,0.9915912293252381,261,14,90,365
6373,dark,main,20211027,6,0.990588526538647,270,11,104,385
6373,dark,main,20211027,7,0.9891513706373004,249,16,66,331
6373,dark,main,20211027,8,0.9932755524590648,244,13,111,368
6373,dark,main,20211027,9,0.9899083186422362,274,18,100,392
1174,dark,main,20211027,0,0.9926582356156132,275,14,89,378
1174,dark,main,20211027,1,0.9829037539168679,228,19,75,322
1174,dark,main,20211027,2,0.9920101444374528,269,17,95,381
1174,dark,main,20211027,3,0.9940965545034772,246,18,94,358
1174,dark,main,20211027,4,0.9900434087558477,236,18,94,348
1174,dark,main,20211027,5,0.9954519320077229,276,15,90,381
1174,dark,main,20211027,6,0.9962080743752886,276,12,94,382
1174,dark,main,20211027,7,0.9876410955469503,233,14,82,329
1174,dark,main,20211027,8,0.9910262578366166,255,12,102,369
1174,dark,main,20211027,9,0.9876837595653091,274,19,90,383
7442,dark,main,20211027,0,0.9916754916412285,277,20,87,384
7442,dark,main,20211027,1,0.9889449223971027,243,11,80,334
7442,dark,main,20211027,2,0.9929570282292021,258,20,109,387
7442,dark,main,20211027,3,0.9832064222592752,257,13,92,362
7442,dark,main,20211027,4,0.9946348133238282,262,16,89,367
7442,dark,main,20211027,5,0.9932040672851439,273,12,81,366
7442,dark,main,20211027,6,0.9895209239956586,275,13,86,374
7442,dark,main,20211027,7,0.9956604429199454,236,22,77,335
7442,dark,main,20211027,8,0.9902663678942233,258,16,90,364
7442,dark,main,20211027,9,0.9885883026261644,279,12,92,383
11236,dark,main,20211027,0,0.9939841394618026,261,28,104,393
11236,dark,main,20211027,1,0.9863442089982657,216,16,89,321
11236,dark,main,20211027,2,0.9885867040699,253,22,101,376
11236,dark,main,20211027,3,0.9938578153295142,244,24,77,345
11236,dark,main,20211027,4,0.9921163236855385,238,27,89,354
11236,dark,main,20211027,5,0.9956425452010308,243,30,91,364
11236,dark,main,20211027,6,0.9891649974253344,236,18,72,326
11236,dark,main,20211027,7,0.9879183324081229,198,19,70,287
11236,dark,main,20211027,8,0.9881931331700737,248,19,86,353
11236,dark,main,20211027,9,0.992248457038504,260,21,89,370
9338,dark,main,20211027,0,0.9971155257841886,266,19,107,392
9338,dark,main,20211027,1,0.9894698254996277,220,14,89,323
9338,dark,main,20211027,2,0.9936613777209717,258,15,105,378
9338,dark,main,20211027,3,0.9895253449984968,258,13,84,355
9338,dark,main,20211027,4,0.9827983977420124,254,15,100,369
9338,dark,main,20211027,5,0.9892127199266296,270,14,85,369
9338,dark,main,20211027,6,0.9832755247579293,285,16,77,378
9338,dark,main,20211027,7,0.9885592112380185,237,12,67,316
9338,dark,main,20211027,8,0.9906021337095694,259,19,92,370
9338,dark,main,20211027,9,0.9910681725226852,262,17,95,374
21873,bright,main,20211027,0,0.9951713943490879,348,78,6,432
21873,bright,main,20211027,1,0.9932315800123025,274,107,2,383
21873,bright,main,20211027,2,0.994478139492979,329,86,7,422
21873,bright,main,20211027,3,0.9876020352089283,298,97,7,402
21873,bright,main,20211027,4,0.9948250050191108,311,83,3,397
21873,bright,main,20211027,5,0.9912376680632399,299,108,4,411
21873,bright,main,20211027,6,0.9961093786152958,297,119,4,420
21873,bright,main,20211027,7,0.9879033463278,288,73,3,364
21873,bright,main,20211027,8,0.9912116287541483,337,79,5,421
21873,bright,main,20211027,9,0.9924120456131392,322,102,2,426
11233,dark,main,20211027,0,0.9925472599879519,268,27,88,383
11233,dark,main,20211027,1,0.9917620570845708,256,19,66,341
11233,dark,main,20211027,2,0.9923784385784473,293,24,59,376
11233,dark,main,20211027,3,0.9945069464346428,255,28,53,336
11233,dark,main,20211027,4,0.9886361434197217,287,14,55,356
11233,dark,main,20211027,5,0.9925965574024364,275,17,63,355
11233,dark,main,20211027,6,0.9939433355456119,274,20,64,358
11233,dark,main,20211027,7,0.9933323447430957,230,21,62,313
11233,dark,main,20211027,8,0.9892931379948331,258,22,87,367
11233,dark,main,20211027,9,0.9934485874067259,263,23,88,374
1167,dark,main,20211027,0,0.9942890977039621,278,16,99,393
1167,dark,main,20211027,1,0.9937169712754093,228,12,70,310
1167,dark,main,20211027,2,0.9928383570904163,277,17,81,375
1167,dark,main,20211027,3,0.9960123774283021,253,18,81,352
1167,dark,main,20211027,4,0.9936656524191567,271,11,79,361
1167,dark,main,20211027,5,0.989517770539676,271,14,84,369
1167,dark,main,20211027,6,0.9876500825701396,256,13,89,358
1167,dark,main,20211027,7,0.9890641670457988,244,18,69,331
1167,dark,main,20211027,8,0.9884961273868347,263,14,85,362
1167,dark,main,20211027,9,0.991387562886055,283,16,71,370
11840,dark,main,20211027,0,0.988098098953443,315,13,100,428
11840,dark,main,20211027,1,0.9896734549147712,246,12,85,343
11840,dark,main,20211027,2,0.9940329238986217,292,15,98,405
11840,dark,main,20211027,3,0.991942563881081,269,11,86,366
11840,dark,main,20211027,4,0.9933442525519732,274,21,75,370
11840,dark,main,20211027,5,0.9932516529524462,283,15,87,385
11840,dark,main,20211027,6,0.991734315404925,288,13,78,379
11840,dark,main,20211027,7,0.9899030880613076,233,11,87,331
11840,dark,main,20211027,8,0.9971925299310314,295,12,77,384
11840,dark,main,20211027,9,0.992675088716635,304,10,91,405
1153,dark,main,20211027,0,0.9865284607210468,292,13,89,394
1153,dark,main,20211027,1,0.9950101967209445,238,12,88,338
1153,dark,main,20211027,2,0.9894833728838864,286,17,90,393
1153,dark,main,20211027,3,0.9903447658968245,239,16,96,351
1153,dark,main,20211027,4,0.9951724479778344,244,21,94,359
1153,dark,main,20211027,5,0.984796149810431,247,16,107,370
1153,dark,main,20211027,6,0.9937560798194157,255,13,98,366
1153,dark,main,20211027,7,0.9929213493936089,220,14,108,342
1153,dark,main,20211027,8,0.9936671877162118,248,16,97,361
1153,dark,main,20211027,9,0.9852274814637626,267,16,91,374
8105,dark,main,20211027,0,0.9867327953554074,267,22,90,379
8105,dark,main,20211027,1,0.9852388428329345,242,12,63,317
8105,dark,main,20211027,2,0.994727069037874,269,25,86,380
8105,dark,main,20211027,3,0.9917300631183282,247,20,81,348
8105,dark,main,20211027,4,0.9874377390890892,213,18,93,324
8105,dark,main,20211027,5,0.9959618888049585,238,15,83,336
8105,dark,main,20211027,6,0.99634240429839,267,17,59,343
8105,dark,main,20211027,7,0.9885895881126244,205,17,92,314
8105,dark,main,20211027,8,0.984753465241998,250,20,108,378
8105,dark,main,20211027,9,0.9891281793556936,253,23,84,360
4800,dark,main,20211027,0,0.990935904053551,285,16,83,384
4800,dark,main,20211027,1,0.987576601832969,238,13,88,339
4800,dark,main,20211027,2,0.99300840775097,270,13,93,376
4800,dark,main,20211027,3,0.9895575467925719,263,14,93,370
4800,dark,main,20211027,4,0.9953621252201943,274,13,81,368
4800,dark,main,20211027,5,0.9857036610539498,274,12,79,365
4800,dark,main,20211027,6,0.9876849832985369,276,10,91,377
4800,dark,main,20211027,7,0.9914668686554311,227,12,97,336
4800,dark,main,20211027,8,0.9907437283998184,275,14,105,394
4800,dark,main,20211027,9,0.9936037885960048,294,10,77,381
8763,dark,main,20211027,0,0.9934685546905491,308,15,79,402
8763,dark,main,20211027,1,0.9922147747025005,259,11,81,351
8763,dark,main,20211027,2,0.9941241321390405,283,15,108,406
8763,dark,main,20211027,3,0.9947950914744311,261,14,76,351
8763,dark,main,20211027,4,0.9858932780260076,273,15,84,372
8763,dark,main,20211027,5,0.9865617045446687,278,12,88,378
8763,dark,main,20211027,6,0.9930288574614057,266,15,90,371
8763,dark,main,20211027,7,0.9918973891284293,253,12,71,336
8763,dark,main,20211027,8,0.985955689612064,275,14,96,385
8763,dark,main,20211027,9,0.9921323977672545,281,12,97,390
4303,dark,main,20211028,0,0.9914627665368001,289,20,88,397
4303,dark,main,20211028,1,0.9921771553112991,230,13,88,331
4303,dark,main,20211028,2,0.9906536966415097,278,13,97,388
4303,dark,main,20211028,3,0.9885603726915442,247,14,80,341
4303,dark,main,20211028,4,0.994119615355608,238,13,97,348
4303,dark,main,20211028,5,0.9933604042066363,268,13,89,370
4303,dark,main,20211028,6,0.9929997440666584,267,12,98,377
4303,dark,main,20211028,7,0.9927963870631525,229,20,81,330
4303,dark,main,20211028,8,0.993830990884694,245,17,102,364
4303,dark,main,20211028,9,0.9907082000623593,264,15,100,379
7779,dark,main,20211028,0,0.9917917790000798,269,13,100,382
7779,dark,main,20211028,1,0.9875494418181014,226,13,86,325
7779,dark,main,20211028,2,0.9935037893996146,275,18,89,382
7779,dark,main,20211028,3,0.9906148026100496,253,25,77,355
7779,dark,main,20211028,4,0.994155762210399,248,22,85,355
7779,dark,main,20211028,5,0.9928040665178813,238,20,93,351
7779,dark,main,20211028,6,0.9918807273031733,284,14,84,382
7779,dark,main,20211028,7,0.9890613886698261,209,13,93,315
7779,dark,main,20211028,8,0.9871284462571082,247,17,91,355
7779,dark,main,20211028,9,0.9862861605904868,257,17,103,377
7392,dark,main,20211028,0,0.9908017222116059,269,19,94,382
7392,dark,main,20211028,1,0.994985086795917,248,15,70,333
7392,dark,main,20211028,2,0.9955380273496713,260,18,103,381
7392,dark,main,20211028,3,0.9776161051237581,243,15,80,338
7392,dark,main,20211028,4,0.9920199636295144,273,18,77,368
7392,dark,main,20211028,5,0.9889372777032213,253,15,86,354
7392,dark,main,20211028,6,0.9941327645330811,272,13,84,369
7392,dark,main,20211028,7,0.9913574588166025,234,16,73,323
7392,dark,main,20211028,8,0.9942204626082305,270,16,81,367
7392,dark,main,20211028,9,0.9911949107359317,231,15,84,330
10108,dark,main,20211028,0,0.9916212612209881,284,18,83,385
10108,dark,main,20211028,1,0.9923980895059843,235,17,75,327
10108,dark,main,20211028,2,0.9925407177981165,288,16,83,387
10108,dark,main,20211028,3,0.9885067578993331,259,15,81,355
10108,dark,main,20211028,4,0.9953636494495756,257,20,71,348
10108,dark,main,20211028,5,0.9932573069912587,271,21,76,368
10108,dark,main,20211028,6,0.9893714823821558,274,11,76,361
10108,dark,main,20211028,7,0.993795572145296,242,13,69,324
10108,dark,main,20211028,8,0.9925824667163023,262,14,98,374
10108,dark,main,20211028,9,0.992578273089364,270,19,97,386
3090,dark,main,20211028,0,0.9923186086784925,281,18,83,382
3090,dark,main,20211028,1,0.9950542262184449,234,14,76,324
3090,dark,main,20211028,2,0.991274136112446,258,16,100,374
3090,dark,main,20211028,3,0.9920929061026987,252,15,87,354
3090,dark,main,20211028,4,0.9910111152606146,251,14,87,352
3090,dark,main,20211028,5,0.9891198297470895,257,21,84,362
3090,dark,main,20211028,6,0.9811280774184764,277,16,81,374
3090,dark,main,20211028,7,0.9894931911117294,245,14,72,331
3090,dark,main,20211028,8,0.9919384872486003,265,14,86,365
3090,dark,main,20211028,9,0.997348415843682,254,16,96,366
10913,dark,main,20211028,0,0.9883929946796275,270,19,100,389
10913,dark,main,20211028,1,0.9900246883175818,221,11,89,321
10913,dark,main,20211028,2,0.9890980661303299,267,17,93,377
10913,dark,main,20211028,3,0.9866601051066323,255,23,86,364
10913,dark,main,20211028,4,0.9879176642501706,224,17,116,357
10913,dark,main,20211028,5,0.9875323493770654,241,22,106,369
10913,dark,main,20211028,6,0.9937587864986807,241,18,94,353
10913,dark,main,20211028,7,0.9840006814965804,235,27,69,331
10913,dark,main,20211028,8,0.9869644678784312,252,17,86,355
10913,dark,main,20211028,9,0.9922714574866518,256,20,87,363
11843,dark,main,20211028,0,0.9929447168072549,304,14,78,396
11843,dark,main,20211028,1,0.9899094509920146,241,9,76,326
11843,dark,main,20211028,2,0.9951713933488775,287,19,84,390
11843,dark,main,20211028,3,0.9912926702787213,275,13,79,367
11843,dark,main,20211028,4,0.9952715798346995,263,13,87,363
11843,dark,main,20211028,5,0.9911786126356679,281,18,77,376
11843,dark,main,20211028,6,0.991922440978743,281,16,88,385
11843,dark,main,20211028,7,0.9946803558423836,242,13,84,339
11843,dark,main,20211028,8,0.993032490655631,259,11,89,359
11843,dark,main,20211028,9,0.9826024093108275,282,14,81,377
6375,dark,main,20211028,0,0.9950576357624716,294,17,93,404
6375,dark,main,20211028,1,0.9918819808433502,234,17,81,332
6375,dark,main,20211028,2,0.9872840523431113,271,16,87,374
6375,dark,main,20211028,3,0.9887596960832845,249,16,90,355
6375,dark,main,20211028,4,0.9923605749718316,234,13,101,348
6375,dark,main,20211028,5,0.9918748978018146,260,14,89,363
6375,dark,main,20211028,6,0.9902841231134525,267,16,75,358
6375,dark,main,20211028,7,0.996427495998853,231,12,91,334
6375,dark,main,20211028,8,0.9922336690682875,251,15,92,358
6375,dark,main,20211028,9,0.9901149526063794,273,11,85,369
23443,bright,main,20211028,0,0.9940091412066749,338,101,2,441
23443,bright,main,20211028,1,0.9842732252211571,270,95,6,371
23443,bright,main,20211028,2,0.990493427329459,199,89,4,292
23443,bright,main,20211028,3,0.995110493807246,306,62,4,372
23443,bright,main,20211028,4,0.9841346820437977,324,77,1,402
23443,bright,main,20211028,5,0.9865630553235449,340,73,3,416
23443,bright,main,20211028,6,0.9924084720893861,325,103,1,429
23443,bright,main,20211028,7,0.9942145946743499,280,90,3,373
23443,bright,main,20211028,8,0.9942695986875868,307,110,2,419
23443,bright,main,20211028,9,0.9962937315723476,343,89,2,434
4818,dark,main,20211028,0,0.9904876893635951,245,11,99,355
4818,dark,main,20211028,1,0.9959842803396358,248,12,74,334
4818,dark,main,20211028,2,0.993480282812094,278,16,98,392
4818,dark,main,20211028,3,0.985931283940441,252,12,90,354
4818,dark,main,20211028,4,0.9869247612652942,244,13,93,350
4818,dark,main,20211028,5,0.9892509714448893,248,15,98,361
4818,dark,main,20211028,6,0.9938280409258243,282,17,90,389
4818,dark,main,20211028,7,0.990505995544717,241,12,83,336
4818,dark,main,20211028,8,0.9916164195940226,274,19,84,377
4818,dark,main,20211028,9,0.9931944210944759,268,12,81,361
11240,dark,main,20211028,0,0.9897333557163092,269,25,98,392
11240,dark,main,20211028,1,0.9853689165133089,235,20,72,327
11240,dark,main,20211028,2,0.9872781960181997,273,18,93,384
11240,dark,main,20211028,3,0.9875070128706018,247,18,85,350
11240,dark,main,20211028,4,0.9917277357437511,261,17,75,353
11240,dark,main,20211028,5,0.9886302556141969,263,15,93,371
11240,dark,main,20211028,6,0.9892573352367551,277,14,74,365
11240,dark,main,20211028,7,0.9941920597330588,208,32,73,313
11240,dark,main,20211028,8,0.9939027830861212,241,18,104,363
11240,dark,main,20211028,9,0.9871602114595485,275,16,76,367
11842,dark,main,20211028,0,0.9924390673966929,286,13,94,393
11842,dark,main,20211028,1,0.9913017195149586,258,12,73,343
11842,dark,main,20211028,2,0.9939390159284694,284,10,92,386
11842,dark,main,20211028,3,0.988941534679221,261,13,85,359
11842,dark,main,20211028,4,0.9911585773482305,292,9,81,382
11842,dark,main,20211028,5,0.9877513484978383,283,11,78,372
11842,dark,main,20211028,6,0.9862829949326603,259,14,101,374
11842,dark,main,20211028,7,0.996439997987424,244,11,84,339
11842,dark,main,20211028,8,0.9914909060047895,271,13,92,376
11842,dark,main,20211028,9,0.9958394597251029,291,12,85,388
8739,dark,main,20211028,0,0.9928753551371605,267,15,106,388
8739,dark,main,20211028,1,0.9899566746985711,265,14,64,343
8739,dark,main,20211028,2,0.9949396522382448,273,13,100,386
8739,dark,main,20211028,3,0.9934028485053467,284,10,71,365
8739,dark,main,20211028,4,0.9915037682871799,263,11,93,367
8739,dark,main,20211028,5,0.992809527010397,272,11,92,375
8739,dark,main,20211028,6,0.9908267478999567,258,15,101,374
8739,dark,main,20211028,7,0.9936185749395849,240,12,78,330
8739,dark,main,20211028,8,0.993002181020904,268,12,97,377
8739,dark,main,20211028,9,0.9923207526133986,306,11,84,401
1168,dark,main,20211028,0,0.9939917621359119,283,16,86,385
1168,dark,main,20211028,1,0.9931290223397446,244,19,66,329
1168,dark,main,20211028,2,0.9915071626635176,257,16,100,373
1168,dark,main,20211028,3,0.9922776144156414,229,23,85,337
1168,dark,main,20211028,4,0.9873012509344068,215,22,95,332
1168,dark,main,20211028,5,0.9937975043306659,241,18,92,351
1168,dark,main,20211028,6,0.9901978192239858,270,12,76,358
1168,dark,main,20211028,7,0.9832689525925943,245,14,76,335
1168,dark,main,20211028,8,0.992081652435868,259,16,96,371
1168,dark,main,20211028,9,0.989248082513552,246,19,107,372
3428,dark,main,20211028,0,0.9924930342954492,248,25,97,370
3428,dark,main,20211028,1,0.9727307130699085,59,4,25,88
3428,dark,main,20211028,2,0.9914077475567742,240,29,89,358
3428,dark,main,20211028,3,0.9876196700935633,264,18,60,342
3428,dark,main,20211028,4,0.9912125116454085,280,23,48,351
3428,dark,main,20211028,5,0.9881881152163736,296,14,62,372
3428,dark,main,20211028,6,0.9870295044964503,309,20,57,386
3428,dark,main,20211028,7,0.991522282537,221,35,72,328
3428,dark,main,20211028,8,0.9908775508914568,276,23,75,374
3428,dark,main,20211028,9,0.9923885714916415,263,22,83,368
5425,dark,main,20211028,0,0.9914584487911634,278,13,82,373
5425,dark,main,20211028,1,0.9912456060818892,233,13,72,318
5425,dark,main,20211028,2,0.9947523489409911,267,15,105,387
5425,dark,main,20211028,3,0.9933708767215211,267,19,77,363
5425,dark,main,20211028,4,0.9921656046747341,251,15,81,347
5425,dark,main,20211028,5,0.9942284038070532,271,13,84,368
5425,dark,main,20211028,6,0.9968280537280083,278,16,74,368
5425,dark,main,20211028,7,0.993608825851995,240,20,66,326
5425,dark,main,20211028,8,0.9951994357781061,260,10,88,358
5425,dark,main,20211028,9,0.985642094048455,266,12,88,366
1545,dark,main,20211028,0,0.99264043292966,281,15,97,393
1545,dark,main,20211028,1,0.9940758593856923,243,18,62,323
1545,dark,main,20211028,2,0.993101087782202,272,17,94,383
1545,dark,main,20211028,3,0.9936092627289801,244,16,90,350
1545,dark,main,20211028,4,0.9916901348832039,260,16,90,366
1545,dark,main,20211028,5,0.9915878966639372,245,16,88,349
1545,dark,main,20211028,6,0.9968660613671055,245,13,108,366
1545,dark,main,20211028,7,0.9932428742228796,240,10,79,329
1545,dark,main,20211028,8,0.9945372731259331,253,12,95,360
1545,dark,main,20211028,9,0.9945443429779384,270,12,96,378
11841,dark,main,20211028,0,0.9946399627049164,316,17,75,408
11841,dark,main,20211028,1,0.9943157792738241,253,16,67,336
11841,dark,main,20211028,2,0.99179826403367,301,11,84,396
11841,dark,main,20211028,3,0.9929628832792866,250,21,86,357
11841,dark,main,20211028,4,0.9929173559892552,279,10,84,373
11841,dark,main,20211028,5,0.9901691167425958,293,11,80,384
11841,dark,main,20211028,6,0.9912246179792844,305,16,67,388
11841,dark,main,20211028,7,0.9888575103471279,244,13,79,336
11841,dark,main,20211028,8,0.9913373662103617,276,10,91,377
11841,dark,main,20211028,9,0.9874007012772906,292,17,81,390
1161,dark,main,20211028,0,0.9898833433353893,283,15,90,388
1161,dark,main,20211028,1,0.9899177022012449,221,25,85,331
1161,dark,main,20211028,2,0.9929620317629764,267,14,99,380
1161,dark,main,20211028,3,0.9945983793217922,250,15,89,354
1161,dark,main,20211028,4,0.9864996657637253,228,19,89,336
1161,dark,main,20211028,5,0.9911642437086189,253,16,98,367
1161,dark,main,20211028,6,0.9939581065591738,272,12,94,378
1161,dark,main,20211028,7,0.9954511213910282,244,17,62,323
1161,dark,main,20211028,8,0.9916527716693155,270,13,91,374
1161,dark,main,20211028,9,0.9893221504465686,267,11,94,372
11072,dark,main,20211028,0,0.9945867169785566,265,15,107,387
11072,dark,main,20211028,1,0.9918548876391959,238,11,88,337
11072,dark,main,20211028,2,0.9889572543519973,275,21,99,395
11072,dark,main,20211028,3,0.988959245080078,254,16,87,357
11072,dark,main,20211028,4,0.9894972077922022,256,11,86,353
11072,dark,main,20211028,5,0.9951255147330975,241,11,88,340
11072,dark,main,20211028,6,0.9935464618272634,267,10,79,356
11072,dark,main,20211028,7,0.9874144832469439,208,14,61,283
11072,dark,main,20211028,8,0.9817520374537773,184,7,50,241
11072,dark,main,20211028,9,0.9879041311801215,283,11,85,379
6995,dark,main,20211028,0,0.993141648061772,306,15,85,406
6995,dark,main,20211028,1,0.9906560915462475,232,16,81,329
6995,dark,main,20211028,2,0.991640110145858,266,14,98,378
6995,dark,main,20211028,3,0.9918688731536797,275,14,67,356
6995,dark,main,20211028,4,0.9876626345525719,245,18,75,338
6995,dark,main,20211028,5,0.9914844765746819,259,18,72,349
6995,dark,main,20211028,6,0.9947494220763559,287,14,71,372
6995,dark,main,20211028,7,0.9967517053979662,242,14,81,337
6995,dark,main,20211028,8,0.9950977765517941,275,13,75,363
6995,dark,main,20211028,9,0.9916635193596907,286,17,77,380
10911,dark,main,20211028,0,0.9910883038998362,275,15,111,401
10911,dark,main,20211028,1,0.9926195581423627,226,16,76,318
10911,dark,main,20211028,2,0.9898394417810197,284,19,82,385
10911,dark,main,20211028,3,0.9867547092295494,249,13,93,355
10911,dark,main,20211028,4,0.9950594630510359,245,20,89,354
10911,dark,main,20211028,5,0.9911505108004365,252,17,95,364
10911,dark,main,20211028,6,0.9873992315959529,250,14,89,353
10911,dark,main,20211028,7,0.9877462538465934,218,17,76,311
10911,dark,main,20211028,8,0.9915467835299093,272,20,83,375
10911,dark,main,20211028,9,0.9958828746715707,270,17,85,372
1177,dark,main,20211028,0,0.9935839152531628,278,17,92,387
1177,dark,main,20211028,1,0.9881720649059681,265,15,64,344
1177,dark,main,20211028,2,0.9909487640873915,264,18,95,377
1177,dark,main,20211028,3,0.9944018144530236,274,12,80,366
1177,dark,main,20211028,4,0.996653144464884,237,18,100,355
1177,dark,main,20211028,5,0.9890633391083579,239,11,91,341
1177,dark,main,20211028,6,0.9921823618117156,264,15,83,362
1177,dark,main,20211028,7,0.9948464112919645,240,17,68,325
1177,dark,main,20211028,8,0.9954827805923948,303,12,75,390
1177,dark,main,20211028,9,0.9928616900547081,292,14,72,378
4274,dark,main,20211029,0,0.9904830180932375,295,18,86,399
4274,dark,main,20211029,1,0.9812488492959663,236,18,73,327
4274,dark,main,20211029,2,0.9826012385235586,238,10,79,327
4274,dark,main,20211029,3,0.9933550906384162,225,18,103,346
4274,dark,main,20211029,4,0.9924925079859674,269,16,79,364
4274,dark,main,20211029,5,0.9910813432494944,252,14,106,372
4274,dark,main,20211029,6,0.9933199627448248,243,16,98,357
4274,dark,main,20211029,7,0.9870200498323435,223,18,84,325
4274,dark,main,20211029,8,0.9945801096767922,270,22,80,372
4274,dark,main,20211029,9,0.9904117102347395,253,15,113,381
6386,dark,main,20211029,0,0.9900282898914832,288,12,89,389
6386,dark,main,20211029,1,0.9908915875048818,219,12,100,331
6386,dark,main,20211029,2,0.992151468400632,235,11,86,332
6386,dark,main,20211029,3,0.9951653308138606,247,15,85,347
6386,dark,main,20211029,4,0.9913138756783925,252,17,84,353
6386,dark,main,20211029,5,0.9870786682190805,274,12,83,369
6386,dark,main,20211029,6,0.9922282297494948,272,15,89,376
6386,dark,main,20211029,7,0.9876391758571124,242,12,80,334
6386,dark,main,20211029,8,0.9903794339874733,282,14,87,383
6386,dark,main,20211029,9,0.9899149370832856,287,12,85,384
2338,dark,main,20211029,0,0.9955783622760834,271,13,107,391
2338,dark,main,20211029,1,0.9907695766698137,243,20,64,327
2338,dark,main,20211029,2,0.9920117101402365,245,15,73,333
2338,dark,main,20211029,3,0.994300913025085,261,15,82,358
2338,dark,main,20211029,4,0.9902608510450265,259,19,76,354
2338,dark,main,20211029,5,0.9862755304476636,277,17,79,373
2338,dark,main,20211029,6,0.9858243940042807,311,14,72,397
2338,dark,main,20211029,7,0.9854978095444856,223,14,91,328
2338,dark,main,20211029,8,0.986172347241701,280,13,81,374
2338,dark,main,20211029,9,0.9879520046784263,278,16,77,371
21872,bright,main,20211029,0,0.9831799952965803,192,101,1,294
21872,bright,main,20211029,1,0.9910180236113093,243,106,6,355
21872,bright,main,20211029,2,0.9953311507539248,347,88,2,437
21872,bright,main,20211029,3,0.9886361740769649,290,106,3,399
21872,bright,main,20211029,4,0.995272218243444,318,89,0,407
21872,bright,main,20211029,5,0.9881917824836798,322,92,3,417
21872,bright,main,20211029,6,0.9929425553393975,316,108,3,427
21872,bright,main,20211029,7,0.9953905135753425,264,108,2,374
21872,bright,main,20211029,8,0.9904586594273814,312,110,4,426
21872,bright,main,20211029,9,0.9949705332511947,287,131,8,426
1163,dark,main,20211029,0,0.9937685647003158,279,12,106,397
1163,dark,main,20211029,1,0.9920909292992681,244,13,74,331
1163,dark,main,20211029,2,0.9899855322793195,223,16,89,328
1163,dark,main,20211029,3,0.9891450754751757,243,17,94,354
1163,dark,main,20211029,4,0.9926729762557963,256,13,86,355
1163,dark,main,20211029,5,0.9846165311652035,260,16,88,364
1163,dark,main,20211029,6,0.9918147723749251,250,19,95,364
1163,dark,main,20211029,7,0.9891068141439049,227,17,78,322
1163,dark,main,20211029,8,0.9884183637209891,265,16,87,368
1163,dark,main,20211029,9,0.994155188842567,257,12,100,369
4804,dark,main,20211029,0,0.9865010119325157,306,10,88,404
4804,dark,main,20211029,1,0.991244671590162,236,12,90,338
4804,dark,main,20211029,2,0.9902200091673663,244,11,74,329
4804,dark,main,20211029,3,0.9947483398283756,262,13,80,355
4804,dark,main,20211029,4,0.9940918162282918,282,14,79,375
4804,dark,main,20211029,5,0.9899481637900286,271,13,75,359
4804,dark,main,20211029,6,0.9936731465635894,266,12,85,363
4804,dark,main,20211029,7,0.9958708541631308,229,13,95,337
4804,dark,main,20211029,8,0.9845577581380723,272,18,78,368
4804,dark,main,20211029,9,0.9891983394933713,298,14,83,395
8999,dark,main,20211029,0,0.9889926861099412,290,11,95,396
8999,dark,main,20211029,1,0.9937310601474013,220,15,93,328
8999,dark,main,20211029,2,0.989950438306084,231,16,79,326
8999,dark,main,20211029,3,0.9942588959600852,249,16,90,355
8999,dark,main,20211029,4,0.9842684124558334,260,14,85,359
8999,dark,main,20211029,5,0.9880732141611233,248,17,90,355
8999,dark,main,20211029,6,0.9883344844523766,275,16,88,379
8999,dark,main,20211029,7,0.99084490744603,222,10,98,330
8999,dark,main,20211029,8,0.9897044803780323,266,13,97,376
8999,dark,main,20211029,9,0.9890185759465846,263,12,104,379
7778,dark,main,20211029,0,0.9941240501450407,266,15,96,377
7778,dark,main,20211029,1,0.9930836733639583,226,18,91,335
7778,dark,main,20211029,2,0.9959207846729687,233,17,78,328
7778,dark,main,20211029,3,0.987951499611713,260,15,79,354
7778,dark,main,20211029,4,0.9891832081011239,245,18,95,358
7778,dark,main,20211029,5,0.9889670701561567,256,15,88,359
7778,dark,main,20211029,6,0.9925125526584657,261,21,86,368
7778,dark,main,20211029,7,0.9942739306857831,246,16,76,338
7778,dark,main,20211029,8,0.9941350870826189,249,21,100,370
7778,dark,main,20211029,9,0.99232623906207,246,16,103,365
11690,dark,main,20211029,0,0.9885051844626709,273,18,93,384
11690,dark,main,20211029,1,0.9927875800433472,239,13,78,330
11690,dark,main,20211029,2,0.9898553857488519,239,15,75,329
11690,dark,main,20211029,3,0.994728883178493,257,31,60,348
11690,dark,main,20211029,4,0.9903491580826749,274,16,73,363
11690,dark,main,20211029,5,0.9926871917734132,257,15,81,353
11690,dark,main,20211029,6,0.9904129832239185,271,18,81,370
11690,dark,main,20211029,7,0.9831391248364986,238,14,76,328
11690,dark,main,20211029,8,0.9924790854538256,262,14,96,372
11690,dark,main,20211029,9,0.9924771463580654,271,16,85,372
23997,bright,main,20211029,0,0.9895274512350777,328,109,4,441
23997,bright,main,20211029,1,0.9929314147926465,287,87,2,376
23997,bright,main,20211029,2,0.99139175864655,351,81,6,438
23997,bright,main,20211029,3,0.991891904853675,322,73,4,399
23997,bright,main,20211029,4,0.9939155821643414,354,41,7,402
23997,bright,main,20211029,5,0.9926748937674335,346,64,7,417
23997,bright,main,20211029,6,0.9876063653348034,369,61,0,430
23997,bright,main,20211029,7,0.9780805586506456,315,57,1,373
23997,bright,main,20211029,8,0.9906363223619128,329,88,4,421
23997,bright,main,20211029,9,0.9958091388312899,364,64,2,430
8973,dark,main,20211029,0,0.9939660330786056,279,14,94,387
8973,dark,main,20211029,1,0.9921810799579225,229,14,92,335
8973,dark,main,20211029,2,0.9920022565296874,221,20,83,324
8973,dark,main,20211029,3,0.9913242982408852,260,15,79,354
8973,dark,main,20211029,4,0.9933204471067314,258,17,88,363
8973,dark,main,20211029,5,0.9850472533257673,239,11,104,354
8973,dark,main,20211029,6,0.9928842136109608,282,11,80,373
8973,dark,main,20211029,7,0.9930681577451246,232,12,91,335
8973,dark,main,20211029,8,0.9891386542188889,257,13,100,370
8973,dark,main,20211029,9,0.9909936811950575,247,14,88,349
9968,dark,main,20211029,0,0.9864160568243598,274,27,105,406
9968,dark,main,20211029,1,0.9891152154530206,248,23,56,327
9968,dark,main,20211029,2,0.9838946236377137,219,25,69,313
9968,dark,main,20211029,3,0.9974197200245369,246,33,70,349
9968,dark,main,20211029,4,0.9939077727675265,239,27,90,356
9968,dark,main,20211029,5,0.9892050649305197,250,25,84,359
9968,dark,main,20211029,6,0.9934279988042396,271,23,76,370
9968,dark,main,20211029,7,0.9890118336103547,234,16,66,316
9968,dark,main,20211029,8,0.9874117080441355,264,26,84,374
9968,dark,main,20211029,9,0.9867613255012512,276,29,82,387
22882,bright,main,20211029,0,0.9929486436370716,293,115,9,417
22882,bright,main,20211029,1,0.9928099489653185,262,89,2,353
22882,bright,main,20211029,2,0.9921664079041876,248,110,6,364
22882,bright,main,20211029,3,0.9938116850726806,300,78,3,381
22882,bright,main,20211029,4,0.9949811775229087,325,72,1,398
22882,bright,main,20211029,5,0.9941615667342396,300,93,7,400
22882,bright,main,20211029,6,0.9947790955613562,311,95,5,411
22882,bright,main,20211029,7,0.9917736824063506,235,106,7,348
22882,bright,main,20211029,8,0.9948100730050493,286,114,4,404
22882,bright,main,20211029,9,0.992104583735572,277,119,5,401
8972,dark,main,20211029,0,0.994580010398593,266,14,103,383
8972,dark,main,20211029,1,0.9926050712749975,240,12,79,331
8972,dark,main,20211029,2,0.988864939903604,230,17,83,330
8972,dark,main,20211029,3,0.9858677582658737,233,20,85,338
8972,dark,main,20211029,4,0.9917902179646568,232,17,103,352
8972,dark,main,20211029,5,0.993207322615764,233,20,101,354
8972,dark,main,20211029,6,0.9912365551750136,262,13,91,366
8972,dark,main,20211029,7,0.9915918827662218,224,16,75,315
8972,dark,main,20211029,8,0.9883307445049863,265,17,98,380
8972,dark,main,20211029,9,0.9867635453977851,247,26,98,371
5601,dark,main,20211029,0,0.9830443171604364,268,14,101,383
5601,dark,main,20211029,1,0.9838410699168854,248,11,87,346
5601,dark,main,20211029,2,0.9836909983124343,226,11,82,319
5601,dark,main,20211029,3,0.9917064323970962,264,12,84,360
5601,dark,main,20211029,4,0.9940104012630314,262,12,91,365
5601,dark,main,20211029,5,0.9913545500507286,272,11,83,366
5601,dark,main,20211029,6,0.9859522618444615,261,10,100,371
5601,dark,main,20211029,7,0.9929257997855122,247,11,86,344
5601,dark,main,20211029,8,0.989275580765591,276,12,94,382
5601,dark,main,20211029,9,0.9914312325007897,268,10,94,372
11709,dark,main,20211029,0,0.9901328928248404,285,11,68,364
11709,dark,main,20211029,1,0.9885041589845357,221,9,61,291
11709,dark,main,20211029,2,0.9880479115806955,266,11,85,362
11709,dark,main,20211029,3,0.9926255216307323,245,19,63,327
11709,dark,main,20211029,4,0.9894029824018543,245,16,65,326
11709,dark,main,20211029,5,0.989276987678792,238,10,71,319
11709,dark,main,20211029,6,0.9821574017339575,242,11,55,308
11709,dark,main,20211029,7,0.9893835306897105,232,12,54,298
11709,dark,main,20211029,8,0.9948155909812919,250,15,76,341
11709,dark,main,20211029,9,0.9918610761607565,249,12,66,327
25227,bright,main,20211029,0,0.9966634844235861,335,89,9,433
25227,bright,main,20211029,1,0.9860654519329125,294,69,3,366
25227,bright,main,20211029,2,0.9907371179215527,286,73,10,369
25227,bright,main,20211029,3,0.9891542868335671,322,58,6,386
25227,bright,main,20211029,4,0.9955178906943553,329,62,4,395
25227,bright,main,20211029,5,0.9943375203063216,351,52,3,406
25227,bright,main,20211029,6,0.98951219355361,325,90,6,421
25227,bright,main,20211029,7,0.9829165287329467,275,83,3,361
25227,bright,main,20211029,8,0.9935854645950478,339,71,4,414
25227,bright,main,20211029,9,0.9924040698165381,343,74,5,422
11692,dark,main,20211029,0,0.9935456852684628,276,11,103,390
11692,dark,main,20211029,1,0.9865614335554415,247,8,73,328
11692,dark,main,20211029,2,0.9891634619013977,219,12,83,314
11692,dark,main,20211029,3,0.9869327724621016,266,17,70,353
11692,dark,main,20211029,4,0.9906559974017256,263,12,87,362
11692,dark,main,20211029,5,0.9924737225197564,269,16,89,374
11692,dark,main,20211029,6,0.9943659239403881,274,15,82,371
11692,dark,main,20211029,7,0.9906926671860035,239,18,78,335
11692,dark,main,20211029,8,0.9881071040135762,279,14,86,379
11692,dark,main,20211029,9,0.9904344856908077,277,17,88,382
4305,dark,main,20211029,0,0.9959908341340549,255,15,101,371
4305,dark,main,20211029,1,0.9860358856444666,217,16,88,321
4305,dark,main,20211029,2,0.9836813884052781,223,15,90,328
4305,dark,main,20211029,3,0.9929523711112315,251,21,77,349
4305,dark,main,20211029,4,0.9933089249222767,252,13,86,351
4305,dark,main,20211029,5,0.9944821640290133,266,10,80,356
4305,dark,main,20211029,6,0.9926283897300517,273,19,87,379
4305,dark,main,20211029,7,0.9903339909763742,246,12,81,339
4305,dark,main,20211029,8,0.9937945134572989,261,16,99,376
4305,dark,main,20211029,9,0.9942502200803801,263,18,82,363
9350,dark,main,20211029,0,0.9902639832329686,288,20,97,405
9350,dark,main,20211029,1,0.9884746858220038,223,16,87,326
9350,dark,main,20211029,2,0.9946439684856373,224,12,83,319
9350,dark,main,20211029,3,0.9946379470222522,252,16,87,355
9350,dark,main,20211029,4,0.9905037260367097,253,14,93,360
9350,dark,main,20211029,5,0.98423883423246,275,19,84,378
9350,dark,main,20211029,6,0.9908363271236458,250,16,103,369
9350,dark,main,20211029,7,0.9902943418507176,241,11,73,325
9350,dark,main,20211029,8,0.9905417303425065,278,16,86,380
9350,dark,main,20211029,9,0.991538534955343,280,21,83,384
7398,dark,main,20211029,0,0.9925263613245386,278,20,78,376
7398,dark,main,20211029,1,0.9943673523199933,223,19,87,329
7398,dark,main,20211029,2,0.99400468834378,232,15,81,328
7398,dark,main,20211029,3,0.9897139478776451,250,15,84,349
7398,dark,main,20211029,4,0.9879187439223522,233,17,98,348
7398,dark,main,20211029,5,0.9937343318757998,230,21,102,353
7398,dark,main,20211029,6,0.9926343537923485,256,19,77,352
7398,dark,main,20211029,7,0.9885666236338502,210,19,94,323
7398,dark,main,20211029,8,0.9957092367586244,273,16,100,389
7398,dark,main,20211029,9,0.9914930887581465,259,21,92,372
2318,dark,main,20211029,0,0.995456354529991,286,14,89,389
2318,dark,main,20211029,1,0.9951450842569249,254,12,75,341
2318,dark,main,20211029,2,0.991552813321762,234,31,58,323
2318,dark,main,20211029,3,0.991385842658528,246,18,86,350
2318,dark,main,20211029,4,0.9889967341900029,254,13,92,359
2318,dark,main,20211029,5,0.9937198594259171,273,16,82,371
2318,dark,main,20211029,6,0.9946125695450092,292,16,68,376
2318,dark,main,20211029,7,0.9910952932581423,235,12,82,329
2318,dark,main,20211029,8,0.9928257998208996,254,14,91,359
2318,dark,main,20211029,9,0.9964971468682101,294,13,85,392
8985,dark,main,20211029,0,0.994901299767603,292,16,85,393
8985,dark,main,20211029,1,0.9877335131379755,236,10,80,326
8985,dark,main,20211029,2,0.98435496610508,225,13,82,320
8985,dark,main,20211029,3,0.9928897074544433,230,13,94,337
8985,dark,main,20211029,4,0.9931199161484843,235,16,109,360
8985,dark,main,20211029,5,0.9914123061491364,259,17,98,374
8985,dark,main,20211029,6,0.993171400160531,257,12,93,362
8985,dark,main,20211029,7,0.9910939648418567,230,11,90,331
8985,dark,main,20211029,8,0.9906182127066671,254,15,90,359
8985,dark,main,20211029,9,0.9897219762587603,268,15,94,377
2438,dark,main,20211029,0,0.98788806321325,290,14,97,401
2438,dark,main,20211029,1,0.9900257210671106,243,12,83,338
2438,dark,main,20211029,2,0.9916587655454691,250,10,77,337
2438,dark,main,20211029,3,0.9904123229914803,266,11,75,352
2438,dark,main,20211029,4,0.9896681338510975,257,12,89,358
2438,dark,main,20211029,5,0.9868580611298097,279,11,88,378
2438,dark,main,20211029,6,0.99152215372588,298,12,63,373
2438,dark,main,20211029,7,0.987408362245491,241,12,89,342
2438,dark,main,20211029,8,0.9887349763132338,282,11,90,383
2438,dark,main,20211029,9,0.9859221980696926,263,11,117,391
7785,dark,main,20211029,0,0.9912564094869921,255,16,109,380
7785,dark,main,20211029,1,0.9932147488450161,240,15,84,339
7785,dark,main,20211029,2,0.990471604048715,226,16,77,319
7785,dark,main,20211029,3,0.9895929093053354,241,18,86,345
7785,dark,main,20211029,4,0.9915415405148846,237,16,93,346
7785,dark,main,20211029,5,0.9954814023342007,249,16,99,364
7785,dark,main,20211029,6,0.9901348682971021,261,16,79,356
7785,dark,main,20211029,7,0.9889863623394151,233,17,78,328
7785,dark,main,20211029,8,0.9950247305449271,275,15,87,377
7785,dark,main,20211029,9,0.9889102639358174,265,14,91,370
11826,dark,main,20211029,0,0.9942843958774916,280,14,82,376
11826,dark,main,20211029,1,0.9887024460303241,245,10,84,339
11826,dark,main,20211029,2,0.986699083279355,238,13,85,336
11826,dark,main,20211029,3,0.9947336422302877,260,14,86,360
11826,dark,main,20211029,4,0.9925999599429368,266,15,79,360
11826,dark,main,20211029,5,0.985478500929695,266,11,97,374
11826,dark,main,20211029,6,0.9897228680324293,271,11,87,369
11826,dark,main,20211029,7,0.9857895025373835,248,14,75,337
11826,dark,main,20211029,8,0.9908315473768324,275,15,96,386
11826,dark,main,20211029,9,0.9963534949300374,267,10,100,377
82409,backup,special,20211030,0,0.990260847678741,2,409,0,411
82409,backup,special,20211030,1,0.9937963737688342,4,342,0,346
82409,backup,special,20211030,2,0.9926343539236887,3,403,0,406
82409,backup,special,20211030,3,0.9940594380987682,7,355,0,362
82409,backup,special,20211030,4,0.9922923485588424,8,360,0,368
82409,backup,special,20211030,5,0.9910855542542062,4,377,0,381
82409,backup,special,20211030,6,0.994618491064808,8,387,0,395
82409,backup,special,20211030,7,0.9876895653676359,5,333,0,338
82409,backup,special,20211030,8,0.9930259282648464,6,386,0,392
82409,backup,special,20211030,9,0.9912945615759267,2,396,0,398
2232,dark,main,20211030,0,0.9886719319887028,282,17,94,393
2232,dark,main,20211030,1,0.9812170848790883,235,15,79,329
2232,dark,main,20211030,2,0.9930593330309515,280,13,81,374
2232,dark,main,20211030,3,0.9875673482085491,247,20,80,347
2232,dark,main,20211030,4,0.9949706379100791,254,14,94,362
2232,dark,main,20211030,5,0.9852960478860343,260,17,81,358
2232,dark,main,20211030,6,0.9933895589364917,283,14,86,383
2232,dark,main,20211030,7,0.9869888858029819,239,16,74,329
2232,dark,main,20211030,8,0.992406675636162,254,19,105,378
2232,dark,main,20211030,9,0.9969047373382736,262,14,94,370
82267,bright,special,20211030,0,0.9891769157696582,349,93,3,445
82267,bright,special,20211030,1,0.9907170722438988,286,97,5,388
82267,bright,special,20211030,2,0.9923458118806362,345,89,2,436
82267,bright,special,20211030,3,0.9937072640721599,295,96,5,396
82267,bright,special,20211030,4,0.9920053645346245,314,86,4,404
82267,bright,special,20211030,5,0.9912227590698095,326,83,3,412
82267,bright,special,20211030,6,0.9898410237407111,301,64,3,368
82267,bright,special,20211030,7,0.9916200102362325,297,70,3,370
82267,bright,special,20211030,8,0.9889414062181607,350,73,1,424
82267,bright,special,20211030,9,0.9915680029120076,341,84,6,431
82407,backup,special,20211030,0,0.9916983205269583,1,422,0,423
82407,backup,special,20211030,1,0.9940160272577611,3,353,0,356
82407,backup,special,20211030,2,0.9953620747453163,2,419,0,421
82407,backup,special,20211030,3,0.9905277775627779,4,376,0,380
82407,backup,special,20211030,4,0.9940115819919901,1,388,0,389
82407,backup,special,20211030,5,0.995136640073642,3,400,0,403
82407,backup,special,20211030,6,0.9936999257007221,8,399,0,407
82407,backup,special,20211030,7,0.9908242472449332,6,347,0,353
82407,backup,special,20211030,8,0.9933990594860359,0,403,0,403
82407,backup,special,20211030,9,0.9922538698570688,4,396,1,401
82408,backup,special,20211030,0,0.9928493862690781,7,414,0,421
82408,backup,special,20211030,1,0.9862910500911517,1,360,1,362
82408,backup,special,20211030,2,0.9845531768009937,7,411,0,418
82408,backup,special,20211030,3,0.9974772182279542,3,374,1,378
82408,backup,special,20211030,4,0.9918841246914432,3,383,0,386
82408,backup,special,20211030,5,0.9908967023790322,2,387,0,389
82408,backup,special,20211030,6,0.9903854401289542,8,384,0,392
82408,backup,special,20211030,7,0.9904601223462821,1,335,0,336
82408,backup,special,20211030,8,0.99438031434827,3,385,0,388
82408,backup,special,20211030,9,0.9908909291704877,3,395,0,398
3276,dark,main,20211030,0,0.994007274551118,293,20,87,400
3276,dark,main,20211030,1,0.9878342764345365,239,17,71,327
3276,dark,main,20211030,2,0.9927657897662692,275,13,102,390
3276,dark,main,20211030,3,0.9818627447585342,243,16,86,345
3276,dark,main,20211030,4,0.9894376383516067,251,12,81,344
3276,dark,main,20211030,5,0.9958350832536792,256,12,83,351
3276,dark,main,20211030,6,0.9870463611358329,253,9,101,363
3276,dark,main,20211030,7,0.9826393557475767,214,14,78,306
3276,dark,main,20211030,8,0.9892184604780612,282,13,78,373
3276,dark,main,20211030,9,0.9967955512349407,270,11,83,364
82262,bright,special,20211030,0,0.9936129116379471,313,114,6,433
82262,bright,special,20211030,1,0.9886403750517346,328,51,1,380
82262,bright,special,20211030,2,0.9932569831552486,347,83,5,435
82262,bright,special,20211030,3,0.9940187738149737,277,103,3,383
82262,bright,special,20211030,4,0.9930181516277351,293,106,2,401
82262,bright,special,20211030,5,0.9931796175262623,276,135,4,415
82262,bright,special,20211030,6,0.9885334738243675,243,108,4,355
82262,bright,special,20211030,7,0.9954374267093995,253,107,1,361
82262,bright,special,20211030,8,0.9929802992747225,306,111,4,421
82262,bright,special,20211030,9,0.9969519880376515,317,107,2,426
10078,dark,main,20211030,0,0.9947320241828222,272,16,91,379
10078,dark,main,20211030,1,0.9801674887645654,243,12,70,325
10078,dark,main,20211030,2,0.9939060229071415,284,17,80,381
10078,dark,main,20211030,3,0.9887076716556997,262,12,69,343
10078,dark,main,20211030,4,0.9923025719078759,245,14,93,352
10078,dark,main,20211030,5,0.9931488580169431,254,32,83,369
10078,dark,main,20211030,6,0.9922324277493636,264,17,87,368
10078,dark,main,20211030,7,0.9895090461724059,218,25,74,317
10078,dark,main,20211030,8,0.9868448412922867,267,19,93,379
10078,dark,main,20211030,9,0.994353759240096,252,20,93,365
9650,dark,main,20211030,0,0.9951131330129428,266,20,101,387
9650,dark,main,20211030,1,0.9896879016825108,247,12,70,329
9650,dark,main,20211030,2,0.9944448680035616,278,22,98,398
9650,dark,main,20211030,3,0.9837903556013843,232,28,81,341
9650,dark,main,20211030,4,0.9880818357374919,255,13,77,345
9650,dark,main,20211030,5,0.9912404989844588,253,20,95,368
9650,dark,main,20211030,6,0.9901172117700371,269,29,85,383
9650,dark,main,20211030,7,0.9844122602910474,221,21,81,323
9650,dark,main,20211030,8,0.9941911439126417,272,18,80,370
9650,dark,main,20211030,9,0.9936806657193484,260,14,85,359
11632,dark,main,20211030,0,0.9931384565621663,305,13,76,394
11632,dark,main,20211030,1,0.9908445347154252,255,10,83,348
11632,dark,main,20211030,2,0.9879289584624588,278,17,95,390
11632,dark,main,20211030,3,0.9930903799488771,270,12,64,346
11632,dark,main,20211030,4,0.9918563725587108,243,17,88,348
11632,dark,main,20211030,5,0.985030063778447,257,13,85,355
11632,dark,main,20211030,6,0.9918141154377558,245,14,113,372
11632,dark,main,20211030,7,0.989634595096019,224,15,83,322
11632,dark,main,20211030,8,0.9914749131156774,273,11,86,370
11632,dark,main,20211030,9,0.9854117895764525,285,12,84,381
5174,dark,main,20211030,0,0.9930173731312095,281,15,94,390
5174,dark,main,20211030,1,0.9897645834586396,224,11,90,325
5174,dark,main,20211030,2,0.9855801879883276,270,12,110,392
5174,dark,main,20211030,3,0.9826797828283917,263,14,63,340
5174,dark,main,20211030,4,0.994454895670302,253,13,83,349
5174,dark,main,20211030,5,0.9843909560800248,251,11,100,362
5174,dark,main,20211030,6,0.9878757996581433,265,12,96,373
5174,dark,main,20211030,7,0.9894205258200637,227,10,80,317
5174,dark,main,20211030,8,0.9909940145632176,263,20,84,367
5174,dark,main,20211030,9,0.9856497935242012,283,15,83,381
4845,dark,main,20211030,0,0.9911335836808788,310,16,86,412
4845,dark,main,20211030,1,0.991733140539286,246,15,76,337
4845,dark,main,20211030,2,0.9907547160687166,256,16,92,364
4845,dark,main,20211030,3,0.9888894328017898,248,19,93,360
4845,dark,main,20211030,4,0.9912784859793281,260,10,79,349
4845,dark,main,20211030,5,0.9925076107757463,261,17,74,352
4845,dark,main,20211030,6,0.9926092531243991,260,10,94,364
4845,dark,main,20211030,7,0.9933756367306951,235,14,76,325
4845,dark,main,20211030,8,0.9938152701194788,295,11,89,395
4845,dark,main,20211030,9,0.985758521897672,288,17,63,368
9618,dark,main,20211030,0,0.9922466984347443,285,22,72,379
9618,dark,main,20211030,1,0.9921896128396422,267,12,52,331
9618,dark,main,20211030,2,0.9910754995756322,308,19,54,381
9618,dark,main,20211030,3,0.9910624644432632,236,25,76,337
9618,dark,main,20211030,4,0.9891017315386497,232,24,96,352
9618,dark,main,20211030,5,0.9915530351622776,274,19,75,368
9618,dark,main,20211030,6,0.9874763448888294,267,15,80,362
9618,dark,main,20211030,7,0.9878144013401975,226,15,85,326
9618,dark,main,20211030,8,0.9835042584180156,277,22,89,388
9618,dark,main,20211030,9,0.994995065564648,316,14,53,383
82266,bright,special,20211030,0,0.9912410599659291,357,56,11,424
82266,bright,special,20211030,1,0.9724566247642226,172,17,2,191
82266,bright,special,20211030,2,0.9940217908755563,342,62,4,408
82266,bright,special,20211030,3,0.9954385045856765,262,90,4,356
82266,bright,special,20211030,4,0.9859025468060665,166,29,1,196
82266,bright,special,20211030,5,0.9922575246707517,318,66,4,388
82266,bright,special,20211030,6,0.9935011724330008,286,59,5,350
82266,bright,special,20211030,7,0.9887141387425609,274,68,7,349
82266,bright,special,20211030,8,0.9934714152870937,319,64,6,389
82266,bright,special,20211030,9,0.9957704792700208,350,56,9,415
2246,dark,main,20211030,0,0.9951904651149239,293,21,76,390
2246,dark,main,20211030,1,0.9915770021128875,247,14,74,335
2246,dark,main,20211030,2,0.9920867284568656,275,13,95,383
2246,dark,main,20211030,3,0.9895325761772461,251,17,82,350
2246,dark,main,20211030,4,0.9831932219986562,246,19,85,350
2246,dark,main,20211030,5,0.9910314958345037,272,13,84,369
2246,dark,main,20211030,6,0.9908397402010309,247,14,89,350
2246,dark,main,20211030,7,0.990814374319556,242,12,71,325
2246,dark,main,20211030,8,0.9927808138078233,288,11,72,371
2246,dark,main,20211030,9,0.9938455039619519,288,12,89,389
5126,dark,main,20211030,0,0.9880491505871152,278,13,99,390
5126,dark,main,20211030,1,0.9949364733465287,264,14,64,342
5126,dark,main,20211030,2,0.9918413379431272,279,36,86,401
5126,dark,main,20211030,3,0.9933316062200047,245,16,81,342
5126,dark,main,20211030,4,0.9847220648636823,261,12,84,357
5126,dark,main,20211030,5,0.9875226912969898,267,15,84,366
5126,dark,main,20211030,6,0.9907029875854501,294,10,79,383
5126,dark,main,20211030,7,0.9916982127167971,220,15,87,322
5126,dark,main,20211030,8,0.9899039049803638,262,14,97,373
5126,dark,main,20211030,9,0.9920688369197875,281,12,90,383
9851,dark,main,20211030,0,0.9909774673480258,258,18,104,380
9851,dark,main,20211030,1,0.9918382137394359,235,15,96,346
9851,dark,main,20211030,2,0.9870871788441591,286,15,88,389
9851,dark,main,20211030,3,0.9959138595583708,255,15,99,369
9851,dark,main,20211030,4,0.9909994334225306,262,13,81,356
9851,dark,main,20211030,5,0.9877196468841436,264,13,97,374
9851,dark,main,20211030,6,0.9872378049135265,257,12,85,354
9851,dark,main,20211030,7,0.9879895158074334,224,19,74,317
9851,dark,main,20211030,8,0.9885048124555986,275,13,92,380
9851,dark,main,20211030,9,0.994701298432922,260,11,102,373
20839,bright,main,20211030,0,0.9884375745703786,340,86,8,434
20839,bright,main,20211030,1,0.9921706256107758,265,113,4,382
20839,bright,main,20211030,2,0.9935753411963659,384,47,2,433
20839,bright,main,20211030,3,0.9936364612262121,330,64,4,398
20839,bright,main,20211030,4,0.9899704891675553,325,71,5,401
20839,bright,main,20211030,5,0.9955621774969022,325,81,6,412
20839,bright,main,20211030,6,0.9859518848940882,345,83,2,430
20839,bright,main,20211030,7,0.9921024717065686,308,62,1,371
20839,bright,main,20211030,8,0.9967403523539726,328,94,2,424
20839,bright,main,20211030,9,0.9903713503065623,319,100,3,422
20876,bright,main,20211030,0,0.9947889188338734,318,117,4,439
20876,bright,main,20211030,1,0.9921789234355353,294,83,3,380
20876,bright,main,20211030,2,0.994659946518884,323,108,3,434
20876,bright,main,20211030,3,0.9912256082285505,284,115,3,402
20876,bright,main,20211030,4,0.9936817212625685,312,89,0,401
20876,bright,main,20211030,5,0.9939365301273126,314,94,7,415
20876,bright,main,20211030,6,0.9917572021763513,329,94,6,429
20876,bright,main,20211030,7,0.9903292278359949,286,86,3,375
20876,bright,main,20211030,8,0.9863890309603974,325,101,3,429
20876,bright,main,20211030,9,0.9917948579455551,299,129,4,432
6707,dark,main,20211030,0,0.9933098652931414,292,18,83,393
6707,dark,main,20211030,1,0.9912416477627,250,11,68,329
6707,dark,main,20211030,2,0.9950605548362749,289,13,95,397
6707,dark,main,20211030,3,0.9921195487742681,257,14,82,353
6707,dark,main,20211030,4,0.987764970611755,248,10,88,346
6707,dark,main,20211030,5,0.9875739552387164,244,15,101,360
6707,dark,main,20211030,6,0.9872139724794861,297,13,78,388
6707,dark,main,20211030,7,0.988217560732158,228,16,82,326
6707,dark,main,20211030,8,0.9933550022717221,252,15,82,349
6707,dark,main,20211030,9,0.9895190104825117,275,14,80,369
82402,backup,special,20211030,0,0.9934885874165109,8,429,1,438
82402,backup,special,20211030,1,0.9904398153350871,9,373,0,382
82402,backup,special,20211030,2,0.9936166174318077,4,431,0,435
82402,backup,special,20211030,3,0.9886815358938295,2,385,0,387
82402,backup,special,20211030,4,0.990460640073938,5,363,0,368
82402,backup,special,20211030,5,0.9924228869004941,7,375,0,382
82402,backup,special,20211030,6,0.9921459974251087,3,390,0,393
82402,backup,special,20211030,7,0.9922077520297119,2,340,0,342
82402,backup,special,20211030,8,0.9956443425172464,5,421,0,426
82402,backup,special,20211030,9,0.9928634745253608,3,427,0,430
2258,dark,main,20211030,0,0.994031940464048,274,14,97,385
2258,dark,main,20211030,1,0.9807136919241597,218,13,83,314
2258,dark,main,20211030,2,0.9912351744486607,284,12,89,385
2258,dark,main,20211030,3,0.9847728973119424,253,17,76,346
2258,dark,main,20211030,4,0.9941616795278039,247,17,91,355
2258,dark,main,20211030,5,0.9885317431655001,270,19,88,377
2258,dark,main,20211030,6,0.9892202831849576,245,19,104,368
2258,dark,main,20211030,7,0.9930834004095724,227,16,88,331
2258,dark,main,20211030,8,0.9972951705025804,245,15,110,370
2258,dark,main,20211030,9,0.9902527523271326,255,15,104,374
25555,bright,main,20211030,0,0.9936848628989537,367,71,1,439
25555,bright,main,20211030,1,0.9960479707656955,308,74,0,382
25555,bright,main,20211030,2,0.9928383154461636,371,64,3,438
25555,bright,main,20211030,3,0.9930029271895685,327,75,0,402
25555,bright,main,20211030,4,0.9906087927439836,301,97,3,401
25555,bright,main,20211030,5,0.9948139139531191,316,98,7,421
25555,bright,main,20211030,6,0.9914091658003024,334,95,2,431
25555,bright,main,20211030,7,0.9927456876978944,302,71,3,376
25555,bright,main,20211030,8,0.9886487411404551,316,93,3,412
25555,bright,main,20211030,9,0.9894098110479225,354,72,4,430
9659,dark,main,20211030,0,0.9905937689233735,277,21,97,395
9659,dark,main,20211030,1,0.9885020658118383,239,19,75,333
9659,dark,main,20211030,2,0.9875268921791167,266,19,87,372
9659,dark,main,20211030,3,0.9880061632364261,256,15,78,349
9659,dark,main,20211030,4,0.9900649373642171,244,15,82,341
9659,dark,main,20211030,5,0.9913926286197383,260,13,75,348
9659,dark,main,20211030,6,0.9888902124860081,281,15,70,366
9659,dark,main,20211030,7,0.992372185878622,226,16,79,321
9659,dark,main,20211030,8,0.9932424690930668,271,15,93,379
9659,dark,main,20211030,9,0.9895432052526865,283,16,84,383
6706,dark,main,20211030,0,0.9913256751429156,275,14,105,394
6706,dark,main,20211030,1,0.9842032475301525,229,14,83,326
6706,dark,main,20211030,2,0.9905573362679909,279,13,94,386
6706,dark,main,20211030,3,0.9873473552332679,269,16,68,353
6706,dark,main,20211030,4,0.9929491646242721,249,13,103,365
6706,dark,main,20211030,5,0.9884370242448486,278,13,79,370
6706,dark,main,20211030,6,0.9924807519165065,276,17,93,386
6706,dark,main,20211030,7,0.9845232595948984,245,12,74,331
6706,dark,main,20211030,8,0.9913457125890632,279,12,85,376
6706,dark,main,20211030,9,0.9907360048173652,289,12,73,374
11177,dark,main,20211030,0,0.9964988660245105,253,48,80,381
11177,dark,main,20211030,1,0.9934150618189281,216,34,78,328
11177,dark,main,20211030,2,0.9943205912403884,277,25,89,391
11177,dark,main,20211030,3,0.9929771149540562,229,41,79,349
11177,dark,main,20211030,4,0.9887627203264857,240,27,81,348
11177,dark,main,20211030,5,0.9899918530298131,249,32,80,361
11177,dark,main,20211030,6,0.9958537098691227,262,17,90,369
11177,dark,main,20211030,7,0.99087501739035,225,22,75,322
11177,dark,main,20211030,8,0.998534315726445,270,20,90,380
11177,dark,main,20211030,9,0.9924173405322672,258,33,69,360
9843,dark,main,20211030,0,0.9841437080753317,271,17,86,374
9843,dark,main,20211030,1,0.9911970141712839,232,13,86,331
9843,dark,main,20211030,2,0.9874102270660322,287,14,86,387
9843,dark,main,20211030,3,0.993071430473239,261,15,74,350
9843,dark,main,20211030,4,0.9962783863776803,273,10,81,364
9843,dark,main,20211030,5,0.9905516304252644,256,16,85,357
9843,dark,main,20211030,6,0.9885707546871246,256,13,94,363
9843,dark,main,20211030,7,0.9933446052242183,234,12,77,323
9843,dark,main,20211030,8,0.9909490670574574,258,17,96,371
9843,dark,main,20211030,9,0.9745820127906192,260,13,101,374
3833,dark,main,20211030,0,0.9834697579946734,271,17,99,387
3833,dark,main,20211030,1,0.9899647798480907,236,16,84,336
3833,dark,main,20211030,2,0.9913821364036902,278,18,86,382
3833,dark,main,20211030,3,0.9892080223045953,252,18,79,349
3833,dark,main,20211030,4,0.9924263358948988,259,16,73,348
3833,dark,main,20211030,5,0.9895460476753201,261,13,95,369
3833,dark,main,20211030,6,0.9893410237613681,255,18,105,378
3833,dark,main,20211030,7,0.9938298245302734,239,13,77,329
3833,dark,main,20211030,8,0.9901287671675968,256,17,108,381
3833,dark,main,20211030,9,0.9922159106707059,256,14,94,364
1169,dark,main,20211031,0,0.9892072616722999,268,18,87,373
1169,dark,main,20211031,1,0.9793461973995369,235,13,96,344
1169,dark,main,20211031,2,0.9899602457016329,250,21,102,373
1169,dark,main,20211031,3,0.9834236189444412,257,15,92,364
1169,dark,main,20211031,4,0.9904513964969108,251,16,85,352
1169,dark,main,20211031,5,0.9930972780731203,260,9,106,375
1169,dark,main,20211031,6,0.9948642882603472,261,12,106,379
1169,dark,main,20211031,7,0.9807413753115927,213,13,100,326
1169,dark,main,20211031,8,0.9915851497830606,228,15,110,353
1169,dark,main,20211031,9,0.9944745452339016,249,14,100,363
20982,bright,main,20211031,0,0.9905806604375726,389,48,3,440
20982,bright,main,20211031,1,0.9840416647728699,310,53,7,370
20982,bright,main,20211031,2,0.9924590137824533,368,62,5,435
20982,bright,main,20211031,3,0.9922058518996844,309,70,4,383
20982,bright,main,20211031,4,0.9946418247803895,323,67,6,396
20982,bright,main,20211031,5,0.9927107959727306,358,46,3,407
20982,bright,main,20211031,6,0.9918856741940202,348,66,2,416
20982,bright,main,20211031,7,0.9904952893064446,306,56,2,364
20982,bright,main,20211031,8,0.9886293366235668,352,54,8,414
20982,bright,main,20211031,9,0.9964171689767455,375,44,3,422
6394,dark,main,20211031,0,0.9939045015527807,283,11,99,393
6394,dark,main,20211031,1,0.9966832596830973,250,10,70,330
6394,dark,main,20211031,2,0.9944000896666694,292,15,86,393
6394,dark,main,20211031,3,0.9867562953375885,264,16,73,353
6394,dark,main,20211031,4,0.9903682558450704,266,13,76,355
6394,dark,main,20211031,5,0.992375619800712,257,13,97,367
6394,dark,main,20211031,6,0.9902799495234986,279,8,98,385
6394,dark,main,20211031,7,0.9922461012620981,218,11,94,323
6394,dark,main,20211031,8,0.9927124043781145,267,27,89,383
6394,dark,main,20211031,9,0.9861188457029321,261,15,103,379
4681,dark,main,20211031,0,0.9860258891778801,173,20,79,272
4681,dark,main,20211031,1,0.9847024161076001,204,17,77,298
4681,dark,main,20211031,2,0.9923105452697698,286,20,78,384
4681,dark,main,20211031,3,0.9908300528811298,264,22,67,353
4681,dark,main,20211031,4,0.9941282050082202,245,15,80,340
4681,dark,main,20211031,5,0.9851972575899435,247,15,88,350
4681,dark,main,20211031,6,0.9953246444772269,272,14,88,374
4681,dark,main,20211031,7,0.9940131868453217,237,15,78,330
4681,dark,main,20211031,8,0.9910297322209545,251,20,93,364
4681,dark,main,20211031,9,0.9934746756729268,245,19,72,336
11354,dark,main,20211031,0,0.9950725973202051,298,17,91,406
11354,dark,main,20211031,1,0.984985603105497,237,21,79,337
11354,dark,main,20211031,2,0.98959751044529,270,27,92,389
11354,dark,main,20211031,3,0.987522768983803,245,10,88,343
11354,dark,main,20211031,4,0.9937265048905953,264,17,77,358
11354,dark,main,20211031,5,0.9905045787723045,271,19,88,378
11354,dark,main,20211031,6,0.9961225245172475,271,17,94,382
11354,dark,main,20211031,7,0.9926066008028415,253,15,68,336
11354,dark,main,20211031,8,0.9933660588494087,266,13,79,358
11354,dark,main,20211031,9,0.99664510051534,275,14,90,379
25668,bright,main,20211031,0,0.994895705973588,326,82,4,412
25668,bright,main,20211031,1,0.9912694752063351,282,67,2,351
25668,bright,main,20211031,2,0.99105331924587,343,70,8,421
25668,bright,main,20211031,3,0.9875335532711893,315,68,4,387
25668,bright,main,20211031,4,0.9908746044905604,307,78,1,386
25668,bright,main,20211031,5,0.9919231952437615,295,92,3,390
25668,bright,main,20211031,6,0.9921527835553949,332,73,2,407
25668,bright,main,20211031,7,0.9905092663055041,289,52,7,348
25668,bright,main,20211031,8,0.9884711814131842,313,82,6,401
25668,bright,main,20211031,9,0.9886738252098766,322,82,4,408
10949,dark,main,20211031,0,0.9855108439832128,283,29,72,384
10949,dark,main,20211031,1,0.9904327430562183,216,11,89,316
10949,dark,main,20211031,2,0.9922624498237015,279,20,79,378
10949,dark,main,20211031,3,0.9915969821701499,258,18,77,353
10949,dark,main,20211031,4,0.9926893949688644,251,17,75,343
10949,dark,main,20211031,5,0.9901312550153533,243,19,90,352
10949,dark,main,20211031,6,0.9967117754061227,241,20,100,361
10949,dark,main,20211031,7,0.9933324192408971,221,17,95,333
10949,dark,main,20211031,8,0.9931511479905365,251,22,97,370
10949,dark,main,20211031,9,0.9931177170753482,268,15,71,354
10693,dark,main,20211031,0,0.9889341520300602,279,14,95,388
10693,dark,main,20211031,1,0.9817478309587532,239,21,71,331
10693,dark,main,20211031,2,0.9873089941259147,260,17,98,375
10693,dark,main,20211031,3,0.9956399055584257,235,24,87,346
10693,dark,main,20211031,4,0.9938730281452419,241,21,85,347
10693,dark,main,20211031,5,0.9932217622186168,244,19,82,345
10693,dark,main,20211031,6,0.995058766180183,258,24,77,359
10693,dark,main,20211031,7,0.9907929190906448,232,22,73,327
10693,dark,main,20211031,8,0.991574394229927,249,20,104,373
10693,dark,main,20211031,9,0.9905187342306038,244,18,107,369
5278,dark,main,20211031,0,0.9935938745628379,306,23,81,410
5278,dark,main,20211031,1,0.9906655446384205,242,23,62,327
5278,dark,main,20211031,2,0.993919390906929,294,23,77,394
5278,dark,main,20211031,3,0.9954375110439153,248,25,74,347
5278,dark,main,20211031,4,0.990408177444937,251,26,88,365
5278,dark,main,20211031,5,0.9935500241680087,250,37,77,364
5278,dark,main,20211031,6,0.9934475979159593,278,27,76,381
5278,dark,main,20211031,7,0.9932767268678456,233,33,77,343
5278,dark,main,20211031,8,0.9889373155785002,266,31,80,377
5278,dark,main,20211031,9,0.9890208359431,274,24,71,369
1517,dark,main,20211031,0,0.9910393979272477,277,21,92,390
1517,dark,main,20211031,1,0.9930321796956285,251,13,71,335
1517,dark,main,20211031,2,0.992649340719664,276,16,88,380
1517,dark,main,20211031,3,0.9838853046380374,259,18,67,344
1517,dark,main,20211031,4,0.99302522477537,240,18,81,339
1517,dark,main,20211031,5,0.9963447955886264,265,14,74,353
1517,dark,main,20211031,6,0.9934661864959476,267,17,88,372
1517,dark,main,20211031,7,0.9858076227222233,237,18,79,334
1517,dark,main,20211031,8,0.9952850499092655,257,16,98,371
1517,dark,main,20211031,9,0.9916370320716053,259,20,97,376
5109,dark,main,20211031,0,0.9939148023614885,295,16,82,393
5109,dark,main,20211031,1,0.9873027585659094,253,20,64,337
5109,dark,main,20211031,2,0.9936905960337176,279,18,99,396
5109,dark,main,20211031,3,0.9895715404320415,230,20,101,351
5109,dark,main,20211031,4,0.9911467598596754,228,24,88,340
5109,dark,main,20211031,5,0.9941124893251668,249,19,90,358
5109,dark,main,20211031,6,0.9927860848216042,267,22,88,377
5109,dark,main,20211031,7,0.9892518262946234,255,18,64,337
5109,dark,main,20211031,8,0.9827903345375492,271,15,94,380
5109,dark,main,20211031,9,0.9911940960123409,263,19,90,372
6668,dark,main,20211031,0,0.9935717782744395,289,11,92,392
6668,dark,main,20211031,1,0.9899098950748191,247,10,83,340
6668,dark,main,20211031,2,0.9900698505140129,259,16,107,382
6668,dark,main,20211031,3,0.9936131488196981,256,12,90,358
6668,dark,main,20211031,4,0.9943828971541537,258,11,85,354
6668,dark,main,20211031,5,0.9885828664454362,264,14,86,364
6668,dark,main,20211031,6,0.9960094925465576,260,15,104,379
6668,dark,main,20211031,7,0.9918153780415787,221,12,88,321
6668,dark,main,20211031,8,0.9853183874014327,261,11,104,376
6668,dark,main,20211031,9,0.9911732198159934,281,13,90,384
6384,dark,main,20211031,0,0.9959406704680142,274,12,105,391
6384,dark,main,20211031,1,0.9837509258516868,238,15,74,327
6384,dark,main,20211031,2,0.9949130831454595,267,12,111,390
6384,dark,main,20211031,3,0.9859225226574405,241,13,105,359
6384,dark,main,20211031,4,0.9933846866811129,250,11,94,355
6384,dark,main,20211031,5,0.9943960595026031,269,11,94,374
6384,dark,main,20211031,6,0.9965629328100436,293,11,71,375
6384,dark,main,20211031,7,0.9917094631891229,233,10,85,328
6384,dark,main,20211031,8,0.9906113709769983,266,12,95,373
6384,dark,main,20211031,9,0.9913251872055765,274,19,84,377
7407,dark,main,20211031,0,0.9878540644788791,272,18,96,386
7407,dark,main,20211031,1,0.9907096175806883,238,14,78,330
7407,dark,main,20211031,2,0.9965709472386076,240,19,111,370
7407,dark,main,20211031,3,0.9899643771812006,222,23,112,357
7407,dark,main,20211031,4,0.9918620599331407,247,13,88,348
7407,dark,main,20211031,5,0.9957064159685927,256,17,87,360
7407,dark,main,20211031,6,0.9891375955951623,254,14,101,369
7407,dark,main,20211031,7,0.9891633083457161,240,14,83,337
7407,dark,main,20211031,8,0.9894556259358024,250,17,95,362
7407,dark,main,20211031,9,0.9882047814550089,275,15,80,370
4302,dark,main,20211031,0,0.9948797568408291,253,18,106,377
4302,dark,main,20211031,1,0.9949802039621649,226,15,84,325
4302,dark,main,20211031,2,0.9891482702464942,264,22,88,374
4302,dark,main,20211031,3,0.9872943124129183,244,21,75,340
4302,dark,main,20211031,4,0.9950666253847745,262,15,78,355
4302,dark,main,20211031,5,0.9874819543714213,257,16,79,352
4302,dark,main,20211031,6,0.9905483008244788,243,14,102,359
4302,dark,main,20211031,7,0.9923660549131434,234,20,76,330
4302,dark,main,20211031,8,0.9921764832461923,261,17,89,367
4302,dark,main,20211031,9,0.9897519073305464,263,14,104,381
11239,dark,main,20211031,0,0.9961075263196092,267,19,94,380
11239,dark,main,20211031,1,0.9781226639126269,238,17,82,337
11239,dark,main,20211031,2,0.9890615727685158,271,18,90,379
11239,dark,main,20211031,3,0.9874625860102451,243,19,89,351
11239,dark,main,20211031,4,0.9908984616796109,252,26,81,359
11239,dark,main,20211031,5,0.9926103217558312,233,32,110,375
11239,dark,main,20211031,6,0.9929202075930674,250,18,111,379
11239,dark,main,20211031,7,0.9904448623888295,219,21,84,324
11239,dark,main,20211031,8,0.9867025387207665,246,27,100,373
11239,dark,main,20211031,9,0.9916962787453638,278,16,91,385
2475,dark,main,20211031,0,0.9912778288428773,278,14,94,386
2475,dark,main,20211031,1,0.9843333049511628,227,10,99,336
2475,dark,main,20211031,2,0.9940538167409193,270,12,108,390
2475,dark,main,20211031,3,0.9970704425711097,251,16,93,360
2475,dark,main,20211031,4,0.991559598125892,268,10,79,357
2475,dark,main,20211031,5,0.9869993709355883,272,11,94,377
2475,dark,main,20211031,6,0.9951378784543988,265,11,108,384
2475,dark,main,20211031,7,0.9939610653709227,212,14,102,328
2475,dark,main,20211031,8,0.9913606573059639,267,15,99,381
2475,dark,main,20211031,9,0.9908719426961585,247,14,115,376
2436,dark,main,20211031,0,0.9906313290292906,229,65,73,367
2436,dark,main,20211031,1,0.9927899534691544,244,12,85,341
2436,dark,main,20211031,2,0.991621591102776,289,12,89,390
2436,dark,main,20211031,3,0.9898036778220713,262,15,83,360
2436,dark,main,20211031,4,0.9936724854978016,260,17,80,357
2436,dark,main,20211031,5,0.9872913598498687,276,15,92,383
2436,dark,main,20211031,6,0.983926636755068,286,9,89,384
2436,dark,main,20211031,7,0.9910090162321004,241,13,95,349
2436,dark,main,20211031,8,0.9880235966626895,292,13,90,395
2436,dark,main,20211031,9,0.9961091083812754,264,15,99,378
6374,dark,main,20211031,0,0.9915853232395282,251,15,108,374
6374,dark,main,20211031,1,0.9817114997342192,221,14,88,323
6374,dark,main,20211031,2,0.9945589645060368,293,15,88,396
6374,dark,main,20211031,3,0.994409034884632,250,14,93,357
6374,dark,main,20211031,4,0.9976831567567725,258,14,89,361
6374,dark,main,20211031,5,0.9930521181078745,277,11,80,368
6374,dark,main,20211031,6,0.9865064027432089,289,11,85,385
6374,dark,main,20211031,7,0.9854204320428647,232,13,85,330
6374,dark,main,20211031,8,0.9923951828259736,283,11,85,379
6374,dark,main,20211031,9,0.9921894988517341,250,17,104,371
2389,dark,main,20211031,0,0.9938904037181846,279,17,101,397
2389,dark,main,20211031,1,0.9886141403342319,223,20,91,334
2389,dark,main,20211031,2,0.9970781335967116,275,16,87,378
2389,dark,main,20211031,3,0.9914638848322773,252,17,89,358
2389,dark,main,20211031,4,0.9947448323534918,250,13,83,346
2389,dark,main,20211031,5,0.9936443880198376,282,15,72,369
2389,dark,main,20211031,6,0.9934561667285053,263,16,90,369
2389,dark,main,20211031,7,0.989930928127426,232,13,80,325
2389,dark,main,20211031,8,0.9901224360903498,268,15,94,377
2389,dark,main,20211031,9,0.9904849918454068,279,18,89,386
8736,dark,main,20211031,0,0.9913789149857607,277,17,103,397
8736,dark,main,20211031,1,0.9917682365250887,229,11,92,332
8736,dark,main,20211031,2,0.9911394096927225,255,12,109,376
8736,dark,main,20211031,3,0.9897071596775884,257,13,81,351
8736,dark,main,20211031,4,0.9828664558978726,224,13,112,349
8736,dark,main,20211031,5,0.9920399067433492,272,10,85,367
8736,dark,main,20211031,6,0.9886898403564044,281,11,86,378
8736,dark,main,20211031,7,0.9815885825552818,242,11,85,338
8736,dark,main,20211031,8,0.9880194704741481,279,12,100,391
8736,dark,main,20211031,9,0.9957175635909855,275,11,95,381
22433,bright,main,20211031,0,0.9924298470860075,366,65,9,440
22433,bright,main,20211031,1,0.9905781670979454,308,65,3,376
22433,bright,main,20211031,2,0.9828204831599974,343,87,5,435
22433,bright,main,20211031,3,0.9884181465868499,325,68,5,398
22433,bright,main,20211031,4,0.9893679555444638,310,79,5,394
22433,bright,main,20211031,5,0.989838832339552,340,73,1,414
22433,bright,main,20211031,6,0.9932853242776487,342,81,3,426
22433,bright,main,20211031,7,0.9904168133359986,293,76,6,375
22433,bright,main,20211031,8,0.9942591161504402,370,48,3,421
22433,bright,main,20211031,9,0.9909001069454394,351,68,5,424
10534,dark,main,20211031,0,0.9908757395487683,265,15,104,384
10534,dark,main,20211031,1,0.9867993913255797,246,14,71,331
10534,dark,main,20211031,2,0.9927246449339813,267,17,100,384
10534,dark,main,20211031,3,0.9921296806486964,264,16,87,367
10534,dark,main,20211031,4,0.9924765631115267,240,14,102,356
10534,dark,main,20211031,5,0.9940464370893254,245,12,106,363
10534,dark,main,20211031,6,0.9894786743627925,261,14,82,357
10534,dark,main,20211031,7,0.9926007005699619,232,17,85,334
10534,dark,main,20211031,8,0.9898308423765679,248,9,112,369
10534,dark,main,20211031,9,0.9903758953025138,242,17,108,367
9107,dark,main,20211031,0,0.9896706304044227,277,17,99,393
9107,dark,main,20211031,1,0.9836368894091473,235,14,93,342
9107,dark,main,20211031,2,0.9921521792145521,262,13,120,395
9107,dark,main,20211031,3,0.9914881148581901,273,18,71,362
9107,dark,main,20211031,4,0.9894132791194021,260,14,88,362
9107,dark,main,20211031,5,0.9974056679890461,260,16,93,369
9107,dark,main,20211031,6,0.9864241724290682,247,13,100,360
9107,dark,main,20211031,7,0.9938750951946539,227,14,100,341
9107,dark,main,20211031,8,0.9896522765032245,291,12,78,381
9107,dark,main,20211031,9,0.9936394652917679,276,11,87,374
1524,dark,main,20211031,0,0.9901622684015655,285,16,92,393
1524,dark,main,20211031,1,0.9880315274896496,218,14,88,320
1524,dark,main,20211031,2,0.9911407197887405,242,23,87,352
1524,dark,main,20211031,3,0.9826920268907069,259,14,75,348
1524,dark,main,20211031,4,0.9932483907827444,254,16,90,360
1524,dark,main,20211031,5,0.9911238922462894,235,16,103,354
1524,dark,main,20211031,6,0.9892036900445256,268,19,77,364
1524,dark,main,20211031,7,0.9946952419425587,231,25,81,337
1524,dark,main,20211031,8,0.9882792983146996,275,17,96,388
1524,dark,main,20211031,9,0.9853698561844628,272,15,94,381
9000,dark,main,20211031,0,0.9817664274965872,276,15,99,390
9000,dark,main,20211031,1,0.9876455593478642,233,13,97,343
9000,dark,main,20211031,2,0.9924317720827087,270,17,102,389
9000,dark,main,20211031,3,0.993893830255325,261,14,77,352
9000,dark,main,20211031,4,0.9917642120690927,253,18,102,373
9000,dark,main,20211031,5,0.9907199554194637,249,14,102,365
9000,dark,main,20211031,6,0.9917502941412314,270,13,102,385
9000,dark,main,20211031,7,0.9931075699894689,220,12,99,331
9000,dark,main,20211031,8,0.9900291070372497,287,15,81,383
9000,dark,main,20211031,9,0.9937445518462615,282,11,94,387
1526,dark,main,20211031,0,0.9887358972655058,298,17,76,391
1526,dark,main,20211031,1,0.9876203334159528,232,19,76,327
1526,dark,main,20211031,2,0.9932937207859912,263,19,93,375
1526,dark,main,20211031,3,0.993682377063557,236,19,100,355
1526,dark,main,20211031,4,0.9935768747899131,261,12,78,351
1526,dark,main,20211031,5,0.9891893414589796,250,20,88,358
1526,dark,main,20211031,6,0.9839422293415468,249,14,98,361
1526,dark,main,20211031,7,0.9916036120387896,216,17,84,317
1526,dark,main,20211031,8,0.9926519970146,269,19,85,373
1526,dark,main,20211031,9,0.9945925718089639,275,12,81,368
2390,dark,main,20211031,0,0.9888719378359595,294,15,92,401
2390,dark,main,20211031,1,0.9957463143667938,225,22,87,334
2390,dark,main,20211031,2,0.9902353073654107,281,19,88,388
2390,dark,main,20211031,3,0.9942877896733147,246,14,89,349
2390,dark,main,20211031,4,0.9863931310608631,258,14,93,365
2390,dark,main,20211031,5,0.9852580626248998,262,15,89,366
2390,dark,main,20211031,6,0.9943584570295392,252,15,113,380
2390,dark,main,20211031,7,0.9951730842555621,235,15,76,326
2390,dark,main,20211031,8,0.9889997514500631,273,18,86,377
2390,dark,main,20211031,9,0.9911213123979821,284,12,82,378
7789,dark,main,20211031,0,0.9915215310710143,291,19,82,392
7789,dark,main,20211031,1,0.9801589831657175,243,20,71,334
7789,dark,main,20211031,2,0.9920714174751819,265,24,100,389
7789,dark,main,20211031,3,0.9918904217641114,250,14,94,358
7789,dark,main,20211031,4,0.9952181710577356,261,15,86,362
7789,dark,main,20211031,5,0.9896083604566634,256,13,90,359
7789,dark,main,20211031,6,0.9936526103786449,264,20,93,377
7789,dark,main,20211031,7,0.9839477100090732,216,16,102,334
7789,dark,main,20211031,8,0.9887811438130717,262,19,105,386
7789,dark,main,20211031,9,0.9911709403307828,265,16,85,366
20983,bright,main,20211031,0,0.9917069544505155,364,69,1,434
20983,bright,main,20211031,1,0.9920364774430883,301,67,5,373
20983,bright,main,20211031,2,0.9919110710986654,357,64,6,427
20983,bright,main,20211031,3,0.9917739547097931,308,72,4,384
20983,bright,main,20211031,4,0.9907637232414214,333,59,4,396
20983,bright,main,20211031,5,0.984788558477689,331,63,8,402
20983,bright,main,20211031,6,0.99537950694412,373,40,6,419
20983,bright,main,20211031,7,0.9932651386199722,290,60,5,355
20983,bright,main,20211031,8,0.9940995310774626,309,97,3,409
20983,bright,main,20211031,9,0.9948311103994687,325,87,1,413
11235,dark,main,20211031,0,0.9913889780054895,263,23,91,377
11235,dark,main,20211031,1,0.9887994360638971,238,16,73,327
11235,dark,main,20211031,2,0.9954618654483195,283,23,78,384
11235,dark,main,20211031,3,0.9952703860283646,249,20,81,350
11235,dark,main,20211031,4,0.9920523804614634,245,16,83,344
11235,dark,main,20211031,5,0.9924624697872984,257,18,84,359
11235,dark,main,20211031,6,0.9865211222308087,258,17,97,372
11235,dark,main,20211031,7,0.9933429182040838,233,18,74,325
11235,dark,main,20211031,8,0.9952760437507842,261,20,89,370
11235,dark,main,20211031,9,0.9869682626522235,281,16,83,380
9757,dark,main,20211101,0,0.9966434125315786,291,12,88,391
9757,dark,main,20211101,1,0.9912253060299446,227,22,82,331
9757,dark,main,20211101,2,0.9900731193776556,296,15,86,397
9757,dark,main,20211101,3,0.9933322624978262,246,15,102,363
9757,dark,main,20211101,4,0.9913900452649932,266,17,76,359
9757,dark,main,20211101,5,0.9923358459872769,256,19,93,368
9757,dark,main,20211101,6,0.9928368108135928,275,17,75,367
9757,dark,main,20211101,7,0.9824440799047586,251,14,70,335
9757,dark,main,20211101,8,0.9907910895543989,258,21,91,370
9757,dark,main,20211101,9,0.987568023635918,279,10,82,371
9524,dark,main,20211101,0,0.986293915482105,289,15,83,387
9524,dark,main,20211101,1,0.9945547052671355,241,12,88,341
9524,dark,main,20211101,2,0.9932131278908338,287,14,91,392
9524,dark,main,20211101,3,0.9850511243434785,248,15,90,353
9524,dark,main,20211101,4,0.9934942657102528,265,18,76,359
9524,dark,main,20211101,5,0.9920917988049563,259,10,89,358
9524,dark,main,20211101,6,0.9946638183850905,279,16,83,378
9524,dark,main,20211101,7,0.9908215883952322,239,14,68,321
9524,dark,main,20211101,8,0.9878952418727421,275,14,84,373
9524,dark,main,20211101,9,0.9899837786623316,276,11,87,374
11096,dark,main,20211101,0,0.994211642227025,290,17,94,401
11096,dark,main,20211101,1,0.9871044558373938,211,21,95,327
11096,dark,main,20211101,2,0.9946175961167648,285,13,89,387
11096,dark,main,20211101,3,0.9963962558762564,257,14,93,364
11096,dark,main,20211101,4,0.9931402925397036,272,12,67,351
11096,dark,main,20211101,5,0.9962004959463732,272,14,76,362
11096,dark,main,20211101,6,0.9952095385855373,282,12,93,387
11096,dark,main,20211101,7,0.9899746584770778,247,18,66,331
11096,dark,main,20211101,8,0.9913780321602794,262,28,75,365
11096,dark,main,20211101,9,0.9939804800034417,275,12,93,380
3279,dark,main,20211101,0,0.9914801201308422,231,22,72,325
3279,dark,main,20211101,1,0.9894198900218083,192,16,58,266
3279,dark,main,20211101,2,0.9901798722460353,218,16,77,311
3279,dark,main,20211101,3,0.9915789981303262,180,11,78,269
3279,dark,main,20211101,4,0.9925792957312727,207,15,60,282
3279,dark,main,20211101,5,0.98899885241586,237,16,69,322
3279,dark,main,20211101,6,0.9871072554037359,231,12,59,302
3279,dark,main,20211101,7,0.9863769794118239,189,15,66,270
3279,dark,main,20211101,8,0.9904321449461784,225,20,72,317
3279,dark,main,20211101,9,0.9899521696019132,201,15,81,297
9529,dark,main,20211101,0,0.9921705882400219,297,16,95,408
9529,dark,main,20211101,1,0.9887538688290044,233,10,87,330
9529,dark,main,20211101,2,0.9951197180304668,299,11,90,400
9529,dark,main,20211101,3,0.9899319346493307,259,14,82,355
9529,dark,main,20211101,4,0.9952026704686042,274,14,70,358
9529,dark,main,20211101,5,0.9884435257783901,262,13,96,371
9529,dark,main,20211101,6,0.9930317908522962,265,13,88,366
9529,dark,main,20211101,7,0.9922083923922099,240,15,60,315
9529,dark,main,20211101,8,0.9929700712008233,275,12,89,376
9529,dark,main,20211101,9,0.9953738455165402,266,11,87,364
21011,bright,main,20211101,0,0.9906595836895526,347,70,8,425
21011,bright,main,20211101,1,0.9876929552564309,302,55,3,360
21011,bright,main,20211101,2,0.9889757835177515,354,68,7,429
21011,bright,main,20211101,3,0.9908025716060018,295,75,5,375
21011,bright,main,20211101,4,0.9938482871242167,311,74,3,388
21011,bright,main,20211101,5,0.9942322163725303,313,77,7,397
21011,bright,main,20211101,6,0.9950763726850815,352,61,3,416
21011,bright,main,20211101,7,0.9937760124154259,292,65,5,362
21011,bright,main,20211101,8,0.9899814036442908,342,79,2,423
21011,bright,main,20211101,9,0.9910917387747881,340,66,6,412
5482,dark,main,20211101,0,0.9940334722335233,266,15,93,374
5482,dark,main,20211101,1,0.9912179492368594,213,14,82,309
5482,dark,main,20211101,2,0.9903151737371195,261,16,81,358
5482,dark,main,20211101,3,0.9872310490339502,231,15,90,336
5482,dark,main,20211101,4,0.9843553051343948,223,14,79,316
5482,dark,main,20211101,5,0.98772013762293,216,16,92,324
5482,dark,main,20211101,6,0.9900167138695921,261,17,90,368
5482,dark,main,20211101,7,0.9908079375650259,228,11,71,310
5482,dark,main,20211101,8,0.9884431587774212,260,14,76,350
5482,dark,main,20211101,9,0.9907818342675934,253,11,91,355
1949,dark,main,20211101,0,0.9951024964007658,295,30,77,402
1949,dark,main,20211101,1,0.9888809782700076,246,11,83,340
1949,dark,main,20211101,2,0.9903845041968589,290,22,81,393
1949,dark,main,20211101,3,0.9948155292020737,253,17,98,368
1949,dark,main,20211101,4,0.993458243658033,249,17,78,344
1949,dark,main,20211101,5,0.991726693197342,273,13,81,367
1949,dark,main,20211101,6,0.9903648537977929,267,17,91,375
1949,dark,main,20211101,7,0.9926398536666252,222,22,78,322
1949,dark,main,20211101,8,0.9889766038088663,279,21,80,380
1949,dark,main,20211101,9,0.9929561005588073,293,23,78,394
21058,bright,main,20211101,0,0.9915405361627029,351,81,3,435
21058,bright,main,20211101,1,0.9923959821386,307,58,5,370
21058,bright,main,20211101,2,0.9853682880136438,330,87,6,423
21058,bright,main,20211101,3,0.9892523757483063,299,76,8,383
21058,bright,main,20211101,4,0.9874463592241712,256,114,5,375
21058,bright,main,20211101,5,0.992395114032265,292,96,6,394
21058,bright,main,20211101,6,0.9903380907135612,299,96,3,398
21058,bright,main,20211101,7,0.9917350500213483,269,71,7,347
21058,bright,main,20211101,8,0.991096195864099,295,101,5,401
21058,bright,main,20211101,9,0.9937513737139162,330,61,7,398
7076,dark,main,20211101,0,0.9931283080435634,268,32,91,391
7076,dark,main,20211101,1,0.9929578451963299,246,15,78,339
7076,dark,main,20211101,2,0.9882989147766323,271,18,113,402
7076,dark,main,20211101,3,0.9938274776637509,251,18,83,352
7076,dark,main,20211101,4,0.98730595519553,253,21,81,355
7076,dark,main,20211101,5,0.9920258557711903,243,21,87,351
7076,dark,main,20211101,6,0.9946102315554263,273,17,91,381
7076,dark,main,20211101,7,0.9910512639995424,228,15,84,327
7076,dark,main,20211101,8,0.9927415303655623,267,20,87,374
7076,dark,main,20211101,9,0.9872870580690809,257,16,94,367
10389,dark,main,20211101,0,0.9922060382238027,274,30,86,390
10389,dark,main,20211101,1,0.9875329002249358,256,19,70,345
10389,dark,main,20211101,2,0.9928088831037714,282,18,93,393
10389,dark,main,20211101,3,0.9898647566255706,246,35,78,359
10389,dark,main,20211101,4,0.9917906101960182,236,28,86,350
10389,dark,main,20211101,5,0.9897180145307671,221,27,103,351
10389,dark,main,20211101,6,0.9970782645135791,283,20,79,382
10389,dark,main,20211101,7,0.9880987263936014,238,23,70,331
10389,dark,main,20211101,8,0.9879429458549615,268,23,91,382
10389,dark,main,20211101,9,0.9927218675640418,274,23,79,376
24000,bright,main,20211101,0,0.9945686638353863,340,98,3,441
24000,bright,main,20211101,1,0.9932145196967525,279,99,3,381
24000,bright,main,20211101,2,0.9952216277772868,319,117,4,440
24000,bright,main,20211101,3,0.9908419972778872,269,125,4,398
24000,bright,main,20211101,4,0.9944516432529176,258,141,2,401
24000,bright,main,20211101,5,0.9939883646535528,311,102,3,416
24000,bright,main,20211101,6,0.9932465267977703,320,106,7,433
24000,bright,main,20211101,7,0.9873016244301406,283,86,2,371
24000,bright,main,20211101,8,0.9933872098204101,345,69,5,419
24000,bright,main,20211101,9,0.9925157507214682,328,95,9,432
20940,bright,main,20211101,0,0.9966308059048369,350,89,2,441
20940,bright,main,20211101,1,0.9829668734248183,311,58,3,372
20940,bright,main,20211101,2,0.9891352131096933,350,78,3,431
20940,bright,main,20211101,3,0.9914657301971685,306,80,6,392
20940,bright,main,20211101,4,0.9874073632960388,309,83,4,396
20940,bright,main,20211101,5,0.9937360739924259,301,101,3,405
20940,bright,main,20211101,6,0.9938792925512252,328,87,5,420
20940,bright,main,20211101,7,0.9907682672865104,264,92,8,364
20940,bright,main,20211101,8,0.9907461001923986,301,106,5,412
20940,bright,main,20211101,9,0.9943064816949275,321,95,4,420
9801,dark,main,20211101,0,0.9844352322282521,275,13,109,397
9801,dark,main,20211101,1,0.9913762743125151,236,16,73,325
9801,dark,main,20211101,2,0.9888374714145992,281,16,97,394
9801,dark,main,20211101,3,0.9903740659724409,255,15,72,342
9801,dark,main,20211101,4,0.9902944227094244,255,12,81,348
9801,dark,main,20211101,5,0.9861748318161176,256,17,74,347
9801,dark,main,20211101,6,0.9925671635845331,260,16,94,370
9801,dark,main,20211101,7,0.9898034875406871,226,12,75,313
9801,dark,main,20211101,8,0.9933435848993638,271,13,94,378
9801,dark,main,20211101,9,0.995212089824139,248,23,81,352
8484,dark,main,20211101,0,0.9896552021511346,283,17,94,394
8484,dark,main,20211101,1,0.988101260442297,243,16,74,333
8484,dark,main,20211101,2,0.9908984160418314,282,15,86,383
8484,dark,main,20211101,3,0.9931279644572104,255,17,89,361
8484,dark,main,20211101,4,0.9929621072955482,260,11,83,354
8484,dark,main,20211101,5,0.9896968136397448,245,15,90,350
8484,dark,main,20211101,6,0.9909865869294953,249,15,102,366
8484,dark,main,20211101,7,0.9962952892637157,216,14,87,317
8484,dark,main,20211101,8,0.9923866214535776,274,15,89,378
8484,dark,main,20211101,9,0.9918481131489024,257,16,86,359
20840,bright,main,20211101,0,0.9962608163837834,337,96,4,437
20840,bright,main,20211101,1,0.9927990669149649,315,59,8,382
20840,bright,main,20211101,2,0.9908670655895038,344,89,5,438
20840,bright,main,20211101,3,0.9917265319953937,284,109,4,397
20840,bright,main,20211101,4,0.9871477268725052,298,104,1,403
20840,bright,main,20211101,5,0.9938364514267896,309,104,2,415
20840,bright,main,20211101,6,0.9929289273542606,308,112,7,427
20840,bright,main,20211101,7,0.9856171092552991,279,84,5,368
20840,bright,main,20211101,8,0.9959697575158404,309,113,5,427
20840,bright,main,20211101,9,0.9905411748107332,344,82,3,429
8226,dark,main,20211101,0,0.987763189034797,263,18,89,370
8226,dark,main,20211101,1,0.9865240701454568,219,13,78,310
8226,dark,main,20211101,2,0.988400392476877,237,14,90,341
8226,dark,main,20211101,3,0.9830493591024181,241,15,74,330
8226,dark,main,20211101,4,0.9910991003106498,239,14,79,332
8226,dark,main,20211101,5,0.9864591310947758,249,13,77,339
8226,dark,main,20211101,6,0.9899420319824158,262,15,72,349
8226,dark,main,20211101,7,0.9915966632007879,224,11,87,322
8226,dark,main,20211101,8,0.9958260963779202,257,11,81,349
8226,dark,main,20211101,9,0.9907761333670473,258,14,73,345
9853,dark,main,20211101,0,0.9930228465926774,294,12,83,389
9853,dark,main,20211101,1,0.9881934264987692,240,12,87,339
9853,dark,main,20211101,2,0.9827995607834338,282,15,86,383
9853,dark,main,20211101,3,0.9899776671788464,259,16,81,356
9853,dark,main,20211101,4,0.9905878461156561,260,15,85,360
9853,dark,main,20211101,5,0.9905101237618925,263,17,84,364
9853,dark,main,20211101,6,0.9950130588418321,274,10,94,378
9853,dark,main,20211101,7,0.9863954859971147,199,15,99,313
9853,dark,main,20211101,8,0.9876370489446228,289,14,63,366
9853,dark,main,20211101,9,0.9941954216302602,279,16,79,374
9800,dark,main,20211101,0,0.9890228812865919,259,12,106,377
9800,dark,main,20211101,1,0.9922767105271124,261,16,73,350
9800,dark,main,20211101,2,0.9895098534883113,276,15,90,381
9800,dark,main,20211101,3,0.9946911746049425,252,13,93,358
9800,dark,main,20211101,4,0.9858382763478772,250,12,91,353
9800,dark,main,20211101,5,0.9949476652095446,256,17,90,363
9800,dark,main,20211101,6,0.990206307744679,261,16,83,360
9800,dark,main,20211101,7,0.9893179343628238,238,13,84,335
9800,dark,main,20211101,8,0.9950920156634578,272,18,85,375
9800,dark,main,20211101,9,0.9922477910396056,253,15,106,374
9648,dark,main,20211101,0,0.9861935406303269,273,26,96,395
9648,dark,main,20211101,1,0.9936475394783632,236,21,74,331
9648,dark,main,20211101,2,0.9950232269917902,279,25,86,390
9648,dark,main,20211101,3,0.9871675358168949,244,20,73,337
9648,dark,main,20211101,4,0.993620601159718,262,16,83,361
9648,dark,main,20211101,5,0.9919035795967748,241,21,93,355
9648,dark,main,20211101,6,0.9913150747883295,270,26,79,375
9648,dark,main,20211101,7,0.9899533620792516,228,18,68,314
9648,dark,main,20211101,8,0.9891137360818294,262,22,77,361
9648,dark,main,20211101,9,0.9924991593082427,281,16,71,368
3828,dark,main,20211101,0,0.9892829298227745,296,11,94,401
3828,dark,main,20211101,1,0.9902220195818201,246,16,67,329
3828,dark,main,20211101,2,0.9932629010493729,280,21,92,393
3828,dark,main,20211101,3,0.9944577862730479,249,22,72,343
3828,dark,main,20211101,4,0.989945945561463,247,17,85,349
3828,dark,main,20211101,5,0.9916916551370978,247,15,94,356
3828,dark,main,20211101,6,0.9864831987632677,277,14,74,365
3828,dark,main,20211101,7,0.9874758478246716,241,21,66,328
3828,dark,main,20211101,8,0.9913737965362789,249,14,98,361
3828,dark,main,20211101,9,0.9885257013756877,287,17,81,385
9842,dark,main,20211101,0,0.9941066741604941,281,13,95,389
9842,dark,main,20211101,1,0.9909105767667555,239,12,85,336
9842,dark,main,20211101,2,0.9914282489481644,277,13,94,384
9842,dark,main,20211101,3,0.9893192075352083,254,13,95,362
9842,dark,main,20211101,4,0.9920522761656629,260,11,72,343
9842,dark,main,20211101,5,0.9943035088235224,278,11,75,364
9842,dark,main,20211101,6,0.9848308506444604,275,12,82,369
9842,dark,main,20211101,7,0.9939149363077352,233,16,84,333
9842,dark,main,20211101,8,0.9881244397176325,267,15,91,373
9842,dark,main,20211101,9,0.995447909951528,273,13,105,391
21057,bright,main,20211101,0,0.9925521822666075,317,100,6,423
21057,bright,main,20211101,1,0.9909855598463672,287,67,5,359
21057,bright,main,20211101,2,0.9936936453415817,362,60,5,427
21057,bright,main,20211101,3,0.9914097297183729,312,63,6,381
21057,bright,main,20211101,4,0.9895607629462342,336,52,3,391
21057,bright,main,20211101,5,0.9959315630258769,356,37,5,398
21057,bright,main,20211101,6,0.993556216788474,324,80,4,408
21057,bright,main,20211101,7,0.9923400989669768,288,64,3,355
21057,bright,main,20211101,8,0.9939948881381856,343,62,4,409
21057,bright,main,20211101,9,0.9957514016574514,321,85,4,410
2311,dark,main,20211101,0,0.9943899291053655,255,41,81,377
2311,dark,main,20211101,1,0.9900783174060406,181,44,52,277
2311,dark,main,20211101,2,0.9899450015843428,137,22,40,199
2311,dark,main,20211101,3,0.9921788479098559,241,24,74,339
2311,dark,main,20211101,4,0.9944653479004888,253,20,67,340
2311,dark,main,20211101,5,0.9850834231986282,255,22,79,356
2311,dark,main,20211101,6,0.9921411096841654,263,16,85,364
2311,dark,main,20211101,7,0.9912597662162829,240,23,69,332
2311,dark,main,20211101,8,0.9942165008338544,244,26,88,358
2311,dark,main,20211101,9,0.993210401922096,255,32,72,359
9805,dark,main,20211101,0,0.9936453045307102,255,18,105,378
9805,dark,main,20211101,1,0.9912590907273936,249,11,75,335
9805,dark,main,20211101,2,0.9920555306465684,282,15,94,391
9805,dark,main,20211101,3,0.9931004524967523,260,12,86,358
9805,dark,main,20211101,4,0.9913004231239229,257,13,85,355
9805,dark,main,20211101,5,0.9928150246714211,261,14,96,371
9805,dark,main,20211101,6,0.990138394606989,257,10,109,376
9805,dark,main,20211101,7,0.9910066703356278,206,14,103,323
9805,dark,main,20211101,8,0.9915813983486743,260,10,99,369
9805,dark,main,20211101,9,0.995182056045932,267,20,94,381
21227,bright,main,20211101,0,0.9902026945062853,359,73,5,437
21227,bright,main,20211101,1,0.9935576294865808,291,77,4,372
21227,bright,main,20211101,2,0.9927590248989755,355,76,2,433
21227,bright,main,20211101,3,0.9946924035251432,317,67,6,390
21227,bright,main,20211101,4,0.994062547243172,320,73,5,398
21227,bright,main,20211101,5,0.9856578935569866,328,70,4,402
21227,bright,main,20211101,6,0.9911050225912911,303,109,4,416
21227,bright,main,20211101,7,0.9913512256584819,256,99,5,360
21227,bright,main,20211101,8,0.9948143747368802,286,117,5,408
21227,bright,main,20211101,9,0.9909193299469458,351,67,4,422
8192,dark,main,20211102,0,0.9924797045812308,287,15,95,397
8192,dark,main,20211102,1,0.9916939885355824,240,16,73,329
8192,dark,main,20211102,2,0.9884878324103872,251,21,102,374
8192,dark,main,20211102,3,0.9941053449043931,266,18,75,359
8192,dark,main,20211102,4,0.9902055089696011,259,18,86,363
8192,dark,main,20211102,5,0.9828529947353802,272,12,76,360
8192,dark,main,20211102,6,0.9952634112114153,248,16,97,361
8192,dark,main,20211102,7,0.9932016425021387,256,12,78,346
8192,dark,main,20211102,8,0.9935334422886095,280,15,81,376
8192,dark,main,20211102,9,0.9918637451621569,273,21,89,383
8655,dark,main,20211102,0,0.9932996860982727,269,17,104,390
8655,dark,main,20211102,1,0.9837443688584524,245,14,76,335
8655,dark,main,20211102,2,0.9949619062154863,264,12,93,369
8655,dark,main,20211102,3,0.9827958818903001,261,16,80,357
8655,dark,main,20211102,4,0.9879997255948192,249,10,102,361
8655,dark,main,20211102,5,0.9921973737138609,281,14,85,380
8655,dark,main,20211102,6,0.9923996578913773,259,13,98,370
8655,dark,main,20211102,7,0.9914763097277636,233,15,74,322
8655,dark,main,20211102,8,0.9946383854612384,277,19,88,384
8655,dark,main,20211102,9,0.9883150423917951,260,18,96,374
3531,dark,main,20211102,0,0.9936878229540377,266,16,109,391
3531,dark,main,20211102,1,0.9934876726697376,244,14,75,333
3531,dark,main,20211102,2,0.9901600241192302,287,14,88,389
3531,dark,main,20211102,3,0.9902030259591482,266,13,74,353
3531,dark,main,20211102,4,0.9929372602394495,287,15,59,361
3531,dark,main,20211102,5,0.992320524873312,255,18,87,360
3531,dark,main,20211102,6,0.9920557000601868,271,15,87,373
3531,dark,main,20211102,7,0.9917833412767617,248,12,76,336
3531,dark,main,20211102,8,0.9929421593929194,256,12,99,367
3531,dark,main,20211102,9,0.99029678795329,263,11,90,364
9612,dark,main,20211102,0,0.9885059107046282,289,20,78,387
9612,dark,main,20211102,1,0.9855224759567407,233,22,73,328
9612,dark,main,20211102,2,0.9950135517118542,289,20,76,385
9612,dark,main,20211102,3,0.9939710738072145,217,24,92,333
9612,dark,main,20211102,4,0.996260382681626,243,24,83,350
9612,dark,main,20211102,5,0.9952853884900484,262,18,78,358
9612,dark,main,20211102,6,0.9904007259113892,273,19,80,372
9612,dark,main,20211102,7,0.9869663885437497,218,19,79,316
9612,dark,main,20211102,8,0.9913537927180051,256,17,78,351
9612,dark,main,20211102,9,0.990912781411559,242,29,97,368
9799,dark,main,20211102,0,0.9915099656422739,278,15,84,377
9799,dark,main,20211102,1,0.9924749310594879,233,13,87,333
9799,dark,main,20211102,2,0.9919773793267245,253,15,103,371
9799,dark,main,20211102,3,0.9948187162082555,241,18,92,351
9799,dark,main,20211102,4,0.9925465238735353,251,15,86,352
9799,dark,main,20211102,5,0.9940050042526151,271,15,87,373
9799,dark,main,20211102,6,0.989995859211397,269,16,96,381
9799,dark,main,20211102,7,0.9895898038209274,254,9,70,333
9799,dark,main,20211102,8,0.9931593871557091,279,17,79,375
9799,dark,main,20211102,9,0.9958188566587541,272,12,82,366
3832,dark,main,20211102,0,0.9928780815427961,283,15,93,391
3832,dark,main,20211102,1,0.99131613248994,227,12,97,336
3832,dark,main,20211102,2,0.9915505452376471,287,17,88,392
3832,dark,main,20211102,3,0.9922501772653206,252,16,86,354
3832,dark,main,20211102,4,0.9916065926390397,236,19,100,355
3832,dark,main,20211102,5,0.9939204399154237,258,16,96,370
3832,dark,main,20211102,6,0.9905374845059591,278,17,76,371
3832,dark,main,20211102,7,0.985980467992628,235,15,81,331
3832,dark,main,20211102,8,0.9885098313963727,267,21,86,374
3832,dark,main,20211102,9,0.9946921800569349,294,15,71,380
3431,dark,main,20211102,0,0.9897997356374784,285,20,72,377
3431,dark,main,20211102,1,0.9911085932738631,219,19,75,313
3431,dark,main,20211102,2,0.9927283637924643,249,24,93,366
3431,dark,main,20211102,3,0.9926144369755983,241,24,79,344
3431,dark,main,20211102,4,0.9913503090028161,236,31,78,345
3431,dark,main,20211102,5,0.9891763866387415,247,21,88,356
3431,dark,main,20211102,6,0.9888585632884862,250,20,81,351
3431,dark,main,20211102,7,0.9954819559261474,213,24,73,310
3431,dark,main,20211102,8,0.9912573190830689,252,22,89,363
3431,dark,main,20211102,9,0.9895157774637622,271,17,85,373
11619,dark,main,20211102,0,0.9936000481409547,275,17,103,395
11619,dark,main,20211102,1,0.9909144615359267,263,11,74,348
11619,dark,main,20211102,2,0.9927764896858745,279,13,93,385
11619,dark,main,20211102,3,0.9939595504928416,244,10,94,348
11619,dark,main,20211102,4,0.9967319539510313,265,17,81,363
11619,dark,main,20211102,5,0.9946556520094719,260,16,90,366
11619,dark,main,20211102,6,0.9916260616154108,290,13,75,378
11619,dark,main,20211102,7,0.9866712066766046,240,11,78,329
11619,dark,main,20211102,8,0.9960051816105256,254,17,103,374
11619,dark,main,20211102,9,0.9907249760577889,267,14,100,381
1947,dark,main,20211102,0,0.9942632472554401,279,21,95,395
1947,dark,main,20211102,1,0.9903465365778356,233,24,78,335
1947,dark,main,20211102,2,0.9895118696392214,270,21,79,370
1947,dark,main,20211102,3,0.9902907321156874,229,23,86,338
1947,dark,main,20211102,4,0.9936793160017164,252,23,93,368
1947,dark,main,20211102,5,0.9947079990939665,272,19,75,366
1947,dark,main,20211102,6,0.9949129476458581,277,15,81,373
1947,dark,main,20211102,7,0.991421122965418,234,15,72,321
1947,dark,main,20211102,8,0.9905995689584172,281,15,72,368
1947,dark,main,20211102,9,0.9962150631312127,280,21,68,369
9528,dark,main,20211102,0,0.9902608201637657,287,17,96,400
9528,dark,main,20211102,1,0.9916769741521072,222,12,86,320
9528,dark,main,20211102,2,0.9892142577298029,283,9,84,376
9528,dark,main,20211102,3,0.9931659790675498,268,18,73,359
9528,dark,main,20211102,4,0.9904072526019305,274,13,83,370
9528,dark,main,20211102,5,0.9939442261482302,279,12,74,365
9528,dark,main,20211102,6,0.994474530713703,288,12,84,384
9528,dark,main,20211102,7,0.9922419838650679,248,12,78,338
9528,dark,main,20211102,8,0.9856114992708171,270,16,93,379
9528,dark,main,20211102,9,0.9927503689431143,274,14,92,380
1940,dark,main,20211102,0,0.9908798025542479,275,15,90,380
1940,dark,main,20211102,1,0.9944084894391932,231,18,82,331
1940,dark,main,20211102,2,0.9924544384731072,288,15,95,398
1940,dark,main,20211102,3,0.9856439358336415,239,13,96,348
1940,dark,main,20211102,4,0.9887299126543364,257,16,98,371
1940,dark,main,20211102,5,0.9932251155262227,246,20,105,371
1940,dark,main,20211102,6,0.9892189098658832,263,10,89,362
1940,dark,main,20211102,7,0.9920855821792709,243,14,63,320
1940,dark,main,20211102,8,0.9909514122432784,272,17,92,381
1940,dark,main,20211102,9,0.9885010050869539,287,12,86,385
10202,dark,main,20211102,0,0.9952019157958216,273,14,105,392
10202,dark,main,20211102,1,0.9955177651128194,243,19,82,344
10202,dark,main,20211102,2,0.9835464051430719,274,17,100,391
10202,dark,main,20211102,3,0.9848736827449128,256,15,81,352
10202,dark,main,20211102,4,0.985909263792102,239,20,94,353
10202,dark,main,20211102,5,0.99545240580345,245,11,104,360
10202,dark,main,20211102,6,0.9913152247988675,272,16,86,374
10202,dark,main,20211102,7,0.9913010008876901,246,12,71,329
10202,dark,main,20211102,8,0.9882274228230336,292,13,94,399
10202,dark,main,20211102,9,0.9937068522790407,266,14,96,376
11631,dark,main,20211102,0,0.994264729953284,265,14,109,388
11631,dark,main,20211102,1,0.9948296468536655,236,16,84,336
11631,dark,main,20211102,2,0.9901683020767729,284,17,86,387
11631,dark,main,20211102,3,0.9895638173897096,251,16,77,344
11631,dark,main,20211102,4,0.9907078470357468,272,11,89,372
11631,dark,main,20211102,5,0.9919366657424965,270,13,99,382
11631,dark,main,20211102,6,0.988650086404873,270,17,82,369
11631,dark,main,20211102,7,0.990825727734152,256,10,77,343
11631,dark,main,20211102,8,0.9892977392936451,260,14,100,374
11631,dark,main,20211102,9,0.9969582491581943,247,14,100,361
6708,dark,main,20211102,0,0.9978146667872335,288,14,96,398
6708,dark,main,20211102,1,0.9838335414393445,238,16,74,328
6708,dark,main,20211102,2,0.9887396319535895,277,13,98,388
6708,dark,main,20211102,3,0.9891862809586631,255,12,91,358
6708,dark,main,20211102,4,0.9899270821756065,267,11,83,361
6708,dark,main,20211102,5,0.9893554274498062,254,10,93,357
6708,dark,main,20211102,6,0.9920561971064094,275,14,83,372
6708,dark,main,20211102,7,0.9911785250130623,244,15,71,330
6708,dark,main,20211102,8,0.9923056917729501,281,15,96,392
6708,dark,main,20211102,9,0.988310085860993,274,12,96,382
11648,dark,main,20211102,0,0.9942510631110092,284,22,81,387
11648,dark,main,20211102,1,0.9939678284847975,260,13,63,336
11648,dark,main,20211102,2,0.9939678284847975,260,13,63,336
11648,dark,main,20211102,3,0.9904939462539568,242,24,93,359
11648,dark,main,20211102,4,0.9946503448042405,228,40,90,358
11648,dark,main,20211102,5,0.9902339920296933,270,12,78,360
11648,dark,main,20211102,6,0.9917616152701407,281,15,59,355
11648,dark,main,20211102,7,0.9931557955337892,237,21,73,331
11648,dark,main,20211102,8,0.9929529503644001,280,18,84,382
11648,dark,main,20211102,9,0.9907192934363416,239,11,117,367
9856,dark,main,20211102,0,0.9934428458677611,276,13,104,393
9856,dark,main,20211102,1,0.9893058255307481,255,15,60,330
9856,dark,main,20211102,2,0.9927361133476228,278,10,79,367
9856,dark,main,20211102,3,0.9908405961809962,247,17,85,349
9856,dark,main,20211102,4,0.9944298627911362,267,13,80,360
9856,dark,main,20211102,5,0.9963192955994755,276,15,90,381
9856,dark,main,20211102,6,0.9877261403322573,271,13,99,383
9856,dark,main,20211102,7,0.9881897301869288,232,15,84,331
9856,dark,main,20211102,8,0.9885828362586977,275,16,90,381
9856,dark,main,20211102,9,0.9908543581613323,284,15,89,388
8654,dark,main,20211102,0,0.9937575917478324,262,18,110,390
8654,dark,main,20211102,1,0.9910351570338704,239,17,87,343
8654,dark,main,20211102,2,0.9931901917196206,292,17,87,396
8654,dark,main,20211102,3,0.9927629647482407,264,16,65,345
8654,dark,main,20211102,4,0.9902138700430516,239,22,99,360
8654,dark,main,20211102,5,0.9880584826604927,253,14,92,359
8654,dark,main,20211102,6,0.9889659355335914,272,13,94,379
8654,dark,main,20211102,7,0.9859052779317152,239,11,72,322
8654,dark,main,20211102,8,0.9871097285455384,249,14,93,356
8654,dark,main,20211102,9,0.9917859198533545,261,14,100,375
5359,dark,main,20211102,0,0.9955848783956712,279,23,92,394
5359,dark,main,20211102,1,0.9849572932674916,245,19,79,343
5359,dark,main,20211102,2,0.9853736885423335,272,23,88,383
5359,dark,main,20211102,3,0.9965864136577788,262,20,78,360
5359,dark,main,20211102,4,0.9890329314096599,263,15,74,352
5359,dark,main,20211102,5,0.99064951525427,268,15,86,369
5359,dark,main,20211102,6,0.9881686446710086,275,14,87,376
5359,dark,main,20211102,7,0.9860941767731224,224,17,92,333
5359,dark,main,20211102,8,0.9943137894172399,265,16,105,386
5359,dark,main,20211102,9,0.9895358909790561,288,15,77,380
3385,dark,main,20211102,0,0.9948447365091304,271,23,94,388
3385,dark,main,20211102,1,0.9936828338788921,227,21,95,343
3385,dark,main,20211102,2,0.988035656525317,256,28,97,381
3385,dark,main,20211102,3,0.9917140689585917,252,22,74,348
3385,dark,main,20211102,4,0.9955067560704872,240,22,87,349
3385,dark,main,20211102,5,0.9879511172503034,276,16,74,366
3385,dark,main,20211102,6,0.9940279996726601,248,19,98,365
3385,dark,main,20211102,7,0.9929692217091955,235,19,67,321
3385,dark,main,20211102,8,0.9915949966206276,261,25,80,366
3385,dark,main,20211102,9,0.993381900211925,258,20,95,373
2312,dark,main,20211102,0,0.9900577045477067,283,31,83,397
2312,dark,main,20211102,1,0.9949086562210472,220,26,86,332
2312,dark,main,20211102,2,0.9959104050594156,260,25,88,373
2312,dark,main,20211102,3,0.991954873208705,235,27,84,346
2312,dark,main,20211102,4,0.9908655691165742,235,21,95,351
2312,dark,main,20211102,5,0.9901580376851605,264,18,70,352
2312,dark,main,20211102,6,0.990724197833767,273,18,96,387
2312,dark,main,20211102,7,0.9898552631488557,233,19,83,335
2312,dark,main,20211102,8,0.9838964531800101,264,22,85,371
2312,dark,main,20211102,9,0.9960227059805505,267,37,71,375
3535,dark,main,20211102,0,0.9966094814524882,298,19,89,406
3535,dark,main,20211102,1,0.9893727759129771,238,14,74,326
3535,dark,main,20211102,2,0.9928180800964765,261,14,101,376
3535,dark,main,20211102,3,0.9807253101795481,268,15,86,369
3535,dark,main,20211102,4,0.9896660637377435,248,17,98,363
3535,dark,main,20211102,5,0.9935736488848371,273,18,78,369
3535,dark,main,20211102,6,0.9949703625550064,267,13,98,378
3535,dark,main,20211102,7,0.9912136018924951,248,20,74,342
3535,dark,main,20211102,8,0.9899128701264348,283,13,79,375
3535,dark,main,20211102,9,0.9903158868367777,270,15,86,371
9854,dark,main,20211102,0,0.9943320419286061,274,13,109,396
9854,dark,main,20211102,1,0.9926175343332916,225,11,95,331
9854,dark,main,20211102,2,0.993982913602777,282,13,88,383
9854,dark,main,20211102,3,0.992271598883303,237,14,94,345
9854,dark,main,20211102,4,0.9885154420746122,254,14,90,358
9854,dark,main,20211102,5,0.9958818365049747,263,15,94,372
9854,dark,main,20211102,6,0.9894217046539381,256,16,102,374
9854,dark,main,20211102,7,0.9930279304256014,241,17,73,331
9854,dark,main,20211102,8,0.9957779915701289,298,12,70,380
9854,dark,main,20211102,9,0.9916338561272777,278,13,77,368
10333,dark,main,20211102,0,0.9880238267754743,280,22,90,392
10333,dark,main,20211102,1,0.9795311897476927,226,23,82,331
10333,dark,main,20211102,2,0.9885564355403648,201,34,56,291
10333,dark,main,20211102,3,0.9856591266276314,174,27,46,247
10333,dark,main,20211102,4,0.9929168347814283,252,20,73,345
10333,dark,main,20211102,5,0.9894927178362102,236,31,78,345
10333,dark,main,20211102,6,0.9872172628990921,249,17,85,351
10333,dark,main,20211102,7,0.9826981924305935,213,16,81,310
10333,dark,main,20211102,8,0.9894476681120966,246,19,101,366
10333,dark,main,20211102,9,0.9913857183210002,258,18,91,367
9388,dark,main,20211102,0,0.9942991186144182,257,15,107,379
9388,dark,main,20211102,1,0.9911961834836913,234,17,81,332
9388,dark,main,20211102,2,0.9954382849258142,278,16,89,383
9388,dark,main,20211102,3,0.9946351799674316,255,17,77,349
9388,dark,main,20211102,4,0.9811570041093673,271,17,71,359
9388,dark,main,20211102,5,0.9922296019831985,280,17,80,377
9388,dark,main,20211102,6,0.9965584964455586,281,22,82,385
9388,dark,main,20211102,7,0.9955519458908064,234,21,78,333
9388,dark,main,20211102,8,0.987792206431002,147,12,50,209
9388,dark,main,20211102,9,0.9900860623276521,192,18,37,247
9829,dark,main,20211102,0,0.9904088185094433,284,13,97,394
9829,dark,main,20211102,1,0.9930650305252271,234,12,95,341
9829,dark,main,20211102,2,0.9867418454404732,286,12,92,390
9829,dark,main,20211102,3,0.9939695042678162,238,11,97,346
9829,dark,main,20211102,4,0.9932776250618619,237,13,96,346
9829,dark,main,20211102,5,0.9914385783677809,231,15,104,350
9829,dark,main,20211102,6,0.990712462693492,262,16,91,369
9829,dark,main,20211102,7,0.9874168418726067,256,9,76,341
9829,dark,main,20211102,8,0.9954631942487009,280,14,78,372
9829,dark,main,20211102,9,0.9909635428909338,269,11,99,379
11183,dark,main,20211102,0,0.993243434078636,263,36,77,376
11183,dark,main,20211102,1,0.9946839208033825,237,29,67,333
11183,dark,main,20211102,2,0.9875414897057488,244,30,91,365
11183,dark,main,20211102,3,0.9928575178565842,226,29,94,349
11183,dark,main,20211102,4,0.988706767280513,244,21,88,353
11183,dark,main,20211102,5,0.9942978970384115,247,21,104,372
11183,dark,main,20211102,6,0.9890352450320803,239,32,93,364
11183,dark,main,20211102,7,0.9903707934400504,221,23,85,329
11183,dark,main,20211102,8,0.9936028671928075,276,29,80,385
11183,dark,main,20211102,9,0.9974992323378469,266,20,98,384
1965,dark,main,20211102,0,0.9957859147838183,261,30,93,384
1965,dark,main,20211102,1,0.9902965196822566,249,15,63,327
1965,dark,main,20211102,2,0.9919840454449184,274,20,78,372
1965,dark,main,20211102,3,0.9902650100951478,232,21,92,345
1965,dark,main,20211102,4,0.9904342088663843,268,19,81,368
1965,dark,main,20211102,5,0.9909773133622428,252,19,83,354
1965,dark,main,20211102,6,0.9950323639226252,264,16,94,374
1965,dark,main,20211102,7,0.9814856638976031,242,17,78,337
1965,dark,main,20211102,8,0.9906198557146492,265,19,93,377
1965,dark,main,20211102,9,0.9902525432566431,290,22,76,388
3974,dark,main,20211102,0,0.9864186581970285,256,15,117,388
3974,dark,main,20211102,1,0.9862606708494777,228,16,81,325
3974,dark,main,20211102,2,0.9878130065671017,289,15,85,389
3974,dark,main,20211102,3,0.9909690500484972,242,17,84,343
3974,dark,main,20211102,4,0.9926902254311593,254,16,78,348
3974,dark,main,20211102,5,0.9853765111641842,237,18,94,349
3974,dark,main,20211102,6,0.9915592700265573,274,14,95,383
3974,dark,main,20211102,7,0.9886904675647439,235,11,76,322
3974,dark,main,20211102,8,0.9882128883604262,279,13,77,369
3974,dark,main,20211102,9,0.9944812918913766,293,14,74,381
9803,dark,main,20211102,0,0.9835149112743133,298,13,94,405
9803,dark,main,20211102,1,0.9879627832530083,257,18,71,346
9803,dark,main,20211102,2,0.9866032961823509,282,12,88,382
9803,dark,main,20211102,3,0.9920293159975943,254,13,93,360
9803,dark,main,20211102,4,0.9903498266675614,264,15,72,351
9803,dark,main,20211102,5,0.9897173935609818,264,14,89,367
9803,dark,main,20211102,6,0.9914476544985378,273,15,90,378
9803,dark,main,20211102,7,0.9894074008557895,231,14,82,327
9803,dark,main,20211102,8,0.9920650571034727,280,13,89,382
9803,dark,main,20211102,9,0.9897930288082393,258,14,92,364
9660,dark,main,20211102,0,0.9899007201613317,273,20,92,385
9660,dark,main,20211102,1,0.9928184561158794,250,18,71,339
9660,dark,main,20211102,2,0.986641938644756,277,20,78,375
9660,dark,main,20211102,3,0.9929162981412002,253,17,84,354
9660,dark,main,20211102,4,0.993056427590268,261,19,79,359
9660,dark,main,20211102,5,0.9901881161334047,251,18,100,369
9660,dark,main,20211102,6,0.9898535189356336,271,15,90,376
9660,dark,main,20211102,7,0.9902518600523337,236,16,65,317
9660,dark,main,20211102,8,0.9942890325819048,279,19,77,375
9660,dark,main,20211102,9,0.9881165267924786,260,17,104,381
23441,bright,main,20211102,0,0.9971219581683883,357,84,4,445
23441,bright,main,20211102,1,0.9903570752467726,287,88,3,378
23441,bright,main,20211102,2,0.991966889476922,314,109,5,428
23441,bright,main,20211102,3,0.9952528929731753,322,72,3,397
23441,bright,main,20211102,4,0.9972094534342759,317,84,6,407
23441,bright,main,20211102,5,0.9847744168799842,289,116,1,406
23441,bright,main,20211102,6,0.9948844847941479,325,100,2,427
23441,bright,main,20211102,7,0.987766392759343,247,128,0,375
23441,bright,main,20211102,8,0.9945168986627011,311,116,2,429
23441,bright,main,20211102,9,0.9934931739983909,352,70,2,424
5365,dark,main,20211103,0,0.9918119008831437,284,15,94,393
5365,dark,main,20211103,1,0.9950883968959501,240,15,85,340
5365,dark,main,20211103,2,0.9893797308920171,264,14,110,388
5365,dark,main,20211103,3,0.9924681437618839,252,19,81,352
5365,dark,main,20211103,4,0.9895062776268079,258,12,90,360
5365,dark,main,20211103,5,0.993028594970834,257,13,78,348
5365,dark,main,20211103,6,0.9929496037299094,259,13,91,363
5365,dark,main,20211103,7,0.9914024546479758,238,13,85,336
5365,dark,main,20211103,8,0.9906335929104204,275,15,88,378
5365,dark,main,20211103,9,0.9917851337407668,257,15,103,375
3406,dark,main,20211103,0,0.9889862492596192,287,19,73,379
3406,dark,main,20211103,1,0.9914500503005771,224,25,84,333
3406,dark,main,20211103,2,0.9887541324371499,279,21,74,374
3406,dark,main,20211103,3,0.9834523648369561,219,37,71,327
3406,dark,main,20211103,4,0.9908606569614381,219,55,70,344
3406,dark,main,20211103,5,0.9947424814883651,256,32,94,382
3406,dark,main,20211103,6,0.9926579439314464,269,26,80,375
3406,dark,main,20211103,7,0.9929610359154456,226,31,71,328
3406,dark,main,20211103,8,0.9927919000557226,265,28,66,359
3406,dark,main,20211103,9,0.9925073651253501,288,18,66,372
2266,dark,main,20211103,0,0.9930198712224384,268,19,98,385
2266,dark,main,20211103,1,0.9866685066145504,256,16,67,339
2266,dark,main,20211103,2,0.9882724824012565,291,18,73,382
2266,dark,main,20211103,3,0.9899202692127873,267,19,72,358
2266,dark,main,20211103,4,0.9884818572527412,242,20,88,350
2266,dark,main,20211103,5,0.9904680311441237,240,17,85,342
2266,dark,main,20211103,6,0.9949890647321683,288,13,90,391
2266,dark,main,20211103,7,0.9949985159260101,240,17,87,344
2266,dark,main,20211103,8,0.99164789214187,263,21,80,364
2266,dark,main,20211103,9,0.9860281090559104,267,26,92,385
9390,dark,main,20211103,0,0.9906922801423469,295,17,83,395
9390,dark,main,20211103,1,0.9901983460323055,246,16,80,342
9390,dark,main,20211103,2,0.9932286479503344,268,13,114,395
9390,dark,main,20211103,3,0.9928503352704231,241,26,79,346
9390,dark,main,20211103,4,0.9903812706389918,263,14,82,359
9390,dark,main,20211103,5,0.9835503211743949,253,15,94,362
9390,dark,main,20211103,6,0.9943550649476337,274,13,85,372
9390,dark,main,20211103,7,0.9875762078231272,235,17,79,331
9390,dark,main,20211103,8,0.9900659188438744,269,15,90,374
9390,dark,main,20211103,9,0.9849226079969802,274,11,75,360
10370,dark,main,20211103,0,0.9904121221005333,295,16,88,399
10370,dark,main,20211103,1,0.9942892213312675,232,16,87,335
10370,dark,main,20211103,2,0.9903339331058931,247,14,119,380
10370,dark,main,20211103,3,0.9936255704227149,255,16,88,359
10370,dark,main,20211103,4,0.9962178229840197,253,16,83,352
10370,dark,main,20211103,5,0.9858368889400393,255,15,90,360
10370,dark,main,20211103,6,0.9927035568263247,271,12,105,388
10370,dark,main,20211103,7,0.9910929014720812,212,17,89,318
10370,dark,main,20211103,8,0.9896065453213235,277,13,93,383
10370,dark,main,20211103,9,0.9883652453871398,283,13,80,376
3582,dark,main,20211103,0,0.9940478287420128,282,13,93,388
3582,dark,main,20211103,1,0.9883551708008544,232,12,84,328
3582,dark,main,20211103,2,0.9929271570268473,269,15,101,385
3582,dark,main,20211103,3,0.9909732652323513,245,19,92,356
3582,dark,main,20211103,4,0.9877870416840824,260,18,85,363
3582,dark,main,20211103,5,0.9904224716246243,249,15,81,345
3582,dark,main,20211103,6,0.9907242215577412,274,14,88,376
3582,dark,main,20211103,7,0.985871765875251,235,13,82,330
3582,dark,main,20211103,8,0.9919094750554474,277,14,87,378
3582,dark,main,20211103,9,0.9940719847512454,275,14,81,370
9828,dark,main,20211103,0,0.9955698209346068,283,12,101,396
9828,dark,main,20211103,1,0.9815601541638319,236,16,76,328
9828,dark,main,20211103,2,0.9932337180427123,274,11,101,386
9828,dark,main,20211103,3,0.9775638178322911,252,14,80,346
9828,dark,main,20211103,4,0.9845860818729562,254,15,92,361
9828,dark,main,20211103,5,0.9916274123484745,293,10,70,373
9828,dark,main,20211103,6,0.991641964839662,283,13,83,379
9828,dark,main,20211103,7,0.9936539107178399,230,15,75,320
9828,dark,main,20211103,8,0.9904359371003719,255,14,119,388
9828,dark,main,20211103,9,0.9900388407764456,264,12,95,371
3555,dark,main,20211103,0,0.9924125278184849,292,13,95,400
3555,dark,main,20211103,1,0.9896653502979972,236,14,77,327
3555,dark,main,20211103,2,0.9925746947598828,274,18,91,383
3555,dark,main,20211103,3,0.9874474173959286,257,22,78,357
3555,dark,main,20211103,4,0.9949511157105954,251,16,90,357
3555,dark,main,20211103,5,0.9945469643979641,229,17,102,348
3555,dark,main,20211103,6,0.9979099568419091,261,14,90,365
3555,dark,main,20211103,7,0.9896933651822236,238,18,79,335
3555,dark,main,20211103,8,0.9900550582509056,280,20,77,377
3555,dark,main,20211103,9,0.9912448610899237,270,15,91,376
3819,dark,main,20211103,0,0.9860844710520583,271,16,106,393
3819,dark,main,20211103,1,0.9932158056475715,224,13,94,331
3819,dark,main,20211103,2,0.9935073098803265,272,14,96,382
3819,dark,main,20211103,3,0.9866138944192874,260,12,83,355
3819,dark,main,20211103,4,0.9902794494917915,253,15,79,347
3819,dark,main,20211103,5,0.9902888224446782,248,15,93,356
3819,dark,main,20211103,6,0.9922134622570651,287,17,81,385
3819,dark,main,20211103,7,0.9924095710244262,228,14,76,318
3819,dark,main,20211103,8,0.9973677551911799,264,16,103,383
3819,dark,main,20211103,9,0.989271239038777,274,13,87,374
1977,dark,main,20211103,0,0.98653208707726,293,15,95,403
1977,dark,main,20211103,1,0.9956666492554808,228,19,84,331
1977,dark,main,20211103,2,0.9933691158781442,280,16,87,383
1977,dark,main,20211103,3,0.9967406918924877,264,11,89,364
1977,dark,main,20211103,4,0.9953557365313429,273,16,71,360
1977,dark,main,20211103,5,0.991977187754624,269,13,83,365
1977,dark,main,20211103,6,0.9884564927501976,269,16,94,379
1977,dark,main,20211103,7,0.9855247598711186,221,22,88,331
1977,dark,main,20211103,8,0.9900435902771125,261,21,96,378
1977,dark,main,20211103,9,0.9880585363393505,267,13,87,367
9812,dark,main,20211103,0,0.99621541060036,283,11,99,393
9812,dark,main,20211103,1,0.990095418261994,244,17,79,340
9812,dark,main,20211103,2,0.992571968927509,274,11,98,383
9812,dark,main,20211103,3,0.9847145425111414,253,14,91,358
9812,dark,main,20211103,4,0.9949739263082185,260,13,89,362
9812,dark,main,20211103,5,0.9956642417462944,254,12,96,362
9812,dark,main,20211103,6,0.9885185870672701,289,19,89,397
9812,dark,main,20211103,7,0.9852514014513375,229,15,93,337
9812,dark,main,20211103,8,0.9889389510030142,268,15,90,373
9812,dark,main,20211103,9,0.99152093612633,290,13,81,384
5358,dark,main,20211103,0,0.9923207453264784,278,13,99,390
5358,dark,main,20211103,1,0.9827980042470152,235,10,86,331
5358,dark,main,20211103,2,0.9909195672061588,258,15,97,370
5358,dark,main,20211103,3,0.9930656938111095,251,17,94,362
5358,dark,main,20211103,4,0.9882646928621934,250,14,89,353
5358,dark,main,20211103,5,0.9928845162524023,261,15,80,356
5358,dark,main,20211103,6,0.9940816528256233,256,12,105,373
5358,dark,main,20211103,7,0.9915589626900606,231,17,85,333
5358,dark,main,20211103,8,0.9934397275286678,262,16,79,357
5358,dark,main,20211103,9,0.9910291435551188,262,14,88,364
9861,dark,main,20211103,0,0.9911120977638459,294,11,84,389
9861,dark,main,20211103,1,0.9903057543390822,238,13,65,316
9861,dark,main,20211103,2,0.995999641265139,273,15,89,377
9861,dark,main,20211103,3,0.9942182876060872,269,10,71,350
9861,dark,main,20211103,4,0.9931297699308635,270,16,77,363
9861,dark,main,20211103,5,0.9917463264728682,259,11,87,357
9861,dark,main,20211103,6,0.9911852308778523,280,13,92,385
9861,dark,main,20211103,7,0.9878796531386995,243,14,86,343
9861,dark,main,20211103,8,0.9896411335210398,266,13,98,377
9861,dark,main,20211103,9,0.987154338201401,269,12,91,372
8051,dark,main,20211103,0,0.9921561058856306,271,21,95,387
8051,dark,main,20211103,1,0.990607666568468,239,19,70,328
8051,dark,main,20211103,2,0.9910678087004878,272,19,87,378
8051,dark,main,20211103,3,0.9881536281084315,250,24,69,343
8051,dark,main,20211103,4,0.9909557756884035,265,14,86,365
8051,dark,main,20211103,5,0.9918731021877886,264,19,89,372
8051,dark,main,20211103,6,0.9950786825884649,214,14,83,311
8051,dark,main,20211103,7,0.9850574606413937,211,16,72,299
8051,dark,main,20211103,8,0.9954967379102478,273,12,92,377
8051,dark,main,20211103,9,0.9927363278623317,268,11,92,371
9855,dark,main,20211103,0,0.9856485794894049,276,17,87,380
9855,dark,main,20211103,1,0.9873536005257885,249,11,75,335
9855,dark,main,20211103,2,0.9928769691410421,283,14,86,383
9855,dark,main,20211103,3,0.9943406989946589,267,16,77,360
9855,dark,main,20211103,4,0.9938733238235617,250,15,89,354
9855,dark,main,20211103,5,0.9917990977147104,246,22,98,366
9855,dark,main,20211103,6,0.9890475779652436,265,19,92,376
9855,dark,main,20211103,7,0.9847234623899244,243,14,83,340
9855,dark,main,20211103,8,0.9951761933987195,271,11,93,375
9855,dark,main,20211103,9,0.9889015222688161,291,19,73,383
8218,dark,main,20211103,0,0.9904229283810019,279,32,89,400
8218,dark,main,20211103,1,0.9921124751563652,237,14,86,337
8218,dark,main,20211103,2,0.9907459196220961,288,22,86,396
8218,dark,main,20211103,3,0.9901719229785884,247,18,98,363
8218,dark,main,20211103,4,0.9934399578506994,273,12,93,378
8218,dark,main,20211103,5,0.9922351895962647,264,14,74,352
8218,dark,main,20211103,6,0.9925464101173475,270,15,91,376
8218,dark,main,20211103,7,0.9877336639757596,233,15,78,326
8218,dark,main,20211103,8,0.9872814243403567,295,12,75,382
8218,dark,main,20211103,9,0.9898486820780961,264,15,86,365
11798,dark,main,20211103,0,0.9958134473231878,268,17,112,397
11798,dark,main,20211103,1,0.9907968741492995,250,14,70,334
11798,dark,main,20211103,2,0.9924173014747819,296,14,73,383
11798,dark,main,20211103,3,0.9892231844445223,228,21,81,330
11798,dark,main,20211103,4,0.9881082917429403,268,14,75,357
11798,dark,main,20211103,5,0.9923007613770062,249,17,90,356
11798,dark,main,20211103,6,0.9920912920673193,240,13,97,350
11798,dark,main,20211103,7,0.9945618020827228,224,15,75,314
11798,dark,main,20211103,8,0.9945984372795889,256,14,85,355
11798,dark,main,20211103,9,0.9933030005575734,262,15,80,357
10239,dark,main,20211103,0,0.9908650951392106,298,14,98,410
10239,dark,main,20211103,1,0.9840497881199837,234,13,94,341
10239,dark,main,20211103,2,0.9888150656610816,283,15,98,396
10239,dark,main,20211103,3,0.9898336950617193,247,14,80,341
10239,dark,main,20211103,4,0.9893459025449769,247,12,98,357
10239,dark,main,20211103,5,0.9931742517769279,251,13,98,362
10239,dark,main,20211103,6,0.986397255034081,272,13,106,391
10239,dark,main,20211103,7,0.9898886654745548,246,18,78,342
10239,dark,main,20211103,8,0.9838837272270283,282,19,88,389
10239,dark,main,20211103,9,0.9885920648288813,283,16,89,388
10243,dark,main,20211103,0,0.9890110104938389,288,12,92,392
10243,dark,main,20211103,1,0.986815776747874,233,14,85,332
10243,dark,main,20211103,2,0.9905764151435479,257,14,117,388
10243,dark,main,20211103,3,0.9926047409136304,256,13,93,362
10243,dark,main,20211103,4,0.9942893057877927,244,18,109,371
10243,dark,main,20211103,5,0.9938022710848445,257,11,86,354
10243,dark,main,20211103,6,0.9927823161846464,252,11,117,380
10243,dark,main,20211103,7,0.9969057747824183,231,12,82,325
10243,dark,main,20211103,8,0.9849322878389781,263,12,102,377
10243,dark,main,20211103,9,0.9957577806843598,278,11,97,386
9864,dark,main,20211103,0,0.9923778918481075,280,18,97,395
9864,dark,main,20211103,1,0.9917749443503154,227,14,90,331
9864,dark,main,20211103,2,0.9885989299401415,268,24,88,380
9864,dark,main,20211103,3,0.989532372663713,262,11,85,358
9864,dark,main,20211103,4,0.9949726688120135,258,11,85,354
9864,dark,main,20211103,5,0.9934966640762144,255,20,81,356
9864,dark,main,20211103,6,0.9949100278647157,243,14,102,359
9864,dark,main,20211103,7,0.9859677830139578,250,14,76,340
9864,dark,main,20211103,8,0.9918949129818095,251,15,92,358
9864,dark,main,20211103,9,0.9941222209261876,266,10,102,378
9798,dark,main,20211103,0,0.9906520911344158,266,15,112,393
9798,dark,main,20211103,1,0.9898225186022359,223,12,93,328
9798,dark,main,20211103,2,0.9899263842783746,266,14,103,383
9798,dark,main,20211103,3,0.9918410128396851,259,12,83,354
9798,dark,main,20211103,4,0.9947155624580011,249,14,96,359
9798,dark,main,20211103,5,0.994486315439356,234,18,89,341
9798,dark,main,20211103,6,0.9874809846342371,273,15,86,374
9798,dark,main,20211103,7,0.9946852828361653,226,12,91,329
9798,dark,main,20211103,8,0.9894120774900211,258,16,92,366
9798,dark,main,20211103,9,0.9934389922635867,279,14,84,377
3820,dark,main,20211103,0,0.9935256314935769,250,17,100,367
3820,dark,main,20211103,1,0.9919745959281756,252,13,78,343
3820,dark,main,20211103,2,0.9900040777309633,261,18,113,392
3820,dark,main,20211103,3,0.9924414144182327,230,19,101,350
3820,dark,main,20211103,4,0.9909703557236653,260,15,87,362
3820,dark,main,20211103,5,0.9918160760608197,282,11,82,375
3820,dark,main,20211103,6,0.9930604525158837,266,15,90,371
3820,dark,main,20211103,7,0.994090902830738,234,17,80,331
3820,dark,main,20211103,8,0.9883737146447497,262,15,95,372
3820,dark,main,20211103,9,0.9918556434665234,266,14,106,386
22425,bright,main,20211103,0,0.994201289514776,363,81,1,445
22425,bright,main,20211103,1,0.9884396635116354,304,73,3,380
22425,bright,main,20211103,2,0.9907939686101558,357,75,1,433
22425,bright,main,20211103,3,0.9943858577620348,323,68,2,393
22425,bright,main,20211103,4,0.995194571969259,344,51,4,399
22425,bright,main,20211103,5,0.995267010849267,331,69,8,408
22425,bright,main,20211103,6,0.9969194991642922,339,85,3,427
22425,bright,main,20211103,7,0.9904975570158945,306,66,3,375
22425,bright,main,20211103,8,0.9858122033452476,351,73,0,424
22425,bright,main,20211103,9,0.9927258165932115,359,65,5,429
2253,dark,main,20211103,0,0.9950998695833875,261,21,107,389
2253,dark,main,20211103,1,0.9923395188965453,245,17,83,345
2253,dark,main,20211103,2,0.992871861811103,251,20,108,379
2253,dark,main,20211103,3,0.9896574937511221,266,18,73,357
2253,dark,main,20211103,4,0.9909809869055936,261,11,84,356
2253,dark,main,20211103,5,0.9897806817655888,240,16,100,356
2253,dark,main,20211103,6,0.9955956484119343,247,17,100,364
2253,dark,main,20211103,7,0.9937467837378284,233,32,75,340
2253,dark,main,20211103,8,0.9904018382151987,269,17,93,379
2253,dark,main,20211103,9,0.9855758974258786,271,17,80,368
6983,dark,main,20211103,0,0.9920524345245237,268,20,110,398
6983,dark,main,20211103,1,0.9904504296044102,215,34,73,322
6983,dark,main,20211103,2,0.9948879582842169,268,22,92,382
6983,dark,main,20211103,3,0.9893279906599752,231,26,83,340
6983,dark,main,20211103,4,0.980328560634065,239,23,75,337
6983,dark,main,20211103,5,0.9807469873765552,217,9,67,293
6983,dark,main,20211103,6,0.9892344174007537,253,17,99,369
6983,dark,main,20211103,7,0.989694034049442,230,23,88,341
6983,dark,main,20211103,8,0.987680377206629,257,17,93,367
6983,dark,main,20211103,9,0.989800198140867,257,16,92,365
8054,dark,main,20211103,0,0.9864613504903509,301,16,91,408
8054,dark,main,20211103,1,0.986080514132551,237,13,80,330
8054,dark,main,20211103,2,0.9865394156713021,258,24,84,366
8054,dark,main,20211103,3,0.9958132205415019,254,20,83,357
8054,dark,main,20211103,4,0.9928098299262429,243,15,96,354
8054,dark,main,20211103,5,0.9901712701837557,244,23,91,358
8054,dark,main,20211103,6,0.9901992937396817,273,15,92,380
8054,dark,main,20211103,7,0.9941732727274614,238,16,72,326
8054,dark,main,20211103,8,0.9849725703091081,278,14,93,385
8054,dark,main,20211103,9,0.9929967553374639,278,10,90,378
5496,dark,main,20211103,0,0.9947875037267678,267,22,97,386
5496,dark,main,20211103,1,0.9940548372923508,227,18,88,333
5496,dark,main,20211103,2,0.9904458846154404,285,18,84,387
5496,dark,main,20211103,3,0.9896627385165049,242,20,86,348
5496,dark,main,20211103,4,0.9924785253913246,287,15,69,371
5496,dark,main,20211103,5,0.9926330490514066,268,18,76,362
5496,dark,main,20211103,6,0.9952166712016763,263,11,104,378
5496,dark,main,20211103,7,0.9922042165666949,223,17,94,334
5496,dark,main,20211103,8,0.9838105719154259,264,15,103,382
5496,dark,main,20211103,9,0.9885621629382326,237,20,100,357
5504,dark,main,20211103,0,0.9932573495808831,279,18,94,391
5504,dark,main,20211103,1,0.9923277048687988,246,15,73,334
5504,dark,main,20211103,2,0.9933131040496754,269,22,93,384
5504,dark,main,20211103,3,0.9919794371315929,264,15,82,361
5504,dark,main,20211103,4,0.9912702184669611,264,12,89,365
5504,dark,main,20211103,5,0.99031518603244,249,9,102,360
5504,dark,main,20211103,6,0.991839432063858,295,13,77,385
5504,dark,main,20211103,7,0.9904125737361608,233,14,83,330
5504,dark,main,20211103,8,0.989006801070741,267,12,79,358
5504,dark,main,20211103,9,0.9907612299083839,268,12,100,380
3817,dark,main,20211103,0,0.9882181756609627,284,16,92,392
3817,dark,main,20211103,1,0.9932897683535805,242,14,87,343
3817,dark,main,20211103,2,0.9900912231959209,278,25,85,388
3817,dark,main,20211103,3,0.994041974448531,242,15,95,352
3817,dark,main,20211103,4,0.9846799988838556,268,16,74,358
3817,dark,main,20211103,5,0.9949682020971758,250,21,93,364
3817,dark,main,20211103,6,0.9893547115531162,277,16,87,380
3817,dark,main,20211103,7,0.991102783345894,221,11,95,327
3817,dark,main,20211103,8,0.9906026367442106,273,13,83,369
3817,dark,main,20211103,9,0.9938835080795635,281,14,84,379
9808,dark,main,20211103,0,0.9927162469184462,295,15,93,403
9808,dark,main,20211103,1,0.9938096035049062,226,17,85,328
9808,dark,main,20211103,2,0.9943736892796119,283,16,84,383
9808,dark,main,20211103,3,0.9896090552220784,256,13,90,359
9808,dark,main,20211103,4,0.9900502290330513,262,16,78,356
9808,dark,main,20211103,5,0.993462028656475,278,12,85,375
9808,dark,main,20211103,6,0.9928547177734625,265,14,91,370
9808,dark,main,20211103,7,0.9955663969458708,253,15,77,345
9808,dark,main,20211103,8,0.9919865647746169,269,13,100,382
9808,dark,main,20211103,9,0.9953644829255235,275,16,88,379
2353,dark,main,20211103,0,0.993844527884443,266,14,106,386
2353,dark,main,20211103,1,0.9956863934658566,229,22,82,333
2353,dark,main,20211103,2,0.995010301133931,284,16,93,393
2353,dark,main,20211103,3,0.9886843865728903,257,16,79,352
2353,dark,main,20211103,4,0.9919134084351964,255,17,80,352
2353,dark,main,20211103,5,0.9920863811339703,251,14,79,344
2353,dark,main,20211103,6,0.9912407418123462,297,14,77,388
2353,dark,main,20211103,7,0.9904688358061731,233,17,81,331
2353,dark,main,20211103,8,0.9858199555706975,262,20,95,377
2353,dark,main,20211103,9,0.9929633874102931,261,17,95,373
11617,dark,main,20211103,0,0.9904256893522806,294,16,76,386
11617,dark,main,20211103,1,0.9866888026879614,229,17,84,330
11617,dark,main,20211103,2,0.9846586535266992,261,19,88,368
11617,dark,main,20211103,3,0.9897224915906646,258,22,64,344
11617,dark,main,20211103,4,0.9907130903919512,257,14,79,350
11617,dark,main,20211103,5,0.9931319832241456,249,17,73,339
11617,dark,main,20211103,6,0.9908388895908349,287,12,66,365
11617,dark,main,20211103,7,0.9951512650779589,209,22,90,321
11617,dark,main,20211103,8,0.9914322041257242,284,15,83,382
11617,dark,main,20211103,9,0.9858469789565196,272,19,86,377
9804,dark,main,20211103,0,0.9930558547403752,290,15,100,405
9804,dark,main,20211103,1,0.9941241029191844,244,12,86,342
9804,dark,main,20211103,2,0.990473898975234,278,12,83,373
9804,dark,main,20211103,3,0.9951579242078025,274,15,80,369
9804,dark,main,20211103,4,0.9940000475148725,256,12,99,367
9804,dark,main,20211103,5,0.9873304614662205,268,14,86,368
9804,dark,main,20211103,6,0.9911691933343156,278,14,88,380
9804,dark,main,20211103,7,0.9907079740031375,228,19,75,322
9804,dark,main,20211103,8,0.9936849990347069,261,14,104,379
9804,dark,main,20211103,9,0.9871997145284175,257,12,104,373
9810,dark,main,20211103,0,0.9900841398964498,288,12,92,392
9810,dark,main,20211103,1,0.9821585271585475,232,11,91,334
9810,dark,main,20211103,2,0.9885487006025793,296,12,83,391
9810,dark,main,20211103,3,0.9949326915329969,222,17,95,334
9810,dark,main,20211103,4,0.9866629052963974,238,16,85,339
9810,dark,main,20211103,5,0.9858249470269166,256,12,87,355
9810,dark,main,20211103,6,0.9900696766373946,256,15,95,366
9810,dark,main,20211103,7,0.9956966327374239,248,13,75,336
9810,dark,main,20211103,8,0.9895240717998923,264,15,90,369
9810,dark,main,20211103,9,0.9892501957686304,265,19,98,382
5575,dark,main,20211103,0,0.9950776910852684,294,11,96,401
5575,dark,main,20211103,1,0.9886577678872884,249,8,75,332
5575,dark,main,20211103,2,0.9930396268424609,287,12,102,401
5575,dark,main,20211103,3,0.9941153797667656,252,14,92,358
5575,dark,main,20211103,4,0.9945611594681721,260,13,97,370
5575,dark,main,20211103,5,0.9912140932549437,257,14,103,374
5575,dark,main,20211103,6,0.9933571918522975,288,12,90,390
5575,dark,main,20211103,7,0.9922834501689031,255,11,79,345
5575,dark,main,20211103,8,0.9924140467546793,274,13,97,384
5575,dark,main,20211103,9,0.9864231360648991,274,14,93,381
1839,dark,main,20211103,0,0.9941522334536032,266,22,90,378
1839,dark,main,20211103,1,0.988389539953823,209,42,80,331
1839,dark,main,20211103,2,0.9877266224771276,263,33,84,380
1839,dark,main,20211103,3,0.994860604085346,244,27,81,352
1839,dark,main,20211103,4,0.9905230656031859,247,30,66,343
1839,dark,main,20211103,5,0.9924192588956874,246,21,94,361
1839,dark,main,20211103,6,0.9813446960517047,262,21,81,364
1839,dark,main,20211103,7,0.9922605747316906,218,28,77,323
1839,dark,main,20211103,8,0.9890034452076251,260,29,87,376
1839,dark,main,20211103,9,0.9929596586701417,257,21,85,363
3384,dark,main,20211103,0,0.9932200949492195,273,19,96,388
3384,dark,main,20211103,1,0.9917207267345084,232,22,76,330
3384,dark,main,20211103,2,0.986493282218609,263,24,95,382
3384,dark,main,20211103,3,0.9887904378788706,226,25,87,338
3384,dark,main,20211103,4,0.9925248814681648,242,28,77,347
3384,dark,main,20211103,5,0.9894300357224983,234,27,98,359
3384,dark,main,20211103,6,0.9908250431244366,242,22,109,373
3384,dark,main,20211103,7,0.9929989615647749,196,56,78,330
3384,dark,main,20211103,8,0.992251466450891,252,32,74,358
3384,dark,main,20211103,9,0.9902304980063109,275,25,77,377
7060,dark,main,20211103,0,0.9920037998678504,266,20,92,378
7060,dark,main,20211103,1,0.997830234647776,225,16,89,330
7060,dark,main,20211103,2,0.9937700823800848,260,21,100,381
7060,dark,main,20211103,3,0.9872530737373952,237,18,98,353
7060,dark,main,20211103,4,0.9879646187592528,256,22,80,358
7060,dark,main,20211103,5,0.9951526301606322,250,21,83,354
7060,dark,main,20211103,6,0.9949776128510001,266,14,80,360
7060,dark,main,20211103,7,0.9923406010935754,232,14,85,331
7060,dark,main,20211103,8,0.9900582485892641,252,26,99,377
7060,dark,main,20211103,9,0.9832395766373533,259,18,93,370
11653,dark,main,20211103,0,0.9870104078296429,273,17,86,376
11653,dark,main,20211103,1,0.9929253709478725,232,13,92,337
11653,dark,main,20211103,2,0.9914447770234885,289,18,87,394
11653,dark,main,20211103,3,0.9872080491979739,263,13,67,343
11653,dark,main,20211103,4,0.9911742705873663,253,17,93,363
11653,dark,main,20211103,5,0.9923396249880864,258,20,90,368
11653,dark,main,20211103,6,0.9910056280096052,282,16,70,368
11653,dark,main,20211103,7,0.9935050732626072,232,18,87,337
11653,dark,main,20211103,8,0.9927596835023305,279,17,69,365
11653,dark,main,20211103,9,0.9926791220761263,286,19,79,384
3945,dark,main,20211103,0,0.9921148934892517,290,18,86,394
3945,dark,main,20211103,1,0.9888567534807297,250,14,83,347
3945,dark,main,20211103,2,0.9931924553813825,264,20,96,380
3945,dark,main,20211103,3,0.9897050006874029,266,23,75,364
3945,dark,main,20211103,4,0.9931141158024627,267,18,82,367
3945,dark,main,20211103,5,0.992365875751821,256,16,83,355
3945,dark,main,20211103,6,0.9935708535602226,277,13,82,372
3945,dark,main,20211103,7,0.9866314242863579,233,21,82,336
3945,dark,main,20211103,8,0.9933489069783543,253,17,90,360
3945,dark,main,20211103,9,0.9919500267542808,265,16,100,381
9814,dark,main,20211104,0,0.9917459920741433,272,16,98,386
9814,dark,main,20211104,1,0.9944808411556335,244,15,77,336
9814,dark,main,20211104,2,0.9966575548452312,288,18,84,390
9814,dark,main,20211104,3,0.9906493644501206,247,19,74,340
9814,dark,main,20211104,4,0.9936724144308974,252,22,85,359
9814,dark,main,20211104,5,0.9952102414656798,265,14,86,365
9814,dark,main,20211104,6,0.9899258815543825,265,14,94,373
9814,dark,main,20211104,7,0.9904857978794438,245,17,77,339
9814,dark,main,20211104,8,0.9915463874261153,257,15,91,363
9814,dark,main,20211104,9,0.9887992492518204,272,15,96,383
8540,dark,main,20211104,0,0.9930416631176179,282,32,74,388
8540,dark,main,20211104,1,0.9912107277974822,224,26,88,338
8540,dark,main,20211104,2,0.993469476605757,268,21,102,391
8540,dark,main,20211104,3,0.9930789528156162,249,17,91,357
8540,dark,main,20211104,4,0.9891730421405356,269,12,67,348
8540,dark,main,20211104,5,0.9919553730214064,251,23,88,362
8540,dark,main,20211104,6,0.9905521559123285,245,29,86,360
8540,dark,main,20211104,7,0.9914513673261081,200,32,82,314
8540,dark,main,20211104,8,0.9933775516265589,271,23,69,363
8540,dark,main,20211104,9,0.9929370426752521,263,28,79,370
8653,dark,main,20211104,0,0.9881773604401418,281,17,94,392
8653,dark,main,20211104,1,0.9927224677841034,248,19,78,345
8653,dark,main,20211104,2,0.9944467793100399,268,31,86,385
8653,dark,main,20211104,3,0.993020587918748,245,21,94,360
8653,dark,main,20211104,4,0.9943523688273267,249,19,97,365
8653,dark,main,20211104,5,0.9863063842505498,238,21,105,364
8653,dark,main,20211104,6,0.9910071623763634,268,14,102,384
8653,dark,main,20211104,7,0.9934391542068388,251,18,69,338
8653,dark,main,20211104,8,0.9903689533100027,255,20,99,374
8653,dark,main,20211104,9,0.9944775357155639,267,21,82,370
5565,dark,main,20211104,0,0.9879579234987849,283,18,101,402
5565,dark,main,20211104,1,0.9909350059273434,253,19,83,355
5565,dark,main,20211104,2,0.9903684238375305,277,13,103,393
5565,dark,main,20211104,3,0.9921115124829746,259,12,94,365
5565,dark,main,20211104,4,0.992243935130624,269,14,87,370
5565,dark,main,20211104,5,0.9916524370492764,310,9,71,390
5565,dark,main,20211104,6,0.990173544016349,279,13,87,379
5565,dark,main,20211104,7,0.9895822877433748,234,12,93,339
5565,dark,main,20211104,8,0.9901733498497128,269,10,113,392
5565,dark,main,20211104,9,0.9900141556585438,291,16,86,393
6937,dark,main,20211104,0,0.9905270176173772,297,15,81,393
6937,dark,main,20211104,1,0.9891378723057368,243,13,75,331
6937,dark,main,20211104,2,0.9900095383895599,272,15,91,378
6937,dark,main,20211104,3,0.9870028338247947,249,19,88,356
6937,dark,main,20211104,4,0.9910968767881891,264,22,73,359
6937,dark,main,20211104,5,0.9923444879245927,257,19,86,362
6937,dark,main,20211104,6,0.990027223079761,265,18,81,364
6937,dark,main,20211104,7,0.9925279029947133,247,19,60,326
6937,dark,main,20211104,8,0.9924000974175962,262,14,84,360
6937,dark,main,20211104,9,0.9936501403947724,265,22,85,372
9832,dark,main,20211104,0,0.9932783325829363,285,17,84,386
9832,dark,main,20211104,1,0.984297924082529,224,13,87,324
9832,dark,main,20211104,2,0.990962105648664,281,21,86,388
9832,dark,main,20211104,3,0.9937664103710889,246,13,97,356
9832,dark,main,20211104,4,0.9935602396192771,245,12,97,354
9832,dark,main,20211104,5,0.9915026760359279,267,22,78,367
9832,dark,main,20211104,6,0.9895631574231903,282,20,81,383
9832,dark,main,20211104,7,0.9877774018309785,215,22,76,313
9832,dark,main,20211104,8,0.9877417255098887,256,16,96,368
9832,dark,main,20211104,9,0.9885717219562583,258,16,100,374
9802,dark,main,20211104,0,0.9942514317777961,282,16,88,386
9802,dark,main,20211104,1,0.9927633464458069,234,14,70,318
9802,dark,main,20211104,2,0.9944246933919931,261,20,114,395
9802,dark,main,20211104,3,0.9861561886563782,254,19,80,353
9802,dark,main,20211104,4,0.9862124268787026,242,18,88,348
9802,dark,main,20211104,5,0.9940185530963299,243,16,96,355
9802,dark,main,20211104,6,0.9894638609773871,257,16,97,370
9802,dark,main,20211104,7,0.9909390191121721,228,18,86,332
9802,dark,main,20211104,8,0.9855544471551475,254,17,93,364
9802,dark,main,20211104,9,0.9914648461974461,260,15,91,366
2016,dark,main,20211104,0,0.9958252810060849,279,14,95,388
2016,dark,main,20211104,1,0.9930552771023557,222,11,89,322
2016,dark,main,20211104,2,0.9927377652067229,269,15,100,384
2016,dark,main,20211104,3,0.9883932139412162,253,12,91,356
2016,dark,main,20211104,4,0.9912970313276322,261,10,87,358
2016,dark,main,20211104,5,0.9958372492946589,251,18,100,369
2016,dark,main,20211104,6,0.9909540829018865,265,11,85,361
2016,dark,main,20211104,7,0.9871433787474259,248,14,80,342
2016,dark,main,20211104,8,0.9878230028230305,283,15,78,376
2016,dark,main,20211104,9,0.9924026438364478,276,17,77,370
7836,dark,main,20211104,0,0.9905770410129232,285,19,93,397
7836,dark,main,20211104,1,0.9932232961883796,245,12,73,330
7836,dark,main,20211104,2,0.9896235288179328,276,29,75,380
7836,dark,main,20211104,3,0.9888111154207175,240,23,94,357
7836,dark,main,20211104,4,0.9919432875614967,251,26,90,367
7836,dark,main,20211104,5,0.9912757714008162,256,23,81,360
7836,dark,main,20211104,6,0.9919414785381159,248,34,94,376
7836,dark,main,20211104,7,0.9913795001703157,215,14,91,320
7836,dark,main,20211104,8,0.988661039161724,257,22,95,374
7836,dark,main,20211104,9,0.9887529213459673,280,21,80,381
5602,dark,main,20211104,0,0.9941716519599213,290,10,98,398
5602,dark,main,20211104,1,0.9879103258866238,250,10,73,333
5602,dark,main,20211104,2,0.9905374079563527,277,15,101,393
5602,dark,main,20211104,3,0.9945039007762224,267,14,81,362
5602,dark,main,20211104,4,0.9914669598555219,256,11,93,360
5602,dark,main,20211104,5,0.9920499642010495,287,17,81,385
5602,dark,main,20211104,6,0.9943126433204373,275,14,85,374
5602,dark,main,20211104,7,0.9876427685828487,228,11,83,322
5602,dark,main,20211104,8,0.9924001063365395,282,14,95,391
5602,dark,main,20211104,9,0.9878815332315649,263,10,109,382
8271,dark,main,20211104,0,0.993420696557477,277,13,110,400
8271,dark,main,20211104,1,0.9871150689089467,235,15,73,323
8271,dark,main,20211104,2,0.9905533111374154,274,15,104,393
8271,dark,main,20211104,3,0.9929979585232818,256,16,93,365
8271,dark,main,20211104,4,0.988947041194349,264,14,85,363
8271,dark,main,20211104,5,0.9918710240794832,263,17,93,373
8271,dark,main,20211104,6,0.9866224563023951,291,12,78,381
8271,dark,main,20211104,7,0.9934549903372155,251,17,76,344
8271,dark,main,20211104,8,0.9904647276869721,270,22,85,377
8271,dark,main,20211104,9,0.9968339193502961,269,15,101,385
4854,dark,main,20211104,0,0.9906202743748521,257,32,94,383
4854,dark,main,20211104,1,0.9918798629753912,223,32,75,330
4854,dark,main,20211104,2,0.9929608695837147,268,33,91,392
4854,dark,main,20211104,3,0.9935046524450888,263,26,71,360
4854,dark,main,20211104,4,0.98799598751713,257,23,84,364
4854,dark,main,20211104,5,0.9955852619062405,263,24,81,368
4854,dark,main,20211104,6,0.992580589898566,262,16,100,378
4854,dark,main,20211104,7,0.9907370941333596,225,35,73,333
4854,dark,main,20211104,8,0.9933315709618629,246,38,77,361
4854,dark,main,20211104,9,0.9958131122515731,258,25,88,371
11661,dark,main,20211104,0,0.9860311993779459,290,19,80,389
11661,dark,main,20211104,1,0.9900430468758039,236,17,79,332
11661,dark,main,20211104,2,0.9925263521618517,279,18,93,390
11661,dark,main,20211104,3,0.9915728392362895,261,18,68,347
11661,dark,main,20211104,4,0.9959138635677329,270,19,57,346
11661,dark,main,20211104,5,0.9881342017446417,276,22,63,361
11661,dark,main,20211104,6,0.9943473897138168,274,15,88,377
11661,dark,main,20211104,7,0.9933845345466316,215,18,91,324
11661,dark,main,20211104,8,0.9887096001838314,273,18,84,375
11661,dark,main,20211104,9,0.9958344010055195,266,15,75,356
4830,dark,main,20211104,0,0.9935765532751194,270,12,112,394
4830,dark,main,20211104,1,0.9886799021139167,247,12,79,338
4830,dark,main,20211104,2,0.9888930821723694,295,12,96,403
4830,dark,main,20211104,3,0.9861153748865615,240,17,103,360
4830,dark,main,20211104,4,0.9942851576050229,263,13,93,369
4830,dark,main,20211104,5,0.987206475951346,265,12,91,368
4830,dark,main,20211104,6,0.989618537537699,274,11,95,380
4830,dark,main,20211104,7,0.9871165207424641,254,13,64,331
4830,dark,main,20211104,8,0.98483530832609,259,16,93,368
4830,dark,main,20211104,9,0.9883713552227151,265,13,104,382
2284,dark,main,20211104,0,0.992984664735442,271,19,115,405
2284,dark,main,20211104,1,0.9855444041996564,237,25,76,338
2284,dark,main,20211104,2,0.9924827909723531,260,27,95,382
2284,dark,main,20211104,3,0.9853961763102461,251,21,71,343
2284,dark,main,20211104,4,0.9952447309438177,244,20,76,340
2284,dark,main,20211104,5,0.9871558712659214,253,21,73,347
2284,dark,main,20211104,6,0.9934599765694387,255,26,88,369
2284,dark,main,20211104,7,0.988094634042842,212,27,86,325
2284,dark,main,20211104,8,0.9935919349775739,263,20,95,378
2284,dark,main,20211104,9,0.993417019503234,258,33,84,375
5566,dark,main,20211104,0,0.9964702418062591,291,13,98,402
5566,dark,main,20211104,1,0.9922410720222495,239,16,80,335
5566,dark,main,20211104,2,0.9904427920561809,285,11,88,384
5566,dark,main,20211104,3,0.986944860373477,249,12,98,359
5566,dark,main,20211104,4,0.9938694291194221,285,15,73,373
5566,dark,main,20211104,5,0.9937996968275276,228,11,92,331
5566,dark,main,20211104,6,0.9918387487322876,281,12,99,392
5566,dark,main,20211104,7,0.9867763590713686,250,13,73,336
5566,dark,main,20211104,8,0.9951172025990784,262,14,108,384
5566,dark,main,20211104,9,0.9895525005352106,262,16,105,383
9813,dark,main,20211104,0,0.9959075947142431,290,14,89,393
9813,dark,main,20211104,1,0.9933980402006495,252,11,66,329
9813,dark,main,20211104,2,0.99042107509331,264,13,111,388
9813,dark,main,20211104,3,0.9954961338159072,242,14,86,342
9813,dark,main,20211104,4,0.9929741147944326,253,13,89,355
9813,dark,main,20211104,5,0.9934826620538809,255,19,96,370
9813,dark,main,20211104,6,0.9912984196334997,272,20,90,382
9813,dark,main,20211104,7,0.9894155105863216,224,17,81,322
9813,dark,main,20211104,8,0.9895712469972765,265,18,98,381
9813,dark,main,20211104,9,0.98944487327873,270,13,98,381
3982,dark,main,20211104,0,0.9968402418378969,269,24,89,382
3982,dark,main,20211104,1,0.994023621926581,229,25,69,323
3982,dark,main,20211104,2,0.9921263423705164,274,26,89,389
3982,dark,main,20211104,3,0.9935980450442344,251,29,76,356
3982,dark,main,20211104,4,0.9891911387051292,264,18,85,367
3982,dark,main,20211104,5,0.9899295553269708,250,24,94,368
3982,dark,main,20211104,6,0.9886999302482815,270,17,92,379
3982,dark,main,20211104,7,0.9861177984536555,232,24,77,333
3982,dark,main,20211104,8,0.9963760985680062,269,18,95,382
3982,dark,main,20211104,9,0.9906297704273284,259,40,82,381
3818,dark,main,20211104,0,0.9878884789337155,283,13,101,397
3818,dark,main,20211104,1,0.9905877740875256,220,23,90,333
3818,dark,main,20211104,2,0.9916913816970205,276,15,94,385
3818,dark,main,20211104,3,0.9958984533008611,259,14,75,348
3818,dark,main,20211104,4,0.9894545221013724,263,13,86,362
3818,dark,main,20211104,5,0.9947590054339112,262,14,80,356
3818,dark,main,20211104,6,0.9921219228445582,269,17,74,360
3818,dark,main,20211104,7,0.9953311484012102,231,16,82,329
3818,dark,main,20211104,8,0.9922922605646279,268,17,93,378
3818,dark,main,20211104,9,0.9893785750872246,259,19,94,372
9822,dark,main,20211104,0,0.9877958487495431,297,14,79,390
9822,dark,main,20211104,1,0.9873307189803704,229,12,90,331
9822,dark,main,20211104,2,0.9916333937998043,293,11,82,386
9822,dark,main,20211104,3,0.9911720655946272,242,13,90,345
9822,dark,main,20211104,4,0.9949768085372153,254,12,84,350
9822,dark,main,20211104,5,0.9885620370236489,236,14,99,349
9822,dark,main,20211104,6,0.9931787173291331,266,18,92,376
9822,dark,main,20211104,7,0.9866398655134558,265,12,56,333
9822,dark,main,20211104,8,0.9944305253427674,269,12,85,366
9822,dark,main,20211104,9,0.9899923369541167,264,15,105,384
10276,dark,main,20211104,0,0.9959827627594311,273,13,113,399
10276,dark,main,20211104,1,0.9915479336463556,245,15,75,335
10276,dark,main,20211104,2,0.9911792496087682,274,12,99,385
10276,dark,main,20211104,3,0.9920188711456496,258,11,91,360
10276,dark,main,20211104,4,0.9892393434702056,268,23,78,369
10276,dark,main,20211104,5,0.9939388576951137,264,13,100,377
10276,dark,main,20211104,6,0.984731860261196,262,15,92,369
10276,dark,main,20211104,7,0.989830903931803,238,13,85,336
10276,dark,main,20211104,8,0.993216778633912,288,12,89,389
10276,dark,main,20211104,9,0.9915405891790425,281,10,100,391
9821,dark,main,20211104,0,0.9918032120801651,292,16,86,394
9821,dark,main,20211104,1,0.9866621842797219,258,10,68,336
9821,dark,main,20211104,2,0.9960499220039856,272,13,94,379
9821,dark,main,20211104,3,0.9902576059932977,255,13,78,346
9821,dark,main,20211104,4,0.9821491670574171,243,17,95,355
9821,dark,main,20211104,5,0.9894676985255808,261,15,89,365
9821,dark,main,20211104,6,0.9914174315861817,271,13,81,365
9821,dark,main,20211104,7,0.9817009094487208,237,16,83,336
9821,dark,main,20211104,8,0.9936209723848334,272,17,80,369
9821,dark,main,20211104,9,0.990996064186993,285,9,81,375
11616,dark,main,20211104,0,0.9889992911394574,295,17,85,397
11616,dark,main,20211104,1,0.9910072242800235,237,10,81,328
11616,dark,main,20211104,2,0.9888990681012063,284,18,87,389
11616,dark,main,20211104,3,0.9895152635005391,241,19,88,348
11616,dark,main,20211104,4,0.9765543702838074,224,21,94,339
11616,dark,main,20211104,5,0.9862943542615417,265,14,77,356
11616,dark,main,20211104,6,0.9910007490224697,269,17,82,368
11616,dark,main,20211104,7,0.9870805536868649,229,16,84,329
11616,dark,main,20211104,8,0.9946478364363347,289,16,81,386
11616,dark,main,20211104,9,0.9932615399388276,268,14,83,365
8050,dark,main,20211104,0,0.990136053857474,297,18,89,404
8050,dark,main,20211104,1,0.9944648448446642,232,15,82,329
8050,dark,main,20211104,2,0.9914197205603251,283,21,85,389
8050,dark,main,20211104,3,0.9941586988255907,248,22,78,348
8050,dark,main,20211104,4,0.9950844910256834,260,14,87,361
8050,dark,main,20211104,5,0.9913004878441208,255,20,83,358
8050,dark,main,20211104,6,0.988880535081361,274,19,82,375
8050,dark,main,20211104,7,0.9949975350927961,225,16,94,335
8050,dark,main,20211104,8,0.9886154333274685,251,22,87,360
8050,dark,main,20211104,9,0.9921672149041673,287,16,86,389
11201,dark,main,20211104,0,0.9878330910007224,271,21,95,387
11201,dark,main,20211104,1,0.9851407796281998,234,20,71,325
11201,dark,main,20211104,2,0.9919409594972054,266,38,82,386
11201,dark,main,20211104,3,0.9904736005317092,238,20,94,352
11201,dark,main,20211104,4,0.990581955796681,233,20,92,345
11201,dark,main,20211104,5,0.9929498522127941,241,34,86,361
11201,dark,main,20211104,6,0.9905537929816645,261,19,86,366
11201,dark,main,20211104,7,0.9856750319767955,220,28,87,335
11201,dark,main,20211104,8,0.9912452944782363,258,26,92,376
11201,dark,main,20211104,9,0.9786271875617837,249,24,95,368
25561,bright,main,20211104,0,0.9966414862655146,341,93,6,440
25561,bright,main,20211104,1,0.9874127207640894,265,100,4,369
25561,bright,main,20211104,2,0.9950922661253896,302,126,10,438
25561,bright,main,20211104,3,0.9927382919656031,276,110,5,391
25561,bright,main,20211104,4,0.9927647384145751,314,80,5,399
25561,bright,main,20211104,5,0.9913971780312163,325,80,5,410
25561,bright,main,20211104,6,0.9944231262216082,349,69,4,422
25561,bright,main,20211104,7,0.9884160286575102,271,92,4,367
25561,bright,main,20211104,8,0.99501932504543,329,94,2,425
25561,bright,main,20211104,9,0.995605672051091,353,73,3,429
2019,dark,main,20211104,0,0.9922223070853559,279,23,82,384
2019,dark,main,20211104,1,0.9878688761902135,247,12,78,337
2019,dark,main,20211104,2,0.9897221813714202,296,13,89,398
2019,dark,main,20211104,3,0.9931220059309305,256,16,83,355
2019,dark,main,20211104,4,0.9940017611671893,240,17,88,345
2019,dark,main,20211104,5,0.9898294997249371,251,22,93,366
2019,dark,main,20211104,6,0.9937611678047679,273,15,78,366
2019,dark,main,20211104,7,0.9944133491406213,225,13,83,321
2019,dark,main,20211104,8,0.9914396345017761,269,12,93,374
2019,dark,main,20211104,9,0.9923860550640251,281,17,89,387
2281,dark,main,20211104,0,0.99000619764732,269,17,91,377
2281,dark,main,20211104,1,0.989081242196391,243,13,81,337
2281,dark,main,20211104,2,0.9864279884321907,274,19,93,386
2281,dark,main,20211104,3,0.9868869899553577,247,22,74,343
2281,dark,main,20211104,4,0.9907443297832987,254,17,76,347
2281,dark,main,20211104,5,0.9871162935744656,246,18,95,359
2281,dark,main,20211104,6,0.994356552897803,285,15,76,376
2281,dark,main,20211104,7,0.9904649712521991,227,16,91,334
2281,dark,main,20211104,8,0.9888013701473566,262,25,89,376
2281,dark,main,20211104,9,0.9885099827930206,258,18,97,373
2278,dark,main,20211104,0,0.9890971502999861,255,29,92,376
2278,dark,main,20211104,1,0.995176759811102,239,17,86,342
2278,dark,main,20211104,2,0.9904350295689242,278,24,76,378
2278,dark,main,20211104,3,0.9894995733653068,249,28,76,353
2278,dark,main,20211104,4,0.9892658873711253,256,29,65,350
2278,dark,main,20211104,5,0.9938526012181906,262,21,92,375
2278,dark,main,20211104,6,0.99037788674567,248,30,94,372
2278,dark,main,20211104,7,0.9851468598593133,211,15,80,306
2278,dark,main,20211104,8,0.9943111000295503,274,16,93,383
2278,dark,main,20211104,9,0.9928464684118686,262,23,86,371
10975,dark,main,20211104,0,0.9940591980216664,282,20,89,391
10975,dark,main,20211104,1,0.9942082157488566,217,30,84,331
10975,dark,main,20211104,2,0.9959231222737546,263,39,82,384
10975,dark,main,20211104,3,0.9948479157645401,244,33,75,352
10975,dark,main,20211104,4,0.9946452603651578,237,28,93,358
10975,dark,main,20211104,5,0.9906841909230294,259,25,87,371
10975,dark,main,20211104,6,0.9936388917157085,277,20,76,373
10975,dark,main,20211104,7,0.9924994617808474,233,29,75,337
10975,dark,main,20211104,8,0.9892065599165641,255,28,91,374
10975,dark,main,20211104,9,0.9932602902251774,258,22,92,372
4103,dark,main,20211104,0,0.9957628224394726,273,25,93,391
4103,dark,main,20211104,1,0.9895764937924607,237,21,86,344
4103,dark,main,20211104,2,0.9953131576657892,275,24,92,391
4103,dark,main,20211104,3,0.9884102701329126,228,35,80,343
4103,dark,main,20211104,4,0.991502687830284,242,28,84,354
4103,dark,main,20211104,5,0.9925941203812999,237,22,107,366
4103,dark,main,20211104,6,0.9912971523758657,248,21,97,366
4103,dark,main,20211104,7,0.9920383237706271,236,18,83,337
4103,dark,main,20211104,8,0.9849150950284695,276,23,84,383
4103,dark,main,20211104,9,0.9945320893979345,256,18,103,377
7252,dark,main,20211104,0,0.9929282008355444,285,17,96,398
7252,dark,main,20211104,1,0.9915651092407435,219,22,100,341
7252,dark,main,20211104,2,0.9933744598183719,276,23,99,398
7252,dark,main,20211104,3,0.9901846695334755,246,23,85,354
7252,dark,main,20211104,4,0.9916993085185789,252,20,98,370
7252,dark,main,20211104,5,0.9855286355279396,263,17,95,375
7252,dark,main,20211104,6,0.9880495273384355,257,19,89,365
7252,dark,main,20211104,7,0.9949576827267745,208,17,103,328
7252,dark,main,20211104,8,0.9954300411700537,265,22,81,368
7252,dark,main,20211104,9,0.987415784668149,262,19,91,372
9823,dark,main,20211104,0,0.9910037478658382,293,15,88,396
9823,dark,main,20211104,1,0.9930003400736329,237,16,83,336
9823,dark,main,20211104,2,0.9907467715776921,279,14,81,374
9823,dark,main,20211104,3,0.9967936484479848,247,19,85,351
9823,dark,main,20211104,4,0.993029085002582,253,11,100,364
9823,dark,main,20211104,5,0.995925199367394,270,16,91,377
9823,dark,main,20211104,6,0.9915762239113358,278,17,85,380
9823,dark,main,20211104,7,0.9926547398695023,250,17,65,332
9823,dark,main,20211104,8,0.9895356221234574,275,14,85,374
9823,dark,main,20211104,9,0.9924871117914814,267,12,85,364
11651,dark,main,20211104,0,0.9916531944150975,266,35,89,390
11651,dark,main,20211104,1,0.9932815155765985,228,17,68,313
11651,dark,main,20211104,2,0.9892978021082559,286,15,82,383
11651,dark,main,20211104,3,0.9910064697392785,236,21,86,343
11651,dark,main,20211104,4,0.98334383966012,249,20,69,338
11651,dark,main,20211104,5,0.9927431255672753,263,23,73,359
11651,dark,main,20211104,6,0.9836267533836878,247,26,104,377
11651,dark,main,20211104,7,0.9938764207234321,237,24,57,318
11651,dark,main,20211104,8,0.9905945016452631,255,17,85,357
11651,dark,main,20211104,9,0.9926731980548974,266,14,100,380
3599,dark,main,20211105,0,0.9946917044433501,291,14,87,392
3599,dark,main,20211105,1,0.9791132855666926,259,13,62,334
3599,dark,main,20211105,2,0.9894477167553505,273,14,66,353
3599,dark,main,20211105,3,0.9953492302801655,277,14,60,351
3599,dark,main,20211105,4,0.9939321436173209,286,18,56,360
3599,dark,main,20211105,5,0.9935033906903163,306,11,56,373
3599,dark,main,20211105,6,0.9895976683365556,292,15,68,375
3599,dark,main,20211105,7,0.9888316312139797,253,14,62,329
3599,dark,main,20211105,8,0.9908323299317777,293,18,69,380
3599,dark,main,20211105,9,0.9913783276642432,295,13,61,369
10924,dark,main,20211105,0,0.9888238934672421,289,15,72,376
10924,dark,main,20211105,1,0.9883750793269803,233,13,83,329
10924,dark,main,20211105,2,0.9915906953302266,262,14,78,354
10924,dark,main,20211105,3,0.9932821350322147,245,15,91,351
10924,dark,main,20211105,4,0.989551239408087,254,15,87,356
10924,dark,main,20211105,5,0.9897127415682168,272,13,76,361
10924,dark,main,20211105,6,0.9924288888555028,312,12,56,380
10924,dark,main,20211105,7,0.9906333215745496,243,20,72,335
10924,dark,main,20211105,8,0.9917024513341448,308,12,64,384
10924,dark,main,20211105,9,0.98988700191896,296,13,61,370
10361,dark,main,20211105,0,0.9888917875834357,261,34,103,398
10361,dark,main,20211105,1,0.9867915539633585,220,27,78,325
10361,dark,main,20211105,2,0.9946893801188466,286,18,58,362
10361,dark,main,20211105,3,0.9948321260911409,273,18,56,347
10361,dark,main,20211105,4,0.9942064078297269,266,30,56,352
10361,dark,main,20211105,5,0.9924164810527171,261,24,91,376
10361,dark,main,20211105,6,0.993025063402428,258,21,93,372
10361,dark,main,20211105,7,0.9911950996088223,234,24,83,341
10361,dark,main,20211105,8,0.9952643642802879,287,29,68,384
10361,dark,main,20211105,9,0.9904210476584646,288,28,63,379
20859,bright,main,20211105,0,0.9851095155720245,312,126,3,441
20859,bright,main,20211105,1,0.9936142235756262,293,82,0,375
20859,bright,main,20211105,2,0.9925060586484986,349,81,8,438
20859,bright,main,20211105,3,0.9929820299544114,301,96,0,397
20859,bright,main,20211105,4,0.9956799730553637,279,118,6,403
20859,bright,main,20211105,5,0.9943273318007804,292,116,5,413
20859,bright,main,20211105,6,0.9854527729275151,325,100,7,432
20859,bright,main,20211105,7,0.985730252114232,287,83,3,373
20859,bright,main,20211105,8,0.9940743820087263,356,62,3,421
20859,bright,main,20211105,9,0.9881046287021098,347,78,3,428
8069,dark,main,20211105,0,0.9892971820842043,273,24,85,382
8069,dark,main,20211105,1,0.9893376250744966,237,16,74,327
8069,dark,main,20211105,2,0.9893376250744966,237,16,74,327
8069,dark,main,20211105,3,0.9828694439379188,277,14,69,360
8069,dark,main,20211105,4,0.992858236345605,271,19,64,354
8069,dark,main,20211105,5,0.987831642843096,271,23,57,351
8069,dark,main,20211105,6,0.9932379563173843,297,11,66,374
8069,dark,main,20211105,7,0.9936529251149683,245,10,58,313
8069,dark,main,20211105,8,0.9947035847753726,292,14,63,369
8069,dark,main,20211105,9,0.9929496968498415,286,15,83,384
6403,dark,main,20211105,0,0.9940177021825322,270,18,82,370
6403,dark,main,20211105,1,0.9939426162261026,233,17,81,331
6403,dark,main,20211105,2,0.9906451651321668,269,13,70,352
6403,dark,main,20211105,3,0.9835406814137708,266,13,74,353
6403,dark,main,20211105,4,0.9895907721751079,271,16,60,347
6403,dark,main,20211105,5,0.9899692277055466,283,13,69,365
6403,dark,main,20211105,6,0.9903727738791707,293,16,63,372
6403,dark,main,20211105,7,0.983740245202445,247,17,64,328
6403,dark,main,20211105,8,0.9934000143641487,305,18,52,375
6403,dark,main,20211105,9,0.9904852222642704,287,14,70,371
3274,dark,main,20211105,0,0.9791543071703052,285,16,80,381
3274,dark,main,20211105,1,0.9915632802910344,245,14,61,320
3274,dark,main,20211105,2,0.9866025230654271,277,15,57,349
3274,dark,main,20211105,3,0.984380022285376,282,16,60,358
3274,dark,main,20211105,4,0.9874738041098006,303,10,50,363
3274,dark,main,20211105,5,0.994481597973286,276,8,78,362
3274,dark,main,20211105,6,0.9877232140497046,281,16,80,377
3274,dark,main,20211105,7,0.9948363663390547,240,17,76,333
3274,dark,main,20211105,8,0.9896021845587172,274,15,85,374
3274,dark,main,20211105,9,0.9805390134455344,259,16,94,369
10309,dark,main,20211105,0,0.993325624591538,321,13,68,402
10309,dark,main,20211105,1,0.9902861450887678,280,14,54,348
10309,dark,main,20211105,2,0.9934580804301884,287,11,76,374
10309,dark,main,20211105,3,0.9926427620744336,254,16,91,361
10309,dark,main,20211105,4,0.9843698914187085,240,14,97,351
10309,dark,main,20211105,5,0.9931216727532417,272,16,80,368
10309,dark,main,20211105,6,0.9948437370357118,266,10,104,380
10309,dark,main,20211105,7,0.9872241497498804,257,11,63,331
10309,dark,main,20211105,8,0.9938111009694588,283,15,63,361
10309,dark,main,20211105,9,0.9889151549555371,289,14,71,374
6741,dark,main,20211105,0,0.9900732351651803,296,14,78,388
6741,dark,main,20211105,1,0.9925153616089423,270,11,42,323
6741,dark,main,20211105,2,0.9860523629494393,273,15,67,355
6741,dark,main,20211105,3,0.9896645732133253,268,11,71,350
6741,dark,main,20211105,4,0.9926729958900732,285,13,53,351
6741,dark,main,20211105,5,0.9931591328978294,304,12,50,366
6741,dark,main,20211105,6,0.9946647989575129,285,13,79,377
6741,dark,main,20211105,7,0.989528889077492,230,9,83,322
6741,dark,main,20211105,8,0.9966963849896388,289,14,82,385
6741,dark,main,20211105,9,0.9880338973378965,264,13,96,373
3271,dark,main,20211105,0,0.9860150798865557,276,15,106,397
3271,dark,main,20211105,1,0.9917736606510094,250,11,58,319
3271,dark,main,20211105,2,0.9933959622658964,277,13,69,359
3271,dark,main,20211105,3,0.9969495201444327,262,12,59,333
3271,dark,main,20211105,4,0.996357236717559,293,13,49,355
3271,dark,main,20211105,5,0.9960051265706962,279,12,69,360
3271,dark,main,20211105,6,0.9880877040184151,275,15,76,366
3271,dark,main,20211105,7,0.9927920344011028,260,11,57,328
3271,dark,main,20211105,8,0.9884058885204419,285,13,63,361
3271,dark,main,20211105,9,0.9935198092814289,271,15,101,387
11928,dark,main,20211105,0,0.9897505514232577,265,23,114,402
11928,dark,main,20211105,1,0.9816600694564864,239,18,77,334
11928,dark,main,20211105,2,0.9878316531109866,291,26,60,377
11928,dark,main,20211105,3,0.9890500805316932,273,21,59,353
11928,dark,main,20211105,4,0.9833482947161352,292,13,49,354
11928,dark,main,20211105,5,0.9853432487196271,278,16,72,366
11928,dark,main,20211105,6,0.9900987333923644,288,15,66,369
11928,dark,main,20211105,7,0.9873767949379515,257,20,58,335
11928,dark,main,20211105,8,0.9938053719241597,285,20,66,371
11928,dark,main,20211105,9,0.9833261115011039,246,33,102,381
3851,dark,main,20211105,0,0.9939639418356844,260,26,90,376
3851,dark,main,20211105,1,0.993308771974214,235,21,69,325
3851,dark,main,20211105,2,0.9939360548999456,285,14,54,353
3851,dark,main,20211105,3,0.9874882995548055,285,14,58,357
3851,dark,main,20211105,4,0.9951825641266314,250,16,91,357
3851,dark,main,20211105,5,0.9880230456542353,260,17,76,353
3851,dark,main,20211105,6,0.9877653093470454,261,23,79,363
3851,dark,main,20211105,7,0.9847798660437795,236,16,76,328
3851,dark,main,20211105,8,0.9931688043639246,269,22,92,383
3851,dark,main,20211105,9,0.9888701255521881,288,14,82,384
10396,dark,main,20211105,0,0.9831838040858422,315,18,59,392
10396,dark,main,20211105,1,0.9915646837211398,260,18,54,332
10396,dark,main,20211105,2,0.9877177132397588,290,13,68,371
10396,dark,main,20211105,3,0.9918500586876574,261,18,61,340
10396,dark,main,20211105,4,0.99123902238448,254,13,72,339
10396,dark,main,20211105,5,0.9854957380154883,294,12,71,377
10396,dark,main,20211105,6,0.9949243060963936,274,14,91,379
10396,dark,main,20211105,7,0.9925772495925048,220,16,88,324
10396,dark,main,20211105,8,0.9892222337236121,283,16,80,379
10396,dark,main,20211105,9,0.9968099116905579,309,13,55,377
23949,bright,main,20211105,0,0.9947467548923487,270,166,2,438
23949,bright,main,20211105,1,0.9882682904404331,249,111,9,369
23949,bright,main,20211105,2,0.9946157110964668,334,92,5,431
23949,bright,main,20211105,3,0.9928861969601992,293,83,4,380
23949,bright,main,20211105,4,0.992386060665771,266,133,3,402
23949,bright,main,20211105,5,0.995044151323356,244,159,6,409
23949,bright,main,20211105,6,0.9948960441536169,283,135,5,423
23949,bright,main,20211105,7,0.9905099567515961,265,99,7,371
23949,bright,main,20211105,8,0.9914167029365742,282,133,6,421
23949,bright,main,20211105,9,0.9909958715472865,263,161,6,430
3604,dark,main,20211105,0,0.987763563674301,327,10,57,394
3604,dark,main,20211105,1,0.9861311863116771,264,11,49,324
3604,dark,main,20211105,2,0.9865022400465454,264,11,104,379
3604,dark,main,20211105,3,0.9916917172620773,245,10,94,349
3604,dark,main,20211105,4,0.9923020464730478,271,11,72,354
3604,dark,main,20211105,5,0.9955973243818734,275,17,87,379
3604,dark,main,20211105,6,0.9932036510659648,286,15,78,379
3604,dark,main,20211105,7,0.9903729369386669,246,14,60,320
3604,dark,main,20211105,8,0.990992914051029,323,14,43,380
3604,dark,main,20211105,9,0.9894767028689124,297,14,71,382
10971,dark,main,20211105,0,0.9933271141907533,286,25,89,400
10971,dark,main,20211105,1,0.9896659608415195,252,16,62,330
10971,dark,main,20211105,2,0.9930981440639206,281,19,65,365
10971,dark,main,20211105,3,0.9899525914692228,280,17,67,364
10971,dark,main,20211105,4,0.983858233526672,287,14,54,355
10971,dark,main,20211105,5,0.9947408421770755,259,23,97,379
10971,dark,main,20211105,6,0.9931188303904411,284,20,89,393
10971,dark,main,20211105,7,0.9942854335827213,215,24,94,333
10971,dark,main,20211105,8,0.9890802123851947,258,20,91,369
10971,dark,main,20211105,9,0.9931835756119531,256,20,93,369
9503,dark,main,20211105,0,0.9869949995123393,326,14,45,385
9503,dark,main,20211105,1,0.9837791629158802,275,11,50,336
9503,dark,main,20211105,2,0.9925593774328347,294,10,54,358
9503,dark,main,20211105,3,0.9917644820507191,279,11,56,346
9503,dark,main,20211105,4,0.9948149960162983,269,14,67,350
9503,dark,main,20211105,5,0.9888461685500428,287,12,66,365
9503,dark,main,20211105,6,0.9907369319044673,273,17,86,376
9503,dark,main,20211105,7,0.9930849770349695,266,20,72,358
9503,dark,main,20211105,8,0.9909537798260608,287,14,69,370
9503,dark,main,20211105,9,0.9904799388560511,287,10,69,366
24647,bright,main,20211105,0,0.989418881966556,358,79,3,440
24647,bright,main,20211105,1,0.994254897408367,303,67,3,373
24647,bright,main,20211105,2,0.9931163409468833,341,82,8,431
24647,bright,main,20211105,3,0.9875099427532351,302,81,7,390
24647,bright,main,20211105,4,0.9877829202083798,334,57,5,396
24647,bright,main,20211105,5,0.9916625093403245,327,75,6,408
24647,bright,main,20211105,6,0.9914776714404396,317,93,7,417
24647,bright,main,20211105,7,0.9939163981514295,272,92,4,368
24647,bright,main,20211105,8,0.9944580835264648,330,85,3,418
24647,bright,main,20211105,9,0.9908388672922234,342,85,3,430
4044,dark,main,20211105,0,0.9954499451335542,302,13,85,400
4044,dark,main,20211105,1,0.9952970656180131,263,17,54,334
4044,dark,main,20211105,2,0.9920135740446704,289,13,63,365
4044,dark,main,20211105,3,0.9908562810102483,249,17,85,351
4044,dark,main,20211105,4,0.9898392444264805,262,13,87,362
4044,dark,main,20211105,5,0.9883497285591247,283,14,83,380
4044,dark,main,20211105,6,0.9906474845070629,282,10,96,388
4044,dark,main,20211105,7,0.9940648933610049,262,13,68,343
4044,dark,main,20211105,8,0.9944172013360804,317,15,54,386
4044,dark,main,20211105,9,0.992388855943579,309,20,58,387
7107,dark,main,20211105,0,0.9888297100599287,291,20,89,400
7107,dark,main,20211105,1,0.9875010800256409,223,34,80,337
7107,dark,main,20211105,2,0.9916207721819852,244,21,93,358
7107,dark,main,20211105,3,0.9804428303125414,252,23,77,352
7107,dark,main,20211105,4,0.9914199467518205,258,24,93,375
7107,dark,main,20211105,5,0.9887378476644797,255,23,91,369
7107,dark,main,20211105,6,0.9950833632237939,264,20,98,382
7107,dark,main,20211105,7,0.9932911044233678,232,21,81,334
7107,dark,main,20211105,8,0.9927888399386857,267,21,92,380
7107,dark,main,20211105,9,0.9952586084430516,270,19,90,379
10512,dark,main,20211105,0,0.9904503353054719,300,13,81,394
10512,dark,main,20211105,1,0.9977654608401254,260,13,65,338
10512,dark,main,20211105,2,0.9966341830104272,239,11,102,352
10512,dark,main,20211105,3,0.9920316231034186,256,16,83,355
10512,dark,main,20211105,4,0.9895756175594093,262,15,91,368
10512,dark,main,20211105,5,0.9871677480530844,269,12,90,371
10512,dark,main,20211105,6,0.9869885804326336,285,10,61,356
10512,dark,main,20211105,7,0.9940629101929396,249,11,60,320
10512,dark,main,20211105,8,0.988883124139088,308,11,57,376
10512,dark,main,20211105,9,0.993113473166237,306,12,62,380
10943,dark,main,20211105,0,0.9922502205825465,314,14,70,398
10943,dark,main,20211105,1,0.9908020787853943,248,10,64,322
10943,dark,main,20211105,2,0.9923861032446963,307,9,59,375
10943,dark,main,20211105,3,0.9779146430689369,263,13,71,347
10943,dark,main,20211105,4,0.986822873178352,243,17,91,351
10943,dark,main,20211105,5,0.9908104009333988,289,10,77,376
10943,dark,main,20211105,6,0.9937181700879725,297,11,75,383
10943,dark,main,20211105,7,0.9826042663652026,274,14,45,333
10943,dark,main,20211105,8,0.9931389324731414,267,22,81,370
10943,dark,main,20211105,9,0.985849219984532,302,14,65,381
9848,dark,main,20211105,0,0.989947354322969,277,18,88,383
9848,dark,main,20211105,1,0.9899489871738852,228,13,75,316
9848,dark,main,20211105,2,0.9919408197836221,251,16,95,362
9848,dark,main,20211105,3,0.9870439448556672,267,11,69,347
9848,dark,main,20211105,4,0.9942176514320591,281,14,57,352
9848,dark,main,20211105,5,0.9915971990561563,294,12,66,372
9848,dark,main,20211105,6,0.9933177917708094,317,12,55,384
9848,dark,main,20211105,7,0.9933936918092614,260,12,57,329
9848,dark,main,20211105,8,0.994554953073362,302,14,62,378
9848,dark,main,20211105,9,0.9975790965986314,314,14,55,383
2371,dark,main,20211105,0,0.9927761750452454,271,25,91,387
2371,dark,main,20211105,1,0.9891879145313947,238,18,87,343
2371,dark,main,20211105,2,0.9875190286687849,244,24,92,360
2371,dark,main,20211105,3,0.9963097036446451,245,28,81,354
2371,dark,main,20211105,4,0.9924765191205099,260,19,69,348
2371,dark,main,20211105,5,0.9937787096391614,293,15,52,360
2371,dark,main,20211105,6,0.994892181830398,305,22,56,383
2371,dark,main,20211105,7,0.9915812860632754,259,27,53,339
2371,dark,main,20211105,8,0.9959774350072688,254,23,93,370
2371,dark,main,20211105,9,0.9890005186489257,264,31,81,376
11875,dark,main,20211105,0,0.9931899927449533,304,12,75,391
11875,dark,main,20211105,1,0.9914173921126492,243,17,78,338
11875,dark,main,20211105,2,0.9951854750571357,267,20,85,372
11875,dark,main,20211105,3,0.9894197414718601,273,11,70,354
11875,dark,main,20211105,4,0.9927229006811904,293,12,55,360
11875,dark,main,20211105,5,0.9951721208149649,301,12,48,361
11875,dark,main,20211105,6,0.9907312640181717,279,14,99,392
11875,dark,main,20211105,7,0.9915848264022048,248,12,82,342
11875,dark,main,20211105,8,0.9957154112448056,275,18,92,385
11875,dark,main,20211105,9,0.9916063643394616,298,16,65,379
4127,dark,main,20211105,0,0.9923522120111437,219,53,77,349
4127,dark,main,20211105,1,0.9886704960614939,228,15,85,328
4127,dark,main,20211105,2,0.9913992753686496,269,17,99,385
4127,dark,main,20211105,3,0.9925394203419556,235,17,93,345
4127,dark,main,20211105,4,0.9910915194816352,265,17,79,361
4127,dark,main,20211105,5,0.9929308533229272,253,14,96,363
4127,dark,main,20211105,6,0.9902805215817188,272,13,89,374
4127,dark,main,20211105,7,0.9946552717867376,230,19,78,327
4127,dark,main,20211105,8,0.9918201605173025,278,13,74,365
4127,dark,main,20211105,9,0.9880946376234827,261,19,86,366
7947,dark,main,20211105,0,0.9950612247896028,287,20,75,382
7947,dark,main,20211105,1,0.9943731146497681,235,25,71,331
7947,dark,main,20211105,2,0.9938080693576042,279,17,65,361
7947,dark,main,20211105,3,0.9912752747915184,253,19,67,339
7947,dark,main,20211105,4,0.9906506460011828,238,18,79,335
7947,dark,main,20211105,5,0.98913753473196,232,24,94,350
7947,dark,main,20211105,6,0.9973995781069346,267,18,76,361
7947,dark,main,20211105,7,0.9921929063819962,211,20,75,306
7947,dark,main,20211105,8,0.9941423019542276,264,16,92,372
7947,dark,main,20211105,9,0.9887791076724715,259,22,90,371
6404,dark,main,20211105,0,0.9928249228575343,294,13,82,389
6404,dark,main,20211105,1,0.9889181409503665,261,12,54,327
6404,dark,main,20211105,2,0.9943237444551463,253,23,84,360
6404,dark,main,20211105,3,0.9913733691869216,250,14,78,342
6404,dark,main,20211105,4,0.9909488027552918,256,22,83,361
6404,dark,main,20211105,5,0.9909114608213615,299,10,60,369
6404,dark,main,20211105,6,0.9860013452507292,269,12,79,360
6404,dark,main,20211105,7,0.9923078289663809,223,25,77,325
6404,dark,main,20211105,8,0.993124921504262,289,14,60,363
6404,dark,main,20211105,9,0.9939172935022679,276,15,66,357
4101,dark,main,20211105,0,0.9866586589055419,258,30,101,389
4101,dark,main,20211105,1,0.9861839361789854,218,16,88,322
4101,dark,main,20211105,2,0.9928836117328012,243,16,91,350
4101,dark,main,20211105,3,0.994923326578702,246,22,82,350
4101,dark,main,20211105,4,0.9958427263083912,263,11,83,357
4101,dark,main,20211105,5,0.9886857439019101,251,16,89,356
4101,dark,main,20211105,6,0.991243130222621,276,16,84,376
4101,dark,main,20211105,7,0.9927831304380739,228,15,76,319
4101,dark,main,20211105,8,0.9865987669793912,264,17,84,365
4101,dark,main,20211105,9,0.9929053132467573,249,23,113,385
10077,dark,main,20211105,0,0.9938039199481628,269,17,96,382
10077,dark,main,20211105,1,0.990992503685679,235,14,85,334
10077,dark,main,20211105,2,0.9934693510890708,257,15,94,366
10077,dark,main,20211105,3,0.990784791049653,277,11,57,345
10077,dark,main,20211105,4,0.9918918210501533,270,14,56,340
10077,dark,main,20211105,5,0.9908333953127224,260,12,83,355
10077,dark,main,20211105,6,0.9922485614557305,289,10,61,360
10077,dark,main,20211105,7,0.9922861595720341,269,10,55,334
10077,dark,main,20211105,8,0.9938981836166134,278,11,73,362
10077,dark,main,20211105,9,0.9961644918116359,281,15,93,389
11779,dark,main,20211106,0,0.9953233155181412,262,20,95,377
11779,dark,main,20211106,1,0.9902023176878708,248,20,78,346
11779,dark,main,20211106,2,0.9940417490054013,275,19,86,380
11779,dark,main,20211106,3,0.9910618096074411,276,15,62,353
11779,dark,main,20211106,4,0.9908513834041693,272,20,65,357
11779,dark,main,20211106,5,0.9885224604322577,299,18,50,367
11779,dark,main,20211106,6,0.9953147987669781,289,24,56,369
11779,dark,main,20211106,7,0.9926035765514368,239,26,68,333
11779,dark,main,20211106,8,0.9894016581997952,266,28,94,388
11779,dark,main,20211106,9,0.9867751489267601,267,15,95,377
6397,dark,main,20211106,0,0.9911246451908448,267,19,97,383
6397,dark,main,20211106,1,0.9949192940675218,264,16,65,345
6397,dark,main,20211106,2,0.9864173821274065,286,14,94,394
6397,dark,main,20211106,3,0.9930889740594194,261,16,82,359
6397,dark,main,20211106,4,0.9936872418925151,249,23,87,359
6397,dark,main,20211106,5,0.988916524584565,250,20,91,361
6397,dark,main,20211106,6,0.9835281947063119,282,17,80,379
6397,dark,main,20211106,7,0.9852565484987399,226,16,75,317
6397,dark,main,20211106,8,0.9920413981044068,271,18,100,389
6397,dark,main,20211106,9,0.9941334557506033,253,16,101,370
4308,dark,main,20211106,0,0.9888230361495783,321,14,60,395
4308,dark,main,20211106,1,0.9961955793042022,238,13,89,340
4308,dark,main,20211106,2,0.990541163164047,275,17,100,392
4308,dark,main,20211106,3,0.993777697502816,245,16,88,349
4308,dark,main,20211106,4,0.9881226872003633,247,18,90,355
4308,dark,main,20211106,5,0.9967094231015193,248,16,111,375
4308,dark,main,20211106,6,0.9942250392407117,271,14,82,367
4308,dark,main,20211106,7,0.9919360894994731,253,13,59,325
4308,dark,main,20211106,8,0.9927306229681702,290,15,68,373
4308,dark,main,20211106,9,0.9955101151634917,283,20,75,378
7783,dark,main,20211106,0,0.9944714602483922,314,13,81,408
7783,dark,main,20211106,1,0.9859767407927427,220,13,103,336
7783,dark,main,20211106,2,0.99325469815878,300,11,93,404
7783,dark,main,20211106,3,0.9936196531942583,266,12,77,355
7783,dark,main,20211106,4,0.9929131222356999,288,10,58,356
7783,dark,main,20211106,5,0.9895344267226873,284,14,60,358
7783,dark,main,20211106,6,0.9935586859354082,295,15,62,372
7783,dark,main,20211106,7,0.9925908436213476,262,13,57,332
7783,dark,main,20211106,8,0.9900562233216894,269,12,84,365
7783,dark,main,20211106,9,0.9863679275156977,278,13,83,374
23944,bright,main,20211106,0,0.995623840262457,263,176,4,443
23944,bright,main,20211106,1,0.9936766227463458,221,161,1,383
23944,bright,main,20211106,2,0.9927666940400096,219,206,6,431
23944,bright,main,20211106,3,0.9927510369937802,245,144,4,393
23944,bright,main,20211106,4,0.9957648942819105,333,64,6,403
23944,bright,main,20211106,5,0.9912399934366191,345,67,2,414
23944,bright,main,20211106,6,0.9879707779783706,354,70,5,429
23944,bright,main,20211106,7,0.9904848033639939,309,61,5,375
23944,bright,main,20211106,8,0.9929600338145873,263,156,3,422
23944,bright,main,20211106,9,0.9884792057891985,269,160,4,433
21271,bright,main,20211106,0,0.9942333864927786,378,57,6,441
21271,bright,main,20211106,1,0.9867832477070747,304,73,4,381
21271,bright,main,20211106,2,0.9890387544145937,335,95,3,433
21271,bright,main,20211106,3,0.9945365563985519,328,72,3,403
21271,bright,main,20211106,4,0.9930769650937921,313,82,4,399
21271,bright,main,20211106,5,0.9903038742147766,307,102,3,412
21271,bright,main,20211106,6,0.9965372402238254,327,90,8,425
21271,bright,main,20211106,7,0.9963583175796958,277,94,3,374
21271,bright,main,20211106,8,0.9937026640721459,335,85,3,423
21271,bright,main,20211106,9,0.9940934993456778,345,81,3,429
22382,bright,main,20211106,0,0.996127718552408,325,112,2,439
22382,bright,main,20211106,1,0.995115032998494,280,98,3,381
22382,bright,main,20211106,2,0.9932618500054138,349,87,3,439
22382,bright,main,20211106,3,0.9932698504815873,298,100,2,400
22382,bright,main,20211106,4,0.9915715355323479,223,182,1,406
22382,bright,main,20211106,5,0.994529482422393,242,169,4,415
22382,bright,main,20211106,6,0.9939217570461161,296,125,10,431
22382,bright,main,20211106,7,0.9874505905499663,277,95,2,374
22382,bright,main,20211106,8,0.996261529154895,330,95,4,429
22382,bright,main,20211106,9,0.9954922461658813,336,90,1,427
6727,dark,main,20211106,0,0.9949705883088089,303,15,78,396
6727,dark,main,20211106,1,0.9782023618565076,266,15,62,343
6727,dark,main,20211106,2,0.9904868275926809,305,11,66,382
6727,dark,main,20211106,3,0.988464946478523,298,11,51,360
6727,dark,main,20211106,4,0.988851944170339,290,12,62,364
6727,dark,main,20211106,5,0.9860497008127856,285,12,66,363
6727,dark,main,20211106,6,0.9804987888539665,278,16,70,364
6727,dark,main,20211106,7,0.9928866887914654,240,9,79,328
6727,dark,main,20211106,8,0.9941934819153209,310,12,64,386
6727,dark,main,20211106,9,0.994966532827311,303,13,67,383
10941,dark,main,20211106,0,0.9907545935337045,314,12,81,407
10941,dark,main,20211106,1,0.9867242605630977,252,11,67,330
10941,dark,main,20211106,2,0.9903141054417819,303,14,79,396
10941,dark,main,20211106,3,0.9904593709610665,278,16,70,364
10941,dark,main,20211106,4,0.9872810646851757,281,12,81,374
10941,dark,main,20211106,5,0.9947429791404215,287,14,70,371
10941,dark,main,20211106,6,0.9951668494912571,320,13,49,382
10941,dark,main,20211106,7,0.9904667890000125,275,13,46,334
10941,dark,main,20211106,8,0.9940207156503822,309,13,56,378
10941,dark,main,20211106,9,0.9916741654079779,309,12,57,378
4089,dark,main,20211106,0,0.9942235318026524,274,18,101,393
4089,dark,main,20211106,1,0.9886034174679909,230,16,99,345
4089,dark,main,20211106,2,0.9883424320089927,266,14,101,381
4089,dark,main,20211106,3,0.9919742436883939,264,16,81,361
4089,dark,main,20211106,4,0.9917424022669814,261,18,92,371
4089,dark,main,20211106,5,0.9900824986564261,270,25,80,375
4089,dark,main,20211106,6,0.9945605878492167,260,21,95,376
4089,dark,main,20211106,7,0.9916418074104285,230,14,81,325
4089,dark,main,20211106,8,0.9854754461854568,251,15,98,364
4089,dark,main,20211106,9,0.9952073383562594,259,18,103,380
7083,dark,main,20211106,0,0.9879280762527907,272,24,84,380
7083,dark,main,20211106,1,0.9934586415966843,242,24,75,341
7083,dark,main,20211106,2,0.9927684928968162,260,22,91,373
7083,dark,main,20211106,3,0.9888869999381441,250,20,86,356
7083,dark,main,20211106,4,0.9928213341272075,258,26,77,361
7083,dark,main,20211106,5,0.990200039462146,265,22,71,358
7083,dark,main,20211106,6,0.9901492498930116,266,27,84,377
7083,dark,main,20211106,7,0.9931595344257319,251,22,65,338
7083,dark,main,20211106,8,0.992592708215197,283,14,57,354
7083,dark,main,20211106,9,0.9907779452292584,257,20,86,363
10551,dark,main,20211106,0,0.9905789093699564,260,22,91,373
10551,dark,main,20211106,1,0.989611382858212,237,13,86,336
10551,dark,main,20211106,2,0.9907269132387857,257,21,90,368
10551,dark,main,20211106,3,0.9900107634498396,250,21,93,364
10551,dark,main,20211106,4,0.9905212705587021,250,19,93,362
10551,dark,main,20211106,5,0.9923017368386354,254,24,91,369
10551,dark,main,20211106,6,0.9920731742240843,260,19,95,374
10551,dark,main,20211106,7,0.9918988384004199,248,12,67,327
10551,dark,main,20211106,8,0.9898260286605497,279,13,79,371
10551,dark,main,20211106,9,0.9940108730309516,248,24,100,372
5513,dark,main,20211106,0,0.9899616832224412,287,20,100,407
5513,dark,main,20211106,1,0.9910520495793619,233,18,74,325
5513,dark,main,20211106,2,0.9919029643825359,259,21,97,377
5513,dark,main,20211106,3,0.9903199530833353,250,15,88,353
5513,dark,main,20211106,4,0.996139816905563,252,18,77,347
5513,dark,main,20211106,5,0.9911967071088722,266,18,87,371
5513,dark,main,20211106,6,0.9930828902184777,253,43,91,387
5513,dark,main,20211106,7,0.989528600042571,223,17,89,329
5513,dark,main,20211106,8,0.992225419765755,267,17,93,377
5513,dark,main,20211106,9,0.990846711679146,242,20,110,372
8792,dark,main,20211106,0,0.993863977502953,279,24,92,395
8792,dark,main,20211106,1,0.9910209205531384,238,19,83,340
8792,dark,main,20211106,2,0.9973802988616063,251,30,108,389
8792,dark,main,20211106,3,0.9859230846313772,235,19,85,339
8792,dark,main,20211106,4,0.9940762650528686,241,19,94,354
8792,dark,main,20211106,5,0.9929108432316555,259,16,101,376
8792,dark,main,20211106,6,0.9933035011018126,268,24,89,381
8792,dark,main,20211106,7,0.9871604984663704,239,15,85,339
8792,dark,main,20211106,8,0.9955754262469648,265,18,103,386
8792,dark,main,20211106,9,0.989447858036881,249,24,103,376
22100,bright,main,20211106,0,0.9839264048650104,330,102,8,440
22100,bright,main,20211106,1,0.98712306171395,264,97,4,365
22100,bright,main,20211106,2,0.9933405090137656,344,81,5,430
22100,bright,main,20211106,3,0.9913641816821667,330,61,2,393
22100,bright,main,20211106,4,0.9930778910091608,322,75,3,400
22100,bright,main,20211106,5,0.993147746497375,317,82,6,405
22100,bright,main,20211106,6,0.9932093584310068,332,88,5,425
22100,bright,main,20211106,7,0.9791946023855973,222,132,2,356
22100,bright,main,20211106,8,0.985409620306513,251,156,8,415
22100,bright,main,20211106,9,0.9917475256344382,328,93,1,422
8506,dark,main,20211106,0,0.989680541221499,305,17,70,392
8506,dark,main,20211106,1,0.9927419487794185,243,11,85,339
8506,dark,main,20211106,2,0.9907156023320268,296,12,87,395
8506,dark,main,20211106,3,0.9924564998774111,259,11,84,354
8506,dark,main,20211106,4,0.9925204709948691,264,11,78,353
8506,dark,main,20211106,5,0.9918713576994933,271,10,72,353
8506,dark,main,20211106,6,0.9901034399500087,262,9,81,352
8506,dark,main,20211106,7,0.9951036576925898,263,12,60,335
8506,dark,main,20211106,8,0.9940340562175539,296,11,61,368
8506,dark,main,20211106,9,0.987900579158675,289,15,72,376
21263,bright,main,20211106,0,0.992234430988297,332,101,4,437
21263,bright,main,20211106,1,0.9893984967492634,274,107,2,383
21263,bright,main,20211106,2,0.9936714892756845,335,98,4,437
21263,bright,main,20211106,3,0.9933096657900079,329,57,2,388
21263,bright,main,20211106,4,0.9909686397243586,319,79,2,400
21263,bright,main,20211106,5,0.9943406781267454,326,75,5,406
21263,bright,main,20211106,6,0.9910945570955807,289,126,7,422
21263,bright,main,20211106,7,0.9918320339692139,251,109,3,363
21263,bright,main,20211106,8,0.9958599074761416,286,127,4,417
21263,bright,main,20211106,9,0.991775449575111,279,139,2,420
8711,dark,main,20211106,0,0.9907918095281352,333,9,66,408
8711,dark,main,20211106,1,0.9954220312736256,278,10,68,356
8711,dark,main,20211106,2,0.9902276476917186,280,12,105,397
8711,dark,main,20211106,3,0.9900801716336791,239,14,88,341
8711,dark,main,20211106,4,0.9863668568980386,276,12,96,384
8711,dark,main,20211106,5,0.9888226345066994,282,11,86,379
8711,dark,main,20211106,6,0.9899903777651052,271,10,90,371
8711,dark,main,20211106,7,0.9945078176642973,255,10,78,343
8711,dark,main,20211106,8,0.9952329558359835,306,11,79,396
8711,dark,main,20211106,9,0.9941154843327692,321,13,64,398
3256,dark,main,20211106,0,0.9886986694226985,321,14,59,394
3256,dark,main,20211106,1,0.9911348168041154,245,15,64,324
3256,dark,main,20211106,2,0.9950863980284952,309,13,61,383
3256,dark,main,20211106,3,0.9927737735774793,280,11,67,358
3256,dark,main,20211106,4,0.9934787384945176,281,11,68,360
3256,dark,main,20211106,5,0.9912257377291845,284,13,78,375
3256,dark,main,20211106,6,0.9947901095674964,282,14,77,373
3256,dark,main,20211106,7,0.9856162413186338,233,9,84,326
3256,dark,main,20211106,8,0.99272524696993,270,10,86,366
3256,dark,main,20211106,9,0.9961246552821322,301,13,70,384
4811,dark,main,20211106,0,0.995573764021493,268,14,96,378
4811,dark,main,20211106,1,0.9923903085608834,242,16,80,338
4811,dark,main,20211106,2,0.9939552337036903,292,15,82,389
4811,dark,main,20211106,3,0.9940078781660029,270,12,63,345
4811,dark,main,20211106,4,0.990652875762558,280,13,69,362
4811,dark,main,20211106,5,0.9884568286321359,295,15,70,380
4811,dark,main,20211106,6,0.9943708400014146,310,13,60,383
4811,dark,main,20211106,7,0.9877880141471421,233,15,77,325
4811,dark,main,20211106,8,0.9950513355510358,282,18,75,375
4811,dark,main,20211106,9,0.9934280251982012,277,14,92,383
23943,bright,main,20211106,0,0.9910740379777941,251,184,3,438
23943,bright,main,20211106,1,0.9912638528183445,257,124,2,383
23943,bright,main,20211106,2,0.9936605721314857,310,125,2,437
23943,bright,main,20211106,3,0.9903151400912046,254,137,3,394
23943,bright,main,20211106,4,0.9971855383041041,209,197,1,407
23943,bright,main,20211106,5,0.9878152255379813,200,210,3,413
23943,bright,main,20211106,6,0.9914802660580376,223,201,2,426
23943,bright,main,20211106,7,0.9895728248343443,212,154,3,369
23943,bright,main,20211106,8,0.9953967795935181,231,189,4,424
23943,bright,main,20211106,9,0.9913055438409026,281,145,2,428
10510,dark,main,20211106,0,0.986001537332516,271,14,85,370
10510,dark,main,20211106,1,0.994750370705452,239,11,85,335
10510,dark,main,20211106,2,0.9913466956547793,269,17,111,397
10510,dark,main,20211106,3,0.9857718857352216,241,15,92,348
10510,dark,main,20211106,4,0.9936338596500324,249,18,90,357
10510,dark,main,20211106,5,0.9877201626704755,274,14,81,369
10510,dark,main,20211106,6,0.9868750608168801,278,12,82,372
10510,dark,main,20211106,7,0.9917120199679634,250,14,69,333
10510,dark,main,20211106,8,0.9876639776464968,285,13,67,365
10510,dark,main,20211106,9,0.995041077911651,296,11,66,373
5652,dark,main,20211106,0,0.9943324519988532,270,19,98,387
5652,dark,main,20211106,1,0.9922359026016155,239,16,78,333
5652,dark,main,20211106,2,0.9909297762687409,274,32,95,401
5652,dark,main,20211106,3,0.9910010126795396,243,19,86,348
5652,dark,main,20211106,4,0.9909511100226314,244,15,97,356
5652,dark,main,20211106,5,0.9892937867862752,245,20,105,370
5652,dark,main,20211106,6,0.9858690256437814,258,25,91,374
5652,dark,main,20211106,7,0.9843413449441631,237,15,71,323
5652,dark,main,20211106,8,0.9913043095662142,267,12,96,375
5652,dark,main,20211106,9,0.9926914588031196,271,20,86,377
9860,dark,main,20211106,0,0.9923817746078232,319,14,70,403
9860,dark,main,20211106,1,0.9916154226653365,266,9,62,337
9860,dark,main,20211106,2,0.990723762386794,315,15,62,392
9860,dark,main,20211106,3,0.9898366053518756,258,13,90,361
9860,dark,main,20211106,4,0.9905604526946259,253,13,94,360
9860,dark,main,20211106,5,0.9901351666302213,256,13,101,370
9860,dark,main,20211106,6,0.9955526730870717,272,11,72,355
9860,dark,main,20211106,7,0.9914512144921114,261,12,63,336
9860,dark,main,20211106,8,0.992273921379255,297,10,71,378
9860,dark,main,20211106,9,0.9925465742989713,311,13,62,386
2534,dark,main,20211106,0,0.9921853291303406,279,23,87,389
2534,dark,main,20211106,1,0.9892011589001865,230,23,77,330
2534,dark,main,20211106,2,0.9939245065733201,275,25,93,393
2534,dark,main,20211106,3,0.9888913587553213,245,25,89,359
2534,dark,main,20211106,4,0.9928287826114424,252,16,91,359
2534,dark,main,20211106,5,0.9942489044499502,249,19,105,373
2534,dark,main,20211106,6,0.9975452833313506,270,22,92,384
2534,dark,main,20211106,7,0.9935864551613943,224,23,83,330
2534,dark,main,20211106,8,0.990156776420214,268,23,82,373
2534,dark,main,20211106,9,0.9906811567416125,277,24,75,376
3247,dark,main,20211106,0,0.9911402580445678,265,22,106,393
3247,dark,main,20211106,1,0.9944406503805987,250,11,69,330
3247,dark,main,20211106,2,0.9938714389632451,290,11,77,378
3247,dark,main,20211106,3,0.9824015979544156,245,13,83,341
3247,dark,main,20211106,4,0.9909979720231763,231,23,100,354
3247,dark,main,20211106,5,0.9882062301237862,266,17,87,370
3247,dark,main,20211106,6,0.99337375156515,260,14,98,372
3247,dark,main,20211106,7,0.9911648745130732,238,13,75,326
3247,dark,main,20211106,8,0.9879143787579434,283,12,86,381
3247,dark,main,20211106,9,0.995423853433562,287,16,79,382
22395,bright,main,20211106,0,0.9933622764389334,340,102,3,445
22395,bright,main,20211106,1,0.9906681115291801,277,101,3,381
22395,bright,main,20211106,2,0.9915888381748413,317,114,2,433
22395,bright,main,20211106,3,0.9952865871122994,284,113,3,400
22395,bright,main,20211106,4,0.9919770494382611,295,110,2,407
22395,bright,main,20211106,5,0.985439793638701,294,116,5,415
22395,bright,main,20211106,6,0.9906280529132565,261,154,3,418
22395,bright,main,20211106,7,0.9866976691964395,246,123,2,371
22395,bright,main,20211106,8,0.989072808613297,277,151,0,428
22395,bright,main,20211106,9,0.9972500735910008,348,81,4,433
10312,dark,main,20211106,0,0.99205047565774,322,10,63,395
10312,dark,main,20211106,1,0.9938203584920632,278,10,64,352
10312,dark,main,20211106,2,0.9846958345981501,313,17,53,383
10312,dark,main,20211106,3,0.9904192303839432,288,15,55,358
10312,dark,main,20211106,4,0.989096172878082,263,12,74,349
10312,dark,main,20211106,5,0.9909922883912445,280,11,92,383
10312,dark,main,20211106,6,0.9915065935905195,282,11,82,375
10312,dark,main,20211106,7,0.9882504554810435,276,11,56,343
10312,dark,main,20211106,8,0.9933453359480127,278,14,96,388
10312,dark,main,20211106,9,0.9892473388670132,323,11,56,390
5353,dark,main,20211107,0,0.9946739079157951,321,12,63,396
5353,dark,main,20211107,1,0.9851824885519576,249,14,70,333
5353,dark,main,20211107,2,0.990378885777841,295,24,74,393
5353,dark,main,20211107,3,0.9900231784755033,271,24,66,361
5353,dark,main,20211107,4,0.9916684345697498,262,14,88,364
5353,dark,main,20211107,5,0.9939216979428475,270,17,76,363
5353,dark,main,20211107,6,0.9964018552007907,312,12,51,375
5353,dark,main,20211107,7,0.9933826802152158,245,11,59,315
5353,dark,main,20211107,8,0.9904511901736859,313,13,50,376
5353,dark,main,20211107,9,0.9954770498406406,325,14,55,394
8403,dark,main,20211107,0,0.9946724357604984,293,22,87,402
8403,dark,main,20211107,1,0.9935222643680787,237,24,71,332
8403,dark,main,20211107,2,0.9971604243853907,265,19,91,375
8403,dark,main,20211107,3,0.9911762604642199,231,32,71,334
8403,dark,main,20211107,4,0.9887215325669431,264,23,72,359
8403,dark,main,20211107,5,0.9873326598554392,254,23,64,341
8403,dark,main,20211107,6,0.9965228756079206,258,23,85,366
8403,dark,main,20211107,7,0.9903603603111515,235,20,79,334
8403,dark,main,20211107,8,0.9877607618545654,236,17,75,328
8403,dark,main,20211107,9,0.992101713173501,269,24,83,376
11656,dark,main,20211107,0,0.991815496939629,285,16,101,402
11656,dark,main,20211107,1,0.9828847409817446,243,14,79,336
11656,dark,main,20211107,2,0.9939159690099544,278,16,84,378
11656,dark,main,20211107,3,0.991651126486159,276,10,55,341
11656,dark,main,20211107,4,0.9928917126435616,274,12,62,348
11656,dark,main,20211107,5,0.9926098091746989,295,14,48,357
11656,dark,main,20211107,6,0.9919965171929535,289,22,61,372
11656,dark,main,20211107,7,0.9924031270036302,234,20,74,328
11656,dark,main,20211107,8,0.9895226898919238,274,19,88,381
11656,dark,main,20211107,9,0.9929375613826836,270,17,84,371
25566,bright,main,20211107,0,0.9962222881149609,354,88,4,446
25566,bright,main,20211107,1,0.9886049108509467,302,77,4,383
25566,bright,main,20211107,2,0.9901265527226031,302,129,4,435
25566,bright,main,20211107,3,0.990478842799217,244,151,4,399
25566,bright,main,20211107,4,0.995878652014863,292,108,2,402
25566,bright,main,20211107,5,0.9922812247655782,300,109,3,412
25566,bright,main,20211107,6,0.9904109611225854,302,119,4,425
25566,bright,main,20211107,7,0.993986343188783,275,93,2,370
25566,bright,main,20211107,8,0.988972752213844,312,108,2,422
25566,bright,main,20211107,9,0.9928558638249821,344,78,5,427
3424,dark,main,20211107,0,0.9888655676754848,268,29,81,378
3424,dark,main,20211107,1,0.9911798139467229,268,18,58,344
3424,dark,main,20211107,2,0.991414025864144,297,17,76,390
3424,dark,main,20211107,3,0.9907344191873635,253,16,88,357
3424,dark,main,20211107,4,0.9846897300382029,277,15,66,358
3424,dark,main,20211107,5,0.9896212570067866,287,16,63,366
3424,dark,main,20211107,6,0.9871215706383037,305,14,63,382
3424,dark,main,20211107,7,0.9920536554711614,270,12,46,328
3424,dark,main,20211107,8,0.9900321800007321,298,14,64,376
3424,dark,main,20211107,9,0.9896611763108842,286,22,79,387
11397,dark,main,20211107,0,0.994059133700881,285,15,71,371
11397,dark,main,20211107,1,0.9884615479199175,236,12,89,337
11397,dark,main,20211107,2,0.9927834765455847,287,18,81,386
11397,dark,main,20211107,3,0.9932077207935626,266,17,73,356
11397,dark,main,20211107,4,0.9934230036020616,277,12,87,376
11397,dark,main,20211107,5,0.9902690882031111,250,17,100,367
11397,dark,main,20211107,6,0.9903011087248114,284,16,89,389
11397,dark,main,20211107,7,0.9882112713673853,243,16,76,335
11397,dark,main,20211107,8,0.9881664230584872,272,15,90,377
11397,dark,main,20211107,9,0.9957763236048925,287,10,72,369
11364,dark,main,20211107,0,0.990552586104698,304,11,79,394
11364,dark,main,20211107,1,0.9948260528444667,256,14,73,343
11364,dark,main,20211107,2,0.9907289144782307,307,20,62,389
11364,dark,main,20211107,3,0.9864968459362101,281,12,54,347
11364,dark,main,20211107,4,0.9901264039141622,279,13,68,360
11364,dark,main,20211107,5,0.993564648370104,289,19,60,368
11364,dark,main,20211107,6,0.9917159159926127,305,12,55,372
11364,dark,main,20211107,7,0.9863610916052915,229,14,86,329
11364,dark,main,20211107,8,0.9903553724898075,284,11,79,374
11364,dark,main,20211107,9,0.9863547816554766,302,10,69,381
22426,bright,main,20211107,0,0.9892276260261522,402,34,4,440
22426,bright,main,20211107,1,0.9980133792143454,297,83,4,384
22426,bright,main,20211107,2,0.9889142922980834,354,79,2,435
22426,bright,main,20211107,3,0.9905258536652171,319,72,2,393
22426,bright,main,20211107,4,0.990852193754097,319,82,5,406
22426,bright,main,20211107,5,0.9943516269557214,334,79,1,414
22426,bright,main,20211107,6,0.9917096375887114,317,99,9,425
22426,bright,main,20211107,7,0.994186623901028,256,104,4,364
22426,bright,main,20211107,8,0.9943345572010582,369,53,2,424
22426,bright,main,20211107,9,0.9899957102501417,385,44,2,431
25641,bright,main,20211107,0,0.995317207774084,351,75,4,430
25641,bright,main,20211107,1,0.9954618609667398,308,61,4,373
25641,bright,main,20211107,2,0.9954171175400118,336,79,1,416
25641,bright,main,20211107,3,0.99715138033149,280,90,6,376
25641,bright,main,20211107,4,0.9933957042974464,294,77,5,376
25641,bright,main,20211107,5,0.9935159351060109,307,75,4,386
25641,bright,main,20211107,6,0.9916061055399054,330,76,5,411
25641,bright,main,20211107,7,0.9947983217660363,265,80,3,348
25641,bright,main,20211107,8,0.9930077807134012,279,113,1,393
25641,bright,main,20211107,9,0.9927982799859181,318,88,6,412
82268,bright,special,20211107,0,0.9911582117211194,334,105,1,440
82268,bright,special,20211107,1,0.9888083111636286,280,100,5,385
82268,bright,special,20211107,2,0.9952023790031015,312,120,3,435
82268,bright,special,20211107,3,0.9864091358187779,310,80,5,395
82268,bright,special,20211107,4,0.9920533411865595,286,114,6,406
82268,bright,special,20211107,5,0.9881943745692265,299,107,8,414
82268,bright,special,20211107,6,0.9911384472021519,344,75,8,427
82268,bright,special,20211107,7,0.9901490586715505,315,58,2,375
82268,bright,special,20211107,8,0.997016859978539,362,61,3,426
82268,bright,special,20211107,9,0.9819727964862484,348,77,4,429
23942,bright,main,20211107,0,0.9972137499348074,246,191,2,439
23942,bright,main,20211107,1,0.9919328704846958,267,112,5,384
23942,bright,main,20211107,2,0.9947744837933291,302,125,2,429
23942,bright,main,20211107,3,0.9950410420299997,241,150,7,398
23942,bright,main,20211107,4,0.990211758635662,238,161,4,403
23942,bright,main,20211107,5,0.9874306859350832,244,169,2,415
23942,bright,main,20211107,6,0.9940233164861674,252,174,3,429
23942,bright,main,20211107,7,0.9824288996413796,187,182,0,369
23942,bright,main,20211107,8,0.9959191849192431,143,280,1,424
23942,bright,main,20211107,9,0.9909436376063706,164,265,4,433
9835,dark,main,20211107,0,0.9951281868986658,298,11,92,401
9835,dark,main,20211107,1,0.9884683730294926,236,16,84,336
9835,dark,main,20211107,2,0.9916264910293819,262,14,105,381
9835,dark,main,20211107,3,0.9920170873915733,243,16,86,345
9835,dark,main,20211107,4,0.9893292833930515,258,14,84,356
9835,dark,main,20211107,5,0.9896343788298074,231,12,103,346
9835,dark,main,20211107,6,0.9906043283459204,254,17,98,369
9835,dark,main,20211107,7,0.9884446919577285,223,14,83,320
9835,dark,main,20211107,8,0.9869483014760683,271,18,93,382
9835,dark,main,20211107,9,0.9951431637731467,293,15,79,387
3370,dark,main,20211107,0,0.9876196049988494,300,15,71,386
3370,dark,main,20211107,1,0.984360177653172,253,14,70,337
3370,dark,main,20211107,2,0.9933269967309065,272,17,97,386
3370,dark,main,20211107,3,0.9914285494332161,246,14,86,346
3370,dark,main,20211107,4,0.988836524416534,294,18,60,372
3370,dark,main,20211107,5,0.991213003362573,310,12,49,371
3370,dark,main,20211107,6,0.9869481242844861,306,14,68,388
3370,dark,main,20211107,7,0.9913355021075224,260,14,57,331
3370,dark,main,20211107,8,0.9914592534519063,310,17,60,387
3370,dark,main,20211107,9,0.9886792617842869,281,18,67,366
11380,dark,main,20211107,0,0.9946683687918867,326,10,62,398
11380,dark,main,20211107,1,0.990179786096487,242,17,73,332
11380,dark,main,20211107,2,0.9946428940287316,288,16,73,377
11380,dark,main,20211107,3,0.984172829167575,257,14,89,360
11380,dark,main,20211107,4,0.9933534887823423,271,20,83,374
11380,dark,main,20211107,5,0.9945106651873074,263,16,84,363
11380,dark,main,20211107,6,0.9931873687178244,259,24,98,381
11380,dark,main,20211107,7,0.9925223597080998,242,14,81,337
11380,dark,main,20211107,8,0.9836217355220602,285,18,77,380
11380,dark,main,20211107,9,0.9902535759481349,308,15,58,381
9817,dark,main,20211107,0,0.9922746128748947,282,13,94,389
9817,dark,main,20211107,1,0.985368553486226,235,15,87,337
9817,dark,main,20211107,2,0.9830682603362565,249,29,104,382
9817,dark,main,20211107,3,0.9958519891000417,252,20,85,357
9817,dark,main,20211107,4,0.9903313649628743,238,20,99,357
9817,dark,main,20211107,5,0.9874325335744819,255,19,93,367
9817,dark,main,20211107,6,0.9955130381983908,279,19,87,385
9817,dark,main,20211107,7,0.9930498534718831,220,20,82,322
9817,dark,main,20211107,8,0.9926465791682231,267,16,101,384
9817,dark,main,20211107,9,0.9921013941112427,273,10,94,377
1962,dark,main,20211107,0,0.9931083018869326,312,13,50,375
1962,dark,main,20211107,1,0.9768196155163539,250,12,64,326
1962,dark,main,20211107,2,0.9907082375287566,289,19,76,384
1962,dark,main,20211107,3,0.9877079286906776,262,23,70,355
1962,dark,main,20211107,4,0.9932715749902022,252,20,83,355
1962,dark,main,20211107,5,0.9911456501534773,258,14,92,364
1962,dark,main,20211107,6,0.9847830977325817,250,15,99,364
1962,dark,main,20211107,7,0.9977422302675742,271,14,56,341
1962,dark,main,20211107,8,0.9913658030064203,296,12,70,378
1962,dark,main,20211107,9,0.9898959727765122,309,12,61,382
5141,dark,main,20211107,0,0.9956834480433642,303,12,83,398
5141,dark,main,20211107,1,0.9923875985748523,276,15,50,341
5141,dark,main,20211107,2,0.9925979606234628,289,16,69,374
5141,dark,main,20211107,3,0.995208989228825,284,9,59,352
5141,dark,main,20211107,4,0.9920027844396662,293,12,65,370
5141,dark,main,20211107,5,0.9873202525975363,276,14,83,373
5141,dark,main,20211107,6,0.993708510082337,261,25,95,381
5141,dark,main,20211107,7,0.9953576428024732,226,13,88,327
5141,dark,main,20211107,8,0.9925309520448445,263,17,98,378
5141,dark,main,20211107,9,0.993633476200555,272,13,105,390
20563,bright,main,20211107,0,0.9865285025557556,348,77,4,429
20563,bright,main,20211107,1,0.9931269889317009,294,74,3,371
20563,bright,main,20211107,2,0.9931886967629215,302,106,3,411
20563,bright,main,20211107,3,0.9879759755265128,290,86,1,377
20563,bright,main,20211107,4,0.9939584895877254,305,86,8,399
20563,bright,main,20211107,5,0.9870923465287216,329,72,5,406
20563,bright,main,20211107,6,0.9885724735768018,343,67,5,415
20563,bright,main,20211107,7,0.9860819137950942,271,56,5,332
20563,bright,main,20211107,8,0.995654990099957,318,83,4,405
20563,bright,main,20211107,9,0.9927731447976715,339,76,3,418
24091,bright,main,20211107,0,0.991255353670656,327,94,4,425
24091,bright,main,20211107,1,0.9879538686714353,311,53,3,367
24091,bright,main,20211107,2,0.996652342182223,358,59,5,422
24091,bright,main,20211107,3,0.9928777264757493,309,68,4,381
24091,bright,main,20211107,4,0.9939436731396746,300,82,5,387
24091,bright,main,20211107,5,0.9942152593122048,281,106,5,392
24091,bright,main,20211107,6,0.9943199310651291,301,107,1,409
24091,bright,main,20211107,7,0.9867298234356792,252,98,3,353
24091,bright,main,20211107,8,0.9911072725072131,317,83,3,403
24091,bright,main,20211107,9,0.9908182354781875,284,103,5,392
6256,dark,main,20211107,0,0.9940630336328035,306,16,52,374
6256,dark,main,20211107,1,0.9847239624598725,285,11,43,339
6256,dark,main,20211107,2,0.9918337471651273,314,11,54,379
6256,dark,main,20211107,3,0.9902724056635632,283,12,50,345
6256,dark,main,20211107,4,0.9928993088716493,279,11,56,346
6256,dark,main,20211107,5,0.9903486490081412,291,19,56,366
6256,dark,main,20211107,6,0.986027112533957,270,17,59,346
6256,dark,main,20211107,7,0.9930814468810685,244,12,80,336
6256,dark,main,20211107,8,0.9904427415483263,283,20,72,375
6256,dark,main,20211107,9,0.9860333916111361,295,12,62,369
8492,dark,main,20211108,0,0.9931222601024763,332,15,58,405
8492,dark,main,20211108,1,0.9914834406194993,280,14,43,337
8492,dark,main,20211108,2,0.9913562221479131,300,14,80,394
8492,dark,main,20211108,3,0.9845004859498727,256,16,85,357
8492,dark,main,20211108,4,0.9819456212212408,252,21,81,354
8492,dark,main,20211108,5,0.9929959428970678,274,14,87,375
8492,dark,main,20211108,6,0.992278844065814,281,15,75,371
8492,dark,main,20211108,7,0.9889631233854376,240,15,67,322
8492,dark,main,20211108,8,0.9916420412364785,286,11,53,350
8492,dark,main,20211108,9,0.9883964139886672,318,13,46,377
6954,dark,main,20211108,0,0.9951105345975002,278,14,59,351
6954,dark,main,20211108,1,0.9903779237316679,228,12,64,304
6954,dark,main,20211108,2,0.9922470204822421,300,17,44,361
6954,dark,main,20211108,3,0.9870237444033301,267,12,42,321
6954,dark,main,20211108,4,0.99247851516975,255,13,71,339
6954,dark,main,20211108,5,0.9842541464660257,260,11,72,343
6954,dark,main,20211108,6,0.9950130693287454,252,19,87,358
6954,dark,main,20211108,7,0.990586383817977,239,12,74,325
6954,dark,main,20211108,8,0.9852080498421335,271,16,62,349
6954,dark,main,20211108,9,0.9920910362315462,270,19,61,350
3834,dark,main,20211108,0,0.9925834617454722,291,20,88,399
3834,dark,main,20211108,1,0.9837546319923136,238,17,82,337
3834,dark,main,20211108,2,0.9961326314557903,298,12,71,381
3834,dark,main,20211108,3,0.9922927786010285,265,16,67,348
3834,dark,main,20211108,4,0.9787093129525586,238,16,83,337
3834,dark,main,20211108,5,0.9878846027615338,259,15,84,358
3834,dark,main,20211108,6,0.9927030714129953,283,19,92,394
3834,dark,main,20211108,7,0.9885611160520485,217,17,98,332
3834,dark,main,20211108,8,0.9909199431241956,279,11,89,379
3834,dark,main,20211108,9,0.9923010712806491,272,24,96,392
25556,bright,main,20211108,0,0.9907236407359811,269,169,4,442
25556,bright,main,20211108,1,0.9950935186394515,272,110,2,384
25556,bright,main,20211108,2,0.9947971971013274,351,74,3,428
25556,bright,main,20211108,3,0.9976581915088285,294,98,3,395
25556,bright,main,20211108,4,0.9915969520587936,320,85,3,408
25556,bright,main,20211108,5,0.9926656055206836,279,131,0,410
25556,bright,main,20211108,6,0.9927851141230609,292,133,6,431
25556,bright,main,20211108,7,0.9914340729927564,240,130,3,373
25556,bright,main,20211108,8,0.9919510866360659,251,171,5,427
25556,bright,main,20211108,9,0.9916812759934687,280,149,2,431
10196,dark,main,20211108,0,0.9941872430540799,284,28,82,394
10196,dark,main,20211108,1,0.9887369421342705,250,16,63,329
10196,dark,main,20211108,2,0.9906987757158927,283,14,69,366
10196,dark,main,20211108,3,0.987860269175121,250,19,70,339
10196,dark,main,20211108,4,0.988813303861694,275,14,67,356
10196,dark,main,20211108,5,0.9917662068176532,263,20,81,364
10196,dark,main,20211108,6,0.9945910383920168,281,16,76,373
10196,dark,main,20211108,7,0.9929729488128761,271,16,54,341
10196,dark,main,20211108,8,0.9889651717076043,285,17,63,365
10196,dark,main,20211108,9,0.984787474371421,289,18,69,376
6726,dark,main,20211108,0,0.9972612664161268,308,12,67,387
6726,dark,main,20211108,1,0.9891509056650406,268,10,54,332
6726,dark,main,20211108,2,0.9960564041200962,313,11,54,378
6726,dark,main,20211108,3,0.9889594294255446,279,12,42,333
6726,dark,main,20211108,4,0.9827593130823234,288,14,59,361
6726,dark,main,20211108,5,0.987755114232749,286,11,62,359
6726,dark,main,20211108,6,0.9970030094290877,289,16,81,386
6726,dark,main,20211108,7,0.9897097683199223,243,12,63,318
6726,dark,main,20211108,8,0.9824252333183064,271,13,79,363
6726,dark,main,20211108,9,0.9967494736138611,277,15,78,370
3936,dark,main,20211108,0,0.9878525538535758,256,27,106,389
3936,dark,main,20211108,1,0.9878305833479937,234,26,87,347
3936,dark,main,20211108,2,0.9965365925837171,249,27,112,388
3936,dark,main,20211108,3,0.9919038855214164,224,31,101,356
3936,dark,main,20211108,4,0.9908519387199765,252,23,82,357
3936,dark,main,20211108,5,0.9888500763554212,266,20,89,375
3936,dark,main,20211108,6,0.9882747366574437,259,27,100,386
3936,dark,main,20211108,7,0.9901857478468226,238,20,78,336
3936,dark,main,20211108,8,0.9945722362274393,285,17,64,366
3936,dark,main,20211108,9,0.9928269817971433,273,22,81,376
3569,dark,main,20211108,0,0.994884828032232,294,13,77,384
3569,dark,main,20211108,1,0.9892727459718231,271,13,50,334
3569,dark,main,20211108,2,0.9943823138916865,326,10,58,394
3569,dark,main,20211108,3,0.994238810077329,291,14,49,354
3569,dark,main,20211108,4,0.9953306081134261,304,9,42,355
3569,dark,main,20211108,5,0.995625863301145,317,11,59,387
3569,dark,main,20211108,6,0.986624984769395,272,11,99,382
3569,dark,main,20211108,7,0.9866189523253571,232,12,90,334
3569,dark,main,20211108,8,0.9932926985426289,263,14,98,375
3569,dark,main,20211108,9,0.9914789934734056,264,13,95,372
6848,dark,main,20211108,0,0.9932875758854771,278,29,81,388
6848,dark,main,20211108,1,0.9868874563683151,236,21,72,329
6848,dark,main,20211108,2,0.9946370018118673,280,30,87,397
6848,dark,main,20211108,3,0.9941887274659726,245,28,89,362
6848,dark,main,20211108,4,0.9963279018326723,265,24,60,349
6848,dark,main,20211108,5,0.9887482663428074,297,18,43,358
6848,dark,main,20211108,6,0.9943985901458631,318,15,55,388
6848,dark,main,20211108,7,0.9908039955989196,261,25,47,333
6848,dark,main,20211108,8,0.9880550400314861,261,37,78,376
6848,dark,main,20211108,9,0.9934851923389522,274,22,78,374
11777,dark,main,20211108,0,0.9954319430845869,293,19,90,402
11777,dark,main,20211108,1,0.9903479902434664,257,13,77,347
11777,dark,main,20211108,2,0.9921317664583752,282,33,83,398
11777,dark,main,20211108,3,0.990216393787056,257,16,81,354
11777,dark,main,20211108,4,0.9903726061412883,242,17,103,362
11777,dark,main,20211108,5,0.9895178947587698,260,14,95,369
11777,dark,main,20211108,6,0.987730290748681,241,28,96,365
11777,dark,main,20211108,7,0.9831402972031595,245,17,71,333
11777,dark,main,20211108,8,0.9934385144599659,256,22,100,378
11777,dark,main,20211108,9,0.9854014156898255,250,15,110,375
11084,dark,main,20211108,0,0.989366155782644,318,14,58,390
11084,dark,main,20211108,1,0.9932348252565177,269,14,52,335
11084,dark,main,20211108,2,0.9884178073499431,303,12,60,375
11084,dark,main,20211108,3,0.9866201498093928,268,19,70,357
11084,dark,main,20211108,4,0.994666142951964,263,10,71,344
11084,dark,main,20211108,5,0.98904783810344,268,11,88,367
11084,dark,main,20211108,6,0.995579508263709,277,13,95,385
11084,dark,main,20211108,7,0.9888771740997475,219,18,89,326
11084,dark,main,20211108,8,0.989301762401045,251,19,89,359
11084,dark,main,20211108,9,0.9903026338837615,280,17,77,374
6402,dark,main,20211108,0,0.9861015855327724,278,15,90,383
6402,dark,main,20211108,1,0.9906107875443934,253,15,67,335
6402,dark,main,20211108,2,0.9893316181761437,266,21,78,365
6402,dark,main,20211108,3,0.9930465795954841,235,20,83,338
6402,dark,main,20211108,4,0.9809946569973292,301,14,50,365
6402,dark,main,20211108,5,0.9960305073494361,300,10,52,362
6402,dark,main,20211108,6,0.988494411171121,298,12,71,381
6402,dark,main,20211108,7,0.9906320998650041,240,16,74,330
6402,dark,main,20211108,8,0.9930830760133402,279,14,82,375
6402,dark,main,20211108,9,0.9903404218402242,248,20,94,362
3550,dark,main,20211108,0,0.9916329558422684,290,31,74,395
3550,dark,main,20211108,1,0.989728321444615,251,26,45,322
3550,dark,main,20211108,2,0.9917002897249002,285,39,55,379
3550,dark,main,20211108,3,0.9949255012974371,261,20,71,352
3550,dark,main,20211108,4,0.9867593866732168,264,20,79,363
3550,dark,main,20211108,5,0.9943914064867966,247,23,84,354
3550,dark,main,20211108,6,0.9878287621892275,286,21,60,367
3550,dark,main,20211108,7,0.9917427419145531,258,20,54,332
3550,dark,main,20211108,8,0.9927141364706957,285,12,56,353
3550,dark,main,20211108,9,0.9924493549228889,283,22,70,375
10371,dark,main,20211108,0,0.9912453797294448,276,14,98,388
10371,dark,main,20211108,1,0.994414905341873,238,18,85,341
10371,dark,main,20211108,2,0.9906997748323209,287,14,106,407
10371,dark,main,20211108,3,0.9918690234819357,259,13,97,369
10371,dark,main,20211108,4,0.9854640910482797,232,17,111,360
10371,dark,main,20211108,5,0.9870112736723032,276,15,73,364
10371,dark,main,20211108,6,0.9937497943691936,312,11,63,386
10371,dark,main,20211108,7,0.9928404645918559,242,19,64,325
10371,dark,main,20211108,8,0.9876070273077621,283,18,85,386
10371,dark,main,20211108,9,0.9938004431406583,268,10,97,375
4952,dark,main,20211108,0,0.9893155551229295,305,27,65,397
4952,dark,main,20211108,1,0.9893246355927966,266,12,58,336
4952,dark,main,20211108,2,0.9905492710472468,317,15,58,390
4952,dark,main,20211108,3,0.9806492789006741,282,12,53,347
4952,dark,main,20211108,4,0.9953272587106993,276,15,67,358
4952,dark,main,20211108,5,0.9882846779430968,283,19,74,376
4952,dark,main,20211108,6,0.9945758936473189,317,16,61,394
4952,dark,main,20211108,7,0.9894779356578295,261,16,52,329
4952,dark,main,20211108,8,0.9912286737587822,303,11,66,380
4952,dark,main,20211108,9,0.9882942779517657,283,22,71,376
8505,dark,main,20211108,0,0.9916510938791897,302,17,75,394
8505,dark,main,20211108,1,0.9895563137990442,244,16,76,336
8505,dark,main,20211108,2,0.9943246738168707,281,15,89,385
8505,dark,main,20211108,3,0.9858755770685804,262,11,76,349
8505,dark,main,20211108,4,0.9940817609765986,258,11,87,356
8505,dark,main,20211108,5,0.9832201539873684,282,13,70,365
8505,dark,main,20211108,6,0.99239365506503,302,14,70,386
8505,dark,main,20211108,7,0.993137584245955,265,10,52,327
8505,dark,main,20211108,8,0.9917597958286348,299,11,60,370
8505,dark,main,20211108,9,0.987648939904402,290,14,67,371
6390,dark,main,20211108,0,0.991962053787191,314,11,62,387
6390,dark,main,20211108,1,0.9861588754043092,256,14,79,349
6390,dark,main,20211108,2,0.9915126557745519,282,14,91,387
6390,dark,main,20211108,3,0.9940055735271656,280,14,63,357
6390,dark,main,20211108,4,0.9937946718083177,293,9,65,367
6390,dark,main,20211108,5,0.9929926308265248,310,12,61,383
6390,dark,main,20211108,6,0.9880719302775115,316,13,56,385
6390,dark,main,20211108,7,0.9903637419930372,276,10,58,344
6390,dark,main,20211108,8,0.9904700041166665,328,10,54,392
6390,dark,main,20211108,9,0.9912271953771223,307,14,73,394
11671,dark,main,20211108,0,0.994581929070837,305,17,76,398
11671,dark,main,20211108,1,0.9925035675361896,249,19,50,318
11671,dark,main,20211108,2,0.9924046074561582,318,19,56,393
11671,dark,main,20211108,3,0.9919797066276932,288,15,54,357
11671,dark,main,20211108,4,0.9897066182710039,303,15,48,366
11671,dark,main,20211108,5,0.9933830882188952,262,17,82,361
11671,dark,main,20211108,6,0.9931683714830547,280,19,79,378
11671,dark,main,20211108,7,0.994356046642401,236,22,69,327
11671,dark,main,20211108,8,0.9927629479329365,257,29,89,375
11671,dark,main,20211108,9,0.9885412597865629,303,14,56,373
10310,dark,main,20211108,0,0.9928761866714525,328,15,55,398
10310,dark,main,20211108,1,0.9897288911313478,303,10,50,363
10310,dark,main,20211108,2,0.9951270889754711,342,13,49,404
10310,dark,main,20211108,3,0.9954110329156737,303,14,52,369
10310,dark,main,20211108,4,0.9936167490950953,275,20,67,362
10310,dark,main,20211108,5,0.9871065729519125,295,15,60,370
10310,dark,main,20211108,6,0.9886447148008597,292,14,89,395
10310,dark,main,20211108,7,0.9923350429219685,259,15,66,340
10310,dark,main,20211108,8,0.9971180739997992,276,11,101,388
10310,dark,main,20211108,9,0.9886976359548473,299,11,73,383
7219,dark,main,20211108,0,0.9905271873054632,288,21,94,403
7219,dark,main,20211108,1,0.9909337852935699,239,25,70,334
7219,dark,main,20211108,2,0.9937750320186867,276,28,73,377
7219,dark,main,20211108,3,0.9915974621127914,252,28,78,358
7219,dark,main,20211108,4,0.997297328427589,251,22,89,362
7219,dark,main,20211108,5,0.9939764501877765,232,22,111,365
7219,dark,main,20211108,6,0.9935893027675724,257,33,92,382
7219,dark,main,20211108,7,0.9928845828281941,235,21,81,337
7219,dark,main,20211108,8,0.9925001331660737,262,21,89,372
7219,dark,main,20211108,9,0.9912200465438776,262,17,103,382
6416,dark,main,20211108,0,0.9969494763332696,297,20,73,390
6416,dark,main,20211108,1,0.9902303607860303,255,15,74,344
6416,dark,main,20211108,2,0.9931176583798839,294,14,87,395
6416,dark,main,20211108,3,0.9875973744076849,238,14,95,347
6416,dark,main,20211108,4,0.9795773431079082,252,17,82,351
6416,dark,main,20211108,5,0.9956667551636151,282,18,62,362
6416,dark,main,20211108,6,0.9909911842454552,266,14,85,365
6416,dark,main,20211108,7,0.9904356936818532,225,17,77,319
6416,dark,main,20211108,8,0.9941677501706166,232,14,66,312
6416,dark,main,20211108,9,0.992105281409039,264,16,92,372
4104,dark,main,20211108,0,0.9951685286772668,285,14,88,387
4104,dark,main,20211108,1,0.9900917716227604,231,16,80,327
4104,dark,main,20211108,2,0.9923392449759877,260,17,96,373
4104,dark,main,20211108,3,0.9944934228563728,244,16,86,346
4104,dark,main,20211108,4,0.9929291601488183,240,15,89,344
4104,dark,main,20211108,5,0.9924348442638039,248,14,99,361
4104,dark,main,20211108,6,0.996189744063583,246,19,81,346
4104,dark,main,20211108,7,0.9903635604332927,217,21,81,319
4104,dark,main,20211108,8,0.9907842523914535,247,14,87,348
4104,dark,main,20211108,9,0.9926560113030825,244,17,95,356
8493,dark,main,20211108,0,0.9945089471733334,322,18,58,398
8493,dark,main,20211108,1,0.9899942601624947,263,16,56,335
8493,dark,main,20211108,2,0.9930086072768133,286,17,96,399
8493,dark,main,20211108,3,0.9914530660902365,269,12,62,343
8493,dark,main,20211108,4,0.9928087117177331,267,11,68,346
8493,dark,main,20211108,5,0.9927394920437255,276,13,78,367
8493,dark,main,20211108,6,0.9925269171063699,272,13,85,370
8493,dark,main,20211108,7,0.9954820016008046,237,16,73,326
8493,dark,main,20211108,8,0.9884886709830089,291,17,59,367
8493,dark,main,20211108,9,0.9944420177047626,293,12,66,371
9849,dark,main,20211108,0,0.9952195220058602,307,13,77,397
9849,dark,main,20211108,1,0.9924223893941317,259,11,64,334
9849,dark,main,20211108,2,0.9932652243988124,299,12,74,385
9849,dark,main,20211108,3,0.9937256525614447,270,12,59,341
9849,dark,main,20211108,4,0.9864587749251386,264,11,73,348
9849,dark,main,20211108,5,0.9934782635099804,304,11,53,368
9849,dark,main,20211108,6,0.9927640871364833,294,13,67,374
9849,dark,main,20211108,7,0.993739358978766,269,9,47,325
9849,dark,main,20211108,8,0.9827405304941017,305,11,57,373
9849,dark,main,20211108,9,0.985179316734737,318,14,55,387
25544,bright,main,20211108,0,0.9929959357664948,368,69,2,439
25544,bright,main,20211108,1,0.9940080473203993,294,82,6,382
25544,bright,main,20211108,2,0.9953456395636561,360,70,2,432
25544,bright,main,20211108,3,0.9920280246498625,282,111,3,396
25544,bright,main,20211108,4,0.9913217710068079,249,154,3,406
25544,bright,main,20211108,5,0.9924280792387408,197,219,1,417
25544,bright,main,20211108,6,0.9950639647398296,219,208,7,434
25544,bright,main,20211108,7,0.9883857770570068,238,136,1,375
25544,bright,main,20211108,8,0.9962964166807489,265,153,5,423
25544,bright,main,20211108,9,0.9901204498722168,282,149,0,431
9649,dark,main,20211108,0,0.9921168276353189,278,13,99,390
9649,dark,main,20211108,1,0.9906416877746465,248,23,70,341
9649,dark,main,20211108,2,0.9900310877665662,303,17,60,380
9649,dark,main,20211108,3,0.992783883072239,284,22,51,357
9649,dark,main,20211108,4,0.9855143387982911,284,19,47,350
9649,dark,main,20211108,5,0.9883613519861245,279,16,65,360
9649,dark,main,20211108,6,0.9901404917159642,289,18,62,369
9649,dark,main,20211108,7,0.9906347529353526,230,24,76,330
9649,dark,main,20211108,8,0.9930054827217434,263,15,80,358
9649,dark,main,20211108,9,0.9900780264079488,273,20,84,377
3598,dark,main,20211108,0,0.9882305622198159,282,16,98,396
3598,dark,main,20211108,1,0.993057460693969,246,12,85,343
3598,dark,main,20211108,2,0.9955967723852686,276,12,93,381
3598,dark,main,20211108,3,0.9919555101768591,242,21,81,344
3598,dark,main,20211108,4,0.9908966198635388,267,12,79,358
3598,dark,main,20211108,5,0.9907303473380593,290,15,76,381
3598,dark,main,20211108,6,0.9932890169774408,264,16,88,368
3598,dark,main,20211108,7,0.9925519777026591,258,11,60,329
3598,dark,main,20211108,8,0.9946084747490371,276,10,62,348
3598,dark,main,20211108,9,0.9855934477629863,289,13,74,376
3603,dark,main,20211108,0,0.9905171534715321,286,11,102,399
3603,dark,main,20211108,1,0.9889166278830364,234,12,99,345
3603,dark,main,20211108,2,0.9932770056721286,314,10,60,384
3603,dark,main,20211108,3,0.9948973084375183,263,12,69,344
3603,dark,main,20211108,4,0.9814206492060498,264,13,78,355
3603,dark,main,20211108,5,0.9900486666317195,281,9,78,368
3603,dark,main,20211108,6,0.9871325017724066,285,11,74,370
3603,dark,main,20211108,7,0.9917830793110538,261,13,65,339
3603,dark,main,20211108,8,0.996466532984162,263,19,97,379
3603,dark,main,20211108,9,0.9911862968388355,308,12,64,384
7971,dark,main,20211109,0,0.9891840770612422,295,24,65,384
7971,dark,main,20211109,1,0.9955034597685122,241,13,73,327
7971,dark,main,20211109,2,0.9930388314395051,287,14,97,398
7971,dark,main,20211109,3,0.9876030562273569,254,16,80,350
7971,dark,main,20211109,4,0.9922767068544865,280,13,62,355
7971,dark,main,20211109,5,0.991370050182257,297,9,69,375
7971,dark,main,20211109,6,0.9915099691054902,297,16,65,378
7971,dark,main,20211109,7,0.9764630026702363,250,11,48,309
7971,dark,main,20211109,8,0.9931069564924874,317,12,45,374
7971,dark,main,20211109,9,0.99080339467673,281,14,75,370
1704,dark,main,20211109,0,0.9891746236923628,322,13,41,376
1704,dark,main,20211109,1,0.9905380622989759,267,10,55,332
1704,dark,main,20211109,2,0.9926273629019655,332,14,56,402
1704,dark,main,20211109,3,0.9927127315082542,293,12,57,362
1704,dark,main,20211109,4,0.991115117870659,296,13,42,351
1704,dark,main,20211109,5,0.9848634607371312,296,10,51,357
1704,dark,main,20211109,6,0.9943429489912309,291,16,67,374
1704,dark,main,20211109,7,0.992430094513327,237,16,62,315
1704,dark,main,20211109,8,0.9910742803401444,282,16,73,371
1704,dark,main,20211109,9,0.9952307703044592,305,9,55,369
9519,dark,main,20211109,0,0.9951584398249309,291,15,85,391
9519,dark,main,20211109,1,0.9823661043856129,251,11,70,332
9519,dark,main,20211109,2,0.9924083498809653,305,16,68,389
9519,dark,main,20211109,3,0.9893444615794732,276,10,57,343
9519,dark,main,20211109,4,0.9766674737377387,298,16,42,356
9519,dark,main,20211109,5,0.9936622003039174,287,12,56,355
9519,dark,main,20211109,6,0.9882333761019921,291,15,58,364
9519,dark,main,20211109,7,0.9925241968705064,262,14,50,326
9519,dark,main,20211109,8,0.9920579892622201,295,14,62,371
9519,dark,main,20211109,9,0.9964743666106525,290,14,69,373
21880,bright,main,20211109,0,0.9979269319404179,322,110,4,436
21880,bright,main,20211109,1,0.9952628058013925,275,95,9,379
21880,bright,main,20211109,2,0.9870595319937487,343,85,6,434
21880,bright,main,20211109,3,0.9963732881750172,266,129,3,398
21880,bright,main,20211109,4,0.9916847594622612,208,195,3,406
21880,bright,main,20211109,5,0.990043444365276,262,144,1,407
21880,bright,main,20211109,6,0.995884051743682,262,170,3,435
21880,bright,main,20211109,7,0.997166877833986,200,173,3,376
21880,bright,main,20211109,8,0.9910491524596102,219,130,3,352
21880,bright,main,20211109,9,0.9919038692588695,331,98,7,436
11413,dark,main,20211109,0,0.9905890786438312,288,16,82,386
11413,dark,main,20211109,1,0.9930971502144952,260,19,63,342
11413,dark,main,20211109,2,0.9806719589201748,311,13,58,382
11413,dark,main,20211109,3,0.9921589443306226,279,11,50,340
11413,dark,main,20211109,4,0.9900743530585895,310,11,36,357
11413,dark,main,20211109,5,0.9943800015973359,292,12,42,346
11413,dark,main,20211109,6,0.989775054106557,319,12,44,375
11413,dark,main,20211109,7,0.9842101669652944,244,17,65,326
11413,dark,main,20211109,8,0.9928606448237378,298,14,68,380
11413,dark,main,20211109,9,0.9852199830708559,291,13,77,381
6740,dark,main,20211109,0,0.9934020898021689,325,11,47,383
6740,dark,main,20211109,1,0.9864432044256922,277,9,42,328
6740,dark,main,20211109,2,0.9913591887206554,316,11,47,374
6740,dark,main,20211109,3,0.9937790296493746,264,11,62,337
6740,dark,main,20211109,4,0.9930286608675971,287,14,51,352
6740,dark,main,20211109,5,0.989492712319236,282,11,55,348
6740,dark,main,20211109,6,0.9901718455383801,284,11,84,379
6740,dark,main,20211109,7,0.9916592717131956,259,13,54,326
6740,dark,main,20211109,8,0.9942002492984976,307,13,59,379
6740,dark,main,20211109,9,0.9950922053762072,293,17,74,384
21264,bright,main,20211109,0,0.9946412398255186,360,74,6,440
21264,bright,main,20211109,1,0.989784839469595,309,64,3,376
21264,bright,main,20211109,2,0.9900887654223537,360,72,3,435
21264,bright,main,20211109,3,0.9909864526871943,312,70,6,388
21264,bright,main,20211109,4,0.9947126009678787,299,93,5,397
21264,bright,main,20211109,5,0.991731587610421,318,90,2,410
21264,bright,main,20211109,6,0.9943169744528002,330,94,6,430
21264,bright,main,20211109,7,0.9919527929657821,306,61,4,371
21264,bright,main,20211109,8,0.9901546181124481,345,70,4,419
21264,bright,main,20211109,9,0.9970358148129069,362,61,8,431
10545,dark,main,20211109,0,0.9944814857477206,322,16,56,394
10545,dark,main,20211109,1,0.9920785892647035,255,13,68,336
10545,dark,main,20211109,2,0.99122304956258,299,13,75,387
10545,dark,main,20211109,3,0.9906159502483243,304,12,37,353
10545,dark,main,20211109,4,0.9924664721471242,291,8,49,348
10545,dark,main,20211109,5,0.9826188712067022,275,14,76,365
10545,dark,main,20211109,6,0.9906562299781901,294,12,73,379
10545,dark,main,20211109,7,0.9898265107880276,275,11,42,328
10545,dark,main,20211109,8,0.9910995647128963,308,12,40,360
10545,dark,main,20211109,9,0.9956072919497748,276,15,83,374
6943,dark,main,20211109,0,0.9908658607267529,310,14,61,385
6943,dark,main,20211109,1,0.9910097536997532,254,9,41,304
6943,dark,main,20211109,2,0.9863376378992479,297,11,67,375
6943,dark,main,20211109,3,0.9906006854045829,267,15,50,332
6943,dark,main,20211109,4,0.9915657819298082,278,14,62,354
6943,dark,main,20211109,5,0.9956933591878716,310,10,50,370
6943,dark,main,20211109,6,0.9958517351060938,282,22,76,380
6943,dark,main,20211109,7,0.9802529522199375,256,16,48,320
6943,dark,main,20211109,8,0.9865644993001212,287,10,49,346
6943,dark,main,20211109,9,0.9771681181098806,308,10,56,374
3824,dark,main,20211109,0,0.9906784125558153,303,14,73,390
3824,dark,main,20211109,1,0.9945542126535943,261,13,59,333
3824,dark,main,20211109,2,0.9907799613187774,292,11,74,377
3824,dark,main,20211109,3,0.9879448497199401,293,14,40,347
3824,dark,main,20211109,4,0.9893338385339003,293,13,54,360
3824,dark,main,20211109,5,0.990297806179135,282,10,66,358
3824,dark,main,20211109,6,0.9930309941172184,314,14,44,372
3824,dark,main,20211109,7,0.9939299446760096,264,12,46,322
3824,dark,main,20211109,8,0.98476755839914,320,11,45,376
3824,dark,main,20211109,9,0.9835104730605235,308,14,57,379
2046,dark,main,20211109,0,0.9906212580862829,305,10,68,383
2046,dark,main,20211109,1,0.9895247564123817,264,8,48,320
2046,dark,main,20211109,2,0.9959769513755814,321,10,57,388
2046,dark,main,20211109,3,0.9890013538775946,294,11,38,343
2046,dark,main,20211109,4,0.9925604283148,274,13,52,339
2046,dark,main,20211109,5,0.9918566274838564,297,11,59,367
2046,dark,main,20211109,6,0.9917371335952626,290,12,73,375
2046,dark,main,20211109,7,0.9966653328890482,242,15,72,329
2046,dark,main,20211109,8,0.9936397307770295,257,12,97,366
2046,dark,main,20211109,9,0.9922833210465162,229,12,61,302
4081,dark,main,20211109,0,0.9904203046205082,274,15,92,381
4081,dark,main,20211109,1,0.9907758546136526,218,16,87,321
4081,dark,main,20211109,2,0.9829684487615974,279,13,94,386
4081,dark,main,20211109,3,0.9929410170542571,252,16,78,346
4081,dark,main,20211109,4,0.993690270620846,256,18,91,365
4081,dark,main,20211109,5,0.9913712140449085,252,14,95,361
4081,dark,main,20211109,6,0.9902766579413741,269,12,93,374
4081,dark,main,20211109,7,0.9867852180608123,215,17,79,311
4081,dark,main,20211109,8,0.9917074315579837,271,16,85,372
4081,dark,main,20211109,9,0.9913850460133865,274,20,84,378
4967,dark,main,20211109,0,0.9899498383254295,290,12,61,363
4967,dark,main,20211109,1,0.9890578285175761,243,18,54,315
4967,dark,main,20211109,2,0.9908596565144225,265,24,76,365
4967,dark,main,20211109,3,0.9893506871755019,263,31,45,339
4967,dark,main,20211109,4,0.9800203545196202,263,19,52,334
4967,dark,main,20211109,5,0.9918480660961909,278,15,69,362
4967,dark,main,20211109,6,0.987213901498628,299,17,60,376
4967,dark,main,20211109,7,0.9888251010875304,245,14,62,321
4967,dark,main,20211109,8,0.9886485958027568,255,16,107,378
4967,dark,main,20211109,9,0.9891548599687414,264,18,76,358
8820,dark,main,20211109,0,0.9922105216808342,274,24,93,391
8820,dark,main,20211109,1,0.9934046522821808,232,23,77,332
8820,dark,main,20211109,2,0.9921948474476158,273,19,105,397
8820,dark,main,20211109,3,0.9906269433850659,241,20,92,353
8820,dark,main,20211109,4,0.9951724780606623,255,20,79,354
8820,dark,main,20211109,5,0.9903902951908627,266,18,87,371
8820,dark,main,20211109,6,0.9938783379031773,266,28,79,373
8820,dark,main,20211109,7,0.9919014110870287,256,15,62,333
8820,dark,main,20211109,8,0.9809965708893458,283,20,84,387
8820,dark,main,20211109,9,0.9922096985670007,244,19,103,366
6737,dark,main,20211109,0,0.9864427973129731,305,18,71,394
6737,dark,main,20211109,1,0.990092412921804,270,13,49,332
6737,dark,main,20211109,2,0.9943060548570244,324,13,44,381
6737,dark,main,20211109,3,0.9907929399689179,275,14,51,340
6737,dark,main,20211109,4,0.9941758453120294,246,16,81,343
6737,dark,main,20211109,5,0.9861440519493757,255,17,89,361
6737,dark,main,20211109,6,0.9953460796713735,287,17,79,383
6737,dark,main,20211109,7,0.9901624616944904,239,16,80,335
6737,dark,main,20211109,8,0.9920875451402857,249,19,99,367
6737,dark,main,20211109,9,0.9947794001403412,275,13,100,388
3938,dark,main,20211109,0,0.9949865049146551,330,16,47,393
3938,dark,main,20211109,1,0.9790422066459704,245,23,66,334
3938,dark,main,20211109,2,0.9892808266275942,264,39,83,386
3938,dark,main,20211109,3,0.9892291409499545,248,18,80,346
3938,dark,main,20211109,4,0.9853002478931955,223,46,91,360
3938,dark,main,20211109,5,0.9883050503166888,256,27,86,369
3938,dark,main,20211109,6,0.9954027110968469,269,17,81,367
3938,dark,main,20211109,7,0.9958133082061625,242,21,63,326
3938,dark,main,20211109,8,0.9957198441616217,311,15,53,379
3938,dark,main,20211109,9,0.9884964104426918,297,20,62,379
8751,dark,main,20211109,0,0.9937417622190677,336,10,56,402
8751,dark,main,20211109,1,0.9929970743728956,280,11,38,329
8751,dark,main,20211109,2,0.9950897397567794,302,24,74,400
8751,dark,main,20211109,3,0.9885727063363625,266,14,78,358
8751,dark,main,20211109,4,0.9965304462289631,294,11,67,372
8751,dark,main,20211109,5,0.9880062535580875,329,12,42,383
8751,dark,main,20211109,6,0.9935302903824158,326,13,50,389
8751,dark,main,20211109,7,0.991447344930217,264,15,51,330
8751,dark,main,20211109,8,0.9940660310419204,317,11,52,380
8751,dark,main,20211109,9,0.9936325757679869,318,12,61,391
7837,dark,main,20211109,0,0.9926353734939893,313,18,50,381
7837,dark,main,20211109,1,0.9920652791617468,273,17,41,331
7837,dark,main,20211109,2,0.9909181901958146,319,15,59,393
7837,dark,main,20211109,3,0.9889649731896738,263,21,67,351
7837,dark,main,20211109,4,0.9864432993623573,274,18,76,368
7837,dark,main,20211109,5,0.9908123408425344,269,21,82,372
7837,dark,main,20211109,6,0.9931912165790941,296,19,80,395
7837,dark,main,20211109,7,0.9863520861086797,253,18,62,333
7837,dark,main,20211109,8,0.9933129625888898,307,14,49,370
7837,dark,main,20211109,9,0.9867960314190897,298,21,62,381
8702,dark,main,20211109,0,0.9922679504688974,332,11,56,399
8702,dark,main,20211109,1,0.9884637612906156,281,12,47,340
8702,dark,main,20211109,2,0.9918592896931165,329,12,71,412
8702,dark,main,20211109,3,0.9879768036439043,250,15,86,351
8702,dark,main,20211109,4,0.9897886199966858,265,14,70,349
8702,dark,main,20211109,5,0.9884809083520322,280,15,74,369
8702,dark,main,20211109,6,0.991667836024404,287,13,84,384
8702,dark,main,20211109,7,0.9900516286929235,292,11,46,349
8702,dark,main,20211109,8,0.9911514891135836,316,12,59,387
8702,dark,main,20211109,9,0.9929814814216126,317,19,49,385
5684,dark,main,20211109,0,0.9914798769015375,284,21,89,394
5684,dark,main,20211109,1,0.9906512265451506,245,21,87,353
5684,dark,main,20211109,2,0.991395748847826,306,12,77,395
5684,dark,main,20211109,3,0.9908035062783567,298,14,41,353
5684,dark,main,20211109,4,0.9910653148838638,267,18,74,359
5684,dark,main,20211109,5,0.993993842543199,272,18,91,381
5684,dark,main,20211109,6,0.9918415632607653,255,38,88,381
5684,dark,main,20211109,7,0.9937577368276582,241,15,82,338
5684,dark,main,20211109,8,0.98424169361194,262,18,94,374
5684,dark,main,20211109,9,0.9930753343105869,259,18,100,377
5272,dark,main,20211109,0,0.9901222393217811,318,20,60,398
5272,dark,main,20211109,1,0.9862786369991965,227,24,85,336
5272,dark,main,20211109,2,0.9930312591376269,276,32,76,384
5272,dark,main,20211109,3,0.9904683939379622,269,24,56,349
5272,dark,main,20211109,4,0.9928344791241532,271,18,54,343
5272,dark,main,20211109,5,0.9911255634333711,298,19,56,373
5272,dark,main,20211109,6,0.99121370423466,308,18,43,369
5272,dark,main,20211109,7,0.9872193058440863,255,23,38,316
5272,dark,main,20211109,8,0.9859733822318362,301,23,39,363
5272,dark,main,20211109,9,0.993490344643629,265,14,71,350
2541,dark,main,20211109,0,0.9902713411165519,294,23,58,375
2541,dark,main,20211109,1,0.983302847149674,263,17,43,323
2541,dark,main,20211109,2,0.989325658542875,314,16,54,384
2541,dark,main,20211109,3,0.9946150725696545,285,17,45,347
2541,dark,main,20211109,4,0.9936933112333591,289,22,36,347
2541,dark,main,20211109,5,0.9929763399667121,282,16,53,351
2541,dark,main,20211109,6,0.9908888227638313,308,16,55,379
2541,dark,main,20211109,7,0.9897086613389328,269,17,49,335
2541,dark,main,20211109,8,0.9876619382241532,309,23,44,376
2541,dark,main,20211109,9,0.9874918530093849,291,27,59,377
21261,bright,main,20211109,0,0.9864273295645929,351,75,8,434
21261,bright,main,20211109,1,0.9935376137948131,291,76,3,370
21261,bright,main,20211109,2,0.9893080463920134,327,93,5,425
21261,bright,main,20211109,3,0.9969340274616983,300,83,5,388
21261,bright,main,20211109,4,0.9923921479166131,313,84,3,400
21261,bright,main,20211109,5,0.9944479848126708,319,81,6,406
21261,bright,main,20211109,6,0.9852862131436898,361,58,4,423
21261,bright,main,20211109,7,0.9862406103975738,309,52,4,365
21261,bright,main,20211109,8,0.9955845869828939,350,65,4,419
21261,bright,main,20211109,9,0.9941862592007067,359,63,7,429
3813,dark,main,20211110,0,0.9926347487898182,292,18,79,389
3813,dark,main,20211110,1,0.9890350672275423,247,18,58,323
3813,dark,main,20211110,2,0.9918331660371789,304,20,65,389
3813,dark,main,20211110,3,0.989689968481101,250,20,65,335
3813,dark,main,20211110,4,0.9917868519793733,240,20,91,351
3813,dark,main,20211110,5,0.9924289567711414,260,20,92,372
3813,dark,main,20211110,6,0.9925320202736752,255,18,106,379
3813,dark,main,20211110,7,0.9879205850166521,239,21,69,329
3813,dark,main,20211110,8,0.9947374445475768,262,16,92,370
3813,dark,main,20211110,9,0.9934309815805586,269,15,91,375
2714,dark,main,20211110,0,0.992751659276561,313,10,77,400
2714,dark,main,20211110,1,0.9874953514775913,246,15,72,333
2714,dark,main,20211110,2,0.9941264837213343,291,16,80,387
2714,dark,main,20211110,3,0.9867602822555683,248,14,93,355
2714,dark,main,20211110,4,0.9901383602153115,287,12,67,366
2714,dark,main,20211110,5,0.9902343633325744,277,10,84,371
2714,dark,main,20211110,6,0.996703066218158,297,12,63,372
2714,dark,main,20211110,7,0.9873445115387978,263,11,59,333
2714,dark,main,20211110,8,0.9884963643087069,281,11,83,375
2714,dark,main,20211110,9,0.995832173832556,300,11,48,359
5410,dark,main,20211110,0,0.9883769654189278,290,19,89,398
5410,dark,main,20211110,1,0.9863200162054953,264,14,56,334
5410,dark,main,20211110,2,0.9920597222067432,285,26,73,384
5410,dark,main,20211110,3,0.9920174011004856,261,23,71,355
5410,dark,main,20211110,4,0.9925160384003101,257,19,78,354
5410,dark,main,20211110,5,0.991827198726977,283,14,62,359
5410,dark,main,20211110,6,0.9868088528145094,276,19,73,368
5410,dark,main,20211110,7,0.9859512508593152,246,15,56,317
5410,dark,main,20211110,8,0.994108000414366,288,13,67,368
5410,dark,main,20211110,9,0.9946550071235917,293,15,74,382
1144,dark,main,20211110,0,0.9972397486263538,313,11,67,391
1144,dark,main,20211110,1,0.9938580046145565,272,12,49,333
1144,dark,main,20211110,2,0.9861217030556104,290,12,68,370
1144,dark,main,20211110,3,0.9895764691419703,234,25,72,331
1144,dark,main,20211110,4,0.9951816309762452,273,12,73,358
1144,dark,main,20211110,5,0.9917825131873558,288,11,65,364
1144,dark,main,20211110,6,0.990373561821168,318,15,44,377
1144,dark,main,20211110,7,0.9922116965245714,288,10,39,337
1144,dark,main,20211110,8,0.9942693242119246,298,13,63,374
1144,dark,main,20211110,9,0.9908870670112344,275,12,58,345
6424,dark,main,20211110,0,0.9898788471299764,313,19,38,370
6424,dark,main,20211110,1,0.9930001499518005,276,18,36,330
6424,dark,main,20211110,2,0.9966521227345622,312,16,53,381
6424,dark,main,20211110,3,0.9951363608232483,293,21,41,355
6424,dark,main,20211110,4,0.9934528201764848,270,23,46,339
6424,dark,main,20211110,5,0.9930126232850026,273,18,72,363
6424,dark,main,20211110,6,0.9849591583604586,272,21,80,373
6424,dark,main,20211110,7,0.9877042104094157,256,20,49,325
6424,dark,main,20211110,8,0.9905540249587564,294,24,47,365
6424,dark,main,20211110,9,0.992947159669682,275,15,52,342
2484,dark,main,20211110,0,0.9954572632767512,344,12,52,408
2484,dark,main,20211110,1,0.9901791456012695,284,14,49,347
2484,dark,main,20211110,2,0.9944098740270947,332,13,48,393
2484,dark,main,20211110,3,0.986911528675796,283,16,47,346
2484,dark,main,20211110,4,0.9971474051516352,296,14,41,351
2484,dark,main,20211110,5,0.9922637813986613,321,11,48,380
2484,dark,main,20211110,6,0.9923530584144502,322,11,63,396
2484,dark,main,20211110,7,0.9934078837791782,267,14,40,321
2484,dark,main,20211110,8,0.9892764950420713,309,15,55,379
2484,dark,main,20211110,9,0.9933728822020381,304,18,40,362
5546,dark,main,20211110,0,0.9901944851686348,315,17,61,393
5546,dark,main,20211110,1,0.9920352011925064,254,19,70,343
5546,dark,main,20211110,2,0.9899724606591622,284,22,79,385
5546,dark,main,20211110,3,0.9965141183019736,253,22,97,372
5546,dark,main,20211110,4,0.9849651639946334,274,15,78,367
5546,dark,main,20211110,5,0.9963508069862675,286,17,67,370
5546,dark,main,20211110,6,0.9921783834053685,307,14,64,385
5546,dark,main,20211110,7,0.9939797697164353,275,14,42,331
5546,dark,main,20211110,8,0.9948134078306178,281,17,67,365
5546,dark,main,20211110,9,0.9893096197291181,280,18,52,350
6023,dark,main,20211110,0,0.9928485347157584,260,19,96,375
6023,dark,main,20211110,1,0.9902898360383106,249,17,69,335
6023,dark,main,20211110,2,0.9921287563309426,278,18,91,387
6023,dark,main,20211110,3,0.9842405051684628,253,17,62,332
6023,dark,main,20211110,4,0.9905863417843671,235,22,98,355
6023,dark,main,20211110,5,0.9947315936477408,244,35,85,364
6023,dark,main,20211110,6,0.9914560527932336,245,26,106,377
6023,dark,main,20211110,7,0.9876771752389464,226,18,83,327
6023,dark,main,20211110,8,0.989836587595302,274,15,85,374
6023,dark,main,20211110,9,0.9945962589144637,261,21,89,371
11806,dark,main,20211110,0,0.9861485597559075,297,15,67,379
11806,dark,main,20211110,1,0.9902677091844622,254,17,43,314
11806,dark,main,20211110,2,0.9834653900557252,315,16,45,376
11806,dark,main,20211110,3,0.9882641158792216,274,29,55,358
11806,dark,main,20211110,4,0.9953397516807616,278,20,53,351
11806,dark,main,20211110,5,0.9917485597681083,289,17,62,368
11806,dark,main,20211110,6,0.9893482162993923,272,14,91,377
11806,dark,main,20211110,7,0.9941504425782601,249,16,68,333
11806,dark,main,20211110,8,0.9925339122441733,283,14,70,367
11806,dark,main,20211110,9,0.9966111464697611,288,11,57,356
8401,dark,main,20211110,0,0.9920178957090171,305,16,64,385
8401,dark,main,20211110,1,0.9899338325294181,258,19,44,321
8401,dark,main,20211110,2,0.986574146313269,311,19,45,375
8401,dark,main,20211110,3,0.9920761575861016,275,13,51,339
8401,dark,main,20211110,4,0.9924835202477935,286,20,29,335
8401,dark,main,20211110,5,0.9948367247053723,296,19,43,358
8401,dark,main,20211110,6,0.9907900185437177,292,25,38,355
8401,dark,main,20211110,7,0.9940398436024324,237,24,48,309
8401,dark,main,20211110,8,0.9884552781494329,270,25,66,361
8401,dark,main,20211110,9,0.994211139454115,287,16,39,342
2382,dark,main,20211110,0,0.9911231605543823,300,18,58,376
2382,dark,main,20211110,1,0.9873403586197589,272,13,50,335
2382,dark,main,20211110,2,0.9946890473184782,321,21,44,386
2382,dark,main,20211110,3,0.9895818157786653,282,24,46,352
2382,dark,main,20211110,4,0.9929585864418424,278,17,59,354
2382,dark,main,20211110,5,0.9839425978724166,300,17,53,370
2382,dark,main,20211110,6,0.9901226051973838,301,13,62,376
2382,dark,main,20211110,7,0.9881920138527837,283,14,34,331
2382,dark,main,20211110,8,0.9922047936518265,313,17,44,374
2382,dark,main,20211110,9,0.991330539262464,278,20,53,351
7580,dark,main,20211110,0,0.9956842330335346,330,15,52,397
7580,dark,main,20211110,1,0.990840586361037,235,19,78,332
7580,dark,main,20211110,2,0.9879984700319182,262,50,72,384
7580,dark,main,20211110,3,0.9852097787427934,237,30,79,346
7580,dark,main,20211110,4,0.9943512150542171,249,30,71,350
7580,dark,main,20211110,5,0.9843500463139799,247,29,82,358
7580,dark,main,20211110,6,0.9918484097501626,254,29,77,360
7580,dark,main,20211110,7,0.9872412363126484,245,20,70,335
7580,dark,main,20211110,8,0.9923621133198468,307,21,50,378
7580,dark,main,20211110,9,0.9878865548825505,296,21,61,378
5158,dark,main,20211110,0,0.9894582231931789,315,16,52,383
5158,dark,main,20211110,1,0.9949467393942549,268,13,49,330
5158,dark,main,20211110,2,0.993558036842405,326,12,43,381
5158,dark,main,20211110,3,0.9938917937801826,291,16,35,342
5158,dark,main,20211110,4,0.9877642070637668,287,10,49,346
5158,dark,main,20211110,5,0.9936421132706279,306,11,37,354
5158,dark,main,20211110,6,0.9946736694747812,304,15,55,374
5158,dark,main,20211110,7,0.9932557236428581,247,11,56,314
5158,dark,main,20211110,8,0.9940119941109926,271,17,77,365
5158,dark,main,20211110,9,0.993547679907382,296,14,44,354
10256,dark,main,20211110,0,0.9886599253153419,313,11,80,404
10256,dark,main,20211110,1,0.9868472871008339,262,14,58,334
10256,dark,main,20211110,2,0.9903375075407872,320,12,55,387
10256,dark,main,20211110,3,0.9919124629287172,280,12,67,359
10256,dark,main,20211110,4,0.9915322500942084,297,10,56,363
10256,dark,main,20211110,5,0.9912604953930304,290,11,67,368
10256,dark,main,20211110,6,0.9868697573018436,288,10,86,384
10256,dark,main,20211110,7,0.9899992517016942,251,10,67,328
10256,dark,main,20211110,8,0.992148617326482,302,19,70,391
10256,dark,main,20211110,9,0.9919537475393456,268,13,80,361
11062,dark,main,20211110,0,0.9932306999615297,292,17,71,380
11062,dark,main,20211110,1,0.9894025220947146,280,14,40,334
11062,dark,main,20211110,2,0.9905889391852943,306,15,47,368
11062,dark,main,20211110,3,0.990814003196755,291,11,45,347
11062,dark,main,20211110,4,0.994492218620506,287,13,57,357
11062,dark,main,20211110,5,0.987259135891622,298,9,51,358
11062,dark,main,20211110,6,0.9928425054851755,295,14,67,376
11062,dark,main,20211110,7,0.9928612084326531,274,13,44,331
11062,dark,main,20211110,8,0.9927192121788581,303,12,58,373
11062,dark,main,20211110,9,0.9919513233064153,255,22,78,355
23450,bright,main,20211110,0,0.9969467377520695,314,119,2,435
23450,bright,main,20211110,1,0.9903094777299121,270,110,5,385
23450,bright,main,20211110,2,0.9942347543212514,303,124,1,428
23450,bright,main,20211110,3,0.9861742693599598,275,117,5,397
23450,bright,main,20211110,4,0.9930576418982879,238,96,6,340
23450,bright,main,20211110,5,0.9891516883813811,151,83,6,240
23450,bright,main,20211110,6,0.9901937055987082,273,154,4,431
23450,bright,main,20211110,7,0.992139631206856,274,97,4,375
23450,bright,main,20211110,8,0.9929844748757346,221,203,2,426
23450,bright,main,20211110,9,0.9919773112912846,207,223,0,430
8400,dark,main,20211110,0,0.9914419444679322,326,25,42,393
8400,dark,main,20211110,1,0.986981454994378,241,17,57,315
8400,dark,main,20211110,2,0.9872247995981904,304,18,54,376
8400,dark,main,20211110,3,0.9875701402683505,270,24,55,349
8400,dark,main,20211110,4,0.9942865576568665,300,15,50,365
8400,dark,main,20211110,5,0.9976197923108332,271,15,66,352
8400,dark,main,20211110,6,0.9946361954757778,299,20,60,379
8400,dark,main,20211110,7,0.9684428455881753,251,31,50,332
8400,dark,main,20211110,8,0.9970852164146119,320,19,31,370
8400,dark,main,20211110,9,0.9924024202793778,287,15,35,337
4698,dark,main,20211110,0,0.9953752609558103,281,16,67,364
4698,dark,main,20211110,1,0.9916372552943495,258,27,46,331
4698,dark,main,20211110,2,0.9842755247587166,293,22,56,371
4698,dark,main,20211110,3,0.9906960921649276,267,20,61,348
4698,dark,main,20211110,4,0.9919976841263547,302,15,50,367
4698,dark,main,20211110,5,0.995140197698636,279,20,64,363
4698,dark,main,20211110,6,0.993500599275384,306,22,53,381
4698,dark,main,20211110,7,0.9877477263772181,259,23,44,326
4698,dark,main,20211110,8,0.9933975173977396,298,15,55,368
4698,dark,main,20211110,9,0.9839453997008639,281,14,47,342
21879,bright,main,20211110,0,0.9938462402482999,307,128,5,440
21879,bright,main,20211110,1,0.993414052350271,260,121,3,384
21879,bright,main,20211110,2,0.9904387362005984,239,189,2,430
21879,bright,main,20211110,3,0.9922438170300174,200,195,5,400
21879,bright,main,20211110,4,0.9901053653512708,183,219,4,406
21879,bright,main,20211110,5,0.992787755291213,222,190,5,417
21879,bright,main,20211110,6,0.9888753552652543,232,186,8,426
21879,bright,main,20211110,7,0.9950372160983656,212,154,4,370
21879,bright,main,20211110,8,0.9904173591709874,261,159,4,424
21879,bright,main,20211110,9,0.9914301326754168,277,147,5,429
10062,dark,main,20211110,0,0.9932839571703748,312,12,52,376
10062,dark,main,20211110,1,0.9947843617962091,273,12,52,337
10062,dark,main,20211110,2,0.9944758455677148,316,10,49,375
10062,dark,main,20211110,3,0.9861527909562087,271,11,53,335
10062,dark,main,20211110,4,0.9889310288311299,300,13,44,357
10062,dark,main,20211110,5,0.992721377479949,318,10,46,374
10062,dark,main,20211110,6,0.9907496501734889,316,10,59,385
10062,dark,main,20211110,7,0.9917112230102099,253,10,69,332
10062,dark,main,20211110,8,0.9946977618592633,299,11,82,392
10062,dark,main,20211110,9,0.9884186349403478,314,14,54,382
8290,dark,main,20211110,0,0.9868915338695312,305,14,62,381
8290,dark,main,20211110,1,0.9785014405536369,251,11,66,328
8290,dark,main,20211110,2,0.9900451238281163,308,13,62,383
8290,dark,main,20211110,3,0.9892980583279428,289,13,43,345
8290,dark,main,20211110,4,0.9833258005309977,265,12,68,345
8290,dark,main,20211110,5,0.9851273728604261,289,12,55,356
8290,dark,main,20211110,6,0.9865354716448735,297,14,46,357
8290,dark,main,20211110,7,0.9943579132633997,280,12,41,333
8290,dark,main,20211110,8,0.9937041828118985,287,11,55,353
8290,dark,main,20211110,9,0.9930233147101991,270,11,64,345
11058,dark,main,20211110,0,0.9860455432774908,316,10,59,385
11058,dark,main,20211110,1,0.9875679846856809,259,11,52,322
11058,dark,main,20211110,2,0.9938869059663297,327,10,57,394
11058,dark,main,20211110,3,0.988753355591136,297,11,54,362
11058,dark,main,20211110,4,0.9927877710902707,275,16,55,346
11058,dark,main,20211110,5,0.9858566578089278,271,15,73,359
11058,dark,main,20211110,6,0.9940803597177815,289,16,73,378
11058,dark,main,20211110,7,0.9940191685897847,274,12,45,331
11058,dark,main,20211110,8,0.9891617260880271,305,11,54,370
11058,dark,main,20211110,9,0.9924448612932313,302,13,54,369
5663,dark,main,20211110,0,0.9942669315557192,271,27,73,371
5663,dark,main,20211110,1,0.9920047456120967,232,15,93,340
5663,dark,main,20211110,2,0.9877173186586401,275,18,89,382
5663,dark,main,20211110,3,0.992245869194547,251,19,85,355
5663,dark,main,20211110,4,0.9896292871920995,252,16,85,353
5663,dark,main,20211110,5,0.9925128874393063,253,21,87,361
5663,dark,main,20211110,6,0.992602662536162,278,16,89,383
5663,dark,main,20211110,7,0.9848168726427924,230,14,85,329
5663,dark,main,20211110,8,0.9835592804118254,271,22,80,373
5663,dark,main,20211110,9,0.9943908712229627,272,21,73,366
6977,dark,main,20211110,0,0.9900888088600496,301,18,67,386
6977,dark,main,20211110,1,0.9878861312619734,256,23,60,339
6977,dark,main,20211110,2,0.9904690976673599,313,19,56,388
6977,dark,main,20211110,3,0.9892485997532283,269,17,69,355
6977,dark,main,20211110,4,0.993602464585444,269,13,75,357
6977,dark,main,20211110,5,0.9902456091003214,287,19,53,359
6977,dark,main,20211110,6,0.9883805813435774,285,14,63,362
6977,dark,main,20211110,7,0.9932086708851222,248,12,50,310
6977,dark,main,20211110,8,0.9932602243836505,281,18,55,354
6977,dark,main,20211110,9,0.9909042403551407,279,14,63,356
11076,dark,main,20211110,0,0.9896680966129248,331,12,51,394
11076,dark,main,20211110,1,0.9914657209762752,255,13,72,340
11076,dark,main,20211110,2,0.9895071947562921,311,14,62,387
11076,dark,main,20211110,3,0.9892176160813619,296,11,49,356
11076,dark,main,20211110,4,0.9823182899563259,291,11,45,347
11076,dark,main,20211110,5,0.9933819375373714,314,11,43,368
11076,dark,main,20211110,6,0.9891471474565603,328,11,52,391
11076,dark,main,20211110,7,0.994955002126249,246,10,52,308
11076,dark,main,20211110,8,0.9904752239450106,272,15,86,373
11076,dark,main,20211110,9,0.9892707246211002,279,14,53,346
11067,dark,main,20211110,0,0.9928762736388352,320,11,54,385
11067,dark,main,20211110,1,0.9910065880210908,254,16,52,322
11067,dark,main,20211110,2,0.9915242549010328,314,15,72,401
11067,dark,main,20211110,3,0.986547191353305,283,14,49,346
11067,dark,main,20211110,4,0.9921452061370897,286,11,70,367
11067,dark,main,20211110,5,0.9939756515602902,275,15,81,371
11067,dark,main,20211110,6,0.9945890917545741,259,13,100,372
11067,dark,main,20211110,7,0.9879585852737003,238,18,82,338
11067,dark,main,20211110,8,0.9926026127686622,317,15,56,388
11067,dark,main,20211110,9,0.9830832318117352,273,12,76,361
10516,dark,main,20211110,0,0.9943997219076819,281,19,84,384
10516,dark,main,20211110,1,0.9883611766518546,219,10,97,326
10516,dark,main,20211110,2,0.9908378255582343,280,17,81,378
10516,dark,main,20211110,3,0.9871181584135904,278,11,65,354
10516,dark,main,20211110,4,0.9918202150587564,293,16,54,363
10516,dark,main,20211110,5,0.9908953231294453,272,15,78,365
10516,dark,main,20211110,6,0.9938618103301061,304,13,66,383
10516,dark,main,20211110,7,0.9913747523451917,261,12,56,329
10516,dark,main,20211110,8,0.9894332715384405,290,12,57,359
10516,dark,main,20211110,9,0.9903280234731788,289,12,53,354
11083,dark,main,20211110,0,0.994378227789982,315,11,57,383
11083,dark,main,20211110,1,0.9891552791671191,265,15,36,316
11083,dark,main,20211110,2,0.9937269942787655,297,15,55,367
11083,dark,main,20211110,3,0.9895182625412923,292,13,45,350
11083,dark,main,20211110,4,0.99481523410245,297,15,42,354
11083,dark,main,20211110,5,0.9970745604992988,272,16,81,369
11083,dark,main,20211110,6,0.989185906330424,276,16,88,380
11083,dark,main,20211110,7,0.9855839370187692,259,13,61,333
11083,dark,main,20211110,8,0.9924780358289133,309,16,49,374
11083,dark,main,20211110,9,0.9944082852092774,300,11,49,360
1705,dark,main,20211110,0,0.9921226954473146,306,12,59,377
1705,dark,main,20211110,1,0.991444972752528,263,15,38,316
1705,dark,main,20211110,2,0.9905319939942226,310,12,51,373
1705,dark,main,20211110,3,0.990480143511132,281,14,53,348
1705,dark,main,20211110,4,0.989680926881935,273,13,59,345
1705,dark,main,20211110,5,0.9913711620406279,279,16,63,358
1705,dark,main,20211110,6,0.991456665574617,281,20,70,371
1705,dark,main,20211110,7,0.9853929458186789,222,20,75,317
1705,dark,main,20211110,8,0.9928761629205851,286,12,59,357
1705,dark,main,20211110,9,0.9905744465875691,281,10,61,352
2540,dark,main,20211110,0,0.9906400265239259,322,10,49,381
2540,dark,main,20211110,1,0.9900066542240883,281,15,38,334
2540,dark,main,20211110,2,0.9937181664864507,294,22,61,377
2540,dark,main,20211110,3,0.9909975667464563,268,22,68,358
2540,dark,main,20211110,4,0.9953420109172252,256,19,85,360
2540,dark,main,20211110,5,0.9890253037216373,292,16,61,369
2540,dark,main,20211110,6,0.993495035681307,300,16,56,372
2540,dark,main,20211110,7,0.9925481798767347,252,16,62,330
2540,dark,main,20211110,8,0.9897032426710632,287,17,68,372
2540,dark,main,20211110,9,0.9908921684604297,297,13,45,355
11612,dark,main,20211110,0,0.9879947068231134,308,16,64,388
11612,dark,main,20211110,1,0.994746928548835,251,11,76,338
11612,dark,main,20211110,2,0.990056028982972,285,19,77,381
11612,dark,main,20211110,3,0.9835517942682189,277,16,55,348
11612,dark,main,20211110,4,0.9931782628649051,273,12,77,362
11612,dark,main,20211110,5,0.9909508985730687,259,14,86,359
11612,dark,main,20211110,6,0.9831274314895695,256,16,106,378
11612,dark,main,20211110,7,0.9949369204465535,237,14,80,331
11612,dark,main,20211110,8,0.9900465178313577,268,13,99,380
11612,dark,main,20211110,9,0.991491820879652,277,19,89,385
6008,dark,main,20211111,0,0.9918064288701869,308,30,47,385
6008,dark,main,20211111,1,0.9912228495111803,264,25,44,333
6008,dark,main,20211111,2,0.9901204579020491,289,26,55,370
6008,dark,main,20211111,3,0.9932469999008885,262,27,56,345
6008,dark,main,20211111,4,0.9866204388221061,268,16,77,361
6008,dark,main,20211111,5,0.9880289891185026,270,15,83,368
6008,dark,main,20211111,6,0.9953479796049711,273,25,77,375
6008,dark,main,20211111,7,0.9847986097528845,219,25,81,325
6008,dark,main,20211111,8,0.9933631873596604,286,20,72,378
6008,dark,main,20211111,9,0.9949134831924445,291,14,60,365
11950,dark,main,20211111,0,0.9950068429820448,313,23,37,373
11950,dark,main,20211111,1,0.9926950041596814,254,19,60,333
11950,dark,main,20211111,2,0.9928852236967206,295,32,46,373
11950,dark,main,20211111,3,0.990507521149393,282,15,45,342
11950,dark,main,20211111,4,0.9895973662987213,310,14,31,355
11950,dark,main,20211111,5,0.9961569537632126,294,17,37,348
11950,dark,main,20211111,6,0.9894902277791767,293,20,57,370
11950,dark,main,20211111,7,0.9863237673499553,264,21,35,320
11950,dark,main,20211111,8,0.989530914981254,286,23,47,356
11950,dark,main,20211111,9,0.9934120648568218,298,24,41,363
7830,dark,main,20211111,0,0.9911385167271266,291,25,76,392
7830,dark,main,20211111,1,0.9903921108702983,252,19,60,331
7830,dark,main,20211111,2,0.9898069752331768,312,19,64,395
7830,dark,main,20211111,3,0.9856443640200169,292,20,38,350
7830,dark,main,20211111,4,0.9915643840030066,283,13,48,344
7830,dark,main,20211111,5,0.9872451359406723,295,14,33,342
7830,dark,main,20211111,6,0.9847921402092672,311,19,44,374
7830,dark,main,20211111,7,0.9947214914889563,266,14,49,329
7830,dark,main,20211111,8,0.9883697828797333,301,23,57,381
7830,dark,main,20211111,9,0.97927858351058,293,21,63,377
5661,dark,main,20211111,0,0.9872699979355358,318,18,42,378
5661,dark,main,20211111,1,0.9900285261079891,258,18,58,334
5661,dark,main,20211111,2,0.9928077277141455,296,21,72,389
5661,dark,main,20211111,3,0.9848989824231847,248,21,79,348
5661,dark,main,20211111,4,0.9790866594164626,268,14,63,345
5661,dark,main,20211111,5,0.9876352858385051,274,16,58,348
5661,dark,main,20211111,6,0.989861475934903,308,13,48,369
5661,dark,main,20211111,7,0.9919734609571002,264,14,38,316
5661,dark,main,20211111,8,0.9867105152753887,318,10,36,364
5661,dark,main,20211111,9,0.9932688768754355,319,12,43,374
11635,dark,main,20211111,0,0.9940841822918085,282,17,77,376
11635,dark,main,20211111,1,0.9912597506835694,243,17,77,337
11635,dark,main,20211111,2,0.9939086136879958,274,17,84,375
11635,dark,main,20211111,3,0.9959573918123295,258,18,78,354
11635,dark,main,20211111,4,0.9888729899986727,256,22,76,354
11635,dark,main,20211111,5,0.9893628259992615,267,18,77,362
11635,dark,main,20211111,6,0.9925604643442801,268,16,86,370
11635,dark,main,20211111,7,0.9816002029911348,243,17,67,327
11635,dark,main,20211111,8,0.995756787166211,273,16,74,363
11635,dark,main,20211111,9,0.9898296653015984,272,12,81,365
24147,bright,main,20211111,0,0.9918915318414003,321,94,8,423
24147,bright,main,20211111,1,0.9903666092750468,250,99,11,360
24147,bright,main,20211111,2,0.9885406230511373,282,134,6,422
24147,bright,main,20211111,3,0.993456606285991,298,79,5,382
24147,bright,main,20211111,4,0.9922948677771917,328,61,4,393
24147,bright,main,20211111,5,0.9956739081769593,351,50,2,403
24147,bright,main,20211111,6,0.9945080352988039,340,71,5,416
24147,bright,main,20211111,7,0.9844429446808534,296,63,0,359
24147,bright,main,20211111,8,0.9943660126280321,336,65,1,402
24147,bright,main,20211111,9,0.9939702399939959,306,106,2,414
21038,bright,main,20211111,0,0.99487406892567,288,138,3,429
21038,bright,main,20211111,1,0.9867890081551757,224,123,6,353
21038,bright,main,20211111,2,0.9973189081342044,294,104,7,405
21038,bright,main,20211111,3,0.9814724852647158,227,132,9,368
21038,bright,main,20211111,4,0.9943697682059688,256,122,4,382
21038,bright,main,20211111,5,0.9907263664383867,294,94,5,393
21038,bright,main,20211111,6,0.990755188421421,309,94,4,407
21038,bright,main,20211111,7,0.9932760832911708,240,98,4,342
21038,bright,main,20211111,8,0.9942554640622725,297,108,3,408
21038,bright,main,20211111,9,0.9917703018581936,234,161,6,401
3585,dark,main,20211111,0,0.9944011500841574,331,11,56,398
3585,dark,main,20211111,1,0.9953934263766875,245,13,67,325
3585,dark,main,20211111,2,0.9894469322636786,283,11,92,386
3585,dark,main,20211111,3,0.9941688610769838,238,17,86,341
3585,dark,main,20211111,4,0.9956852743061256,263,16,71,350
3585,dark,main,20211111,5,0.9908295444690891,284,19,70,373
3585,dark,main,20211111,6,0.9901460524083993,275,12,88,375
3585,dark,main,20211111,7,0.9960429735940313,244,16,70,330
3585,dark,main,20211111,8,0.9849646303302734,307,19,50,376
3585,dark,main,20211111,9,0.9902361545503758,296,14,67,377
21006,bright,main,20211111,0,0.994089167232762,295,116,8,419
21006,bright,main,20211111,1,0.9875597596303393,258,88,6,352
21006,bright,main,20211111,2,0.9910934259179781,331,78,7,416
21006,bright,main,20211111,3,0.9907677216064783,271,102,3,376
21006,bright,main,20211111,4,0.9898261993498279,297,87,3,387
21006,bright,main,20211111,5,0.9932424034807745,291,104,5,400
21006,bright,main,20211111,6,0.9849189614156026,314,95,2,411
21006,bright,main,20211111,7,0.9890361049967514,252,97,3,352
21006,bright,main,20211111,8,0.9924597993877518,296,87,8,391
21006,bright,main,20211111,9,0.9895752361931357,254,139,8,401
23446,bright,main,20211111,0,0.9920043056209298,250,185,4,439
23446,bright,main,20211111,1,0.9949900467865643,219,161,4,384
23446,bright,main,20211111,2,0.986464761291166,199,234,3,436
23446,bright,main,20211111,3,0.9943069185121037,193,204,2,399
23446,bright,main,20211111,4,0.9923820092548604,273,126,8,407
23446,bright,main,20211111,5,0.9935284842367248,265,142,4,411
23446,bright,main,20211111,6,0.9964444294207102,333,87,8,428
23446,bright,main,20211111,7,0.992884498208204,269,100,4,373
23446,bright,main,20211111,8,0.9957110500747496,301,113,7,421
23446,bright,main,20211111,9,0.9925596490478275,278,145,3,426
4446,dark,main,20211111,0,0.9900792283543665,291,19,72,382
4446,dark,main,20211111,1,0.9859159097152599,255,19,54,328
4446,dark,main,20211111,2,0.992579835065442,298,37,50,385
4446,dark,main,20211111,3,0.9903910438585368,262,36,45,343
4446,dark,main,20211111,4,0.9912496195225048,245,26,73,344
4446,dark,main,20211111,5,0.992916104183773,220,32,72,324
4446,dark,main,20211111,6,0.9942736279722185,256,25,84,365
4446,dark,main,20211111,7,0.991475185985241,216,32,60,308
4446,dark,main,20211111,8,0.9883938773610618,238,38,83,359
4446,dark,main,20211111,9,0.9900609735515323,254,33,89,376
20664,bright,main,20211111,0,0.9896575387784273,338,81,4,423
20664,bright,main,20211111,1,0.9865137886442634,299,64,3,366
20664,bright,main,20211111,2,0.9942858359495951,329,73,8,410
20664,bright,main,20211111,3,0.9888522756357682,312,61,6,379
20664,bright,main,20211111,4,0.9901231000121714,308,70,3,381
20664,bright,main,20211111,5,0.9902830403136582,357,41,3,401
20664,bright,main,20211111,6,0.9967560774425192,360,45,6,411
20664,bright,main,20211111,7,0.9923506778703283,277,65,7,349
20664,bright,main,20211111,8,0.9918663484758796,321,80,3,404
20664,bright,main,20211111,9,0.9904633811907586,331,70,2,403
6012,dark,main,20211111,0,0.9933929384917954,299,19,66,384
6012,dark,main,20211111,1,0.9923098176612807,246,19,78,343
6012,dark,main,20211111,2,0.996014000475387,293,25,82,400
6012,dark,main,20211111,3,0.992061717469501,260,22,68,350
6012,dark,main,20211111,4,0.9938079587623467,254,20,79,353
6012,dark,main,20211111,5,0.9920485384564269,294,24,48,366
6012,dark,main,20211111,6,0.9907420315791898,313,22,55,390
6012,dark,main,20211111,7,0.9926507537446145,256,18,53,327
6012,dark,main,20211111,8,0.9899483602235876,299,23,54,376
6012,dark,main,20211111,9,0.975656242195959,273,18,61,352
21543,bright,main,20211111,0,0.9889528702458515,327,102,4,433
21543,bright,main,20211111,1,0.9911527477616187,289,74,6,369
21543,bright,main,20211111,2,0.9887171664198442,325,65,9,399
21543,bright,main,20211111,3,0.991904144263815,285,83,8,376
21543,bright,main,20211111,4,0.9883196335317999,324,64,4,392
21543,bright,main,20211111,5,0.991209549750819,304,91,5,400
21543,bright,main,20211111,6,0.9916837438820973,321,84,4,409
21543,bright,main,20211111,7,0.9929016272670859,284,70,9,363
21543,bright,main,20211111,8,0.9947140085381501,309,102,5,416
21543,bright,main,20211111,9,0.9918284157280687,324,96,2,422
11864,dark,main,20211111,0,0.9934709678779795,308,11,70,389
11864,dark,main,20211111,1,0.9877367759779991,234,8,44,286
11864,dark,main,20211111,2,0.9904549539002729,307,9,55,371
11864,dark,main,20211111,3,0.989558630157929,281,13,48,342
11864,dark,main,20211111,4,0.9898861943903458,294,12,45,351
11864,dark,main,20211111,5,0.9938304243114795,318,11,46,375
11864,dark,main,20211111,6,0.9956918949382461,368,12,36,416
11864,dark,main,20211111,7,0.9947307097459982,270,10,75,355
11864,dark,main,20211111,8,0.9944621518556461,300,10,81,391
11864,dark,main,20211111,9,0.985394519866946,305,13,53,371
11079,dark,main,20211111,0,0.9905589284470633,323,14,56,393
11079,dark,main,20211111,1,0.9890431618754488,270,11,60,341
11079,dark,main,20211111,2,0.9881870030935481,332,12,46,390
11079,dark,main,20211111,3,0.9884460800013856,277,12,61,350
11079,dark,main,20211111,4,0.9927820350655348,293,12,64,369
11079,dark,main,20211111,5,0.9917885841876681,290,13,64,367
11079,dark,main,20211111,6,0.9959351672200619,269,20,90,379
11079,dark,main,20211111,7,0.9939607873951022,245,11,64,320
11079,dark,main,20211111,8,0.9902180815194946,302,11,67,380
11079,dark,main,20211111,9,0.9892278615651448,306,17,56,379
21243,bright,main,20211111,0,0.9917989858147357,339,96,5,440
21243,bright,main,20211111,1,0.9916438620134425,312,61,5,378
21243,bright,main,20211111,2,0.9945302841085574,355,62,4,421
21243,bright,main,20211111,3,0.9808981245360606,330,54,2,386
21243,bright,main,20211111,4,0.9896982383573304,318,76,3,397
21243,bright,main,20211111,5,0.9961013223885163,268,133,3,404
21243,bright,main,20211111,6,0.9872350914368602,330,87,4,421
21243,bright,main,20211111,7,0.9889763332934752,271,93,4,368
21243,bright,main,20211111,8,0.9878954893869017,314,96,2,412
21243,bright,main,20211111,9,0.9943792721367709,331,85,4,420
8747,dark,main,20211111,0,0.9897822986062897,313,12,64,389
8747,dark,main,20211111,1,0.9885925587861726,276,14,51,341
8747,dark,main,20211111,2,0.9948336950297166,321,14,60,395
8747,dark,main,20211111,3,0.9916362748325926,276,13,59,348
8747,dark,main,20211111,4,0.9909499051577175,299,14,55,368
8747,dark,main,20211111,5,0.9900279899257349,292,14,61,367
8747,dark,main,20211111,6,0.9906584919320757,309,18,55,382
8747,dark,main,20211111,7,0.985116451882077,267,13,62,342
8747,dark,main,20211111,8,0.9942462863203348,327,12,56,395
8747,dark,main,20211111,9,0.9932017453949686,313,14,61,388
21748,bright,main,20211111,0,0.9922975588053109,323,88,2,413
21748,bright,main,20211111,1,0.9935120035533712,291,57,4,352
21748,bright,main,20211111,2,0.9915984919726772,348,63,4,415
21748,bright,main,20211111,3,0.9883998236226655,315,52,7,374
21748,bright,main,20211111,4,0.9972692308435142,329,56,1,386
21748,bright,main,20211111,5,0.9856530276805322,325,57,6,388
21748,bright,main,20211111,6,0.9933233859567488,348,60,3,411
21748,bright,main,20211111,7,0.9923616214350703,320,33,2,355
21748,bright,main,20211111,8,0.9892612313962077,334,68,4,406
21748,bright,main,20211111,9,0.9939142801747544,332,64,4,400
25716,bright,main,20211111,0,0.9872753568070881,345,86,8,439
25716,bright,main,20211111,1,0.9886275694469095,282,85,7,374
25716,bright,main,20211111,2,0.988015964466092,323,94,5,422
25716,bright,main,20211111,3,0.9950919300331158,268,111,5,384
25716,bright,main,20211111,4,0.991868526576059,258,133,7,398
25716,bright,main,20211111,5,0.9942731110999825,286,108,2,396
25716,bright,main,20211111,6,0.9946688998823862,306,106,3,415
25716,bright,main,20211111,7,0.9821105745175556,287,78,4,369
25716,bright,main,20211111,8,0.9950739415745026,297,121,1,419
25716,bright,main,20211111,9,0.9966832476246119,297,106,7,410
21040,bright,main,20211111,0,0.995091024432789,340,80,7,427
21040,bright,main,20211111,1,0.9906559987006672,311,43,4,358
21040,bright,main,20211111,2,0.9937125428507888,343,71,4,418
21040,bright,main,20211111,3,0.995367996543288,278,90,2,370
21040,bright,main,20211111,4,0.9919631654124501,307,82,2,391
21040,bright,main,20211111,5,0.9903156252990111,327,54,3,384
21040,bright,main,20211111,6,0.9948487447920921,313,100,2,415
21040,bright,main,20211111,7,0.9946667851424674,244,104,6,354
21040,bright,main,20211111,8,0.9902375726556886,319,83,3,405
21040,bright,main,20211111,9,0.9927768755580151,331,62,7,400
11529,dark,main,20211111,0,0.9887332567496063,250,27,95,372
11529,dark,main,20211111,1,0.9908213797684232,234,24,62,320
11529,dark,main,20211111,2,0.9909249097171396,318,17,43,378
11529,dark,main,20211111,3,0.9914964575668652,281,17,30,328
11529,dark,main,20211111,4,0.9926678368895897,254,44,43,341
11529,dark,main,20211111,5,0.9926387227737652,290,13,47,350
11529,dark,main,20211111,6,0.9928372435002305,256,19,102,377
11529,dark,main,20211111,7,0.9833818810909691,227,22,75,324
11529,dark,main,20211111,8,0.9898875154494776,251,22,100,373
11529,dark,main,20211111,9,0.991114622603554,253,32,85,370
22265,bright,main,20211111,0,0.9905322390990342,346,67,6,419
22265,bright,main,20211111,1,0.9914587373645138,298,69,1,368
22265,bright,main,20211111,2,0.9940463019725388,303,110,4,417
22265,bright,main,20211111,3,0.9916288444672298,286,87,5,378
22265,bright,main,20211111,4,0.9914221779455008,277,109,3,389
22265,bright,main,20211111,5,0.9870826692119188,278,103,8,389
22265,bright,main,20211111,6,0.98512386502705,281,112,12,405
22265,bright,main,20211111,7,0.9923055860263018,244,109,2,355
22265,bright,main,20211111,8,0.9921209682256136,275,120,5,400
22265,bright,main,20211111,9,0.9892523305113005,347,61,3,411
21747,bright,main,20211111,0,0.9944765597807746,373,52,6,431
21747,bright,main,20211111,1,0.9918071856444762,299,54,6,359
21747,bright,main,20211111,2,0.9963137925994219,328,83,2,413
21747,bright,main,20211111,3,0.9932346181552817,276,72,7,355
21747,bright,main,20211111,4,0.9914695580328937,322,60,3,385
21747,bright,main,20211111,5,0.9943614487293223,327,55,4,386
21747,bright,main,20211111,6,0.9905731721192957,346,59,7,412
21747,bright,main,20211111,7,0.9882062922844349,291,72,3,366
21747,bright,main,20211111,8,0.988080494587614,306,78,5,389
21747,bright,main,20211111,9,0.9904796523012359,345,50,4,399
7770,dark,main,20211112,0,0.9895385202557082,252,42,84,378
7770,dark,main,20211112,1,0.9865596630794577,222,23,77,322
7770,dark,main,20211112,2,0.9911818285593004,275,29,77,381
7770,dark,main,20211112,3,0.9872040177101448,239,26,69,334
7770,dark,main,20211112,4,0.9910164594733876,278,27,63,368
7770,dark,main,20211112,5,0.9925727094701832,289,24,60,373
7770,dark,main,20211112,6,0.9935551869023426,293,27,62,382
7770,dark,main,20211112,7,0.9909123276061804,259,23,53,335
7770,dark,main,20211112,8,0.9908005062022754,269,44,64,377
7770,dark,main,20211112,9,0.9911378916377244,254,39,80,373
11536,dark,main,20211112,0,0.9956917100226017,309,15,52,376
11536,dark,main,20211112,1,0.9932197936543296,271,16,37,324
11536,dark,main,20211112,2,0.9933067317946259,288,26,40,354
11536,dark,main,20211112,3,0.9933266974298471,281,20,47,348
11536,dark,main,20211112,4,0.9839748903523441,278,14,56,348
11536,dark,main,20211112,5,0.9951803660885267,325,13,36,374
11536,dark,main,20211112,6,0.9889879505069157,277,42,58,377
11536,dark,main,20211112,7,0.9937948808023702,256,20,67,343
11536,dark,main,20211112,8,0.9915232331981015,291,17,67,375
11536,dark,main,20211112,9,0.9949085430937354,304,11,54,369
6210,dark,main,20211112,0,0.9925685819622413,313,23,59,395
6210,dark,main,20211112,1,0.9959427985198098,259,21,49,329
6210,dark,main,20211112,2,0.9911759781438682,316,26,46,388
6210,dark,main,20211112,3,0.9870168428368643,263,21,64,348
6210,dark,main,20211112,4,0.9897959741878001,260,27,70,357
6210,dark,main,20211112,5,0.9945118056461104,279,26,55,360
6210,dark,main,20211112,6,0.9935602051538522,285,34,56,375
6210,dark,main,20211112,7,0.9945921333091413,243,29,57,329
6210,dark,main,20211112,8,0.9920918558936704,286,31,51,368
6210,dark,main,20211112,9,0.995061341393679,284,25,61,370
8680,dark,main,20211112,0,0.9863541873273226,317,15,39,371
8680,dark,main,20211112,1,0.9875395717237146,266,19,46,331
8680,dark,main,20211112,2,0.9934784491040005,275,22,73,370
8680,dark,main,20211112,3,0.9931984222670538,270,22,52,344
8680,dark,main,20211112,4,0.9930836222553633,291,18,53,362
8680,dark,main,20211112,5,0.9939094850090914,309,15,43,367
8680,dark,main,20211112,6,0.990178072498502,318,16,47,381
8680,dark,main,20211112,7,0.9928846768651597,263,15,56,334
8680,dark,main,20211112,8,0.9888289671494598,295,18,63,376
8680,dark,main,20211112,9,0.991662520668456,307,14,49,370
3713,dark,main,20211112,0,0.9903924428139194,299,29,39,367
3713,dark,main,20211112,1,0.9863721461279112,288,9,33,330
3713,dark,main,20211112,2,0.9886581197582721,338,15,27,380
3713,dark,main,20211112,3,0.9918672769156185,286,22,39,347
3713,dark,main,20211112,4,0.9948537573268831,293,17,51,361
3713,dark,main,20211112,5,0.9942070146347523,306,24,48,378
3713,dark,main,20211112,6,0.9909072063456325,262,26,83,371
3713,dark,main,20211112,7,0.9882245123454487,231,25,71,327
3713,dark,main,20211112,8,0.9926391365949152,293,20,71,384
3713,dark,main,20211112,9,0.9943099561635307,304,23,32,359
8263,dark,main,20211112,0,0.990417883747708,325,16,50,391
8263,dark,main,20211112,1,0.9929924188605226,253,14,69,336
8263,dark,main,20211112,2,0.9913174231398633,305,14,68,387
8263,dark,main,20211112,3,0.9935199251904743,262,15,71,348
8263,dark,main,20211112,4,0.9922560082491588,272,15,64,351
8263,dark,main,20211112,5,0.9917937775368604,284,15,74,373
8263,dark,main,20211112,6,0.9872334843744003,280,15,74,369
8263,dark,main,20211112,7,0.9958998480090931,238,29,58,325
8263,dark,main,20211112,8,0.992906702708623,272,23,84,379
8263,dark,main,20211112,9,0.9857746704052773,307,12,55,374
7175,dark,main,20211112,0,0.9883133151252914,277,24,78,379
7175,dark,main,20211112,1,0.9918905041338979,287,11,47,345
7175,dark,main,20211112,2,0.9938615242477491,317,13,58,388
7175,dark,main,20211112,3,0.9920217785848843,285,11,52,348
7175,dark,main,20211112,4,0.9889886289260961,294,11,46,351
7175,dark,main,20211112,5,0.9892382223762543,308,13,46,367
7175,dark,main,20211112,6,0.9941775269168436,315,15,57,387
7175,dark,main,20211112,7,0.9931107535004418,268,17,54,339
7175,dark,main,20211112,8,0.9925117491111262,303,14,66,383
7175,dark,main,20211112,9,0.9881932468341186,287,18,81,386
6514,dark,main,20211112,0,0.9916541564511179,327,13,49,389
6514,dark,main,20211112,1,0.9901237748932864,258,12,72,342
6514,dark,main,20211112,2,0.9941016646290669,309,12,57,378
6514,dark,main,20211112,3,0.9925494704669661,282,14,56,352
6514,dark,main,20211112,4,0.9919709001215314,294,13,47,354
6514,dark,main,20211112,5,0.9873372862455239,308,12,51,371
6514,dark,main,20211112,6,0.9891085033205669,302,18,49,369
6514,dark,main,20211112,7,0.9929845410150817,281,16,32,329
6514,dark,main,20211112,8,0.9890687032983108,298,23,51,372
6514,dark,main,20211112,9,0.9914804365106215,320,12,49,381
23937,bright,main,20211112,0,0.9929141992462284,348,87,6,441
23937,bright,main,20211112,1,0.9891767064981526,283,88,5,376
23937,bright,main,20211112,2,0.9937402199802997,284,147,4,435
23937,bright,main,20211112,3,0.9922378804553742,208,178,4,390
23937,bright,main,20211112,4,0.9924966997646633,241,158,3,402
23937,bright,main,20211112,5,0.9908886222354962,227,185,2,414
23937,bright,main,20211112,6,0.9958608712199564,223,199,2,424
23937,bright,main,20211112,7,0.9896725554665114,288,84,2,374
23937,bright,main,20211112,8,0.9911472576426362,277,132,4,413
23937,bright,main,20211112,9,0.9948702615003058,266,157,5,428
22070,bright,main,20211112,0,0.9923681548391068,302,139,3,444
22070,bright,main,20211112,1,0.9897904154905298,248,125,3,376
22070,bright,main,20211112,2,0.9976306548384544,287,133,7,427
22070,bright,main,20211112,3,0.9951404019037515,250,141,4,395
22070,bright,main,20211112,4,0.9910131333603207,295,102,5,402
22070,bright,main,20211112,5,0.9926420614264417,314,97,4,415
22070,bright,main,20211112,6,0.9899998573470128,290,134,5,429
22070,bright,main,20211112,7,0.9907392461266936,264,108,3,375
22070,bright,main,20211112,8,0.9954465643720287,263,158,5,426
22070,bright,main,20211112,9,0.9928098529100412,289,139,3,431
11088,dark,main,20211112,0,0.9929742325434503,302,13,56,371
11088,dark,main,20211112,1,0.9895770737442678,271,10,39,320
11088,dark,main,20211112,2,0.9893390797153662,310,13,57,380
11088,dark,main,20211112,3,0.989546242083712,289,13,51,353
11088,dark,main,20211112,4,0.9937633428871993,308,11,35,354
11088,dark,main,20211112,5,0.9959839748184894,278,18,59,355
11088,dark,main,20211112,6,0.9940905602439604,293,16,69,378
11088,dark,main,20211112,7,0.9835039584827769,269,15,48,332
11088,dark,main,20211112,8,0.988881270621602,325,11,46,382
11088,dark,main,20211112,9,0.994284644191859,315,11,52,378
23925,bright,main,20211112,0,0.9937000771650798,314,122,1,437
23925,bright,main,20211112,1,0.9950034481138891,285,90,4,379
23925,bright,main,20211112,2,0.9924251597476231,317,111,3,431
23925,bright,main,20211112,3,0.9901334954298744,296,92,4,392
23925,bright,main,20211112,4,0.991092995249468,299,98,2,399
23925,bright,main,20211112,5,0.9911052886057996,275,137,4,416
23925,bright,main,20211112,6,0.9919950926305965,282,138,4,424
23925,bright,main,20211112,7,0.9920153796034586,233,137,2,372
23925,bright,main,20211112,8,0.9921821857374254,249,162,5,416
23925,bright,main,20211112,9,0.9933672998929732,269,148,7,424
2477,dark,main,20211112,0,0.9826112376799224,316,13,64,393
2477,dark,main,20211112,1,0.988651188669972,276,14,39,329
2477,dark,main,20211112,2,0.9826579888777408,336,9,47,392
2477,dark,main,20211112,3,0.9826579888777408,336,9,47,392
2477,dark,main,20211112,4,0.9940852421463784,279,11,72,362
2477,dark,main,20211112,5,0.9885886822503063,299,13,57,369
2477,dark,main,20211112,6,0.9891411800644021,322,12,48,382
2477,dark,main,20211112,7,0.9844499578613294,287,10,34,331
2477,dark,main,20211112,8,0.9901991212895891,319,11,55,385
2477,dark,main,20211112,9,0.9954138986698954,303,16,62,381
10358,dark,main,20211112,0,0.993233958091846,269,31,90,390
10358,dark,main,20211112,1,0.9914241075777167,223,19,75,317
10358,dark,main,20211112,2,0.9919345752513021,289,25,73,387
10358,dark,main,20211112,3,0.9891551877197644,288,20,42,350
10358,dark,main,20211112,4,0.98538612982932,275,23,45,343
10358,dark,main,20211112,5,0.9943049397986603,288,15,62,365
10358,dark,main,20211112,6,0.9900017218676557,297,17,69,383
10358,dark,main,20211112,7,0.994672764739805,231,20,72,323
10358,dark,main,20211112,8,0.9920460385545724,237,23,91,351
10358,dark,main,20211112,9,0.9895523565741755,264,29,79,372
10354,dark,main,20211112,0,0.9856044414857299,307,12,65,384
10354,dark,main,20211112,1,0.9860123424453562,241,18,75,334
10354,dark,main,20211112,2,0.9935622336742634,300,22,84,406
10354,dark,main,20211112,3,0.9981374196099777,270,17,66,353
10354,dark,main,20211112,4,0.9953544750380454,253,12,58,323
10354,dark,main,20211112,5,0.9859112488692854,239,10,47,296
10354,dark,main,20211112,6,0.9888440694952155,292,19,75,386
10354,dark,main,20211112,7,0.9905071637390188,239,16,59,314
10354,dark,main,20211112,8,0.9963980329638966,298,12,69,379
10354,dark,main,20211112,9,0.9943720608295303,282,18,69,369
7229,dark,main,20211112,0,0.9966227948665336,292,19,85,396
7229,dark,main,20211112,1,0.989945595473665,236,15,83,334
7229,dark,main,20211112,2,0.9967769681559127,301,15,65,381
7229,dark,main,20211112,3,0.989409195642546,300,15,37,352
7229,dark,main,20211112,4,0.9912905288991493,277,15,59,351
7229,dark,main,20211112,5,0.9912261354264317,266,19,81,366
7229,dark,main,20211112,6,0.9913394554838187,273,17,93,383
7229,dark,main,20211112,7,0.9902309515312631,221,19,87,327
7229,dark,main,20211112,8,0.9938197727202077,245,24,86,355
7229,dark,main,20211112,9,0.9871811320681796,264,21,82,367
4102,dark,main,20211112,0,0.9920021265673246,315,18,57,390
4102,dark,main,20211112,1,0.9922480777118614,272,12,51,335
4102,dark,main,20211112,2,0.9944022889522027,289,21,45,355
4102,dark,main,20211112,3,0.9938523173618705,288,18,41,347
4102,dark,main,20211112,4,0.9928712191570302,284,11,67,362
4102,dark,main,20211112,5,0.9952363163282059,267,22,80,369
4102,dark,main,20211112,6,0.9843795910410353,271,20,72,363
4102,dark,main,20211112,7,0.9849802595057657,239,22,69,330
4102,dark,main,20211112,8,0.9868999871866051,292,20,74,386
4102,dark,main,20211112,9,0.9871272912589629,316,14,55,385
6732,dark,main,20211112,0,0.9882241137206624,320,10,61,391
6732,dark,main,20211112,1,0.9926208741687659,271,11,56,338
6732,dark,main,20211112,2,0.9858185066547421,322,14,56,392
6732,dark,main,20211112,3,0.9934376259048658,305,11,50,366
6732,dark,main,20211112,4,0.987695082944211,305,9,58,372
6732,dark,main,20211112,5,0.9940111438816448,305,12,66,383
6732,dark,main,20211112,6,0.9943849498487828,285,13,82,380
6732,dark,main,20211112,7,0.9851731710806202,256,10,64,330
6732,dark,main,20211112,8,0.9901589827982529,278,14,83,375
6732,dark,main,20211112,9,0.9931082060522665,305,13,69,387
5685,dark,main,20211112,0,0.99444773173282,299,20,80,399
5685,dark,main,20211112,1,0.9847662048436704,224,11,36,271
5685,dark,main,20211112,2,0.983886852961149,211,15,36,262
5685,dark,main,20211112,3,0.9897242603174969,270,15,50,335
5685,dark,main,20211112,4,0.9922286458553488,244,25,96,365
5685,dark,main,20211112,5,0.9944001765454579,252,17,96,365
5685,dark,main,20211112,6,0.9885652761326531,278,19,98,395
5685,dark,main,20211112,7,0.9734314524115066,135,12,47,194
5685,dark,main,20211112,8,0.9930324743064266,271,23,81,375
5685,dark,main,20211112,9,0.9934285099069239,250,31,98,379
11913,dark,main,20211112,0,0.9924169299778443,291,18,92,401
11913,dark,main,20211112,1,0.9921504136030359,259,15,62,336
11913,dark,main,20211112,2,0.9954788408825154,315,17,63,395
11913,dark,main,20211112,3,0.9883992667646602,283,14,55,352
11913,dark,main,20211112,4,0.9907446095559072,284,13,56,353
11913,dark,main,20211112,5,0.9938999162348934,311,14,51,376
11913,dark,main,20211112,6,0.9936011968547419,275,16,88,379
11913,dark,main,20211112,7,0.9824349576764727,255,13,77,345
11913,dark,main,20211112,8,0.9837066603199298,246,18,101,365
11913,dark,main,20211112,9,0.9933620619762874,266,19,89,374
11077,dark,main,20211112,0,0.9949639854784175,307,11,72,390
11077,dark,main,20211112,1,0.9909770293182855,275,12,55,342
11077,dark,main,20211112,2,0.9889265741772649,306,11,73,390
11077,dark,main,20211112,3,0.9951222310915343,257,12,83,352
11077,dark,main,20211112,4,0.9927065119673858,243,12,110,365
11077,dark,main,20211112,5,0.9886651802886577,291,11,78,380
11077,dark,main,20211112,6,0.9863076661966315,310,13,63,386
11077,dark,main,20211112,7,0.9930064667294987,273,15,56,344
11077,dark,main,20211112,8,0.9890589966332758,277,12,81,370
11077,dark,main,20211112,9,0.9897625053761658,290,16,77,383
10206,dark,main,20211112,0,0.9953570586846786,305,17,57,379
10206,dark,main,20211112,1,0.9922522919903856,284,20,24,328
10206,dark,main,20211112,2,0.9872909543131316,338,12,30,380
10206,dark,main,20211112,3,0.9882732618032957,289,15,35,339
10206,dark,main,20211112,4,0.9950334941755568,278,17,47,342
10206,dark,main,20211112,5,0.9955345385271545,286,14,34,334
10206,dark,main,20211112,6,0.9887185821253455,307,14,61,382
10206,dark,main,20211112,7,0.9949934649675681,255,19,60,334
10206,dark,main,20211112,8,0.985173383327372,263,16,86,365
10206,dark,main,20211112,9,0.9934366256024003,309,15,55,379
4838,dark,main,20211112,0,0.9918881490053882,316,14,45,375
4838,dark,main,20211112,1,0.9943247002329281,271,13,49,333
4838,dark,main,20211112,2,0.9870783986454388,321,13,49,383
4838,dark,main,20211112,3,0.9861496252584472,292,11,43,346
4838,dark,main,20211112,4,0.9865715709502306,284,13,63,360
4838,dark,main,20211112,5,0.9944746996898983,289,12,71,372
4838,dark,main,20211112,6,0.992588066879383,268,15,86,369
4838,dark,main,20211112,7,0.9913349051670265,254,13,60,327
4838,dark,main,20211112,8,0.9897822837950226,323,12,49,384
4838,dark,main,20211112,9,0.9903426953092419,310,13,42,365
2567,dark,main,20211112,0,0.9938325066432023,297,20,74,391
2567,dark,main,20211112,1,0.9860188310496183,257,13,57,327
2567,dark,main,20211112,2,0.9951427365980734,322,15,61,398
2567,dark,main,20211112,3,0.9903761888434903,289,17,39,345
2567,dark,main,20211112,4,0.9963721963391999,288,13,62,363
2567,dark,main,20211112,5,0.9851144112621703,272,18,88,378
2567,dark,main,20211112,6,0.9939032740898914,264,23,101,388
2567,dark,main,20211112,7,0.9930730094642816,246,21,77,344
2567,dark,main,20211112,8,0.9892442045537763,271,16,100,387
2567,dark,main,20211112,9,0.9925388245446456,285,18,74,377
4053,dark,main,20211112,0,0.9946127377417202,314,16,73,403
4053,dark,main,20211112,1,0.9877413931944355,268,12,56,336
4053,dark,main,20211112,2,0.9920861926413693,311,11,76,398
4053,dark,main,20211112,3,0.9968067628470867,278,11,43,332
4053,dark,main,20211112,4,0.983011012625841,295,12,44,351
4053,dark,main,20211112,5,0.994490950681205,305,17,45,367
4053,dark,main,20211112,6,0.994178965412429,324,11,43,378
4053,dark,main,20211112,7,0.9940079765489421,282,14,39,335
4053,dark,main,20211112,8,0.9915400036428977,328,14,37,379
4053,dark,main,20211112,9,0.9836256147305836,326,10,34,370
8307,dark,main,20211112,0,0.9910446577813324,282,17,100,399
8307,dark,main,20211112,1,0.9928224811417583,237,18,75,330
8307,dark,main,20211112,2,0.9941954208420755,280,23,85,388
8307,dark,main,20211112,3,0.9912698061847133,249,14,87,350
8307,dark,main,20211112,4,0.9942683612898271,260,13,88,361
8307,dark,main,20211112,5,0.9904925456566072,256,16,85,357
8307,dark,main,20211112,6,0.9913291906823164,265,19,92,376
8307,dark,main,20211112,7,0.9943664517175677,261,17,72,350
8307,dark,main,20211112,8,0.9911008127720036,303,18,65,386
8307,dark,main,20211112,9,0.9965618164183906,292,14,80,386
24663,bright,main,20211112,0,0.9960223972640345,363,67,8,438
24663,bright,main,20211112,1,0.9920754524061598,300,72,5,377
24663,bright,main,20211112,2,0.9912478240744028,353,81,1,435
24663,bright,main,20211112,3,0.9914178784724128,312,80,5,397
24663,bright,main,20211112,4,0.9914150831692415,329,62,6,397
24663,bright,main,20211112,5,0.9928030200836068,328,78,5,411
24663,bright,main,20211112,6,0.9894845848641108,348,72,4,424
24663,bright,main,20211112,7,0.9946093401114359,308,62,3,373
24663,bright,main,20211112,8,0.9955164142203218,341,72,3,416
24663,bright,main,20211112,9,0.9950007902385426,318,103,4,425
5651,dark,main,20211113,0,0.9894945775620128,291,23,84,398
5651,dark,main,20211113,1,0.9916474382326885,227,30,84,341
5651,dark,main,20211113,2,0.9861790479648764,298,18,78,394
5651,dark,main,20211113,3,0.9875710149818059,287,14,61,362
5651,dark,main,20211113,4,0.993674863582474,293,15,54,362
5651,dark,main,20211113,5,0.9928272870054046,274,16,82,372
5651,dark,main,20211113,6,0.989746966293268,278,22,102,402
5651,dark,main,20211113,7,0.9941399770628805,236,12,88,336
5651,dark,main,20211113,8,0.9855445472638305,270,19,87,376
5651,dark,main,20211113,9,0.9873066497551941,264,18,95,377
1801,dark,main,20211113,0,0.9879319948370802,315,13,57,385
1801,dark,main,20211113,1,0.9946752457731524,247,14,88,349
1801,dark,main,20211113,2,0.9924755483893135,302,17,69,388
1801,dark,main,20211113,3,0.9903582274261001,276,18,63,357
1801,dark,main,20211113,4,0.9896159802575687,292,17,61,370
1801,dark,main,20211113,5,0.9910344572552948,309,9,60,378
1801,dark,main,20211113,6,0.9963276761070212,303,14,56,373
1801,dark,main,20211113,7,0.9900169709361157,262,23,43,328
1801,dark,main,20211113,8,0.993096307189746,298,12,73,383
1801,dark,main,20211113,9,0.99375010601377,310,15,61,386
23931,bright,main,20211113,0,0.9950547292374896,373,63,7,443
23931,bright,main,20211113,1,0.9925301451541199,307,65,5,377
23931,bright,main,20211113,2,0.9928604039433911,343,82,8,433
23931,bright,main,20211113,3,0.9940867177445375,297,92,3,392
23931,bright,main,20211113,4,0.9902430136802263,319,75,5,399
23931,bright,main,20211113,5,0.9876467690223676,294,105,5,404
23931,bright,main,20211113,6,0.995616371694885,315,97,4,416
23931,bright,main,20211113,7,0.9876406456994045,291,77,2,370
23931,bright,main,20211113,8,0.9927215244065393,322,91,4,417
23931,bright,main,20211113,9,0.9935182923054842,334,80,8,422
24683,bright,main,20211113,0,0.9919369304598238,330,79,4,413
24683,bright,main,20211113,1,0.9950713297687612,272,73,6,351
24683,bright,main,20211113,2,0.9913268302587945,307,95,5,407
24683,bright,main,20211113,3,0.9938130706139623,276,94,5,375
24683,bright,main,20211113,4,0.9874034766264144,296,72,6,374
24683,bright,main,20211113,5,0.9955157945532728,317,64,5,386
24683,bright,main,20211113,6,0.9893017099496029,333,61,4,398
24683,bright,main,20211113,7,0.9898652924602676,269,76,7,352
24683,bright,main,20211113,8,0.989828294628331,300,93,2,395
24683,bright,main,20211113,9,0.9912998343357491,320,80,5,405
5649,dark,main,20211113,0,0.9943982884303326,316,14,56,386
5649,dark,main,20211113,1,0.9923079972961388,259,13,69,341
5649,dark,main,20211113,2,0.9839972327517101,280,18,97,395
5649,dark,main,20211113,3,0.9916057605293923,261,22,83,366
5649,dark,main,20211113,4,0.988901099950433,260,18,89,367
5649,dark,main,20211113,5,0.9961442159521182,245,18,116,379
5649,dark,main,20211113,6,0.9925244598535148,307,13,69,389
5649,dark,main,20211113,7,0.9966415656821376,245,19,65,329
5649,dark,main,20211113,8,0.994948280217203,312,22,49,383
5649,dark,main,20211113,9,0.9932520244797325,300,22,52,374
11171,dark,main,20211113,0,0.9956984420276,280,12,101,393
11171,dark,main,20211113,1,0.9889931782428149,253,28,56,337
11171,dark,main,20211113,2,0.9938587700758467,278,15,103,396
11171,dark,main,20211113,3,0.9884096332710111,261,17,79,357
11171,dark,main,20211113,4,0.9942529027030266,251,10,105,366
11171,dark,main,20211113,5,0.9888991958865712,280,14,80,374
11171,dark,main,20211113,6,0.9927831639158197,265,17,88,370
11171,dark,main,20211113,7,0.989339947220441,240,11,87,338
11171,dark,main,20211113,8,0.9948090795361614,264,21,95,380
11171,dark,main,20211113,9,0.9907977626772076,273,19,85,377
11908,dark,main,20211113,0,0.991700016371557,294,16,79,389
11908,dark,main,20211113,1,0.9920238191660312,257,14,61,332
11908,dark,main,20211113,2,0.9948053955015348,281,21,90,392
11908,dark,main,20211113,3,0.9931311382713216,268,10,72,350
11908,dark,main,20211113,4,0.9901551779692139,267,13,78,358
11908,dark,main,20211113,5,0.9936069997806175,251,14,80,345
11908,dark,main,20211113,6,0.9933774222598577,282,17,97,396
11908,dark,main,20211113,7,0.9850608045845944,245,12,81,338
11908,dark,main,20211113,8,0.988577989380025,275,24,84,383
11908,dark,main,20211113,9,0.9920041206959131,261,18,92,371
11763,dark,main,20211113,0,0.9935124209971594,288,21,87,396
11763,dark,main,20211113,1,0.9921108386558964,282,17,52,351
11763,dark,main,20211113,2,0.9929486243245512,321,14,69,404
11763,dark,main,20211113,3,0.9924807944585079,276,24,57,357
11763,dark,main,20211113,4,0.9892823953708465,258,17,87,362
11763,dark,main,20211113,5,0.9929955160509358,268,16,90,374
11763,dark,main,20211113,6,0.9915848816653436,259,18,106,383
11763,dark,main,20211113,7,0.9927541536513812,244,15,71,330
11763,dark,main,20211113,8,0.993293118036438,293,19,67,379
11763,dark,main,20211113,9,0.9949588550508013,286,13,80,379
22360,bright,main,20211113,0,0.9935609514072938,345,94,4,443
22360,bright,main,20211113,1,0.9906846597607435,307,63,5,375
22360,bright,main,20211113,2,0.994329487548919,345,86,7,438
22360,bright,main,20211113,3,0.9910680249801772,302,91,4,397
22360,bright,main,20211113,4,0.9863461040736068,305,92,6,403
22360,bright,main,20211113,5,0.9946998352091866,313,93,7,413
22360,bright,main,20211113,6,0.9902685713644431,304,112,4,420
22360,bright,main,20211113,7,0.9921677987610249,253,76,1,330
22360,bright,main,20211113,8,0.9900758866373451,256,79,8,343
22360,bright,main,20211113,9,0.9952427751590446,343,77,7,427
7070,dark,main,20211113,0,0.9913613420530207,306,19,50,375
7070,dark,main,20211113,1,0.9890327509716549,274,12,43,329
7070,dark,main,20211113,2,0.9923172183556273,316,19,41,376
7070,dark,main,20211113,3,0.9918036630105254,279,16,44,339
7070,dark,main,20211113,4,0.9933069048354407,279,18,64,361
7070,dark,main,20211113,5,0.9857531091784594,301,16,59,376
7070,dark,main,20211113,6,0.992569865972258,290,15,62,367
7070,dark,main,20211113,7,0.99128094788167,266,14,50,330
7070,dark,main,20211113,8,0.9943557819221759,306,15,56,377
7070,dark,main,20211113,9,0.9880546244664516,293,12,58,363
22629,bright,main,20211113,0,0.991791110383164,244,185,4,433
22629,bright,main,20211113,1,0.9910895778901238,199,181,3,383
22629,bright,main,20211113,2,0.9887999077408929,218,224,0,442
22629,bright,main,20211113,3,0.9918303445821315,145,248,1,394
22629,bright,main,20211113,4,0.994304100198049,211,195,2,408
22629,bright,main,20211113,5,0.9874193776576181,213,193,1,407
22629,bright,main,20211113,6,0.9923518394870643,230,195,1,426
22629,bright,main,20211113,7,0.9928216152569873,212,161,3,376
22629,bright,main,20211113,8,0.99315448537817,258,165,2,425
22629,bright,main,20211113,9,0.994105260875288,219,205,4,428
6211,dark,main,20211113,0,0.9882065024024799,277,28,78,383
6211,dark,main,20211113,1,0.9808633513734788,226,32,62,320
6211,dark,main,20211113,2,0.9851216042952853,285,27,72,384
6211,dark,main,20211113,3,0.9938479495406665,245,32,60,337
6211,dark,main,20211113,4,0.9948962555442108,233,37,76,346
6211,dark,main,20211113,5,0.9936093364116867,259,30,60,349
6211,dark,main,20211113,6,0.9935730060319258,283,25,58,366
6211,dark,main,20211113,7,0.9912148792789733,232,33,60,325
6211,dark,main,20211113,8,0.9909128546165044,272,28,60,360
6211,dark,main,20211113,9,0.9930968888818918,265,27,81,373
24639,bright,main,20211113,0,0.9874607025218107,370,71,1,442
24639,bright,main,20211113,1,0.9917355369789989,271,92,4,367
24639,bright,main,20211113,2,0.9913851751416823,311,104,6,421
24639,bright,main,20211113,3,0.9825669944978985,315,73,4,392
24639,bright,main,20211113,4,0.9917819956856474,296,97,4,397
24639,bright,main,20211113,5,0.9896300012281485,336,70,2,408
24639,bright,main,20211113,6,0.9916570699630736,350,65,3,418
24639,bright,main,20211113,7,0.99012572206548,291,61,11,363
24639,bright,main,20211113,8,0.9919656730253598,332,78,9,419
24639,bright,main,20211113,9,0.9932740114313869,341,73,1,415
11358,dark,main,20211113,0,0.9941863117890989,316,14,61,391
11358,dark,main,20211113,1,0.9903375319505648,280,16,41,337
11358,dark,main,20211113,2,0.9934115166995583,313,12,59,384
11358,dark,main,20211113,3,0.9886659493875458,276,14,53,343
11358,dark,main,20211113,4,0.9896392336820174,286,13,53,352
11358,dark,main,20211113,5,0.9957134926300774,284,13,67,364
11358,dark,main,20211113,6,0.994166038009728,294,12,65,371
11358,dark,main,20211113,7,0.9902477791206833,261,16,58,335
11358,dark,main,20211113,8,0.9857970642796258,299,15,73,387
11358,dark,main,20211113,9,0.9881716997595047,294,19,68,381
21507,bright,main,20211113,0,0.9960287004846525,313,118,4,435
21507,bright,main,20211113,1,0.9947532190444924,297,75,6,378
21507,bright,main,20211113,2,0.9937132883003423,309,109,5,423
21507,bright,main,20211113,3,0.9924284055320889,289,81,6,376
21507,bright,main,20211113,4,0.9932355630317367,288,91,2,381
21507,bright,main,20211113,5,0.9899461039310024,301,75,8,384
21507,bright,main,20211113,6,0.9910420449728984,335,79,5,419
21507,bright,main,20211113,7,0.9945082203276452,296,65,4,365
21507,bright,main,20211113,8,0.9908549709790425,292,112,11,415
21507,bright,main,20211113,9,0.9954535744846532,261,149,6,416
11176,dark,main,20211113,0,0.9803754597996281,326,13,48,387
11176,dark,main,20211113,1,0.9863089738029448,267,16,47,330
11176,dark,main,20211113,2,0.9891082453166011,305,18,56,379
11176,dark,main,20211113,3,0.9877249617933799,278,14,54,346
11176,dark,main,20211113,4,0.988106252165209,300,13,57,370
11176,dark,main,20211113,5,0.9892531386803781,263,15,54,332
11176,dark,main,20211113,6,0.9876825587666358,281,19,79,379
11176,dark,main,20211113,7,0.9936065870441714,243,20,60,323
11176,dark,main,20211113,8,0.9860018610368284,286,23,57,366
11176,dark,main,20211113,9,0.9903042674862174,317,13,56,386
2379,dark,main,20211113,0,0.9924699776206625,280,22,101,403
2379,dark,main,20211113,1,0.9953118492865557,225,18,89,332
2379,dark,main,20211113,2,0.9930389628840106,277,21,92,390
2379,dark,main,20211113,3,0.9937096669504972,248,17,84,349
2379,dark,main,20211113,4,0.9933335396764423,256,21,90,367
2379,dark,main,20211113,5,0.9916119792533141,269,26,90,385
2379,dark,main,20211113,6,0.9947780210937529,275,13,102,390
2379,dark,main,20211113,7,0.989571418243093,237,17,69,323
2379,dark,main,20211113,8,0.9961267687883365,264,20,102,386
2379,dark,main,20211113,9,0.989832241979264,255,20,98,373
10353,dark,main,20211113,0,0.9874745152132088,296,14,72,382
10353,dark,main,20211113,1,0.9925268658208664,262,16,59,337
10353,dark,main,20211113,2,0.9844960803148557,289,23,63,375
10353,dark,main,20211113,3,0.9933180348443569,248,12,78,338
10353,dark,main,20211113,4,0.9889689243136204,234,17,97,348
10353,dark,main,20211113,5,0.9909912229756753,240,15,87,342
10353,dark,main,20211113,6,0.9928901471454527,282,18,80,380
10353,dark,main,20211113,7,0.986132864678142,260,12,48,320
10353,dark,main,20211113,8,0.9947388752277758,297,13,63,373
10353,dark,main,20211113,9,0.990861256631529,289,15,59,363
6217,dark,main,20211113,0,0.9953502563864128,298,27,69,394
6217,dark,main,20211113,1,0.9845377560401672,233,25,76,334
6217,dark,main,20211113,2,0.9897634383883034,271,24,78,373
6217,dark,main,20211113,3,0.9907469656798052,238,27,80,345
6217,dark,main,20211113,4,0.9900657964943522,271,20,77,368
6217,dark,main,20211113,5,0.9856731168218704,266,19,80,365
6217,dark,main,20211113,6,0.9938364783949362,283,27,73,383
6217,dark,main,20211113,7,0.9902927748104732,235,29,64,328
6217,dark,main,20211113,8,0.9933843241971643,254,35,69,358
6217,dark,main,20211113,9,0.990033902917562,269,44,66,379
23650,bright,main,20211113,0,0.9921316590939605,353,79,4,436
23650,bright,main,20211113,1,0.9866160032584579,299,79,6,384
23650,bright,main,20211113,2,0.9922592894217622,282,144,6,432
23650,bright,main,20211113,3,0.9950604733725354,277,118,1,396
23650,bright,main,20211113,4,0.9937458913680834,305,96,5,406
23650,bright,main,20211113,5,0.9927538708274436,279,133,1,413
23650,bright,main,20211113,6,0.9897559004582192,244,187,3,434
23650,bright,main,20211113,7,0.9914401467544062,247,115,8,370
23650,bright,main,20211113,8,0.9828678624308933,305,119,1,425
23650,bright,main,20211113,9,0.9905680916278665,334,93,2,429
11175,dark,main,20211113,0,0.9833904359244765,325,15,46,386
11175,dark,main,20211113,1,0.9842379053890564,275,12,48,335
11175,dark,main,20211113,2,0.9974207899064587,343,10,40,393
11175,dark,main,20211113,3,0.9886200329208978,299,13,38,350
11175,dark,main,20211113,4,0.9834422658749268,299,12,57,368
11175,dark,main,20211113,5,0.9918751816766709,273,13,73,359
11175,dark,main,20211113,6,0.9940447785906213,284,14,79,377
11175,dark,main,20211113,7,0.9917338310186933,224,17,88,329
11175,dark,main,20211113,8,0.9900392399518865,300,13,75,388
11175,dark,main,20211113,9,0.9905999800933812,320,12,48,380
10205,dark,main,20211113,0,0.9932684865049984,304,14,57,375
10205,dark,main,20211113,1,0.9907944288900041,260,17,58,335
10205,dark,main,20211113,2,0.9882228920382752,279,18,76,373
10205,dark,main,20211113,3,0.9925919750136923,275,15,70,360
10205,dark,main,20211113,4,0.9936423382031228,257,17,90,364
10205,dark,main,20211113,5,0.9953848622391893,250,23,87,360
10205,dark,main,20211113,6,0.9935866293500106,280,21,75,376
10205,dark,main,20211113,7,0.9932172379914979,243,29,64,336
10205,dark,main,20211113,8,0.9925468201803651,304,14,62,380
10205,dark,main,20211113,9,0.991147526779594,317,20,49,386
9789,dark,main,20211113,0,0.9965546424156205,269,25,87,381
9789,dark,main,20211113,1,0.9905249499287225,242,27,67,336
9789,dark,main,20211113,2,0.9889317366070935,270,26,86,382
9789,dark,main,20211113,3,0.9903695241386443,254,16,89,359
9789,dark,main,20211113,4,0.99466538154446,261,21,79,361
9789,dark,main,20211113,5,0.9955897585845385,268,17,83,368
9789,dark,main,20211113,6,0.9915060494694203,267,23,94,384
9789,dark,main,20211113,7,0.9917356046117142,244,17,74,335
9789,dark,main,20211113,8,0.9956720122470812,299,22,59,380
9789,dark,main,20211113,9,0.9907105840131303,271,17,82,370
22359,bright,main,20211113,0,0.992687436683266,341,94,5,440
22359,bright,main,20211113,1,0.9952249798030511,283,89,5,377
22359,bright,main,20211113,2,0.994017938114729,324,107,5,436
22359,bright,main,20211113,3,0.9899164745878661,282,113,1,396
22359,bright,main,20211113,4,0.9915173464055989,277,120,3,400
22359,bright,main,20211113,5,0.9909764835575468,281,122,4,407
22359,bright,main,20211113,6,0.9937171708629322,338,84,5,427
22359,bright,main,20211113,7,0.9842484115853504,287,80,2,369
22359,bright,main,20211113,8,0.9817718016385494,334,78,5,417
22359,bright,main,20211113,9,0.9940286119936497,314,100,7,421
8752,dark,main,20211113,0,0.98715753980551,293,17,95,405
8752,dark,main,20211113,1,0.9948020761296931,244,9,82,335
8752,dark,main,20211113,2,0.9887560789489346,296,13,69,378
8752,dark,main,20211113,3,0.9931967390723725,281,12,55,348
8752,dark,main,20211113,4,0.9938122026597411,301,8,43,352
8752,dark,main,20211113,5,0.9927612926355385,318,12,46,376
8752,dark,main,20211113,6,0.9922155395002159,321,11,49,381
8752,dark,main,20211113,7,0.9894740284322457,256,14,61,331
8752,dark,main,20211113,8,0.9857285161540158,276,14,94,384
8752,dark,main,20211113,9,0.9891820901490155,290,12,83,385
21884,bright,main,20211114,0,0.9930153844155271,271,164,3,438
21884,bright,main,20211114,1,0.9949844927813603,227,147,3,377
21884,bright,main,20211114,2,0.9952869035078177,222,207,3,432
21884,bright,main,20211114,3,0.9880387939105143,172,225,3,400
21884,bright,main,20211114,4,0.995095839908361,156,242,3,401
21884,bright,main,20211114,5,0.991006158735845,177,237,2,416
21884,bright,main,20211114,6,0.9961016524921582,191,237,3,431
21884,bright,main,20211114,7,0.99496818338785,183,190,0,373
21884,bright,main,20211114,8,0.9923332470007763,215,208,4,427
21884,bright,main,20211114,9,0.9921873942336052,227,195,5,427
21446,bright,main,20211114,0,0.9929819971838902,340,74,7,421
21446,bright,main,20211114,1,0.9910801152671652,253,83,5,341
21446,bright,main,20211114,2,0.990395322672266,320,90,1,411
21446,bright,main,20211114,3,0.9894677270465525,281,78,5,364
21446,bright,main,20211114,4,0.9892614595307856,319,57,3,379
21446,bright,main,20211114,5,0.9845746450744038,320,64,4,388
21446,bright,main,20211114,6,0.9832677942228458,341,54,5,400
21446,bright,main,20211114,7,0.9934207690643342,301,56,2,359
21446,bright,main,20211114,8,0.996948477321578,327,75,2,404
21446,bright,main,20211114,9,0.9947157362492764,327,77,6,410
23448,bright,main,20211114,0,0.9955572115184727,255,171,3,429
23448,bright,main,20211114,1,0.9914797047461384,173,204,4,381
23448,bright,main,20211114,2,0.9943882710734947,224,204,5,433
23448,bright,main,20211114,3,0.9910895629358505,224,172,1,397
23448,bright,main,20211114,4,0.9922969630266627,196,196,5,397
23448,bright,main,20211114,5,0.9939505019003857,157,256,2,415
23448,bright,main,20211114,6,0.9937306422672725,220,205,2,427
23448,bright,main,20211114,7,0.9889228434247359,175,194,0,369
23448,bright,main,20211114,8,0.9902222397503639,252,168,5,425
23448,bright,main,20211114,9,0.9886601217583001,214,211,5,430
22847,bright,main,20211114,0,0.9929198193629712,240,200,2,442
22847,bright,main,20211114,1,0.9920901557896833,208,174,1,383
22847,bright,main,20211114,2,0.9926344470466931,230,203,3,436
22847,bright,main,20211114,3,0.9831000131722092,240,159,2,401
22847,bright,main,20211114,4,0.9957051912845177,246,154,7,407
22847,bright,main,20211114,5,0.9889142098499271,275,134,3,412
22847,bright,main,20211114,6,0.992883364782836,298,130,5,433
22847,bright,main,20211114,7,0.9920888186822159,261,111,3,375
22847,bright,main,20211114,8,0.9917446290515347,260,166,4,430
22847,bright,main,20211114,9,0.9955052909562716,283,142,5,430
23817,bright,main,20211114,0,0.9967051031846772,336,77,3,416
23817,bright,main,20211114,1,0.9961040245190828,304,57,2,363
23817,bright,main,20211114,2,0.9898066528610873,312,94,5,411
23817,bright,main,20211114,3,0.9934964003177414,306,75,5,386
23817,bright,main,20211114,4,0.9938354639022942,318,64,4,386
23817,bright,main,20211114,5,0.9935280974548873,310,80,5,395
23817,bright,main,20211114,6,0.9897482504166629,348,61,1,410
23817,bright,main,20211114,7,0.9913942915673039,290,58,6,354
23817,bright,main,20211114,8,0.9925171279920381,362,50,6,418
23817,bright,main,20211114,9,0.9935018376017107,342,66,7,415
7064,dark,main,20211114,0,0.9951733625081894,266,19,107,392
7064,dark,main,20211114,1,0.9945303576438324,223,15,97,335
7064,dark,main,20211114,2,0.9924180557557386,264,18,99,381
7064,dark,main,20211114,3,0.9859643625941841,265,12,83,360
7064,dark,main,20211114,4,0.9882555114798521,254,16,83,353
7064,dark,main,20211114,5,0.9938772875119686,302,14,45,361
7064,dark,main,20211114,6,0.9864958617150678,298,18,69,385
7064,dark,main,20211114,7,0.9878800107610608,243,21,59,323
7064,dark,main,20211114,8,0.9949446194769899,240,25,101,366
7064,dark,main,20211114,9,0.986883143917831,251,21,100,372
23816,bright,main,20211114,0,0.9896948422477659,305,95,6,406
23816,bright,main,20211114,1,0.98954798847899,266,80,5,351
23816,bright,main,20211114,2,0.992895950830913,332,81,2,415
23816,bright,main,20211114,3,0.9887296325316463,321,56,3,380
23816,bright,main,20211114,4,0.9925627261466607,319,63,4,386
23816,bright,main,20211114,5,0.9973405068255061,327,68,7,402
23816,bright,main,20211114,6,0.9838000350955872,343,55,11,409
23816,bright,main,20211114,7,0.9886114019801266,283,70,4,357
23816,bright,main,20211114,8,0.990314597863132,316,86,4,406
23816,bright,main,20211114,9,0.9933453731593951,313,87,1,401
7212,dark,main,20211114,0,0.9920940025304423,275,17,107,399
7212,dark,main,20211114,1,0.9916254495655209,239,16,83,338
7212,dark,main,20211114,2,0.9880942886988434,279,21,80,380
7212,dark,main,20211114,3,0.9927508491692898,259,14,85,358
7212,dark,main,20211114,4,0.9918420174508911,253,15,75,343
7212,dark,main,20211114,5,0.9902375325781967,258,18,88,364
7212,dark,main,20211114,6,0.9932030732938029,252,16,103,371
7212,dark,main,20211114,7,0.9810566538976055,229,18,84,331
7212,dark,main,20211114,8,0.9918719807909964,256,15,92,363
7212,dark,main,20211114,9,0.9930174758590028,261,15,103,379
21887,bright,main,20211114,0,0.9953015382365235,335,103,2,440
21887,bright,main,20211114,1,0.990263978530221,246,124,7,377
21887,bright,main,20211114,2,0.9932246438345504,252,184,5,441
21887,bright,main,20211114,3,0.996370489171577,209,185,5,399
21887,bright,main,20211114,4,0.9873690493499604,207,186,5,398
21887,bright,main,20211114,5,0.9944975850850387,229,179,5,413
21887,bright,main,20211114,6,0.992673508711579,187,239,3,429
21887,bright,main,20211114,7,0.9917944676450087,207,167,1,375
21887,bright,main,20211114,8,0.9967460999550051,276,150,3,429
21887,bright,main,20211114,9,0.9874061752615111,285,136,7,428
23978,bright,main,20211114,0,0.9641990126233161,49,48,0,97
23978,bright,main,20211114,1,0.9886472960833473,120,105,2,227
23978,bright,main,20211114,2,0.9897759152717727,135,143,2,280
23978,bright,main,20211114,3,0.980261352301157,134,106,0,240
23978,bright,main,20211114,4,0.9858651076433317,145,117,3,265
23978,bright,main,20211114,5,0.9962274724643717,137,146,1,284
23978,bright,main,20211114,6,0.9831340005436289,129,167,2,298
23978,bright,main,20211114,7,0.9742106769541085,155,92,1,248
23978,bright,main,20211114,8,0.9904226705658224,107,171,2,280
23978,bright,main,20211114,9,0.9874022234942988,93,204,2,299
21478,bright,main,20211114,0,0.9904270966954521,336,69,5,410
21478,bright,main,20211114,1,0.9932556843720464,291,60,4,355
21478,bright,main,20211114,2,0.995258807524148,315,79,7,401
21478,bright,main,20211114,3,0.9918990325878805,318,57,3,378
21478,bright,main,20211114,4,0.9932657752334,318,57,4,379
21478,bright,main,20211114,5,0.9899812320458543,335,58,1,394
21478,bright,main,20211114,6,0.9954851673018605,367,45,7,419
21478,bright,main,20211114,7,0.9910561153988717,266,69,3,338
21478,bright,main,20211114,8,0.9899915017300068,342,60,2,404
21478,bright,main,20211114,9,0.9950315260200572,323,72,4,399
21438,bright,main,20211114,0,0.9933070794926484,359,72,3,434
21438,bright,main,20211114,1,0.9862837628156008,305,52,8,365
21438,bright,main,20211114,2,0.9942170938013527,361,60,8,429
21438,bright,main,20211114,3,0.9931964925518263,325,59,2,386
21438,bright,main,20211114,4,0.9891506567771671,293,86,5,384
21438,bright,main,20211114,5,0.9859369212667236,282,100,2,384
21438,bright,main,20211114,6,0.9945408162804429,325,81,6,412
21438,bright,main,20211114,7,0.9934176620247531,280,82,3,365
21438,bright,main,20211114,8,0.9874918134579309,322,77,10,409
21438,bright,main,20211114,9,0.9864581133835902,322,81,7,410
5664,dark,main,20211114,0,0.9904385721787508,340,10,43,393
5664,dark,main,20211114,1,0.9886904995190577,272,10,53,335
5664,dark,main,20211114,2,0.9922984532150363,329,15,51,395
5664,dark,main,20211114,3,0.9917168082446759,283,11,58,352
5664,dark,main,20211114,4,0.9846169105201908,259,11,80,350
5664,dark,main,20211114,5,0.9839321110412196,313,14,50,377
5664,dark,main,20211114,6,0.9890656243787239,312,12,51,375
5664,dark,main,20211114,7,0.995508434568865,259,13,56,328
5664,dark,main,20211114,8,0.9933739263853112,292,17,63,372
5664,dark,main,20211114,9,0.9855911278864945,297,12,58,367
10171,dark,main,20211114,0,0.99286062116055,284,21,96,401
10171,dark,main,20211114,1,0.9937267663190399,252,22,67,341
10171,dark,main,20211114,2,0.9869317037059934,274,27,93,394
10171,dark,main,20211114,3,0.9867902631030298,249,17,78,344
10171,dark,main,20211114,4,0.9908603114502263,241,22,98,361
10171,dark,main,20211114,5,0.9920732807089087,263,22,84,369
10171,dark,main,20211114,6,0.984688887691653,287,19,83,389
10171,dark,main,20211114,7,0.9915638354419792,222,19,83,324
10171,dark,main,20211114,8,0.9881132563249767,268,14,92,374
10171,dark,main,20211114,9,0.9917516949541114,267,18,90,375
5665,dark,main,20211114,0,0.994963226670357,285,18,100,403
5665,dark,main,20211114,1,0.9905022724312891,248,13,77,338
5665,dark,main,20211114,2,0.9932562614872434,293,18,80,391
5665,dark,main,20211114,3,0.9938395771375447,255,16,95,366
5665,dark,main,20211114,4,0.9910957304433446,231,18,100,349
5665,dark,main,20211114,5,0.991426467139158,263,18,85,366
5665,dark,main,20211114,6,0.9907308412188539,287,17,80,384
5665,dark,main,20211114,7,0.9916680488377444,231,13,93,337
5665,dark,main,20211114,8,0.9941856475250552,272,18,99,389
5665,dark,main,20211114,9,0.9931826414349556,286,16,76,378
21477,bright,main,20211114,0,0.991322331024574,341,87,6,434
21477,bright,main,20211114,1,0.9880246032960891,310,60,2,372
21477,bright,main,20211114,2,0.9903500427820929,359,61,7,427
21477,bright,main,20211114,3,0.9888178677815171,344,43,5,392
21477,bright,main,20211114,4,0.9936282818127612,337,44,4,385
21477,bright,main,20211114,5,0.9899542391647543,352,51,2,405
21477,bright,main,20211114,6,0.9919197011203073,347,69,7,423
21477,bright,main,20211114,7,0.9927028310421558,258,94,11,363
21477,bright,main,20211114,8,0.9936854067454579,337,78,5,420
21477,bright,main,20211114,9,0.9901203196981151,309,103,2,414
21444,bright,main,20211114,0,0.995096876913781,345,69,4,418
21444,bright,main,20211114,1,0.9946551122605124,302,55,1,358
21444,bright,main,20211114,2,0.9920458423615006,364,52,6,422
21444,bright,main,20211114,3,0.9923617248940749,309,62,6,377
21444,bright,main,20211114,4,0.9901876781663991,295,83,6,384
21444,bright,main,20211114,5,0.9964469750705802,273,116,5,394
21444,bright,main,20211114,6,0.9823084149882164,314,86,7,407
21444,bright,main,20211114,7,0.9900479709949972,274,69,9,352
21444,bright,main,20211114,8,0.9932034978099501,314,78,5,397
21444,bright,main,20211114,9,0.9912010308226177,290,95,8,393
21486,bright,main,20211114,0,0.9957353914205395,367,65,3,435
21486,bright,main,20211114,1,0.9914640460059833,300,67,3,370
21486,bright,main,20211114,2,0.9941175235928207,322,98,2,422
21486,bright,main,20211114,3,0.9942773756585385,294,89,6,389
21486,bright,main,20211114,4,0.989227178247286,301,86,5,392
21486,bright,main,20211114,5,0.9932765611965145,328,70,4,402
21486,bright,main,20211114,6,0.9953940505625194,338,79,8,425
21486,bright,main,20211114,7,0.9854028810267511,231,131,5,367
21486,bright,main,20211114,8,0.9923501449765015,310,101,9,420
21486,bright,main,20211114,9,0.9954123601666908,323,86,9,418
25382,bright,main,20211114,0,0.9944157934601328,339,90,1,430
25382,bright,main,20211114,1,0.9849909185420316,288,67,7,362
25382,bright,main,20211114,2,0.9917134509874094,325,83,5,413
25382,bright,main,20211114,3,0.9831259403536249,310,76,3,389
25382,bright,main,20211114,4,0.9925697023355639,323,62,4,389
25382,bright,main,20211114,5,0.989755718966742,337,65,3,405
25382,bright,main,20211114,6,0.9920780177608991,292,109,5,406
25382,bright,main,20211114,7,0.9869252779303923,190,55,2,247
25382,bright,main,20211114,8,0.9934370076180462,326,77,9,412
25382,bright,main,20211114,9,0.9899247228847993,336,75,6,417
22406,bright,main,20211114,0,0.9938582144719548,228,203,6,437
22406,bright,main,20211114,1,0.9862328726655165,277,97,3,377
22406,bright,main,20211114,2,0.9900507529225622,347,79,4,430
22406,bright,main,20211114,3,0.9941020149226443,331,59,4,394
22406,bright,main,20211114,4,0.9967759354601616,299,90,5,394
22406,bright,main,20211114,5,0.9947337846007219,291,123,2,416
22406,bright,main,20211114,6,0.9942772798543521,331,91,4,426
22406,bright,main,20211114,7,0.9921882115456295,301,71,4,376
22406,bright,main,20211114,8,0.9935212934216754,318,98,7,423
22406,bright,main,20211114,9,0.9940923658207614,229,192,3,424
7203,dark,main,20211114,0,0.9916737676287319,269,16,99,384
7203,dark,main,20211114,1,0.9890847903446934,236,13,92,341
7203,dark,main,20211114,2,0.9914601368202286,294,15,82,391
7203,dark,main,20211114,3,0.9877204377700554,250,19,81,350
7203,dark,main,20211114,4,0.9905102668343859,245,17,94,356
7203,dark,main,20211114,5,0.9947374063747543,251,18,92,361
7203,dark,main,20211114,6,0.9834800884105237,279,12,110,401
7203,dark,main,20211114,7,0.9948260270953886,225,18,96,339
7203,dark,main,20211114,8,0.9854778392547224,283,14,82,379
7203,dark,main,20211114,9,0.9961201142914518,292,16,78,386
25390,bright,main,20211114,0,0.9914697234290241,350,74,9,433
25390,bright,main,20211114,1,0.993631742152955,276,67,12,355
25390,bright,main,20211114,2,0.9941482756893139,323,81,1,405
25390,bright,main,20211114,3,0.9913404823189078,278,87,10,375
25390,bright,main,20211114,4,0.986493974113276,268,87,6,361
25390,bright,main,20211114,5,0.9898182517017098,290,89,11,390
25390,bright,main,20211114,6,0.9892396705314938,311,85,7,403
25390,bright,main,20211114,7,0.990368621703253,301,52,7,360
25390,bright,main,20211114,8,0.9932551345605936,333,65,6,404
25390,bright,main,20211114,9,0.9921732277795112,360,49,9,418
10175,dark,main,20211114,0,0.9889166024662541,325,20,55,400
10175,dark,main,20211114,1,0.9879042062209983,269,17,46,332
10175,dark,main,20211114,2,0.9903841384903389,320,13,42,375
10175,dark,main,20211114,3,0.992746822490138,276,18,59,353
10175,dark,main,20211114,4,0.9962811195680638,293,15,47,355
10175,dark,main,20211114,5,0.9933929301877852,312,12,43,367
10175,dark,main,20211114,6,0.991373757771812,315,19,63,397
10175,dark,main,20211114,7,0.9887887526837547,255,17,53,325
10175,dark,main,20211114,8,0.9897488424469189,293,20,72,385
10175,dark,main,20211114,9,0.9888876591372628,300,13,59,372
21489,bright,main,20211114,0,0.9926285685321755,297,129,3,429
21489,bright,main,20211114,1,0.9887002681083923,219,147,3,369
21489,bright,main,20211114,2,0.9913359566053602,213,194,8,415
21489,bright,main,20211114,3,0.9919763056089267,296,76,5,377
21489,bright,main,20211114,4,0.9885185495083888,253,121,4,378
21489,bright,main,20211114,5,0.9934155722446963,270,123,4,397
21489,bright,main,20211114,6,0.9956000347134365,339,75,4,418
21489,bright,main,20211114,7,0.9931318099060829,284,71,4,359
21489,bright,main,20211114,8,0.9947179259432042,317,87,6,410
21489,bright,main,20211114,9,0.9919682507307553,328,85,5,418
26166,bright,main,20211114,0,0.9928177346963958,321,91,2,414
26166,bright,main,20211114,1,0.9939118527124264,263,86,4,353
26166,bright,main,20211114,2,0.9961597028308887,341,62,5,408
26166,bright,main,20211114,3,0.9952830742517831,276,75,7,358
26166,bright,main,20211114,4,0.9927021697796695,281,90,8,379
26166,bright,main,20211114,5,0.9893716607712357,301,82,5,388
26166,bright,main,20211114,6,0.9931805981978878,327,72,8,407
26166,bright,main,20211114,7,0.9829292751642968,300,41,9,350
26166,bright,main,20211114,8,0.993045341687747,323,83,7,413
26166,bright,main,20211114,9,0.9945280331434295,304,88,5,397
22416,bright,main,20211114,0,0.9947352729158178,307,125,7,439
22416,bright,main,20211114,1,0.9950136455861537,261,116,5,382
22416,bright,main,20211114,2,0.9962837156983823,269,159,2,430
22416,bright,main,20211114,3,0.9873714588003885,249,144,4,397
22416,bright,main,20211114,4,0.9900843088653561,274,117,1,392
22416,bright,main,20211114,5,0.9917503543997357,269,136,5,410
22416,bright,main,20211114,6,0.9876064158277785,322,103,3,428
22416,bright,main,20211114,7,0.9838926157305337,300,70,2,372
22416,bright,main,20211114,8,0.99372946532464,336,86,4,426
22416,bright,main,20211114,9,0.9912159504350906,300,122,4,426
11761,dark,main,20211114,0,0.9931776788520776,261,35,95,391
11761,dark,main,20211114,1,0.9937433872195659,221,24,90,335
11761,dark,main,20211114,2,0.9928993036338483,281,23,91,395
11761,dark,main,20211114,3,0.9920175537566576,254,18,73,345
11761,dark,main,20211114,4,0.9905313971736122,238,17,87,342
11761,dark,main,20211114,5,0.9880650914300947,247,26,83,356
11761,dark,main,20211114,6,0.991374094136248,256,19,97,372
11761,dark,main,20211114,7,0.9917236652969422,233,16,85,334
11761,dark,main,20211114,8,0.9893663657853959,267,23,82,372
11761,dark,main,20211114,9,0.9889896179398074,269,16,90,375
23449,bright,main,20211114,0,0.9934495230213258,230,211,2,443
23449,bright,main,20211114,1,0.9901634426417341,177,202,2,381
23449,bright,main,20211114,2,0.9965371883400582,241,184,2,427
23449,bright,main,20211114,3,0.9906808607031575,159,239,2,400
23449,bright,main,20211114,4,0.9842311291742277,164,231,3,398
23449,bright,main,20211114,5,0.9896586905967261,145,267,3,415
23449,bright,main,20211114,6,0.9929920997924068,179,251,2,432
23449,bright,main,20211114,7,0.9886906589392706,165,208,1,374
23449,bright,main,20211114,8,0.9883264793190136,235,187,5,427
23449,bright,main,20211114,9,0.9912237054433483,243,183,2,428
21439,bright,main,20211114,0,0.9928655356679628,370,52,4,426
21439,bright,main,20211114,1,0.9936400326150764,325,41,2,368
21439,bright,main,20211114,2,0.9942054341491705,358,58,5,421
21439,bright,main,20211114,3,0.9958019378137137,307,62,7,376
21439,bright,main,20211114,4,0.9905955715357417,318,57,10,385
21439,bright,main,20211114,5,0.9958634228920937,327,63,5,395
21439,bright,main,20211114,6,0.9918731044491019,364,49,1,414
21439,bright,main,20211114,7,0.9853860613971567,311,49,1,361
21439,bright,main,20211114,8,0.9953077392796055,350,55,5,410
21439,bright,main,20211114,9,0.9920109164590194,326,75,8,409
24280,bright,main,20211115,0,0.9914781293185377,274,159,3,436
24280,bright,main,20211115,1,0.992761938357246,275,103,2,380
24280,bright,main,20211115,2,0.9920346441559256,354,86,1,441
24280,bright,main,20211115,3,0.9888295686704577,315,59,3,377
24280,bright,main,20211115,4,0.9853017020450262,330,70,4,404
24280,bright,main,20211115,5,0.9887697598167557,330,83,2,415
24280,bright,main,20211115,6,0.9931443283684879,333,93,3,429
24280,bright,main,20211115,7,0.9882594795737053,247,122,2,371
24280,bright,main,20211115,8,0.9928467520116091,320,100,4,424
24280,bright,main,20211115,9,0.9931153618610308,326,94,7,427
21877,bright,main,20211115,0,0.9955822648381796,314,123,1,438
21877,bright,main,20211115,1,0.9916242322141064,216,148,8,372
21877,bright,main,20211115,2,0.9921687242799083,261,159,2,422
21877,bright,main,20211115,3,0.9972779545227419,200,172,1,373
21877,bright,main,20211115,4,0.9942308433461537,224,170,2,396
21877,bright,main,20211115,5,0.9944923509981326,264,136,2,402
21877,bright,main,20211115,6,0.9864944574852451,259,161,0,420
21877,bright,main,20211115,7,0.9929259701605887,256,111,4,371
21877,bright,main,20211115,8,0.9933271620296533,285,139,0,424
21877,bright,main,20211115,9,0.9904663403207633,289,131,6,426
21267,bright,main,20211115,0,0.9926929683177036,359,72,6,437
21267,bright,main,20211115,1,0.9871608855665179,301,69,3,373
21267,bright,main,20211115,2,0.9927074794763028,319,103,6,428
21267,bright,main,20211115,3,0.985537103164841,269,101,3,373
21267,bright,main,20211115,4,0.9920104961441976,251,148,6,405
21267,bright,main,20211115,5,0.9902514942164274,259,151,4,414
21267,bright,main,20211115,6,0.9948710497086132,232,193,5,430
21267,bright,main,20211115,7,0.9939444238768002,258,114,4,376
21267,bright,main,20211115,8,0.9921924987717776,292,121,6,419
21267,bright,main,20211115,9,0.9944601160449154,336,86,4,426
20993,bright,main,20211115,0,0.9861424343746296,341,88,8,437
20993,bright,main,20211115,1,0.9918395491161033,278,93,6,377
20993,bright,main,20211115,2,0.9953254099387098,354,78,1,433
20993,bright,main,20211115,3,0.9904756216241055,282,89,1,372
20993,bright,main,20211115,4,0.9945693376424823,337,61,2,400
20993,bright,main,20211115,5,0.9914145546403625,295,115,4,414
20993,bright,main,20211115,6,0.9917491269559425,306,122,2,430
20993,bright,main,20211115,7,0.9942383179875188,266,103,5,374
20993,bright,main,20211115,8,0.9926763218537091,324,101,3,428
20993,bright,main,20211115,9,0.9902101071141952,331,94,4,429
24566,bright,main,20211115,0,0.9899509976271119,339,87,0,426
24566,bright,main,20211115,1,0.9956843679414326,299,55,5,359
24566,bright,main,20211115,2,0.9953459151646499,331,84,2,417
24566,bright,main,20211115,3,0.98523634665426,281,79,3,363
24566,bright,main,20211115,4,0.9826542740004512,322,68,1,391
24566,bright,main,20211115,5,0.9883540366435486,349,56,2,407
24566,bright,main,20211115,6,0.9930999463472285,341,77,5,423
24566,bright,main,20211115,7,0.9836539166244742,268,77,7,352
24566,bright,main,20211115,8,0.9904685711645789,331,72,10,413
24566,bright,main,20211115,9,0.9906103222562519,305,101,6,412
21886,bright,main,20211115,0,0.9929328829970767,252,187,2,441
21886,bright,main,20211115,1,0.9973959476216825,164,216,3,383
21886,bright,main,20211115,2,0.9958049814539413,170,257,7,434
21886,bright,main,20211115,3,0.9952688035730479,153,244,3,400
21886,bright,main,20211115,4,0.9887859852375785,171,235,1,407
21886,bright,main,20211115,5,0.9935315096849122,154,259,3,416
21886,bright,main,20211115,6,0.9922975817466213,177,250,7,434
21886,bright,main,20211115,7,0.9887643502802982,170,202,5,377
21886,bright,main,20211115,8,0.9946430381623206,259,168,3,430
21886,bright,main,20211115,9,0.9960951844006806,253,172,3,428
21414,bright,main,20211115,0,0.9920550559918161,269,177,2,448
21414,bright,main,20211115,1,0.9871507111262724,235,144,1,380
21414,bright,main,20211115,2,0.9909928583944257,289,148,4,441
21414,bright,main,20211115,3,0.9920636643091627,302,68,4,374
21414,bright,main,20211115,4,0.9927117666751231,335,66,3,404
21414,bright,main,20211115,5,0.994373360749462,352,62,4,418
21414,bright,main,20211115,6,0.9955459445530433,341,86,2,429
21414,bright,main,20211115,7,0.987049705046956,252,112,7,371
21414,bright,main,20211115,8,0.995467099246664,276,145,6,427
21414,bright,main,20211115,9,0.9924832215725988,201,220,7,428
26128,bright,main,20211115,0,0.991970310159666,292,134,2,428
26128,bright,main,20211115,1,0.9926795778441108,274,82,2,358
26128,bright,main,20211115,2,0.9928245918610127,314,93,1,408
26128,bright,main,20211115,3,0.9924872479270789,281,69,6,356
26128,bright,main,20211115,4,0.9938062560722513,317,56,6,379
26128,bright,main,20211115,5,0.9893526702401464,318,71,2,391
26128,bright,main,20211115,6,0.9928440954617007,333,75,5,413
26128,bright,main,20211115,7,0.9926892744475009,283,72,1,356
26128,bright,main,20211115,8,0.9972221246990018,308,96,6,410
26128,bright,main,20211115,9,0.9871267744330097,268,134,5,407
82404,backup,special,20211115,0,0.9894649961698749,3,408,0,411
82404,backup,special,20211115,1,0.9956948653424833,0,336,0,336
82404,backup,special,20211115,2,0.9949021489580006,3,402,0,405
82404,backup,special,20211115,3,0.9900316239983796,1,341,0,342
82404,backup,special,20211115,4,0.9928924359451926,16,355,0,371
82404,backup,special,20211115,5,0.9947765923233223,27,356,0,383
82404,backup,special,20211115,6,0.9933639704331053,15,383,0,398
82404,backup,special,20211115,7,0.9864839552159421,3,335,0,338
82404,backup,special,20211115,8,0.9921857282121093,4,387,0,391
82404,backup,special,20211115,9,0.9922583296356418,9,388,0,397
21451,bright,main,20211115,0,0.9925395294585495,358,70,3,431
21451,bright,main,20211115,1,0.9902981468362594,303,55,2,360
21451,bright,main,20211115,2,0.9924391938814141,373,51,2,426
21451,bright,main,20211115,3,0.9883683346195773,289,67,4,360
21451,bright,main,20211115,4,0.9884296655294752,282,98,7,387
21451,bright,main,20211115,5,0.9904656374354103,260,137,1,398
21451,bright,main,20211115,6,0.9922923190682845,340,76,6,422
21451,bright,main,20211115,7,0.9942237508822317,290,68,3,361
21451,bright,main,20211115,8,0.989434557090859,339,69,2,410
21451,bright,main,20211115,9,0.9937377834534428,324,88,4,416
21448,bright,main,20211115,0,0.9863580484733304,331,91,5,427
21448,bright,main,20211115,1,0.9915062538201788,264,92,6,362
21448,bright,main,20211115,2,0.9889574703295835,313,86,5,404
21448,bright,main,20211115,3,0.9906865014244591,280,55,3,338
21448,bright,main,20211115,4,0.9950085230679541,329,57,9,395
21448,bright,main,20211115,5,0.9934181210442911,301,100,5,406
21448,bright,main,20211115,6,0.9899184128666667,307,99,12,418
21448,bright,main,20211115,7,0.9914716392378689,247,102,7,356
21448,bright,main,20211115,8,0.988543007231995,238,152,7,397
21448,bright,main,20211115,9,0.9933702875295162,273,144,2,419
24278,bright,main,20211115,0,0.9925668960380801,292,144,6,442
24278,bright,main,20211115,1,0.9894626023542382,267,111,1,379
24278,bright,main,20211115,2,0.9871530978610742,366,69,3,438
24278,bright,main,20211115,3,0.9932729266158213,306,67,4,377
24278,bright,main,20211115,4,0.9922178074045485,290,105,5,400
24278,bright,main,20211115,5,0.9842080002477832,309,102,5,416
24278,bright,main,20211115,6,0.9857683790809202,301,124,6,431
24278,bright,main,20211115,7,0.987965685947713,280,86,8,374
24278,bright,main,20211115,8,0.9891423743893167,346,77,2,425
24278,bright,main,20211115,9,0.9942636826295368,345,81,6,432
8773,dark,main,20211116,0,0.9904092578034057,299,14,94,407
8773,dark,main,20211116,1,0.9916393666834313,234,16,83,333
8773,dark,main,20211116,2,0.9890660612539031,293,16,80,389
8773,dark,main,20211116,3,0.9934447657805832,244,14,89,347
8773,dark,main,20211116,4,0.9948689703965943,272,16,73,361
8773,dark,main,20211116,5,0.9876811221688422,270,15,92,377
8773,dark,main,20211116,6,0.9876811221688422,270,15,92,377
8773,dark,main,20211116,7,0.9941583840870164,241,18,86,345
8773,dark,main,20211116,8,0.9940864024125503,278,17,80,375
8773,dark,main,20211116,9,0.9946159761474612,254,19,94,367
21514,bright,main,20211116,0,0.9925900423229411,369,66,4,439
21514,bright,main,20211116,1,0.9938116464129301,266,92,1,359
21514,bright,main,20211116,2,0.9919659201207278,331,100,5,436
21514,bright,main,20211116,3,0.9893710085978442,297,83,4,384
21514,bright,main,20211116,4,0.9896220628368956,333,64,3,400
21514,bright,main,20211116,5,0.9948667848974381,356,47,5,408
21514,bright,main,20211116,6,0.9948667848974381,356,47,5,408
21514,bright,main,20211116,7,0.9904889169025446,309,47,7,363
21514,bright,main,20211116,8,0.9906150321709106,300,106,8,414
21514,bright,main,20211116,9,0.9896568555868847,341,75,6,422
24687,bright,main,20211116,0,0.990709057059138,363,77,3,443
24687,bright,main,20211116,1,0.9900558947533898,284,78,5,367
24687,bright,main,20211116,2,0.9926625783934466,356,71,4,431
24687,bright,main,20211116,3,0.9883911323521336,292,93,5,390
24687,bright,main,20211116,4,0.9959344897043504,302,98,4,404
24687,bright,main,20211116,5,0.9954779471882701,330,81,6,417
24687,bright,main,20211116,6,0.9954779471882701,330,81,6,417
24687,bright,main,20211116,7,0.9879149002183641,324,48,2,374
24687,bright,main,20211116,8,0.9922394629158615,370,54,2,426
24687,bright,main,20211116,9,0.9955297354145295,320,102,5,427
22550,bright,main,20211116,0,0.9954686512739545,279,153,2,434
22550,bright,main,20211116,1,0.9939914822184681,271,93,4,368
22550,bright,main,20211116,2,0.9936076316661735,339,92,1,432
22550,bright,main,20211116,3,0.9912441468586453,308,83,6,397
22550,bright,main,20211116,4,0.9921595414895953,273,128,2,403
22550,bright,main,20211116,5,0.9882591205581535,243,170,2,415
22550,bright,main,20211116,6,0.9882591205581535,243,170,2,415
22550,bright,main,20211116,7,0.9918571982725647,279,82,6,367
22550,bright,main,20211116,8,0.9815653329021614,347,66,5,418
22550,bright,main,20211116,9,0.9835432793126239,341,87,2,430
20989,bright,main,20211116,0,0.9953631092045524,342,90,6,438
20989,bright,main,20211116,1,0.9924297827199724,272,93,0,365
20989,bright,main,20211116,2,0.9945470861441813,344,78,5,427
20989,bright,main,20211116,3,0.9937173343022551,215,179,1,395
20989,bright,main,20211116,4,0.9906509931562194,239,165,5,409
20989,bright,main,20211116,5,0.9962247923548915,306,104,2,412
20989,bright,main,20211116,6,0.9962247923548915,306,104,2,412
20989,bright,main,20211116,7,0.9919377262747583,302,69,0,371
20989,bright,main,20211116,8,0.9899883102224565,342,74,4,420
20989,bright,main,20211116,9,0.9929064315161965,315,110,4,429
22923,bright,main,20211116,0,0.9931764872366343,342,95,5,442
22923,bright,main,20211116,1,0.991884480645241,253,115,1,369
22923,bright,main,20211116,2,0.9921910650846772,284,151,3,438
22923,bright,main,20211116,3,0.9941141136327698,250,137,3,390
22923,bright,main,20211116,4,0.9922618714173214,239,164,5,408
22923,bright,main,20211116,5,0.9895437802711003,270,133,8,411
22923,bright,main,20211116,6,0.9895437802711003,270,133,8,411
22923,bright,main,20211116,7,0.9867708996092719,249,113,5,367
22923,bright,main,20211116,8,0.9942473867533844,282,135,2,419
22923,bright,main,20211116,9,0.9829499949602688,321,100,5,426
21512,bright,main,20211116,0,0.9923300610466204,347,91,3,441
21512,bright,main,20211116,1,0.9895191905665214,291,69,2,362
21512,bright,main,20211116,2,0.9935658706243774,357,73,6,436
21512,bright,main,20211116,3,0.9937103349867419,315,64,5,384
21512,bright,main,20211116,4,0.9909148934267685,311,85,4,400
21512,bright,main,20211116,5,0.9854224978649596,337,68,2,407
21512,bright,main,20211116,6,0.9854224978649596,337,68,2,407
21512,bright,main,20211116,7,0.9946497387190368,282,71,7,360
21512,bright,main,20211116,8,0.9893537386277846,332,79,7,418
21512,bright,main,20211116,9,0.9914479817864865,371,48,5,424
22547,bright,main,20211116,0,0.9857966317310305,301,138,8,447
22547,bright,main,20211116,1,0.9906105863842519,259,108,3,370
22547,bright,main,20211116,2,0.9929441532600938,295,139,0,434
22547,bright,main,20211116,3,0.989490740076657,239,157,1,397
22547,bright,main,20211116,4,0.993392417171391,243,162,0,405
22547,bright,main,20211116,5,0.989466937727184,303,108,6,417
22547,bright,main,20211116,6,0.989466937727184,303,108,6,417
22547,bright,main,20211116,7,0.9952458754556252,270,98,4,372
22547,bright,main,20211116,8,0.992004938923585,266,149,7,422
22547,bright,main,20211116,9,0.9903026126085096,278,143,6,427
22942,bright,main,20211116,0,0.9962489625971613,341,90,7,438
22942,bright,main,20211116,1,0.9927078391372206,307,56,5,368
22942,bright,main,20211116,2,0.9925389825567071,340,85,5,430
22942,bright,main,20211116,3,0.9934752442960336,318,71,3,392
22942,bright,main,20211116,4,0.9905575832768848,343,57,3,403
22942,bright,main,20211116,5,0.9830161879689395,346,65,3,414
22942,bright,main,20211116,6,0.9830161879689395,346,65,3,414
22942,bright,main,20211116,7,0.9948806800435901,278,87,3,368
22942,bright,main,20211116,8,0.9890942799232496,330,86,3,419
22942,bright,main,20211116,9,0.9832324222915789,329,93,2,424
24499,bright,main,20211116,0,0.9935414354322587,350,92,1,443
24499,bright,main,20211116,1,0.9910769615156285,265,100,3,368
24499,bright,main,20211116,2,0.9920850405688746,326,100,5,431
24499,bright,main,20211116,3,0.9889936117905839,216,172,5,393
24499,bright,main,20211116,4,0.9909287054263567,273,121,2,396
24499,bright,main,20211116,5,0.9936236777956892,331,78,5,414
24499,bright,main,20211116,6,0.9936236777956892,331,78,5,414
24499,bright,main,20211116,7,0.9959953309678412,261,103,3,367
24499,bright,main,20211116,8,0.990444199001341,307,104,5,416
24499,bright,main,20211116,9,0.9918154847664106,322,97,3,422
21225,bright,main,20211116,0,0.9900867311593934,372,62,6,440
21225,bright,main,20211116,1,0.9910462957883399,313,54,2,369
21225,bright,main,20211116,2,0.9930662565331537,368,63,3,434
21225,bright,main,20211116,3,0.9938254383069117,339,44,4,387
21225,bright,main,20211116,4,0.9872263315274227,327,66,4,397
21225,bright,main,20211116,5,0.9897410589965955,298,92,10,400
21225,bright,main,20211116,6,0.9897410589965955,298,92,10,400
21225,bright,main,20211116,7,0.9886192339358025,255,101,3,359
21225,bright,main,20211116,8,0.994788704226647,326,72,9,407
21225,bright,main,20211116,9,0.9936087838799109,338,71,5,414
22713,bright,main,20211116,0,0.9952132259654723,238,196,3,437
22713,bright,main,20211116,1,0.9947833344654133,241,123,4,368
22713,bright,main,20211116,2,0.992600830803427,277,151,3,431
22713,bright,main,20211116,3,0.9879148766534243,267,122,6,395
22713,bright,main,20211116,4,0.990791719627769,276,131,4,411
22713,bright,main,20211116,5,0.9928278292563231,325,86,4,415
22713,bright,main,20211116,6,0.9928278292563231,325,86,4,415
22713,bright,main,20211116,7,0.9913827121375944,292,81,3,376
22713,bright,main,20211116,8,0.9871158594055558,308,110,4,422
22713,bright,main,20211116,9,0.9952297793251079,278,149,3,430
21355,bright,main,20211116,0,0.9939817476686573,389,51,2,442
21355,bright,main,20211116,1,0.9946497579100343,297,72,1,370
21355,bright,main,20211116,2,0.9923041414681916,335,89,10,434
21355,bright,main,20211116,3,0.9902758922389554,302,80,2,384
21355,bright,main,20211116,4,0.9912356710908622,308,88,5,401
21355,bright,main,20211116,5,0.9968878368029246,314,90,6,410
21355,bright,main,20211116,6,0.9968878368029246,314,90,6,410
21355,bright,main,20211116,7,0.9953398210142785,208,156,5,369
21355,bright,main,20211116,8,0.9957044891801509,233,178,7,418
21355,bright,main,20211116,9,0.9967698770547401,275,148,6,429
22714,bright,main,20211116,0,0.9903504089983748,289,152,1,442
22714,bright,main,20211116,1,0.9935132324852427,276,89,4,369
22714,bright,main,20211116,2,0.9847717709259438,310,114,1,425
22714,bright,main,20211116,3,0.9837407213727808,271,121,7,399
22714,bright,main,20211116,4,0.9959277939829027,300,102,5,407
22714,bright,main,20211116,5,0.9878925455810563,291,122,2,415
22714,bright,main,20211116,6,0.9878925455810563,291,122,2,415
22714,bright,main,20211116,7,0.9926192295730342,283,84,2,369
22714,bright,main,20211116,8,0.9934893553391619,218,202,3,423
22714,bright,main,20211116,9,0.9840690872308879,232,193,3,428
26010,bright,main,20211116,0,0.9929467006017296,262,171,7,440
26010,bright,main,20211116,1,0.993473915113686,217,153,4,374
26010,bright,main,20211116,2,0.9932567123481278,214,217,4,435
26010,bright,main,20211116,3,0.9947931694250156,202,190,6,398
26010,bright,main,20211116,4,0.988177526364079,229,170,5,404
26010,bright,main,20211116,5,0.9906177446944019,283,127,4,414
26010,bright,main,20211116,6,0.9906177446944019,283,127,4,414
26010,bright,main,20211116,7,0.9906721118926013,251,120,3,374
26010,bright,main,20211116,8,0.9853055498702403,308,102,10,420
26010,bright,main,20211116,9,0.9901336032623432,307,116,3,426
26066,bright,main,20211116,0,0.995559556881333,360,72,8,440
26066,bright,main,20211116,1,0.9884580467240494,296,67,3,366
26066,bright,main,20211116,2,0.993951178765502,372,54,4,430
26066,bright,main,20211116,3,0.9917596088990034,268,117,5,390
26066,bright,main,20211116,4,0.9936932912785447,304,101,3,408
26066,bright,main,20211116,5,0.9858407765883263,313,97,4,414
26066,bright,main,20211116,6,0.9858407765883263,313,97,4,414
26066,bright,main,20211116,7,0.9915363827751366,266,94,6,366
26066,bright,main,20211116,8,0.9939727136438204,306,109,8,423
26066,bright,main,20211116,9,0.9926706954365163,349,74,2,425
26005,bright,main,20211116,0,0.9908982146072889,316,124,1,441
26005,bright,main,20211116,1,0.9919151826639104,243,129,3,375
26005,bright,main,20211116,2,0.9861082040065218,274,155,3,432
26005,bright,main,20211116,3,0.9950932158986997,265,128,3,396
26005,bright,main,20211116,4,0.9964182185217114,281,123,3,407
26005,bright,main,20211116,5,0.9923062256119383,269,142,3,414
26005,bright,main,20211116,6,0.9923062256119383,269,142,3,414
26005,bright,main,20211116,7,0.9930626753191629,232,138,3,373
26005,bright,main,20211116,8,0.9962481851358165,287,132,5,424
26005,bright,main,20211116,9,0.9919283185942308,278,146,6,430
24406,bright,main,20211116,0,0.9869206078075834,343,90,4,437
24406,bright,main,20211116,1,0.9877460333669231,299,68,2,369
24406,bright,main,20211116,2,0.9942224251535915,355,65,3,423
24406,bright,main,20211116,3,0.98542724252196,326,42,7,375
24406,bright,main,20211116,4,0.9906759841098576,342,50,6,398
24406,bright,main,20211116,5,0.9871511025681873,345,59,6,410
24406,bright,main,20211116,6,0.9871511025681873,345,59,6,410
24406,bright,main,20211116,7,0.9939760614138922,303,65,3,371
24406,bright,main,20211116,8,0.9923840870389946,270,146,4,420
24406,bright,main,20211116,9,0.9908719716663136,297,121,1,419
24382,bright,main,20211116,0,0.9919836469923403,400,38,3,441
24382,bright,main,20211116,1,0.995151386686609,313,52,2,367
24382,bright,main,20211116,2,0.9916152155261532,356,69,6,431
24382,bright,main,20211116,3,0.9942374636181336,294,85,7,386
24382,bright,main,20211116,4,0.9922607051149503,332,64,5,401
24382,bright,main,20211116,5,0.9919793447657255,342,67,3,412
24382,bright,main,20211116,6,0.9919793447657255,342,67,3,412
24382,bright,main,20211116,7,0.9912134679873298,294,70,5,369
24382,bright,main,20211116,8,0.9952788079901859,348,67,2,417
24382,bright,main,20211116,9,0.991648142965061,358,62,4,424
24449,bright,main,20211116,0,0.9899692260150245,277,154,3,434
24449,bright,main,20211116,1,0.987275262855448,213,157,7,377
24449,bright,main,20211116,2,0.9908982644357534,292,141,2,435
24449,bright,main,20211116,3,0.9862548784073604,178,207,4,389
24449,bright,main,20211116,4,0.9900688888845901,150,160,6,316
24449,bright,main,20211116,5,0.992882293863579,284,128,7,419
24449,bright,main,20211116,6,0.992882293863579,284,128,7,419
24449,bright,main,20211116,7,0.9859419445616759,221,147,8,376
24449,bright,main,20211116,8,0.9958467885141075,237,182,4,423
24449,bright,main,20211116,9,0.9959750997653674,293,135,2,430
25688,bright,main,20211116,0,0.9970344970710829,343,95,2,440
25688,bright,main,20211116,1,0.9898232588736342,301,62,5,368
25688,bright,main,20211116,2,0.996621010270836,346,81,2,429
25688,bright,main,20211116,3,0.9927210660170686,306,88,1,395
25688,bright,main,20211116,4,0.9930773145747186,278,120,3,401
25688,bright,main,20211116,5,0.9921559643491357,271,138,3,412
25688,bright,main,20211116,6,0.9921559643491357,271,138,3,412
25688,bright,main,20211116,7,0.9827382375543394,289,77,4,370
25688,bright,main,20211116,8,0.9949941907417899,340,74,4,418
25688,bright,main,20211116,9,0.9926097403986421,325,100,2,427
21569,bright,main,20211117,0,0.9941784853904764,314,124,5,443
21569,bright,main,20211117,1,0.993599955196866,303,73,5,381
21569,bright,main,20211117,2,0.9915355780886088,339,91,7,437
21569,bright,main,20211117,3,0.9878706224619548,302,93,2,397
21569,bright,main,20211117,4,0.9876031855484143,303,94,5,402
21569,bright,main,20211117,5,0.9910361809046954,296,114,3,413
21569,bright,main,20211117,6,0.9910361809046954,296,114,3,413
21569,bright,main,20211117,7,0.9898574475782081,261,106,4,371
21569,bright,main,20211117,8,0.9895414611930461,304,111,5,420
21569,bright,main,20211117,9,0.9926457151312148,290,133,5,428
23685,bright,main,20211117,0,0.9938148037091556,308,113,3,424
23685,bright,main,20211117,1,0.9913008266564237,272,84,3,359
23685,bright,main,20211117,2,0.9921074034865834,305,90,9,404
23685,bright,main,20211117,3,0.9939917231887856,300,68,4,372
23685,bright,main,20211117,4,0.992654381370229,317,73,4,394
23685,bright,main,20211117,5,0.9896269614202154,320,54,5,379
23685,bright,main,20211117,6,0.9896269614202154,320,54,5,379
23685,bright,main,20211117,7,0.9935962737959559,297,52,4,353
23685,bright,main,20211117,8,0.986443707838952,318,71,5,394
23685,bright,main,20211117,9,0.9954988431355429,332,69,5,406
20140,bright,main,20211117,0,0.990513464886386,303,96,8,407
20140,bright,main,20211117,1,0.9958362477520333,271,67,10,348
20140,bright,main,20211117,2,0.9915239101341896,326,64,7,397
20140,bright,main,20211117,3,0.9932141366265609,279,63,20,362
20140,bright,main,20211117,4,0.9928602798779557,284,69,23,376
20140,bright,main,20211117,5,0.9894785155511514,302,75,8,385
20140,bright,main,20211117,6,0.9894785155511514,302,75,8,385
20140,bright,main,20211117,7,0.993666078087087,254,62,20,336
20140,bright,main,20211117,8,0.9853513987296837,276,77,9,362
20140,bright,main,20211117,9,0.9913406753105437,309,73,13,395
22951,bright,main,20211117,0,0.987354425745401,349,84,5,438
22951,bright,main,20211117,1,0.9948907105320911,303,68,7,378
22951,bright,main,20211117,2,0.9930246103532139,336,96,5,437
22951,bright,main,20211117,3,0.9914793130318466,316,78,1,395
22951,bright,main,20211117,4,0.9859431241304986,304,96,4,404
22951,bright,main,20211117,5,0.9923579219945163,326,83,5,414
22951,bright,main,20211117,6,0.9923579219945163,326,83,5,414
22951,bright,main,20211117,7,0.9926673946867799,211,158,3,372
22951,bright,main,20211117,8,0.9921332887378406,318,102,5,425
22951,bright,main,20211117,9,0.9932202401284133,338,86,2,426
24376,bright,main,20211117,0,0.9917237952525912,345,68,10,423
24376,bright,main,20211117,1,0.990806641946013,263,83,11,357
24376,bright,main,20211117,2,0.99287059962325,343,73,2,418
24376,bright,main,20211117,3,0.9885639403122918,298,77,7,382
24376,bright,main,20211117,4,0.984796704779034,295,91,2,388
24376,bright,main,20211117,5,0.9913756473188761,246,147,5,398
24376,bright,main,20211117,6,0.9913756473188761,246,147,5,398
24376,bright,main,20211117,7,0.9834026827665643,224,125,3,352
24376,bright,main,20211117,8,0.9948050463532977,304,87,4,395
24376,bright,main,20211117,9,0.992208970354109,315,86,5,406
23276,bright,main,20211117,0,0.9945532174877012,352,56,4,412
23276,bright,main,20211117,1,0.9929906759627724,297,57,5,359
23276,bright,main,20211117,2,0.994756869981301,327,77,3,407
23276,bright,main,20211117,3,0.9891131418587112,304,54,10,368
23276,bright,main,20211117,4,0.9916925426271924,301,77,3,381
23276,bright,main,20211117,5,0.9869566938002688,322,57,6,385
23276,bright,main,20211117,6,0.9869566938002688,322,57,6,385
23276,bright,main,20211117,7,0.9895230426125119,313,29,4,346
23276,bright,main,20211117,8,0.9966417882773976,334,52,8,394
23276,bright,main,20211117,9,0.9958895483716369,345,51,7,403
21539,bright,main,20211117,0,0.992908778065645,329,111,4,444
21539,bright,main,20211117,1,0.9945928407340546,307,65,2,374
21539,bright,main,20211117,2,0.9924998444482842,318,114,4,436
21539,bright,main,20211117,3,0.9936615775101779,288,103,6,397
21539,bright,main,20211117,4,0.9928288754876149,317,85,4,406
21539,bright,main,20211117,5,0.9953858764404019,323,85,4,412
21539,bright,main,20211117,6,0.9953858764404019,323,85,4,412
21539,bright,main,20211117,7,0.9911742720352308,301,64,4,369
21539,bright,main,20211117,8,0.9911023342259119,330,85,4,419
21539,bright,main,20211117,9,0.9899019942035592,336,87,4,427
20998,bright,main,20211117,0,0.9938458412831745,326,103,8,437
20998,bright,main,20211117,1,0.9937463230954118,277,96,3,376
20998,bright,main,20211117,2,0.9918563641359267,333,97,1,431
20998,bright,main,20211117,3,0.9926715589091343,332,61,3,396
20998,bright,main,20211117,4,0.9903424835120841,313,86,4,403
20998,bright,main,20211117,5,0.9903227668040908,332,78,0,410
20998,bright,main,20211117,6,0.9903227668040908,332,78,0,410
20998,bright,main,20211117,7,0.99374498935861,307,61,4,372
20998,bright,main,20211117,8,0.995330842822414,328,88,2,418
20998,bright,main,20211117,9,0.9941465301212498,284,138,3,425
24502,bright,main,20211117,0,0.9940683167794733,324,119,3,446
24502,bright,main,20211117,1,0.9914479041437592,317,62,3,382
24502,bright,main,20211117,2,0.9919602444571277,368,72,2,442
24502,bright,main,20211117,3,0.9911720069169291,320,77,3,400
24502,bright,main,20211117,4,0.9885644793224605,318,82,8,408
24502,bright,main,20211117,5,0.994693434797945,319,91,5,415
24502,bright,main,20211117,6,0.994693434797945,319,91,5,415
24502,bright,main,20211117,7,0.9924515759383684,272,91,3,366
24502,bright,main,20211117,8,0.9897363650579983,339,82,2,423
24502,bright,main,20211117,9,0.990766149824133,332,89,3,424
24400,bright,main,20211117,0,0.9960063451588721,331,103,5,439
24400,bright,main,20211117,1,0.9909737889924178,274,101,4,379
24400,bright,main,20211117,2,0.9940571587344561,288,134,7,429
24400,bright,main,20211117,3,0.9913952839460564,294,95,1,390
24400,bright,main,20211117,4,0.9939751449073673,276,118,3,397
24400,bright,main,20211117,5,0.994650480263673,303,105,4,412
24400,bright,main,20211117,6,0.994650480263673,303,105,4,412
24400,bright,main,20211117,7,0.9891661977000121,268,100,2,370
24400,bright,main,20211117,8,0.9907798564404158,282,134,4,420
24400,bright,main,20211117,9,0.9922402566763051,289,127,9,425
22953,bright,main,20211117,0,0.9943188741441791,281,145,10,436
22953,bright,main,20211117,1,0.9842265909062115,238,140,2,380
22953,bright,main,20211117,2,0.9928855426401542,327,102,9,438
22953,bright,main,20211117,3,0.9899719416108438,254,142,2,398
22953,bright,main,20211117,4,0.9912622734804386,231,171,2,404
22953,bright,main,20211117,5,0.9888454184632776,224,183,3,410
22953,bright,main,20211117,6,0.9888454184632776,224,183,3,410
22953,bright,main,20211117,7,0.9892795499099828,264,107,5,376
22953,bright,main,20211117,8,0.9912092211659576,308,112,4,424
22953,bright,main,20211117,9,0.9928099563395781,296,123,8,427
26063,bright,main,20211117,0,0.9944680956492273,348,86,6,440
26063,bright,main,20211117,1,0.9951975660308434,305,65,6,376
26063,bright,main,20211117,2,0.9955198704260806,348,87,2,437
26063,bright,main,20211117,3,0.9934023086345569,324,70,3,397
26063,bright,main,20211117,4,0.9887287522495652,321,72,7,400
26063,bright,main,20211117,5,0.9916531313383387,330,80,4,414
26063,bright,main,20211117,6,0.9916531313383387,330,80,4,414
26063,bright,main,20211117,7,0.9837921202527201,264,106,3,373
26063,bright,main,20211117,8,0.9963716422103513,309,109,7,425
26063,bright,main,20211117,9,0.9961725060427264,336,87,4,427
21527,bright,main,20211117,0,0.9931307596255892,351,86,4,441
21527,bright,main,20211117,1,0.9916153509686569,285,90,2,377
21527,bright,main,20211117,2,0.9920979962222561,367,62,3,432
21527,bright,main,20211117,3,0.9870988178568181,294,94,5,393
21527,bright,main,20211117,4,0.981968513149621,291,113,1,405
21527,bright,main,20211117,5,0.9845603341189908,305,98,4,407
21527,bright,main,20211117,6,0.9845603341189908,305,98,4,407
21527,bright,main,20211117,7,0.9942179890858625,293,71,4,368
21527,bright,main,20211117,8,0.9932047119637863,324,90,8,422
21527,bright,main,20211117,9,0.9868656720425488,338,86,6,430
24399,bright,main,20211117,0,0.993260431566127,273,152,8,433
24399,bright,main,20211117,1,0.9935300944094317,195,166,8,369
24399,bright,main,20211117,2,0.9951163004202166,252,166,3,421
24399,bright,main,20211117,3,0.9936487871787077,244,136,4,384
24399,bright,main,20211117,4,0.995461935667034,264,131,4,399
24399,bright,main,20211117,5,0.9902516053767807,313,96,4,413
24399,bright,main,20211117,6,0.9902516053767807,313,96,4,413
24399,bright,main,20211117,7,0.9938928526960882,265,100,6,371
24399,bright,main,20211117,8,0.9937514825545835,266,136,3,405
24399,bright,main,20211117,9,0.9935798097260269,271,148,6,425
20950,bright,main,20211117,0,0.9926488664007908,321,108,11,440
20950,bright,main,20211117,1,0.9805663153787735,288,81,6,375
20950,bright,main,20211117,2,0.9833018774867085,322,105,3,430
20950,bright,main,20211117,3,0.9905534171583494,290,95,4,389
20950,bright,main,20211117,4,0.9932795175063852,287,109,1,397
20950,bright,main,20211117,5,0.9908989817627222,272,136,2,410
20950,bright,main,20211117,6,0.9908989817627222,272,136,2,410
20950,bright,main,20211117,7,0.9938955862010392,195,169,5,369
20950,bright,main,20211117,8,0.9810800883000695,304,112,3,419
20950,bright,main,20211117,9,0.9921965838303651,306,111,4,421
21234,bright,main,20211117,0,0.9867751168731194,343,80,4,427
21234,bright,main,20211117,1,0.9849337683894536,265,93,6,364
21234,bright,main,20211117,2,0.989477321185254,305,105,7,417
21234,bright,main,20211117,3,0.9910110358829963,316,68,3,387
21234,bright,main,20211117,4,0.9939456437468476,305,81,6,392
21234,bright,main,20211117,5,0.9910399595226893,331,70,2,403
21234,bright,main,20211117,6,0.9910399595226893,331,70,2,403
21234,bright,main,20211117,7,0.9893669999758556,298,58,4,360
21234,bright,main,20211117,8,0.990800107084591,326,78,8,412
21234,bright,main,20211117,9,0.9960868942656566,320,94,1,415
22507,bright,main,20211117,0,0.9943217846082679,316,118,3,437
22507,bright,main,20211117,1,0.99549056773986,294,86,4,384
22507,bright,main,20211117,2,0.9895689361322985,340,85,5,430
22507,bright,main,20211117,3,0.991414886040451,303,87,4,394
22507,bright,main,20211117,4,0.9944175874555735,309,90,5,404
22507,bright,main,20211117,5,0.986823433497372,338,59,5,402
22507,bright,main,20211117,6,0.986823433497372,338,59,5,402
22507,bright,main,20211117,7,0.9924163260937379,291,70,6,367
22507,bright,main,20211117,8,0.9942686112581695,311,104,9,424
22507,bright,main,20211117,9,0.9944929927237016,299,123,5,427
23705,bright,main,20211117,0,0.9880685051289586,363,77,3,443
23705,bright,main,20211117,1,0.9926769860000627,292,81,6,379
23705,bright,main,20211117,2,0.9947465507093636,340,92,3,435
23705,bright,main,20211117,3,0.9916076691373225,301,96,3,400
23705,bright,main,20211117,4,0.986732088498185,274,127,5,406
23705,bright,main,20211117,5,0.990489187511333,289,124,4,417
23705,bright,main,20211117,6,0.990489187511333,289,124,4,417
23705,bright,main,20211117,7,0.9921804446901936,260,112,3,375
23705,bright,main,20211117,8,0.9871706434655158,296,113,11,420
23705,bright,main,20211117,9,0.9970323316796146,333,91,5,429
24662,bright,main,20211117,0,0.9938043145914037,346,85,1,432
24662,bright,main,20211117,1,0.9906368657006377,290,77,3,370
24662,bright,main,20211117,2,0.9911816421322626,323,96,6,425
24662,bright,main,20211117,3,0.9912009011542972,289,91,6,386
24662,bright,main,20211117,4,0.9960514126262207,316,81,3,400
24662,bright,main,20211117,5,0.9921091703027403,285,109,3,397
24662,bright,main,20211117,6,0.9921091703027403,285,109,3,397
24662,bright,main,20211117,7,0.9927207440080806,283,82,0,365
24662,bright,main,20211117,8,0.991734963123001,322,93,2,417
24662,bright,main,20211117,9,0.9883080582878272,347,71,4,422
20963,bright,main,20211117,0,0.9910161755488468,274,164,2,440
20963,bright,main,20211117,1,0.9844481568959735,238,136,5,379
20963,bright,main,20211117,2,0.9921526518869559,288,142,5,435
20963,bright,main,20211117,3,0.994205628656722,321,72,4,397
20963,bright,main,20211117,4,0.9943524286418289,316,82,2,400
20963,bright,main,20211117,5,0.9898738305176596,304,102,5,411
20963,bright,main,20211117,6,0.9898738305176596,304,102,5,411
20963,bright,main,20211117,7,0.9842184685091991,274,96,3,373
20963,bright,main,20211117,8,0.99361833082907,289,125,8,422
20963,bright,main,20211117,9,0.9931167758727835,309,116,0,425
20959,bright,main,20211117,0,0.9917393114752387,352,79,4,435
20959,bright,main,20211117,1,0.9883953506484703,235,144,1,380
20959,bright,main,20211117,2,0.9955760271920155,262,171,4,437
20959,bright,main,20211117,3,0.9909627864713493,216,175,4,395
20959,bright,main,20211117,4,0.9863563058805769,261,137,4,402
20959,bright,main,20211117,5,0.9922409932795154,295,111,5,411
20959,bright,main,20211117,6,0.9922409932795154,295,111,5,411
20959,bright,main,20211117,7,0.9871546133825532,290,76,8,374
20959,bright,main,20211117,8,0.9920822265882963,333,81,9,423
20959,bright,main,20211117,9,0.9900732657436113,331,94,2,427
24659,bright,main,20211117,0,0.9888589105993482,323,109,8,440
24659,bright,main,20211117,1,0.9919619613900192,270,104,2,376
24659,bright,main,20211117,2,0.982726363347464,318,109,5,432
24659,bright,main,20211117,3,0.9908193124174812,281,103,4,388
24659,bright,main,20211117,4,0.9951659305001898,328,67,6,401
24659,bright,main,20211117,5,0.9968367887816079,323,83,1,407
24659,bright,main,20211117,6,0.9968367887816079,323,83,1,407
24659,bright,main,20211117,7,0.9941258525432553,281,87,2,370
24659,bright,main,20211117,8,0.9928829859346058,320,96,4,420
24659,bright,main,20211117,9,0.9904642980607087,320,101,1,422
21266,bright,main,20211117,0,0.9945710681727421,297,139,2,438
21266,bright,main,20211117,1,0.9930107164034909,255,114,3,372
21266,bright,main,20211117,2,0.9909061558640202,313,117,7,437
21266,bright,main,20211117,3,0.988913661019324,272,109,2,383
21266,bright,main,20211117,4,0.994023362551805,239,163,4,406
21266,bright,main,20211117,5,0.9878469021904658,270,140,3,413
21266,bright,main,20211117,6,0.9878469021904658,270,140,3,413
21266,bright,main,20211117,7,0.9965265560928748,272,98,5,375
21266,bright,main,20211117,8,0.9915321888757166,308,115,2,425
21266,bright,main,20211117,9,0.992428220595902,272,153,3,428
22101,bright,main,20211117,0,0.991243069139347,323,106,5,434
22101,bright,main,20211117,1,0.9882258078542393,266,99,3,368
22101,bright,main,20211117,2,0.9940930758782104,257,162,4,423
22101,bright,main,20211117,3,0.991879142464167,265,117,5,387
22101,bright,main,20211117,4,0.9948582627862186,279,111,7,397
22101,bright,main,20211117,5,0.9930570171490375,298,98,4,400
22101,bright,main,20211117,6,0.9930570171490375,298,98,4,400
22101,bright,main,20211117,7,0.9934696499137896,297,62,8,367
22101,bright,main,20211117,8,0.9875956567642565,324,84,7,415
22101,bright,main,20211117,9,0.9941406796737442,351,63,5,419
23981,bright,main,20211117,0,0.9897969136844276,344,94,2,440
23981,bright,main,20211117,1,0.9891373355604982,250,116,6,372
23981,bright,main,20211117,2,0.9946414935740844,265,167,3,435
23981,bright,main,20211117,3,0.9948108689200992,232,152,4,388
23981,bright,main,20211117,4,0.9940739550856496,279,115,6,400
23981,bright,main,20211117,5,0.9975237638704598,293,112,7,412
23981,bright,main,20211117,6,0.9975237638704598,293,112,7,412
23981,bright,main,20211117,7,0.9951859951542892,251,113,4,368
23981,bright,main,20211117,8,0.9922794267307181,255,158,7,420
23981,bright,main,20211117,9,0.9953198272947418,318,105,4,427
24503,bright,main,20211117,0,0.995979834829126,354,81,3,438
24503,bright,main,20211117,1,0.9829012823006776,310,67,4,381
24503,bright,main,20211117,2,0.9936725292721084,338,94,6,438
24503,bright,main,20211117,3,0.9938736119431089,311,77,6,394
24503,bright,main,20211117,4,0.9879546906080436,301,100,4,405
24503,bright,main,20211117,5,0.9908898079000618,325,80,4,409
24503,bright,main,20211117,6,0.9908898079000618,325,80,4,409
24503,bright,main,20211117,7,0.9937098455230808,278,84,7,369
24503,bright,main,20211117,8,0.9947597583363209,345,75,6,426
24503,bright,main,20211117,9,0.995197796783378,330,95,3,428
25268,bright,main,20211117,0,0.9929081046908748,238,196,5,439
25268,bright,main,20211117,1,0.9972057728444764,268,107,3,378
25268,bright,main,20211117,2,0.9920014259154906,314,120,8,442
25268,bright,main,20211117,3,0.9893503384489419,211,179,5,395
25268,bright,main,20211117,4,0.9948193444519183,185,223,3,411
25268,bright,main,20211117,5,0.9923261235058985,188,226,2,416
25268,bright,main,20211117,6,0.9923261235058985,188,226,2,416
25268,bright,main,20211117,7,0.9945309404965714,200,161,11,372
25268,bright,main,20211117,8,0.9907975230479348,248,171,5,424
25268,bright,main,20211117,9,0.9915104122420404,221,201,3,425
24676,bright,main,20211117,0,0.9923010901441178,242,62,5,309
24676,bright,main,20211117,1,0.990324725037819,240,83,1,324
24676,bright,main,20211117,2,0.9918352743867891,337,93,2,432
24676,bright,main,20211117,3,0.990662621924943,296,97,3,396
24676,bright,main,20211117,4,0.9963332470595754,295,96,8,399
24676,bright,main,20211117,5,0.9952777601301608,320,79,2,401
24676,bright,main,20211117,6,0.9952777601301608,320,79,2,401
24676,bright,main,20211117,7,0.9890817333781988,284,80,6,370
24676,bright,main,20211117,8,0.9931308729923732,337,77,3,417
24676,bright,main,20211117,9,0.9939308279025487,291,90,7,388
26008,bright,main,20211117,0,0.9924915459078757,264,173,2,439
26008,bright,main,20211117,1,0.9937410017516736,260,118,2,380
26008,bright,main,20211117,2,0.9941341501254991,311,118,7,436
26008,bright,main,20211117,3,0.9880325663551085,239,158,0,397
26008,bright,main,20211117,4,0.9937924807318955,306,95,6,407
26008,bright,main,20211117,5,0.987432115824201,317,91,5,413
26008,bright,main,20211117,6,0.987432115824201,317,91,5,413
26008,bright,main,20211117,7,0.9922969136976887,256,111,5,372
26008,bright,main,20211117,8,0.9827269015547201,239,174,5,418
26008,bright,main,20211117,9,0.9937795427499966,236,183,3,422
22921,bright,main,20211117,0,0.9978904731887173,360,74,7,441
22921,bright,main,20211117,1,0.9875863737493421,293,90,1,384
22921,bright,main,20211117,2,0.9943479511860716,306,128,3,437
22921,bright,main,20211117,3,0.9920710849453113,303,83,9,395
22921,bright,main,20211117,4,0.9926649284316762,338,67,1,406
22921,bright,main,20211117,5,0.9859562631554144,342,65,3,410
22921,bright,main,20211117,6,0.9859562631554144,342,65,3,410
22921,bright,main,20211117,7,0.9936098306000564,264,104,1,369
22921,bright,main,20211117,8,0.9906920256548983,312,109,1,422
22921,bright,main,20211117,9,0.9940998583501607,316,107,4,427
20962,bright,main,20211118,0,0.9947319685394069,337,94,2,433
20962,bright,main,20211118,1,0.9899556058411337,304,66,3,373
20962,bright,main,20211118,2,0.9918954911174261,361,75,4,440
20962,bright,main,20211118,3,0.9938220564436372,315,79,3,397
20962,bright,main,20211118,4,0.9876679672477845,312,81,7,400
20962,bright,main,20211118,5,0.9883593323821467,310,92,4,406
20962,bright,main,20211118,6,0.9883593323821467,310,92,4,406
20962,bright,main,20211118,7,0.9948072562253979,294,70,3,367
20962,bright,main,20211118,8,0.9938894728368591,309,105,5,419
20962,bright,main,20211118,9,0.989638121518353,309,107,7,423
20987,bright,main,20211118,0,0.991403010862742,303,133,1,437
20987,bright,main,20211118,1,0.9927774634156068,240,130,2,372
20987,bright,main,20211118,2,0.9899079128900884,304,129,2,435
20987,bright,main,20211118,3,0.9946162160339937,285,110,2,397
20987,bright,main,20211118,4,0.992856978756142,311,85,4,400
20987,bright,main,20211118,5,0.9919027771580838,292,103,6,401
20987,bright,main,20211118,6,0.9919027771580838,292,103,6,401
20987,bright,main,20211118,7,0.9925482247274326,269,94,5,368
20987,bright,main,20211118,8,0.9935862243193815,284,130,7,421
20987,bright,main,20211118,9,0.9887628284430195,322,99,5,426
82406,backup,special,20211118,0,0.9924271613089756,154,237,22,413
82406,backup,special,20211118,1,0.9935425618127459,92,242,18,352
82406,backup,special,20211118,2,0.9908994399162556,157,230,19,406
82406,backup,special,20211118,3,0.9900752449418123,169,186,8,363
82406,backup,special,20211118,4,0.9922428848888597,242,101,28,371
82406,backup,special,20211118,5,0.9938103157230626,288,88,9,385
82406,backup,special,20211118,6,0.9952218622590017,180,200,17,397
82406,backup,special,20211118,7,0.9912965380542132,135,193,14,342
82406,backup,special,20211118,8,0.9957063085690575,170,208,13,391
82406,backup,special,20211118,9,0.9834540934418745,139,239,20,398
21247,bright,main,20211118,0,0.9958814488336903,288,124,8,420
21247,bright,main,20211118,1,0.9944457437101764,227,123,7,357
21247,bright,main,20211118,2,0.9927292577698751,287,119,6,412
21247,bright,main,20211118,3,0.9940717127701577,276,106,5,387
21247,bright,main,20211118,4,0.993836255171786,302,73,9,384
21247,bright,main,20211118,5,0.9903536281999513,359,47,4,410
21247,bright,main,20211118,6,0.9903536281999513,359,47,4,410
21247,bright,main,20211118,7,0.9925941208768215,293,60,6,359
21247,bright,main,20211118,8,0.9899107547389758,341,63,6,410
21247,bright,main,20211118,9,0.9927948452357975,337,77,5,419
24181,bright,main,20211118,0,0.9911343158067796,338,73,9,420
24181,bright,main,20211118,1,0.9958877204659523,277,68,4,349
24181,bright,main,20211118,2,0.9926120388704867,344,63,3,410
24181,bright,main,20211118,3,0.9951265927300509,302,60,4,366
24181,bright,main,20211118,4,0.9914289490615297,290,84,8,382
24181,bright,main,20211118,5,0.9911551138589936,300,94,2,396
24181,bright,main,20211118,6,0.9911551138589936,300,94,2,396
24181,bright,main,20211118,7,0.9940431671828588,281,61,6,348
24181,bright,main,20211118,8,0.9861147500115071,322,77,2,401
24181,bright,main,20211118,9,0.9935363971901082,346,61,6,413
21917,bright,main,20211118,0,0.994981208330883,372,46,2,420
21917,bright,main,20211118,1,0.9876456721904947,325,41,3,369
21917,bright,main,20211118,2,0.991283986667086,361,53,7,421
21917,bright,main,20211118,3,0.984357707781268,337,41,9,387
21917,bright,main,20211118,4,0.9945613677143432,320,59,7,386
21917,bright,main,20211118,5,0.9942613703827577,329,52,3,384
21917,bright,main,20211118,6,0.9942613703827577,329,52,3,384
21917,bright,main,20211118,7,0.993782484804004,324,34,2,360
21917,bright,main,20211118,8,0.9960825359783214,341,63,5,409
21917,bright,main,20211118,9,0.9920239690159481,335,66,4,405
82405,backup,special,20211118,0,0.9940045928446609,11,403,0,414
82405,backup,special,20211118,1,0.9893353462271636,22,330,0,352
82405,backup,special,20211118,2,0.9905401406700755,25,380,0,405
82405,backup,special,20211118,3,0.9952582820827347,39,324,0,363
82405,backup,special,20211118,4,0.9878639205601787,48,320,2,370
82405,backup,special,20211118,5,0.9911089411160879,55,329,0,384
82405,backup,special,20211118,6,0.9866058240715628,54,344,0,398
82405,backup,special,20211118,7,0.989474364784613,43,298,1,342
82405,backup,special,20211118,8,0.9966927272693255,39,352,0,391
82405,backup,special,20211118,9,0.9936721884448212,60,339,0,399
20364,bright,main,20211119,0,0.9895416715807193,348,69,3,420
20364,bright,main,20211119,1,0.9924635901223706,296,54,7,357
20364,bright,main,20211119,2,0.9923849960228734,355,66,3,424
20364,bright,main,20211119,3,0.9894196583638103,311,65,7,383
20364,bright,main,20211119,4,0.9940049404424174,333,47,8,388
20364,bright,main,20211119,5,0.9884482669247149,329,68,5,402
20364,bright,main,20211119,6,0.99059977339035,317,85,4,406
20364,bright,main,20211119,7,0.9923232298135618,272,73,6,351
20364,bright,main,20211119,8,0.9902027296448346,307,77,10,394
20364,bright,main,20211119,9,0.9931081346661916,323,80,8,411
20964,bright,main,20211119,0,0.9901892207164812,277,139,8,424
20964,bright,main,20211119,1,0.9901642921441782,258,105,3,366
20964,bright,main,20211119,2,0.9927155102970129,297,127,4,428
20964,bright,main,20211119,3,0.995338527628364,300,89,4,393
20964,bright,main,20211119,4,0.9943687029997089,317,83,3,403
20964,bright,main,20211119,5,0.9897534381220243,288,114,9,411
20964,bright,main,20211119,6,0.9945116013059853,317,95,8,420
20964,bright,main,20211119,7,0.9922611984262704,239,123,4,366
20964,bright,main,20211119,8,0.9917461961680051,248,164,5,417
20964,bright,main,20211119,9,0.9926416743533445,285,129,4,418
20365,bright,main,20211119,0,0.9958334321522997,352,67,5,424
20365,bright,main,20211119,1,0.9901327882174691,264,89,2,355
20365,bright,main,20211119,2,0.992783758102561,293,113,6,412
20365,bright,main,20211119,3,0.9957422137449782,298,74,7,379
20365,bright,main,20211119,4,0.9926520755506661,328,55,7,390
20365,bright,main,20211119,5,0.9947809091761655,306,80,5,391
20365,bright,main,20211119,6,0.993300040476882,327,65,2,394
20365,bright,main,20211119,7,0.9877980298598268,281,68,3,352
20365,bright,main,20211119,8,0.9866787120125072,347,61,1,409
20365,bright,main,20211119,9,0.9865671781764267,342,63,3,408
22488,bright,main,20211119,0,0.995017413015663,314,112,2,428
22488,bright,main,20211119,1,0.9878821560887618,241,119,3,363
22488,bright,main,20211119,2,0.9902467485018429,312,110,7,429
22488,bright,main,20211119,3,0.9961678638984615,278,105,7,390
22488,bright,main,20211119,4,0.9949058272107216,309,80,7,396
22488,bright,main,20211119,5,0.9948192001707198,322,77,6,405
22488,bright,main,20211119,6,0.9923793838979834,350,67,1,418
22488,bright,main,20211119,7,0.9923173827255114,274,86,3,363
22488,bright,main,20211119,8,0.9941432537275284,320,87,6,413
22488,bright,main,20211119,9,0.9932917778374157,350,64,5,419
25039,bright,main,20211119,0,0.9898455446200635,353,68,3,424
25039,bright,main,20211119,1,0.993371869544593,289,54,5,348
25039,bright,main,20211119,2,0.9893521119261842,320,82,5,407
25039,bright,main,20211119,3,0.9934665027118766,313,57,5,375
25039,bright,main,20211119,4,0.9974329815034086,313,63,3,379
25039,bright,main,20211119,5,0.9914249370129327,318,62,4,384
25039,bright,main,20211119,6,0.9924827879060204,304,84,9,397
25039,bright,main,20211119,7,0.995280075320801,269,75,3,347
25039,bright,main,20211119,8,0.9936980121624691,309,80,6,395
25039,bright,main,20211119,9,0.9916568753113578,297,102,4,403
24067,bright,main,20211119,0,0.9927985221979477,372,68,3,443
24067,bright,main,20211119,1,0.9933075970590636,282,89,3,374
24067,bright,main,20211119,2,0.9890044930222096,329,98,5,432
24067,bright,main,20211119,3,0.9884156535401063,270,122,4,396
24067,bright,main,20211119,4,0.990408328134162,247,138,6,391
24067,bright,main,20211119,5,0.9901772114383792,301,102,4,407
24067,bright,main,20211119,6,0.9933807046227685,300,113,7,420
24067,bright,main,20211119,7,0.9912230047881263,271,93,4,368
24067,bright,main,20211119,8,0.9944139084470625,311,101,8,420
24067,bright,main,20211119,9,0.9943406251253857,345,73,8,426
23469,bright,main,20211119,0,0.9925473764493167,354,67,2,423
23469,bright,main,20211119,1,0.9947404370427619,291,53,7,351
23469,bright,main,20211119,2,0.9868282458609503,381,42,4,427
23469,bright,main,20211119,3,0.981571135155508,323,55,1,379
23469,bright,main,20211119,4,0.9892269482995609,322,50,9,381
23469,bright,main,20211119,5,0.9933259164551866,327,54,5,386
23469,bright,main,20211119,6,0.9929773406144297,352,66,2,420
23469,bright,main,20211119,7,0.9888138284052815,305,46,9,360
23469,bright,main,20211119,8,0.9946443109276086,311,80,9,400
23469,bright,main,20211119,9,0.9922178699034311,359,53,2,414
25667,bright,main,20211119,0,0.987720596405257,307,118,5,430
25667,bright,main,20211119,1,0.9928859306197029,201,153,2,356
25667,bright,main,20211119,2,0.9943373547355366,262,159,5,426
25667,bright,main,20211119,3,0.9900100175964736,215,168,6,389
25667,bright,main,20211119,4,0.9912561373170261,288,95,4,387
25667,bright,main,20211119,5,0.9929687524151241,321,77,1,399
25667,bright,main,20211119,6,0.9935977446540355,318,92,5,415
25667,bright,main,20211119,7,0.9941870369007239,303,50,6,359
25667,bright,main,20211119,8,0.9909964105782219,291,108,6,405
25667,bright,main,20211119,9,0.9874049523501534,286,121,7,414
26006,bright,main,20211119,0,0.9888944968212111,273,153,5,431
26006,bright,main,20211119,1,0.9893145236144765,237,133,4,374
26006,bright,main,20211119,2,0.9923279712354947,272,156,3,431
26006,bright,main,20211119,3,0.9903228515859472,282,112,4,398
26006,bright,main,20211119,4,0.9912238306395077,303,98,3,404
26006,bright,main,20211119,5,0.9943147273060212,292,123,2,417
26006,bright,main,20211119,6,0.9969911984718377,280,142,1,423
26006,bright,main,20211119,7,0.9801562340758384,221,142,1,364
26006,bright,main,20211119,8,0.9934840828463251,277,136,6,419
26006,bright,main,20211119,9,0.9884769101430788,301,116,2,419
23670,bright,main,20211119,0,0.9888708012231301,333,88,5,426
23670,bright,main,20211119,1,0.9918515676744495,274,82,4,360
23670,bright,main,20211119,2,0.9895362648473861,321,94,6,421
23670,bright,main,20211119,3,0.9905769544370793,276,100,6,382
23670,bright,main,20211119,4,0.9820754527924944,283,99,5,387
23670,bright,main,20211119,5,0.9924125418412315,256,131,6,393
23670,bright,main,20211119,6,0.9927072433331623,318,98,3,419
23670,bright,main,20211119,7,0.989924960854406,276,74,4,354
23670,bright,main,20211119,8,0.9914642095016631,339,66,6,411
23670,bright,main,20211119,9,0.9959495834071155,345,65,6,416
20531,bright,main,20211119,0,0.9938460050533141,387,44,3,434
20531,bright,main,20211119,1,0.9779650758214918,302,58,5,365
20531,bright,main,20211119,2,0.9952890711498477,328,86,6,420
20531,bright,main,20211119,3,0.9942886225917584,285,83,3,371
20531,bright,main,20211119,4,0.9938972597434939,288,95,5,388
20531,bright,main,20211119,5,0.989169742415034,330,56,6,392
20531,bright,main,20211119,6,0.9916934712205766,274,133,5,412
20531,bright,main,20211119,7,0.9952907005200046,265,89,5,359
20531,bright,main,20211119,8,0.9931163794788533,312,84,5,401
20531,bright,main,20211119,9,0.9909641736650312,337,76,3,416
20686,bright,main,20211119,0,0.9942379298546036,315,78,5,398
20686,bright,main,20211119,1,0.9929826435096989,287,53,7,347
20686,bright,main,20211119,2,0.9934105392880985,318,79,8,405
20686,bright,main,20211119,3,0.9832171040705843,289,68,4,361
20686,bright,main,20211119,4,0.9953412643513979,286,65,10,361
20686,bright,main,20211119,5,0.9876108647893519,315,52,5,372
20686,bright,main,20211119,6,0.9898896277682795,353,50,4,407
20686,bright,main,20211119,7,0.9921180181261952,298,52,4,354
20686,bright,main,20211119,8,0.992177065618042,343,50,9,402
20686,bright,main,20211119,9,0.9907073465344506,326,74,3,403
25631,bright,main,20211119,0,0.9892303608292187,259,160,5,424
25631,bright,main,20211119,1,0.989104494268092,222,136,7,365
25631,bright,main,20211119,2,0.9959890842578207,283,135,6,424
25631,bright,main,20211119,3,0.9943003977768972,221,162,4,387
25631,bright,main,20211119,4,0.9879862841871603,264,123,3,390
25631,bright,main,20211119,5,0.995383320687993,330,69,5,404
25631,bright,main,20211119,6,0.9932552759785257,337,73,5,415
25631,bright,main,20211119,7,0.9925961376326076,278,76,3,357
25631,bright,main,20211119,8,0.9941400912712132,324,84,7,415
25631,bright,main,20211119,9,0.9948978782739121,312,106,4,422
82403,backup,special,20211119,0,0.9897298821912565,1,413,0,414
82403,backup,special,20211119,1,0.9951566133370393,1,353,0,354
82403,backup,special,20211119,2,0.993025820442048,10,396,0,406
82403,backup,special,20211119,3,0.9917266365647914,2,361,0,363
82403,backup,special,20211119,4,0.9933181582892111,7,369,0,376
82403,backup,special,20211119,5,0.9902643107970706,7,377,0,384
82403,backup,special,20211119,6,0.9962602685770602,3,395,0,398
82403,backup,special,20211119,7,0.9877810972429549,5,335,0,340
82403,backup,special,20211119,8,0.9876392447888466,2,390,0,392
82403,backup,special,20211119,9,0.9849871049745899,12,388,0,400
23518,bright,main,20211119,0,0.9941128132729593,340,75,8,423
23518,bright,main,20211119,1,0.9955328611163364,290,65,5,360
23518,bright,main,20211119,2,0.9953606569070507,334,68,7,409
23518,bright,main,20211119,3,0.9889170749379161,305,62,6,373
23518,bright,main,20211119,4,0.992955656389139,302,70,5,377
23518,bright,main,20211119,5,0.9878071736221027,307,65,10,382
23518,bright,main,20211119,6,0.9962462612832051,329,72,6,407
23518,bright,main,20211119,7,0.9890997532905954,280,59,10,349
23518,bright,main,20211119,8,0.985001680674914,315,82,5,402
23518,bright,main,20211119,9,0.9859412129408148,302,84,4,390
22411,bright,main,20211119,0,0.9936211511896622,233,205,4,442
22411,bright,main,20211119,1,0.9940585105678417,246,131,1,378
22411,bright,main,20211119,2,0.9871381597423685,253,179,5,437
22411,bright,main,20211119,3,0.9858134339915734,295,98,2,395
22411,bright,main,20211119,4,0.9894741037690734,326,78,5,409
22411,bright,main,20211119,5,0.9915155201152063,335,70,5,410
22411,bright,main,20211119,6,0.9915989844289897,353,66,8,427
22411,bright,main,20211119,7,0.9933518614149018,297,72,3,372
22411,bright,main,20211119,8,0.9949522170220116,324,94,6,424
22411,bright,main,20211119,9,0.9923757710798883,211,216,3,430
21475,bright,main,20211119,0,0.9964035966842103,335,75,7,417
21475,bright,main,20211119,1,0.9946279666308502,298,48,3,349
21475,bright,main,20211119,2,0.9956514529859866,349,56,2,407
21475,bright,main,20211119,3,0.9947749720224232,322,53,4,379
21475,bright,main,20211119,4,0.9915611276287564,290,70,7,367
21475,bright,main,20211119,5,0.992496396374558,295,72,5,372
21475,bright,main,20211119,6,0.9932808494066634,328,69,8,405
21475,bright,main,20211119,7,0.986559122447786,293,52,2,347
21475,bright,main,20211119,8,0.9912446550589276,312,64,9,385
21475,bright,main,20211119,9,0.9889048906281155,316,61,3,380
20967,bright,main,20211119,0,0.9924409006133245,347,80,10,437
20967,bright,main,20211119,1,0.986502836316977,293,77,3,373
20967,bright,main,20211119,2,0.9922096173974609,331,92,12,435
20967,bright,main,20211119,3,0.9855225521969675,274,112,2,388
20967,bright,main,20211119,4,0.9916653951818369,283,113,5,401
20967,bright,main,20211119,5,0.9937451213620709,279,122,9,410
20967,bright,main,20211119,6,0.9956210896699219,306,108,2,416
20967,bright,main,20211119,7,0.9940434506908862,289,72,6,367
20967,bright,main,20211119,8,0.9950018796165162,315,100,5,420
20967,bright,main,20211119,9,0.9955901726321592,334,83,3,420
21274,bright,main,20211119,0,0.9959239469500698,341,88,3,432
21274,bright,main,20211119,1,0.9744989700035621,298,74,3,375
21274,bright,main,20211119,2,0.9940279137599183,346,90,1,437
21274,bright,main,20211119,3,0.9882321888969475,331,64,1,396
21274,bright,main,20211119,4,0.9954648129426739,311,86,2,399
21274,bright,main,20211119,5,0.9897172785253243,317,94,3,414
21274,bright,main,20211119,6,0.9896211176811993,316,109,2,427
21274,bright,main,20211119,7,0.991377180953462,243,122,2,367
21274,bright,main,20211119,8,0.9952265918068068,304,107,8,419
21274,bright,main,20211119,9,0.9942827086674091,321,102,6,429
20173,bright,main,20211119,0,0.9945033048648707,338,70,7,415
20173,bright,main,20211119,1,0.9942450613021683,271,74,4,349
20173,bright,main,20211119,2,0.9861674074712127,307,82,2,391
20173,bright,main,20211119,3,0.9917332222298537,268,89,5,362
20173,bright,main,20211119,4,0.9931680449737531,260,90,5,355
20173,bright,main,20211119,5,0.987352048415072,275,96,5,376
20173,bright,main,20211119,6,0.9947215397954415,309,82,5,396
20173,bright,main,20211119,7,0.994813060400891,268,66,6,340
20173,bright,main,20211119,8,0.9895449490337851,325,56,8,389
20173,bright,main,20211119,9,0.9926886208905468,337,67,1,405
21934,bright,main,20211119,0,0.9878012285952664,361,65,4,430
21934,bright,main,20211119,1,0.9880475108626189,285,66,4,355
21934,bright,main,20211119,2,0.9911524890297734,353,66,7,426
21934,bright,main,20211119,3,0.9954503578351709,286,83,3,372
21934,bright,main,20211119,4,0.9908835292888875,322,56,4,382
21934,bright,main,20211119,5,0.9903420337726864,310,72,5,387
21934,bright,main,20211119,6,0.9903116425461285,328,74,9,411
21934,bright,main,20211119,7,0.9915884591469577,287,63,1,351
21934,bright,main,20211119,8,0.9930489217519959,297,89,7,393
21934,bright,main,20211119,9,0.9871014082885192,345,66,2,413
23990,bright,main,20211120,0,0.9941280418913235,327,105,8,440
23990,bright,main,20211120,1,0.993370038344084,314,58,1,373
23990,bright,main,20211120,2,0.9906681242474088,356,76,2,434
23990,bright,main,20211120,3,0.98812507836195,300,86,6,392
23990,bright,main,20211120,4,0.9963906288073804,348,51,1,400
23990,bright,main,20211120,5,0.993601368536448,314,90,3,407
23990,bright,main,20211120,6,0.9891831381911309,344,74,2,420
23990,bright,main,20211120,7,0.9894742728332259,292,71,3,366
23990,bright,main,20211120,8,0.9918506257354559,288,129,3,420
23990,bright,main,20211120,9,0.9789770447748993,276,137,6,419
82401,backup,special,20211120,0,0.9938244046475647,5,436,1,442
82401,backup,special,20211120,1,0.992568574971847,1,376,0,377
82401,backup,special,20211120,2,0.9895678632326003,1,436,0,437
82401,backup,special,20211120,3,0.9930281427584189,3,390,0,393
82401,backup,special,20211120,4,0.9902759273919997,3,402,0,405
82401,backup,special,20211120,5,0.983913937119991,2,411,1,414
82401,backup,special,20211120,6,0.9950230252144298,1,427,0,428
82401,backup,special,20211120,7,0.9869746309243113,0,373,0,373
82401,backup,special,20211120,8,0.9904946783817583,3,421,0,424
82401,backup,special,20211120,9,0.9926678582787553,0,432,0,432
23657,bright,main,20211120,0,0.9922895881940481,358,63,9,430
23657,bright,main,20211120,1,0.9859200096016354,275,93,3,371
23657,bright,main,20211120,2,0.9937808050171132,326,91,7,424
23657,bright,main,20211120,3,0.9913758431731673,257,128,3,388
23657,bright,main,20211120,4,0.989712661524262,275,114,5,394
23657,bright,main,20211120,5,0.9950623693614291,288,105,8,401
23657,bright,main,20211120,6,0.9949504417989524,271,133,5,409
23657,bright,main,20211120,7,0.9929326454526458,282,74,3,359
23657,bright,main,20211120,8,0.9932735601820998,329,79,7,415
23657,bright,main,20211120,9,0.9968567815701391,339,71,6,416
82260,bright,special,20211120,0,0.9820401856499926,160,74,5,239
82260,bright,special,20211120,1,0.976977233288538,96,33,1,130
82260,bright,special,20211120,2,0.9832075159852506,151,130,6,287
82260,bright,special,20211120,3,0.9915144023874004,124,126,3,253
82260,bright,special,20211120,4,0.9728030020510859,73,77,2,152
82260,bright,special,20211120,5,0.9912655305146837,126,163,8,297
82260,bright,special,20211120,6,0.9848560577096473,130,99,3,232
82260,bright,special,20211120,7,0.9806895071346181,123,109,8,240
82260,bright,special,20211120,8,0.9844796278099092,170,1,3,174
82260,bright,special,20211120,9,0.995235930649283,188,5,8,201
23664,bright,main,20211120,0,0.9927376390309411,309,121,1,431
23664,bright,main,20211120,1,0.9845491157840864,281,88,5,374
23664,bright,main,20211120,2,0.9924968954084528,308,115,2,425
23664,bright,main,20211120,3,0.9937013996793695,284,97,7,388
23664,bright,main,20211120,4,0.9932775114154158,249,149,3,401
23664,bright,main,20211120,5,0.9913862737371484,241,153,5,399
23664,bright,main,20211120,6,0.9921400302482561,236,175,9,420
23664,bright,main,20211120,7,0.9911645844200566,260,94,4,358
23664,bright,main,20211120,8,0.9909650520021103,321,89,7,417
23664,bright,main,20211120,9,0.9910554258734419,298,116,1,415
82261,bright,special,20211120,0,0.9841265993793218,347,87,4,438
82261,bright,special,20211120,1,0.9903022421350023,299,72,5,376
82261,bright,special,20211120,2,0.9955105414190907,342,89,4,435
82261,bright,special,20211120,3,0.9942179079259797,330,68,2,400
82261,bright,special,20211120,4,0.9887355523937519,342,46,4,392
82261,bright,special,20211120,5,0.991325079415944,348,60,7,415
82261,bright,special,20211120,6,0.9915927109231168,280,77,5,362
82261,bright,special,20211120,7,0.9954980400758161,293,69,3,365
82261,bright,special,20211120,8,0.9891585923986611,353,68,5,426
82261,bright,special,20211120,9,0.9919000692445856,369,59,3,431
21232,bright,main,20211120,0,0.986578967759955,345,75,7,427
21232,bright,main,20211120,1,0.9907527489727047,308,62,2,372
21232,bright,main,20211120,2,0.9930774498579337,385,41,5,431
21232,bright,main,20211120,3,0.9960050562837244,304,80,5,389
21232,bright,main,20211120,4,0.9934966857985296,283,105,7,395
21232,bright,main,20211120,5,0.9939860634457282,323,75,4,402
21232,bright,main,20211120,6,0.9927067552312312,369,46,4,419
21232,bright,main,20211120,7,0.9917508337663442,312,48,5,365
21232,bright,main,20211120,8,0.9927513866127416,327,89,5,421
21232,bright,main,20211120,9,0.9897925338120436,340,74,5,419
23675,bright,main,20211120,0,0.9881032043877542,308,118,3,429
23675,bright,main,20211120,1,0.9924386538082705,204,154,5,363
23675,bright,main,20211120,2,0.9934549054900703,295,129,5,429
23675,bright,main,20211120,3,0.992726296361329,272,121,3,396
23675,bright,main,20211120,4,0.993553774765376,295,102,4,401
23675,bright,main,20211120,5,0.9969490727423914,241,161,3,405
23675,bright,main,20211120,6,0.9917592413616617,283,127,7,417
23675,bright,main,20211120,7,0.9927571449752203,205,154,4,363
23675,bright,main,20211120,8,0.9934890945414152,214,193,10,417
23675,bright,main,20211120,9,0.9919762720319176,295,115,4,414
24403,bright,main,20211121,0,0.9950308945065824,310,121,7,438
24403,bright,main,20211121,1,0.9940833958202865,292,83,2,377
24403,bright,main,20211121,2,0.9962914674026235,285,142,7,434
24403,bright,main,20211121,3,0.9940583582357663,268,130,3,401
24403,bright,main,20211121,4,0.9907364785220936,292,107,3,402
24403,bright,main,20211121,5,0.9933880726612809,303,99,1,403
24403,bright,main,20211121,6,0.993110151822343,324,100,4,428
24403,bright,main,20211121,7,0.9961130397988279,273,90,4,367
24403,bright,main,20211121,8,0.9914104405965937,260,159,2,421
24403,bright,main,20211121,9,0.9943598067614112,295,124,4,423
24405,bright,main,20211121,0,0.9925352668400316,322,117,3,442
24405,bright,main,20211121,1,0.9937135564738679,281,96,4,381
24405,bright,main,20211121,2,0.9929831477273273,323,104,6,433
24405,bright,main,20211121,3,0.9925232002980703,307,86,5,398
24405,bright,main,20211121,4,0.9929232675528601,276,128,4,408
24405,bright,main,20211121,5,0.9931996743914069,263,139,7,409
24405,bright,main,20211121,6,0.9912703862155532,266,162,4,432
24405,bright,main,20211121,7,0.9907426578659876,288,82,2,372
24405,bright,main,20211121,8,0.9910941941836264,324,91,6,421
24405,bright,main,20211121,9,0.9910131952555119,318,103,4,425
23216,bright,main,20211121,0,0.9915847822713606,346,91,4,441
23216,bright,main,20211121,1,0.9889424683529877,243,138,5,386
23216,bright,main,20211121,2,0.9946970960784047,278,157,2,437
23216,bright,main,20211121,3,0.9834160830462719,289,104,6,399
23216,bright,main,20211121,4,0.9881855279657843,305,96,3,404
23216,bright,main,20211121,5,0.9883480388008171,305,107,2,414
23216,bright,main,20211121,6,0.9861870737650884,313,114,1,428
23216,bright,main,20211121,7,0.9928728666716532,290,79,4,373
23216,bright,main,20211121,8,0.9925930836180085,346,79,1,426
23216,bright,main,20211121,9,0.9922006590729184,357,67,3,427
23993,bright,main,20211122,0,0.9829850330039871,369,64,6,439
23993,bright,main,20211122,1,0.9868543803456529,302,67,2,371
23993,bright,main,20211122,2,0.9855835998892567,272,153,4,429
23993,bright,main,20211122,3,0.9913194256306017,224,161,5,390
23993,bright,main,20211122,4,0.9888761208149017,258,143,3,404
23993,bright,main,20211122,5,0.9923569039700505,253,152,6,411
23993,bright,main,20211122,6,0.9925152066685831,242,163,7,412
23993,bright,main,20211122,7,0.9933540685105804,260,102,5,367
23993,bright,main,20211122,8,0.9971405027926962,285,115,7,407
23993,bright,main,20211122,9,0.9887653530874327,315,103,5,423
23658,bright,main,20211122,0,0.9900564815638238,352,84,3,439
23658,bright,main,20211122,1,0.985824999102582,283,74,4,361
23658,bright,main,20211122,2,0.9951511071856823,294,128,2,424
23658,bright,main,20211122,3,0.991742989523912,253,141,3,397
23658,bright,main,20211122,4,0.9858716599570486,276,116,1,393
23658,bright,main,20211122,5,0.9895327629179412,282,122,8,412
23658,bright,main,20211122,6,0.9925109303268249,284,129,4,417
23658,bright,main,20211122,7,0.9930726386790099,248,100,8,356
23658,bright,main,20211122,8,0.9960738806999909,302,104,4,410
23658,bright,main,20211122,9,0.9750260754915482,313,92,6,411
20704,bright,main,20211125,0,0.9968704719981006,284,134,3,421
20704,bright,main,20211125,1,0.9930901810896722,245,133,4,382
20704,bright,main,20211125,2,0.9924172421749758,289,127,6,422
20704,bright,main,20211125,3,0.9931823078145436,286,105,2,393
20704,bright,main,20211125,4,0.9936371875523013,291,99,4,394
20704,bright,main,20211125,5,0.9943829300973054,313,79,3,395
20704,bright,main,20211125,6,0.9950426516712082,285,115,4,404
20704,bright,main,20211125,7,0.9901496821687863,285,72,1,358
20704,bright,main,20211125,8,0.9948240529980877,309,83,5,397
20704,bright,main,20211125,9,0.9961128118237017,278,139,3,420
22861,bright,main,20211125,0,0.9926664193171119,357,70,4,431
22861,bright,main,20211125,1,0.9965610773942556,308,81,4,393
22861,bright,main,20211125,2,0.989207109740426,335,91,2,428
22861,bright,main,20211125,3,0.990961451245187,305,78,5,388
22861,bright,main,20211125,4,0.9884413209579086,329,75,5,409
22861,bright,main,20211125,5,0.9936569709109204,310,89,3,402
22861,bright,main,20211125,6,0.9906015839644744,317,91,1,409
22861,bright,main,20211125,7,0.9958190630750875,286,77,5,368
22861,bright,main,20211125,8,0.994887764663938,312,92,2,406
22861,bright,main,20211125,9,0.9942537324342382,318,88,4,410
25995,bright,main,20211125,0,0.9929419046706103,317,118,6,441
25995,bright,main,20211125,1,0.9825721201941181,292,102,2,396
25995,bright,main,20211125,2,0.9923556319822318,332,92,6,430
25995,bright,main,20211125,3,0.9925785429024837,283,106,1,390
25995,bright,main,20211125,4,0.9947964820947967,269,129,3,401
25995,bright,main,20211125,5,0.9916729813635974,295,99,2,396
25995,bright,main,20211125,6,0.9962423480802437,320,95,4,419
25995,bright,main,20211125,7,0.9939514606606735,271,83,4,358
25995,bright,main,20211125,8,0.9937695789366611,316,89,6,411
25995,bright,main,20211125,9,0.9937860972913639,310,110,4,424
22892,bright,main,20211125,0,0.995012541149856,350,74,4,428
22892,bright,main,20211125,1,0.988120744542292,313,79,2,394
22892,bright,main,20211125,2,0.9953332098824004,361,61,3,425
22892,bright,main,20211125,3,0.9938897992461706,325,60,5,390
22892,bright,main,20211125,4,0.9923808202318792,341,60,1,402
22892,bright,main,20211125,5,0.989693037142809,317,78,5,400
22892,bright,main,20211125,6,0.9911014724680037,323,79,1,403
22892,bright,main,20211125,7,0.9951812350745244,280,78,3,361
22892,bright,main,20211125,8,0.9921774921390317,307,95,3,405
22892,bright,main,20211125,9,0.9912281046101086,321,83,4,408
22853,bright,main,20211125,0,0.9888977376757725,307,126,2,435
22853,bright,main,20211125,1,0.992563180969356,256,140,3,399
22853,bright,main,20211125,2,0.9960711902895195,335,96,5,436
22853,bright,main,20211125,3,0.9954750099996682,260,134,5,399
22853,bright,main,20211125,4,0.9931918350992801,282,128,4,414
22853,bright,main,20211125,5,0.9890049602387171,284,129,5,418
22853,bright,main,20211125,6,0.99406405192457,277,147,5,429
22853,bright,main,20211125,7,0.9908437642237624,216,143,6,365
22853,bright,main,20211125,8,0.9919512753135615,293,129,2,424
22853,bright,main,20211125,9,0.9922009923914354,337,88,3,428
20708,bright,main,20211125,0,0.98910879263335,201,105,6,312
20708,bright,main,20211125,1,0.9895507911112918,268,90,7,365
20708,bright,main,20211125,2,0.9857564465216186,322,89,2,413
20708,bright,main,20211125,3,0.9944773980916332,289,89,3,381
20708,bright,main,20211125,4,0.9934387044366136,262,84,6,352
20708,bright,main,20211125,5,0.9900977059633669,285,104,2,391
20708,bright,main,20211125,6,0.9909898639163001,277,109,3,389
20708,bright,main,20211125,7,0.9903438171145716,234,59,1,294
20708,bright,main,20211125,8,0.9951310231272125,293,86,5,384
20708,bright,main,20211125,9,0.990613336939729,259,141,9,409
42262,backup,main,20211125,0,0.9939086433802305,3,368,0,371
42262,backup,main,20211125,1,0.9912134384544696,0,328,2,330
42262,backup,main,20211125,2,0.9888193672854739,3,345,1,349
42262,backup,main,20211125,3,0.9955334175352821,2,323,1,326
42262,backup,main,20211125,4,0.9876165362368442,10,322,1,333
42262,backup,main,20211125,5,0.9874423522863548,9,339,1,349
42262,backup,main,20211125,6,0.9904382165981456,4,352,0,356
42262,backup,main,20211125,7,0.9931594365117395,2,317,3,322
42262,backup,main,20211125,8,0.9849932572568444,1,348,1,350
42262,backup,main,20211125,9,0.991636876922411,5,361,1,367
41690,backup,main,20211125,0,0.991727255199245,2,372,1,375
41690,backup,main,20211125,1,0.9947602351925173,3,336,1,340
41690,backup,main,20211125,2,0.9920237080836017,4,374,0,378
41690,backup,main,20211125,3,0.9907539657754924,4,344,0,348
41690,backup,main,20211125,4,0.9876234700822276,4,349,1,354
41690,backup,main,20211125,5,0.9937166751815538,2,320,1,323
41690,backup,main,20211125,6,0.9934066023882777,1,363,2,366
41690,backup,main,20211125,7,0.9825092792659843,3,317,1,321
41690,backup,main,20211125,8,0.986755084897856,5,351,1,357
41690,backup,main,20211125,9,0.9875598394490761,7,366,1,374
26015,bright,main,20211125,0,0.9919043708650336,345,86,6,437
26015,bright,main,20211125,1,0.9935389642752408,309,89,2,400
26015,bright,main,20211125,2,0.9901527533000456,339,91,6,436
26015,bright,main,20211125,3,0.9948877603451414,303,92,7,402
26015,bright,main,20211125,4,0.9938483476252109,297,113,1,411
26015,bright,main,20211125,5,0.993605171549378,298,104,4,406
26015,bright,main,20211125,6,0.9917997073692897,327,93,2,422
26015,bright,main,20211125,7,0.9936480499515504,248,113,3,364
26015,bright,main,20211125,8,0.9915493672356379,295,115,7,417
26015,bright,main,20211125,9,0.9948206350324627,321,104,5,430
42619,backup,main,20211125,0,0.9911729493866112,1,409,1,411
42619,backup,main,20211125,1,0.9925108831064896,2,374,1,377
42619,backup,main,20211125,2,0.9857646936372758,2,418,0,420
42619,backup,main,20211125,3,0.9929241181132424,5,384,0,389
42619,backup,main,20211125,4,0.988969744690039,1,399,3,403
42619,backup,main,20211125,5,0.9907335397899335,4,397,0,401
42619,backup,main,20211125,6,0.9942005987970521,5,400,0,405
42619,backup,main,20211125,7,0.9812119234565063,4,347,1,352
42619,backup,main,20211125,8,0.9884991217958415,2,393,1,396
42619,backup,main,20211125,9,0.9934032323793723,7,392,1,400
25389,bright,main,20211125,0,0.9946111793726933,257,152,9,418
25389,bright,main,20211125,1,0.9918400790881227,276,102,3,381
25389,bright,main,20211125,2,0.9922642753564127,300,119,7,426
25389,bright,main,20211125,3,0.9930953215243505,285,100,1,386
25389,bright,main,20211125,4,0.9858010834297639,327,64,6,397
25389,bright,main,20211125,5,0.9860026115623692,336,66,3,405
25389,bright,main,20211125,6,0.9957611894166805,323,92,4,419
25389,bright,main,20211125,7,0.9898591479248408,277,83,4,364
25389,bright,main,20211125,8,0.9905646492263295,268,131,6,405
25389,bright,main,20211125,9,0.9973303212467316,280,130,5,415
42263,backup,main,20211125,0,0.9864441518990303,4,277,2,283
42263,backup,main,20211125,1,0.9848645871518432,3,173,0,176
42263,backup,main,20211125,2,0.9831403259740494,9,342,0,351
42263,backup,main,20211125,3,0.9923121804553466,8,240,3,251
42263,backup,main,20211125,4,0.988856735727688,6,264,0,270
42263,backup,main,20211125,5,0.9893320048306274,4,298,0,302
42263,backup,main,20211125,6,0.9923414693693775,3,339,0,342
42263,backup,main,20211125,7,0.9901297327153066,6,288,1,295
42263,backup,main,20211125,8,0.9903165335866306,6,326,1,333
42263,backup,main,20211125,9,0.9943634220094336,6,334,0,340
42587,backup,main,20211125,0,0.9495083290535492,1,88,0,89
42587,backup,main,20211125,1,0.6913742480868106,1,11,0,12
42587,backup,main,20211125,2,0.9872868246524055,2,217,1,220
42587,backup,main,20211125,3,0.9769701949684403,6,143,0,149
42587,backup,main,20211125,4,0.9855180973134607,5,308,1,314
42587,backup,main,20211125,5,0.9849754678123712,4,147,0,151
42587,backup,main,20211125,6,0.9259546673305055,2,90,0,92
42587,backup,main,20211125,7,0.9758075386325213,4,293,1,298
42587,backup,main,20211125,8,0.9923435310063399,1,348,0,349
42587,backup,main,20211125,9,0.9917893750556692,5,213,1,219
5159,dark,main,20211126,0,0.9913466537861525,321,18,39,378
5159,dark,main,20211126,1,0.9840855829665712,290,15,39,344
5159,dark,main,20211126,2,0.9935053935982043,308,13,66,387
5159,dark,main,20211126,3,0.9951938732419146,274,14,58,346
5159,dark,main,20211126,4,0.9849107364988975,297,13,49,359
5159,dark,main,20211126,5,0.9931785865520107,301,13,43,357
5159,dark,main,20211126,6,0.9924123013124487,307,12,51,370
5159,dark,main,20211126,7,0.9924455486635418,271,10,41,322
5159,dark,main,20211126,8,0.9921686109873535,289,11,54,354
5159,dark,main,20211126,9,0.9913061971976831,315,12,44,371
2044,dark,main,20211126,0,0.9923472456240344,330,11,45,386
2044,dark,main,20211126,1,0.9928863370580965,289,13,49,351
2044,dark,main,20211126,2,0.9921478948929366,319,12,43,374
2044,dark,main,20211126,3,0.9922464993805595,301,13,35,349
2044,dark,main,20211126,4,0.991817823863359,287,16,62,365
2044,dark,main,20211126,5,0.9936663040015346,312,11,44,367
2044,dark,main,20211126,6,0.9865848822691623,282,12,72,366
2044,dark,main,20211126,7,0.9910440155825018,251,13,56,320
2044,dark,main,20211126,8,0.9809956739771748,285,12,53,350
2044,dark,main,20211126,9,0.9940326366953219,318,12,45,375
3797,dark,main,20211126,0,0.9927466133303355,297,13,82,392
3797,dark,main,20211126,1,0.9942322036175043,270,20,70,360
3797,dark,main,20211126,2,0.9942795139536494,316,15,53,384
3797,dark,main,20211126,3,0.9929421070127847,299,13,39,351
3797,dark,main,20211126,4,0.9886209801355422,290,16,51,357
3797,dark,main,20211126,5,0.9946676129262699,306,9,49,364
3797,dark,main,20211126,6,0.9863659732059095,291,11,54,356
3797,dark,main,20211126,7,0.9925499998887611,270,12,48,330
3797,dark,main,20211126,8,0.9902924638892122,292,13,81,386
3797,dark,main,20211126,9,0.9931468162927866,274,14,82,370
3602,dark,main,20211126,0,0.9948885085000384,280,15,97,392
3602,dark,main,20211126,1,0.9893303769526097,288,11,62,361
3602,dark,main,20211126,2,0.9899693310546647,296,12,62,370
3602,dark,main,20211126,3,0.9887922822860428,291,10,45,346
3602,dark,main,20211126,4,0.9864618931686266,296,12,43,351
3602,dark,main,20211126,5,0.9877781490970828,282,19,64,365
3602,dark,main,20211126,6,0.9842367590049889,310,11,59,380
3602,dark,main,20211126,7,0.9914805004538578,258,10,65,333
3602,dark,main,20211126,8,0.9950136890926258,271,13,88,372
3602,dark,main,20211126,9,0.9939101358117494,280,15,82,377
11700,dark,main,20211126,0,0.992768336954816,289,19,82,390
11700,dark,main,20211126,1,0.9854525242322186,250,14,90,354
11700,dark,main,20211126,2,0.991595664744605,277,18,87,382
11700,dark,main,20211126,3,0.982674525379942,244,16,90,350
11700,dark,main,20211126,4,0.9902059556979274,264,14,76,354
11700,dark,main,20211126,5,0.9957152884573033,277,18,73,368
11700,dark,main,20211126,6,0.991149813860345,270,10,101,381
11700,dark,main,20211126,7,0.9863382982060447,248,14,69,331
11700,dark,main,20211126,8,0.9864869618766836,275,16,85,376
11700,dark,main,20211126,9,0.993557644012666,262,12,97,371
11877,dark,main,20211126,0,0.993788564084585,292,12,69,373
11877,dark,main,20211126,1,0.9924085310847899,295,17,57,369
11877,dark,main,20211126,2,0.992599209762603,345,15,38,398
11877,dark,main,20211126,3,0.9897055393556045,313,9,47,369
11877,dark,main,20211126,4,0.9927007091570361,264,13,48,325
11877,dark,main,20211126,5,0.9920881970974471,331,15,32,378
11877,dark,main,20211126,6,0.9963065769960416,295,13,65,373
11877,dark,main,20211126,7,0.9906901264720485,261,12,53,326
11877,dark,main,20211126,8,0.9945635030642683,319,10,45,374
11877,dark,main,20211126,9,0.9930705575085538,308,9,52,369
22824,bright,main,20211126,0,0.9948566825553389,334,98,3,435
22824,bright,main,20211126,1,0.995203172823309,310,73,10,393
22824,bright,main,20211126,2,0.9924848709285986,313,111,3,427
22824,bright,main,20211126,3,0.9969194675917087,301,88,6,395
22824,bright,main,20211126,4,0.9867256813332662,267,123,7,397
22824,bright,main,20211126,5,0.9925827293742248,277,117,3,397
22824,bright,main,20211126,6,0.9956356020960193,270,151,4,425
22824,bright,main,20211126,7,0.9927007817277299,247,112,3,362
22824,bright,main,20211126,8,0.9884233864226682,336,76,4,416
22824,bright,main,20211126,9,0.9952215542967576,278,132,5,415
22831,bright,main,20211126,0,0.9941063706762737,266,172,2,440
22831,bright,main,20211126,1,0.9944547787717217,220,175,3,398
22831,bright,main,20211126,2,0.9960380211446923,203,213,6,422
22831,bright,main,20211126,3,0.9895501406238678,185,207,3,395
22831,bright,main,20211126,4,0.9963477410548226,222,181,4,407
22831,bright,main,20211126,5,0.9906809124769177,191,211,4,406
22831,bright,main,20211126,6,0.9947820018358459,219,199,4,422
22831,bright,main,20211126,7,0.9944282236278696,240,125,0,365
22831,bright,main,20211126,8,0.9945175117509384,299,114,3,416
22831,bright,main,20211126,9,0.9876139324429705,254,163,2,419
10100,dark,main,20211126,0,0.9913214803541904,305,13,72,390
10100,dark,main,20211126,1,0.9910412193738503,279,13,68,360
10100,dark,main,20211126,2,0.998078670549079,310,13,66,389
10100,dark,main,20211126,3,0.9889759449649772,273,12,65,350
10100,dark,main,20211126,4,0.9924651353210974,283,13,64,360
10100,dark,main,20211126,5,0.993277329924214,286,13,56,355
10100,dark,main,20211126,6,0.9917557232178409,306,15,72,393
10100,dark,main,20211126,7,0.9926504878209359,262,15,59,336
10100,dark,main,20211126,8,0.9929547775154354,264,12,99,375
10100,dark,main,20211126,9,0.9865846560686572,282,13,78,373
5083,dark,main,20211126,0,0.9908986797453045,292,15,83,390
5083,dark,main,20211126,1,0.9954804490397917,275,19,65,359
5083,dark,main,20211126,2,0.9928007132507443,277,15,97,389
5083,dark,main,20211126,3,0.9933818741138654,258,11,84,353
5083,dark,main,20211126,4,0.993576817739453,248,15,91,354
5083,dark,main,20211126,5,0.9840056298472438,243,21,94,358
5083,dark,main,20211126,6,0.9953279573481896,299,13,86,398
5083,dark,main,20211126,7,0.9923256700132617,238,13,77,328
5083,dark,main,20211126,8,0.9881582202707823,264,16,92,372
5083,dark,main,20211126,9,0.9885089586654138,288,22,71,381
7963,dark,main,20211126,0,0.9912647265719104,310,12,41,363
7963,dark,main,20211126,1,0.9910937639936529,290,12,44,346
7963,dark,main,20211126,2,0.989471635044921,317,17,38,372
7963,dark,main,20211126,3,0.9878883818928058,291,11,47,349
7963,dark,main,20211126,4,0.9955291608987932,275,12,53,340
7963,dark,main,20211126,5,0.988075223535218,304,16,31,351
7963,dark,main,20211126,6,0.9885215877086577,277,14,56,347
7963,dark,main,20211126,7,0.9944222033421688,287,10,33,330
7963,dark,main,20211126,8,0.9863598486542708,304,14,43,361
7963,dark,main,20211126,9,0.984342928842123,297,12,40,349
3867,dark,main,20211126,0,0.9923564207113545,323,14,64,401
3867,dark,main,20211126,1,0.9910370731022958,282,15,59,356
3867,dark,main,20211126,2,0.994794488809888,285,15,80,380
3867,dark,main,20211126,3,0.9862043153708275,268,19,69,356
3867,dark,main,20211126,4,0.9918028206796939,253,15,78,346
3867,dark,main,20211126,5,0.9930189061866178,283,13,64,360
3867,dark,main,20211126,6,0.9928271776307206,279,24,81,384
3867,dark,main,20211126,7,0.9892099982965996,237,16,70,323
3867,dark,main,20211126,8,0.9927432890150084,284,13,76,373
3867,dark,main,20211126,9,0.9872486503608993,300,12,50,362
24394,bright,main,20211126,0,0.9893131770952069,330,97,9,436
24394,bright,main,20211126,1,0.9913459300158087,286,106,8,400
24394,bright,main,20211126,2,0.9946318448975342,322,112,5,439
24394,bright,main,20211126,3,0.9945124121347845,259,137,4,400
24394,bright,main,20211126,4,0.9861971576000385,298,97,4,399
24394,bright,main,20211126,5,0.9911484394537249,328,85,2,415
24394,bright,main,20211126,6,0.9961865612275711,355,73,2,430
24394,bright,main,20211126,7,0.9948036250356704,314,53,2,369
24394,bright,main,20211126,8,0.990300377939246,310,108,7,425
24394,bright,main,20211126,9,0.9907080725748544,313,104,6,423
3905,dark,main,20211126,0,0.9904783611894719,289,16,101,406
3905,dark,main,20211126,1,0.9862519236348144,277,15,66,358
3905,dark,main,20211126,2,0.9911059596433464,282,12,78,372
3905,dark,main,20211126,3,0.9891908367343076,272,10,76,358
3905,dark,main,20211126,4,0.9920629118945663,289,10,51,350
3905,dark,main,20211126,5,0.9885621395446063,273,18,77,368
3905,dark,main,20211126,6,0.9909835708072449,266,14,96,376
3905,dark,main,20211126,7,0.9888964729508503,256,11,72,339
3905,dark,main,20211126,8,0.9848865731629621,273,12,75,360
3905,dark,main,20211126,9,0.9890196327924682,287,14,76,377
9847,dark,main,20211126,0,0.9911816672861099,317,12,44,373
9847,dark,main,20211126,1,0.9895661102455814,270,12,60,342
9847,dark,main,20211126,2,0.9947137326481267,305,12,54,371
9847,dark,main,20211126,3,0.990536083536663,291,11,39,341
9847,dark,main,20211126,4,0.9875102025653164,303,15,40,358
9847,dark,main,20211126,5,0.994623985373537,280,12,62,354
9847,dark,main,20211126,6,0.9926759527377652,292,14,82,388
9847,dark,main,20211126,7,0.9904415116959772,249,12,48,309
9847,dark,main,20211126,8,0.9907485248007116,306,12,41,359
9847,dark,main,20211126,9,0.9906451000315424,303,13,54,370
1688,dark,main,20211126,0,0.9905036523556864,300,11,67,378
1688,dark,main,20211126,1,0.993970631346506,266,15,63,344
1688,dark,main,20211126,2,0.986967760159915,308,15,57,380
1688,dark,main,20211126,3,0.9927945035085154,297,12,42,351
1688,dark,main,20211126,4,0.9856454557440146,273,11,46,330
1688,dark,main,20211126,5,0.9881030108395369,286,12,66,364
1688,dark,main,20211126,6,0.990478781782437,294,11,51,356
1688,dark,main,20211126,7,0.9904087205897906,265,15,48,328
1688,dark,main,20211126,8,0.989929072283694,273,12,81,366
1688,dark,main,20211126,9,0.9919585219709806,259,23,75,357
7045,dark,main,20211126,0,0.994484812444775,306,19,77,402
7045,dark,main,20211126,1,0.9948452511603824,284,11,60,355
7045,dark,main,20211126,2,0.9962526183414575,301,13,78,392
7045,dark,main,20211126,3,0.9907481967189882,271,18,47,336
7045,dark,main,20211126,4,0.9921490597613997,273,13,49,335
7045,dark,main,20211126,5,0.9926703783076669,280,14,76,370
7045,dark,main,20211126,6,0.9932749798264942,285,14,71,370
7045,dark,main,20211126,7,0.989604512582954,247,15,77,339
7045,dark,main,20211126,8,0.9919477172239828,274,19,76,369
7045,dark,main,20211126,9,0.9951399082481599,281,21,71,373
22836,bright,main,20211126,0,0.9919977706185545,352,80,5,437
22836,bright,main,20211126,1,0.9918213204012071,308,79,1,388
22836,bright,main,20211126,2,0.9932594475991582,290,133,5,428
22836,bright,main,20211126,3,0.9909234596920298,246,140,2,388
22836,bright,main,20211126,4,0.9955263515085325,234,166,2,402
22836,bright,main,20211126,5,0.9948387246932894,286,118,1,405
22836,bright,main,20211126,6,0.9938696034278717,313,103,4,420
22836,bright,main,20211126,7,0.9909910649069357,298,70,2,370
22836,bright,main,20211126,8,0.992411177472536,329,86,3,418
22836,bright,main,20211126,9,0.998011908691341,316,94,3,413
5160,dark,main,20211126,0,0.9945368852581215,297,12,80,389
5160,dark,main,20211126,1,0.9920853821243191,267,12,73,352
5160,dark,main,20211126,2,0.9933631749409442,299,13,48,360
5160,dark,main,20211126,3,0.9879526701132576,296,10,36,342
5160,dark,main,20211126,4,0.9872998055663305,282,13,44,339
5160,dark,main,20211126,5,0.992441215141837,289,9,59,357
5160,dark,main,20211126,6,0.9912775052042728,296,18,53,367
5160,dark,main,20211126,7,0.9881173029594164,285,14,41,340
5160,dark,main,20211126,8,0.9866862171606235,272,11,92,375
5160,dark,main,20211126,9,0.9908480787495989,298,12,73,383
7171,dark,main,20211126,0,0.9856301532993708,299,18,91,408
7171,dark,main,20211126,1,0.9939745492022184,303,14,47,364
7171,dark,main,20211126,2,0.9802590478023859,324,10,41,375
7171,dark,main,20211126,3,0.9905340471900075,299,13,37,349
7171,dark,main,20211126,4,0.9830058414549866,301,12,33,346
7171,dark,main,20211126,5,0.9909394747576388,302,11,62,375
7171,dark,main,20211126,6,0.9934432039129298,279,15,100,394
7171,dark,main,20211126,7,0.9924939803602154,240,17,64,321
7171,dark,main,20211126,8,0.9919056726127745,255,16,78,349
7171,dark,main,20211126,9,0.995655451680009,270,16,69,355
11649,dark,main,20211127,0,0.9908683279696228,322,13,56,391
11649,dark,main,20211127,1,0.993222569292584,284,13,60,357
11649,dark,main,20211127,2,0.9914913852575452,304,17,69,390
11649,dark,main,20211127,3,0.9904857964315512,244,19,84,347
11649,dark,main,20211127,4,0.9926864573535342,266,15,73,354
11649,dark,main,20211127,5,0.9895216772143797,243,22,92,357
11649,dark,main,20211127,6,0.9914850073818766,287,20,75,382
11649,dark,main,20211127,7,0.9895080760239655,252,15,66,333
11649,dark,main,20211127,8,0.9901411622018769,274,24,80,378
11649,dark,main,20211127,9,0.9961739028596881,307,13,54,374
5518,dark,main,20211127,0,0.9877123593734998,301,17,79,397
5518,dark,main,20211127,1,0.9961124054389956,256,16,78,350
5518,dark,main,20211127,2,0.9941741935267424,313,13,55,381
5518,dark,main,20211127,3,0.991392798150181,287,14,48,349
5518,dark,main,20211127,4,0.9858176920305893,264,16,47,327
5518,dark,main,20211127,5,0.990856038218681,298,13,44,355
5518,dark,main,20211127,6,0.9924883914644426,314,13,49,376
5518,dark,main,20211127,7,0.9939613867871191,267,19,50,336
5518,dark,main,20211127,8,0.9905040640472069,286,24,59,369
5518,dark,main,20211127,9,0.9879357862999435,267,17,100,384
6930,dark,main,20211127,0,0.9957147814676791,325,16,47,388
6930,dark,main,20211127,1,0.9941717662862537,291,10,47,348
6930,dark,main,20211127,2,0.9878427859851526,323,9,50,382
6930,dark,main,20211127,3,0.9929731534620965,259,17,70,346
6930,dark,main,20211127,4,0.9839865693279852,300,12,40,352
6930,dark,main,20211127,5,0.9918910667927497,310,10,41,361
6930,dark,main,20211127,6,0.9941395678832438,299,12,48,359
6930,dark,main,20211127,7,0.9873647229550827,272,11,40,323
6930,dark,main,20211127,8,0.9943293164761836,304,15,43,362
6930,dark,main,20211127,9,0.9934801521685315,322,12,56,390
3816,dark,main,20211127,0,0.9925835258558707,289,16,87,392
3816,dark,main,20211127,1,0.9938115700246717,245,26,75,346
3816,dark,main,20211127,2,0.9927786755757043,270,16,98,384
3816,dark,main,20211127,3,0.9911872169209538,238,22,91,351
3816,dark,main,20211127,4,0.9837947525398788,268,22,47,337
3816,dark,main,20211127,5,0.9856237397038347,275,19,73,367
3816,dark,main,20211127,6,0.9910789393454983,289,14,55,358
3816,dark,main,20211127,7,0.9890119725887258,210,23,73,306
3816,dark,main,20211127,8,0.9879413220497593,295,14,64,373
3816,dark,main,20211127,9,0.991530734073346,305,24,52,381
5074,dark,main,20211127,0,0.9867286860935409,288,13,103,404
5074,dark,main,20211127,1,0.9939951115800528,250,11,81,342
5074,dark,main,20211127,2,0.9950816346592671,286,13,86,385
5074,dark,main,20211127,3,0.9866745230973122,276,15,78,369
5074,dark,main,20211127,4,0.9954482595550391,273,14,79,366
5074,dark,main,20211127,5,0.9894071012908179,258,14,82,354
5074,dark,main,20211127,6,0.9885375855009546,281,11,107,399
5074,dark,main,20211127,7,0.9886997442673793,254,13,73,340
5074,dark,main,20211127,8,0.9883481241709673,272,17,88,377
5074,dark,main,20211127,9,0.9937462370277603,262,14,92,368
5360,dark,main,20211127,0,0.9927265897959556,313,11,56,380
5360,dark,main,20211127,1,0.9893056470566002,288,12,48,348
5360,dark,main,20211127,2,0.9912514869355068,302,12,58,372
5360,dark,main,20211127,3,0.9901366075123372,258,15,78,351
5360,dark,main,20211127,4,0.9909823740721745,262,29,75,366
5360,dark,main,20211127,5,0.9932979471450883,261,22,88,371
5360,dark,main,20211127,6,0.9886743846204032,282,15,84,381
5360,dark,main,20211127,7,0.9933786171118958,239,15,77,331
5360,dark,main,20211127,8,0.9892267200924172,302,13,57,372
5360,dark,main,20211127,9,0.9907094743059712,298,14,48,360
23453,bright,main,20211127,0,0.9955725883852018,211,222,5,438
23453,bright,main,20211127,1,0.9858094468194242,129,269,2,400
23453,bright,main,20211127,2,0.9867148569930193,197,233,2,432
23453,bright,main,20211127,3,0.9964315788462798,160,234,6,400
23453,bright,main,20211127,4,0.9961652804921162,133,269,3,405
23453,bright,main,20211127,5,0.9912607569567247,115,299,2,416
23453,bright,main,20211127,6,0.9952644911538636,93,333,2,428
23453,bright,main,20211127,7,0.9906995967484242,69,303,2,374
23453,bright,main,20211127,8,0.9939500388671787,175,249,5,429
23453,bright,main,20211127,9,0.9906220728771942,204,213,6,423
8288,dark,main,20211127,0,0.9930148109100173,322,19,42,383
8288,dark,main,20211127,1,0.9890895808005568,289,15,46,350
8288,dark,main,20211127,2,0.992310045978933,291,11,71,373
8288,dark,main,20211127,3,0.9922253841673259,287,10,64,361
8288,dark,main,20211127,4,0.9855800611244817,305,12,55,372
8288,dark,main,20211127,5,0.9961130773697251,308,9,52,369
8288,dark,main,20211127,6,0.9951699166598961,311,13,57,381
8288,dark,main,20211127,7,0.9949168545335215,254,15,49,318
8288,dark,main,20211127,8,0.9916100151304751,311,12,54,377
8288,dark,main,20211127,9,0.9875929335609231,308,10,44,362
8227,dark,main,20211127,0,0.9885486642304012,274,17,100,391
8227,dark,main,20211127,1,0.9867392607721192,264,12,69,345
8227,dark,main,20211127,2,0.989272058255497,291,16,77,384
8227,dark,main,20211127,3,0.9894433896336049,249,15,84,348
8227,dark,main,20211127,4,0.9838758645075789,258,16,81,355
8227,dark,main,20211127,5,0.9855981617902554,265,14,93,372
8227,dark,main,20211127,6,0.9934806491396203,289,13,80,382
8227,dark,main,20211127,7,0.984135683369905,227,12,93,332
8227,dark,main,20211127,8,0.9913700733057565,273,16,79,368
8227,dark,main,20211127,9,0.9951541680084331,275,20,84,379
4837,dark,main,20211127,0,0.9850260753828537,311,12,64,387
4837,dark,main,20211127,1,0.9949357614664477,278,13,50,341
4837,dark,main,20211127,2,0.9930722449687649,305,14,50,369
4837,dark,main,20211127,3,0.991865159606845,305,10,32,347
4837,dark,main,20211127,4,0.988088191978893,292,10,51,353
4837,dark,main,20211127,5,0.9913982868509228,281,14,53,348
4837,dark,main,20211127,6,0.9824833831633089,299,11,55,365
4837,dark,main,20211127,7,0.9917095764488822,266,11,45,322
4837,dark,main,20211127,8,0.9957607235731702,301,13,50,364
4837,dark,main,20211127,9,0.9904037498264346,305,11,44,360
5163,dark,main,20211127,0,0.9904728727297537,302,13,47,362
5163,dark,main,20211127,1,0.9891525314770602,286,11,49,346
5163,dark,main,20211127,2,0.9925806275314936,298,15,54,367
5163,dark,main,20211127,3,0.9907439919559943,286,10,52,348
5163,dark,main,20211127,4,0.9799823327343574,279,10,44,333
5163,dark,main,20211127,5,0.9903228847314045,293,15,43,351
5163,dark,main,20211127,6,0.9924328079504848,314,10,54,378
5163,dark,main,20211127,7,0.9904961886680378,276,10,40,326
5163,dark,main,20211127,8,0.9899743612397303,322,12,42,376
5163,dark,main,20211127,9,0.9942577978710775,324,10,40,374
9520,dark,main,20211127,0,0.991571081139679,314,12,46,372
9520,dark,main,20211127,1,0.9822122091553305,287,14,47,348
9520,dark,main,20211127,2,0.9914980818324814,326,11,47,384
9520,dark,main,20211127,3,0.9929548813396322,275,13,57,345
9520,dark,main,20211127,4,0.9900629178652536,283,17,53,353
9520,dark,main,20211127,5,0.9833457101556919,269,13,75,357
9520,dark,main,20211127,6,0.9930489399946817,320,10,49,379
9520,dark,main,20211127,7,0.9880215234477207,254,11,42,307
9520,dark,main,20211127,8,0.9861671274614257,305,13,52,370
9520,dark,main,20211127,9,0.9911610376516,298,12,56,366
5132,dark,main,20211127,0,0.9900907784878551,303,15,74,392
5132,dark,main,20211127,1,0.9933518565258201,287,13,58,358
5132,dark,main,20211127,2,0.9906315810998356,312,15,57,384
5132,dark,main,20211127,3,0.9905447568117892,264,15,68,347
5132,dark,main,20211127,4,0.9940845646914508,295,8,62,365
5132,dark,main,20211127,5,0.9934638919693763,294,10,50,354
5132,dark,main,20211127,6,0.9887446062019204,290,12,58,360
5132,dark,main,20211127,7,0.9858139782855138,254,11,51,316
5132,dark,main,20211127,8,0.9926364957738195,300,12,54,366
5132,dark,main,20211127,9,0.9910589537733279,305,17,59,381
11647,dark,main,20211127,0,0.9899125987951276,300,12,78,390
11647,dark,main,20211127,1,0.9804415772091779,256,16,71,343
11647,dark,main,20211127,2,0.9897721408605901,290,26,75,391
11647,dark,main,20211127,3,0.9897026085920971,263,19,79,361
11647,dark,main,20211127,4,0.9912889016036558,265,11,80,356
11647,dark,main,20211127,5,0.993983230073285,286,15,60,361
11647,dark,main,20211127,6,0.9930176836682877,285,14,71,370
11647,dark,main,20211127,7,0.9905429544537927,257,13,53,323
11647,dark,main,20211127,8,0.9929458958500842,287,20,70,377
11647,dark,main,20211127,9,0.9966940570163457,292,18,50,360
8743,dark,main,20211127,0,0.9928692907255877,308,8,57,373
8743,dark,main,20211127,1,0.9902140612004957,307,12,50,369
8743,dark,main,20211127,2,0.9956616884388726,332,12,60,404
8743,dark,main,20211127,3,0.9965969418528798,282,11,71,364
8743,dark,main,20211127,4,0.9818517418328788,274,11,45,330
8743,dark,main,20211127,5,0.9890527296835963,306,14,43,363
8743,dark,main,20211127,6,0.9946543473677578,322,13,38,373
8743,dark,main,20211127,7,0.9956637245226405,290,12,34,336
8743,dark,main,20211127,8,0.9892710882197303,307,15,41,363
8743,dark,main,20211127,9,0.9930388434669786,307,15,48,370
11427,dark,main,20211127,0,0.9946617734982647,296,12,77,385
11427,dark,main,20211127,1,0.9916667636765343,271,13,63,347
11427,dark,main,20211127,2,0.9931598324061194,324,13,47,384
11427,dark,main,20211127,3,0.9949252517353208,271,13,46,330
11427,dark,main,20211127,4,0.9894355729330837,287,10,46,343
11427,dark,main,20211127,5,0.9928049343398382,309,11,27,347
11427,dark,main,20211127,6,0.9858473937334996,307,11,48,366
11427,dark,main,20211127,7,0.9948705905167055,260,12,47,319
11427,dark,main,20211127,8,0.9915593856748465,305,11,51,367
11427,dark,main,20211127,9,0.9893078779929418,292,13,55,360
6653,dark,main,20211127,0,0.9920723972892938,287,13,98,398
6653,dark,main,20211127,1,0.9853762415794931,254,12,89,355
6653,dark,main,20211127,2,0.9904539435518994,278,14,94,386
6653,dark,main,20211127,3,0.9884419864377794,270,13,73,356
6653,dark,main,20211127,4,0.9901662106510969,276,17,68,361
6653,dark,main,20211127,5,0.9943369080512896,294,16,66,376
6653,dark,main,20211127,6,0.9899014702533709,263,16,92,371
6653,dark,main,20211127,7,0.9865819467709798,259,12,67,338
6653,dark,main,20211127,8,0.9936834384311252,280,20,94,394
6653,dark,main,20211127,9,0.9869352800353816,271,16,86,373
6755,dark,main,20211127,0,0.9935237918453157,312,13,68,393
6755,dark,main,20211127,1,0.9951307930255598,269,12,55,336
6755,dark,main,20211127,2,0.9960134561481655,315,10,48,373
6755,dark,main,20211127,3,0.991011088095108,278,12,48,338
6755,dark,main,20211127,4,0.9822767438749369,270,12,52,334
6755,dark,main,20211127,5,0.9944711700418064,268,12,62,342
6755,dark,main,20211127,6,0.9904996242340933,281,11,78,370
6755,dark,main,20211127,7,0.9905373389918055,255,14,56,325
6755,dark,main,20211127,8,0.9910941738832617,288,12,66,366
6755,dark,main,20211127,9,0.9933851362503179,302,11,64,377
7959,dark,main,20211127,0,0.9890164068045181,296,13,60,369
7959,dark,main,20211127,1,0.9930721334294459,288,12,33,333
7959,dark,main,20211127,2,0.9899572115062627,319,12,43,374
7959,dark,main,20211127,3,0.9830461201473403,283,14,53,350
7959,dark,main,20211127,4,0.9856203139364769,307,14,30,351
7959,dark,main,20211127,5,0.9946430248292171,316,12,34,362
7959,dark,main,20211127,6,0.9964541989770603,324,12,42,378
7959,dark,main,20211127,7,0.9923914877115139,266,15,45,326
7959,dark,main,20211127,8,0.9889946940852631,293,13,50,356
7959,dark,main,20211127,9,0.9920713048236456,310,14,41,365
7173,dark,main,20211127,0,0.9898670706727034,312,10,46,368
7173,dark,main,20211127,1,0.9904532136632879,286,16,54,356
7173,dark,main,20211127,2,0.9945922469065068,311,12,62,385
7173,dark,main,20211127,3,0.9954855205436638,298,11,40,349
7173,dark,main,20211127,4,0.987627745122626,286,14,47,347
7173,dark,main,20211127,5,0.988212268993559,292,10,76,378
7173,dark,main,20211127,6,0.9879133377645182,310,16,40,366
7173,dark,main,20211127,7,0.9894085508934946,282,13,43,338
7173,dark,main,20211127,8,0.9930036444265755,295,14,52,361
7173,dark,main,20211127,9,0.9904762628070674,330,10,47,387
5162,dark,main,20211127,0,0.9889382537300606,319,14,49,382
5162,dark,main,20211127,1,0.9964395291297587,293,11,42,346
5162,dark,main,20211127,2,0.9890601718524774,317,14,57,388
5162,dark,main,20211127,3,0.9900626149814008,290,12,46,348
5162,dark,main,20211127,4,0.9889319653409122,273,12,44,329
5162,dark,main,20211127,5,0.9873304829778841,313,13,46,372
5162,dark,main,20211127,6,0.994343386456966,323,12,51,386
5162,dark,main,20211127,7,0.9862362433590706,281,12,35,328
5162,dark,main,20211127,8,0.9960311428346735,315,13,53,381
5162,dark,main,20211127,9,0.9902186591140987,306,16,52,374
6752,dark,main,20211127,0,0.9916574269159669,298,12,77,387
6752,dark,main,20211127,1,0.9900654414818204,299,10,52,361
6752,dark,main,20211127,2,0.9875061342105496,325,13,44,382
6752,dark,main,20211127,3,0.9924322621197871,269,12,59,340
6752,dark,main,20211127,4,0.9939884772242854,298,13,54,365
6752,dark,main,20211127,5,0.9954883955565913,290,11,57,358
6752,dark,main,20211127,6,0.994581639209079,286,13,86,385
6752,dark,main,20211127,7,0.9851153199267598,253,16,55,324
6752,dark,main,20211127,8,0.9956274380148188,287,15,74,376
6752,dark,main,20211127,9,0.9940796071045694,278,13,90,381
21878,bright,main,20211127,0,0.9940555648239261,184,253,5,442
21878,bright,main,20211127,1,0.9846645975142854,177,219,2,398
21878,bright,main,20211127,2,0.9858507438104239,160,272,1,433
21878,bright,main,20211127,3,0.9926434316873041,121,278,3,402
21878,bright,main,20211127,4,0.997353796951701,110,287,6,403
21878,bright,main,20211127,5,0.9923993791428735,122,286,6,414
21878,bright,main,20211127,6,0.9930392600185063,173,246,5,424
21878,bright,main,20211127,7,0.9953081548026905,162,209,4,375
21878,bright,main,20211127,8,0.9945138235147288,212,214,3,429
21878,bright,main,20211127,9,0.9945806006173139,197,227,3,427
11085,dark,main,20211127,0,0.9907291283042352,308,11,71,390
11085,dark,main,20211127,1,0.9845142063303971,274,12,61,347
11085,dark,main,20211127,2,0.995372934670787,304,11,67,382
11085,dark,main,20211127,3,0.9877196105705085,242,15,68,325
11085,dark,main,20211127,4,0.9819869616158594,214,11,77,302
11085,dark,main,20211127,5,0.9917205690705218,267,10,80,357
11085,dark,main,20211127,6,0.9944046690121765,305,12,62,379
11085,dark,main,20211127,7,0.9914078335678335,269,14,45,328
11085,dark,main,20211127,8,0.9871736730089763,280,13,87,380
11085,dark,main,20211127,9,0.992434783683159,323,16,52,391
5052,dark,main,20211127,0,0.9937970629630695,305,13,76,394
5052,dark,main,20211127,1,0.9902360155442039,259,11,82,352
5052,dark,main,20211127,2,0.983839895120782,279,11,98,388
5052,dark,main,20211127,3,0.990948203858018,261,12,82,355
5052,dark,main,20211127,4,0.9885501150468327,265,12,85,362
5052,dark,main,20211127,5,0.9923997863968806,290,16,75,381
5052,dark,main,20211127,6,0.9918649650435356,271,14,106,391
5052,dark,main,20211127,7,0.9867504421263082,238,13,75,326
5052,dark,main,20211127,8,0.9936781444627062,258,13,99,370
5052,dark,main,20211127,9,0.9943040255440552,271,12,90,373
5567,dark,main,20211127,0,0.9929324482032034,291,9,102,402
5567,dark,main,20211127,1,0.9956355685537369,272,12,57,341
5567,dark,main,20211127,2,0.9881479608237872,335,15,40,390
5567,dark,main,20211127,3,0.9937370128130273,317,11,37,365
5567,dark,main,20211127,4,0.996216153307971,314,12,39,365
5567,dark,main,20211127,5,0.9946769981873573,319,13,43,375
5567,dark,main,20211127,6,0.9880041685578866,315,13,49,377
5567,dark,main,20211127,7,0.9930971394625745,272,14,51,337
5567,dark,main,20211127,8,0.9939375483912471,307,14,49,370
5567,dark,main,20211127,9,0.9918194023504807,291,15,62,368
22381,bright,main,20211127,0,0.9920140721246423,201,237,2,440
22381,bright,main,20211127,1,0.9893066467990222,237,157,4,398
22381,bright,main,20211127,2,0.9942013452375826,227,207,4,438
22381,bright,main,20211127,3,0.9876960314912935,125,272,5,402
22381,bright,main,20211127,4,0.9939210703985403,160,242,3,405
22381,bright,main,20211127,5,0.980674836492513,143,272,1,416
22381,bright,main,20211127,6,0.9957312102442847,151,271,1,423
22381,bright,main,20211127,7,0.9915129402197902,181,185,3,369
22381,bright,main,20211127,8,0.9950359318016887,251,173,1,425
22381,bright,main,20211127,9,0.9916292406408249,171,251,3,425
7041,dark,main,20211127,0,0.9862303121348561,265,14,101,380
7041,dark,main,20211127,1,0.9923353566266456,250,13,80,343
7041,dark,main,20211127,2,0.9955439743670382,278,12,94,384
7041,dark,main,20211127,3,0.9935988205702085,262,13,77,352
7041,dark,main,20211127,4,0.9950124721721596,268,12,82,362
7041,dark,main,20211127,5,0.9910641539477634,265,13,86,364
7041,dark,main,20211127,6,0.9903885518906584,274,17,99,390
7041,dark,main,20211127,7,0.9882984526317398,231,10,88,329
7041,dark,main,20211127,8,0.9891360200882835,262,11,99,372
7041,dark,main,20211127,9,0.98944039543899,266,16,95,377
3809,dark,main,20211127,0,0.9942835696227946,302,18,46,366
3809,dark,main,20211127,1,0.9898697629280939,288,12,43,343
3809,dark,main,20211127,2,0.9934699555662619,300,16,45,361
3809,dark,main,20211127,3,0.996109028986986,300,11,41,352
3809,dark,main,20211127,4,0.9884200893897015,284,11,51,346
3809,dark,main,20211127,5,0.9901507872547921,282,20,56,358
3809,dark,main,20211127,6,0.9894718651041958,314,10,45,369
3809,dark,main,20211127,7,0.9921535914101215,260,10,52,322
3809,dark,main,20211127,8,0.9940344321604019,297,12,53,362
3809,dark,main,20211127,9,0.9901767938369761,291,10,48,349
5053,dark,main,20211127,0,0.9920960458432702,272,15,113,400
5053,dark,main,20211127,1,0.9897310157270605,273,13,75,361
5053,dark,main,20211127,2,0.9910109277040012,281,16,82,379
5053,dark,main,20211127,3,0.9956154280847114,251,13,81,345
5053,dark,main,20211127,4,0.9890805818506558,256,12,79,347
5053,dark,main,20211127,5,0.9944914636510745,287,13,81,381
5053,dark,main,20211127,6,0.9909377072701632,289,13,83,385
5053,dark,main,20211127,7,0.9890148457951021,238,12,81,331
5053,dark,main,20211127,8,0.9901798965369659,273,16,77,366
5053,dark,main,20211127,9,0.9939176740712763,272,18,84,374
6665,dark,main,20211127,0,0.9859503509189539,285,12,98,395
6665,dark,main,20211127,1,0.9911250832140807,232,14,99,345
6665,dark,main,20211127,2,0.9898808422798677,275,13,93,381
6665,dark,main,20211127,3,0.9949573539189411,257,18,72,347
6665,dark,main,20211127,4,0.9943682399397842,239,11,99,349
6665,dark,main,20211127,5,0.9916028908971908,276,12,87,375
6665,dark,main,20211127,6,0.9897198381509055,277,14,92,383
6665,dark,main,20211127,7,0.9926147935435068,232,11,91,334
6665,dark,main,20211127,8,0.994054146160257,297,11,85,393
6665,dark,main,20211127,9,0.9838268476713111,266,11,99,376
9859,dark,main,20211128,0,0.9961429086725974,329,11,54,394
9859,dark,main,20211128,1,0.9938800447771312,286,11,42,339
9859,dark,main,20211128,2,0.9939843791556764,323,11,47,381
9859,dark,main,20211128,3,0.9932038490010853,296,11,46,353
9859,dark,main,20211128,4,0.9936418857371221,298,11,50,359
9859,dark,main,20211128,5,0.994521151092114,285,12,59,356
9859,dark,main,20211128,6,0.9946402407638881,294,12,62,368
9859,dark,main,20211128,7,0.9936524692607901,262,11,48,321
9859,dark,main,20211128,8,0.9960047546422582,329,10,43,382
9859,dark,main,20211128,9,0.9921761738321723,333,13,47,393
9526,dark,main,20211128,0,0.9945602207004592,307,15,45,367
9526,dark,main,20211128,1,0.9917634406105873,295,14,43,352
9526,dark,main,20211128,2,0.9888690954971306,312,15,41,368
9526,dark,main,20211128,3,0.9875803592474977,300,11,42,353
9526,dark,main,20211128,4,0.9915485550964885,271,14,43,328
9526,dark,main,20211128,5,0.9880678147948921,285,11,44,340
9526,dark,main,20211128,6,0.9913641928809943,305,12,41,358
9526,dark,main,20211128,7,0.9932220067629175,274,13,39,326
9526,dark,main,20211128,8,0.9938824167216322,307,14,47,368
9526,dark,main,20211128,9,0.9932060921774547,321,9,44,374
5506,dark,main,20211128,0,0.9940431955301173,319,14,44,377
5506,dark,main,20211128,1,0.9929478447648733,314,15,37,366
5506,dark,main,20211128,2,0.9954480515464068,289,21,59,369
5506,dark,main,20211128,3,0.9904125169092689,255,18,77,350
5506,dark,main,20211128,4,0.9946342773323594,271,14,72,357
5506,dark,main,20211128,5,0.9934819754569036,265,20,92,377
5506,dark,main,20211128,6,0.9841486724866014,263,17,85,365
5506,dark,main,20211128,7,0.9909438347363294,241,18,73,332
5506,dark,main,20211128,8,0.9923630040868698,287,16,68,371
5506,dark,main,20211128,9,0.9828954554835165,311,15,52,378
9195,dark,main,20211128,0,0.9956299668340358,289,13,83,385
9195,dark,main,20211128,1,0.9934486070297781,251,16,91,358
9195,dark,main,20211128,2,0.9898428151030465,248,18,103,369
9195,dark,main,20211128,3,0.9915270773440414,272,14,64,350
9195,dark,main,20211128,4,0.9870337362499573,258,14,91,363
9195,dark,main,20211128,5,0.9933303880219636,281,14,79,374
9195,dark,main,20211128,6,0.992959139941455,291,14,77,382
9195,dark,main,20211128,7,0.993954877808202,252,14,82,348
9195,dark,main,20211128,8,0.9914484835923564,291,12,83,386
9195,dark,main,20211128,9,0.9914613716440399,259,14,96,369
24381,bright,main,20211128,0,0.9946405049423479,366,66,3,435
24381,bright,main,20211128,1,0.9921752720816434,317,67,5,389
24381,bright,main,20211128,2,0.9921945231401701,344,87,1,432
24381,bright,main,20211128,3,0.9937516430662385,319,74,2,395
24381,bright,main,20211128,4,0.9929053782135013,318,80,3,401
24381,bright,main,20211128,5,0.9946000430170449,315,88,3,406
24381,bright,main,20211128,6,0.9888804496001872,343,63,4,410
24381,bright,main,20211128,7,0.9914044557804812,313,50,6,369
24381,bright,main,20211128,8,0.9905348167738767,367,44,4,415
24381,bright,main,20211128,9,0.9908072596338682,338,62,5,405
4528,dark,main,20211128,0,0.9893800140400371,286,16,91,393
4528,dark,main,20211128,1,0.9928434799353439,266,11,80,357
4528,dark,main,20211128,2,0.9865780601254377,277,15,86,378
4528,dark,main,20211128,3,0.9815838970858776,263,12,81,356
4528,dark,main,20211128,4,0.9947884780744046,265,9,86,360
4528,dark,main,20211128,5,0.9953913107460534,263,11,101,375
4528,dark,main,20211128,6,0.9821254936452096,270,13,88,371
4528,dark,main,20211128,7,0.9883297253431687,159,12,72,243
4528,dark,main,20211128,8,0.993639917160892,272,13,94,379
4528,dark,main,20211128,9,0.9922382912653152,280,10,93,383
8404,dark,main,20211128,0,0.9961660044226931,275,30,68,373
8404,dark,main,20211128,1,0.9941976317612373,256,34,68,358
8404,dark,main,20211128,2,0.9935555961649644,264,35,74,373
8404,dark,main,20211128,3,0.9862305720485881,235,29,78,342
8404,dark,main,20211128,4,0.9898588155118234,260,22,74,356
8404,dark,main,20211128,5,0.9931293970146692,277,32,65,374
8404,dark,main,20211128,6,0.9878278923359288,288,15,73,376
8404,dark,main,20211128,7,0.9851708473727312,230,21,81,332
8404,dark,main,20211128,8,0.9880529617541755,287,20,79,386
8404,dark,main,20211128,9,0.9946802001324794,256,25,81,362
9196,dark,main,20211128,0,0.9951372519226396,297,10,83,390
9196,dark,main,20211128,1,0.9917730475347359,261,11,86,358
9196,dark,main,20211128,2,0.9867353773293386,279,12,89,380
9196,dark,main,20211128,3,0.9786788053613749,257,12,94,363
9196,dark,main,20211128,4,0.9894912303584733,251,12,96,359
9196,dark,main,20211128,5,0.9944462328596978,286,15,78,379
9196,dark,main,20211128,6,0.9948650386629398,292,14,78,384
9196,dark,main,20211128,7,0.988065494107047,255,14,57,326
9196,dark,main,20211128,8,0.9898606083724146,278,12,91,381
9196,dark,main,20211128,9,0.9942168979953712,268,12,98,378
21042,bright,main,20211128,0,0.9922975796928238,332,75,7,414
21042,bright,main,20211128,1,0.9901741418212717,279,89,4,372
21042,bright,main,20211128,2,0.9920060657642661,310,87,5,402
21042,bright,main,20211128,3,0.9879085489333219,283,86,3,372
21042,bright,main,20211128,4,0.986642455185105,269,100,5,374
21042,bright,main,20211128,5,0.9916103201630002,316,81,2,399
21042,bright,main,20211128,6,0.9921960861101168,316,75,4,395
21042,bright,main,20211128,7,0.9929512350250198,282,65,4,351
21042,bright,main,20211128,8,0.9919279108209755,340,57,8,405
21042,bright,main,20211128,9,0.9927815131615085,330,74,5,409
11061,dark,main,20211128,0,0.990512843865565,317,14,74,405
11061,dark,main,20211128,1,0.9922866192556353,247,15,85,347
11061,dark,main,20211128,2,0.9931267994602498,316,12,42,370
11061,dark,main,20211128,3,0.9871135133606251,284,17,46,347
11061,dark,main,20211128,4,0.9922876136799761,285,12,42,339
11061,dark,main,20211128,5,0.989270230069362,299,12,42,353
11061,dark,main,20211128,6,0.9779185418501648,294,10,42,346
11061,dark,main,20211128,7,0.9866186500316537,282,11,31,324
11061,dark,main,20211128,8,0.9916876519014916,312,13,47,372
11061,dark,main,20211128,9,0.9918745753168652,266,16,82,364
5280,dark,main,20211128,0,0.9890612337547952,242,33,108,383
5280,dark,main,20211128,1,0.9902005162810067,237,37,77,351
5280,dark,main,20211128,2,0.9943165288206027,274,26,82,382
5280,dark,main,20211128,3,0.9829929805409304,260,30,75,365
5280,dark,main,20211128,4,0.990865555359104,235,23,90,348
5280,dark,main,20211128,5,0.9928889435887163,254,36,87,377
5280,dark,main,20211128,6,0.9920362887702724,259,30,90,379
5280,dark,main,20211128,7,0.9876560647952037,229,36,70,335
5280,dark,main,20211128,8,0.9938276881567021,265,18,95,378
5280,dark,main,20211128,9,0.989813884718362,272,34,78,384
23532,bright,main,20211128,0,0.9925583484312448,280,132,8,420
23532,bright,main,20211128,1,0.9913239473602985,250,114,3,367
23532,bright,main,20211128,2,0.9924213627793957,282,100,4,386
23532,bright,main,20211128,3,0.9968299072625487,272,111,5,388
23532,bright,main,20211128,4,0.990059108326806,249,118,11,378
23532,bright,main,20211128,5,0.9852886770554634,274,109,5,388
23532,bright,main,20211128,6,0.9929472030275195,280,91,4,375
23532,bright,main,20211128,7,0.9875634079428265,296,66,3,365
23532,bright,main,20211128,8,0.9940538945949705,272,117,6,395
23532,bright,main,20211128,9,0.9926754817536074,264,129,6,399
11535,dark,main,20211128,0,0.9903898278702796,286,19,92,397
11535,dark,main,20211128,1,0.9941694090002356,272,15,64,351
11535,dark,main,20211128,2,0.9942549879105727,287,24,63,374
11535,dark,main,20211128,3,0.9928413853300222,284,26,48,358
11535,dark,main,20211128,4,0.9892970441307137,284,21,48,353
11535,dark,main,20211128,5,0.9967040660533286,287,15,68,370
11535,dark,main,20211128,6,0.9906800088476574,282,19,67,368
11535,dark,main,20211128,7,0.9929485810409212,247,20,54,321
11535,dark,main,20211128,8,0.9946932465336823,292,18,58,368
11535,dark,main,20211128,9,0.9865570227673209,288,21,68,377
3922,dark,main,20211128,0,0.9895070350151833,306,15,61,382
3922,dark,main,20211128,1,0.9864910307129152,255,20,97,372
3922,dark,main,20211128,2,0.9906162498692586,252,21,102,375
3922,dark,main,20211128,3,0.9946447809190115,268,14,73,355
3922,dark,main,20211128,4,0.9870373591766773,237,20,66,323
3922,dark,main,20211128,5,0.9912783294995062,265,16,91,372
3922,dark,main,20211128,6,0.9881034533029147,256,20,88,364
3922,dark,main,20211128,7,0.9872052861392686,266,18,45,329
3922,dark,main,20211128,8,0.9855979073501803,318,12,39,369
3922,dark,main,20211128,9,0.9875134733997717,300,12,59,371
3609,dark,main,20211128,0,0.9920911970767503,310,13,69,392
3609,dark,main,20211128,1,0.9919427890852452,294,12,39,345
3609,dark,main,20211128,2,0.9943743932869396,323,12,41,376
3609,dark,main,20211128,3,0.9889678464386763,293,11,38,342
3609,dark,main,20211128,4,0.9913623555234276,301,9,38,348
3609,dark,main,20211128,5,0.9933146951531848,308,13,36,357
3609,dark,main,20211128,6,0.993236940957596,315,12,39,366
3609,dark,main,20211128,7,0.9960271333855232,289,11,32,332
3609,dark,main,20211128,8,0.9878594266313205,302,13,52,367
3609,dark,main,20211128,9,0.9935625354259955,282,10,79,371
25330,bright,main,20211128,0,0.9941800439270619,338,74,5,417
25330,bright,main,20211128,1,0.9938341861607417,294,74,8,376
25330,bright,main,20211128,2,0.992661302026025,315,83,2,400
25330,bright,main,20211128,3,0.9932508571498819,307,70,3,380
25330,bright,main,20211128,4,0.9969153208563608,302,67,6,375
25330,bright,main,20211128,5,0.9917383871777607,304,80,5,389
25330,bright,main,20211128,6,0.9894047708028391,309,71,5,385
25330,bright,main,20211128,7,0.9897941039645684,286,62,4,352
25330,bright,main,20211128,8,0.989780530014317,342,53,6,401
25330,bright,main,20211128,9,0.988306273238854,349,53,3,405
2050,dark,main,20211128,0,0.9888914731610602,316,14,58,388
2050,dark,main,20211128,1,0.9952600792341025,303,12,39,354
2050,dark,main,20211128,2,0.9970556425261679,317,13,49,379
2050,dark,main,20211128,3,0.9922040996501225,298,13,40,351
2050,dark,main,20211128,4,0.9926137561674159,293,9,47,349
2050,dark,main,20211128,5,0.9919419938985565,300,12,43,355
2050,dark,main,20211128,6,0.990759281253147,308,14,34,356
2050,dark,main,20211128,7,0.9945064581787727,273,13,42,328
2050,dark,main,20211128,8,0.9910359815733848,299,11,55,365
2050,dark,main,20211128,9,0.9932968389650056,322,15,47,384
10181,dark,main,20211128,0,0.9928462722952321,316,14,58,388
10181,dark,main,20211128,1,0.9961025222922915,284,13,44,341
10181,dark,main,20211128,2,0.9918478777585087,320,14,45,379
10181,dark,main,20211128,3,0.9893980964478545,279,10,60,349
10181,dark,main,20211128,4,0.9898645896828285,267,14,72,353
10181,dark,main,20211128,5,0.9889717045054194,284,14,64,362
10181,dark,main,20211128,6,0.9899588929482117,268,18,80,366
10181,dark,main,20211128,7,0.9924413776871757,239,11,79,329
10181,dark,main,20211128,8,0.9979260359283604,271,20,75,366
10181,dark,main,20211128,9,0.9869179429495216,311,12,62,385
7965,dark,main,20211128,0,0.9933084160655131,324,14,50,388
7965,dark,main,20211128,1,0.9839469420576826,276,14,46,336
7965,dark,main,20211128,2,0.9907329564523799,299,15,43,357
7965,dark,main,20211128,3,0.9825520156819844,280,14,41,335
7965,dark,main,20211128,4,0.9922934377106012,277,14,56,347
7965,dark,main,20211128,5,0.9874433847396583,298,9,40,347
7965,dark,main,20211128,6,0.9909309552829968,297,13,45,355
7965,dark,main,20211128,7,0.9918586392976207,286,14,36,336
7965,dark,main,20211128,8,0.9919166467944175,318,14,37,369
7965,dark,main,20211128,9,0.986396617649677,305,19,39,363
8187,dark,main,20211128,0,0.9960701803108679,273,14,100,387
8187,dark,main,20211128,1,0.9872868756124692,254,11,87,352
8187,dark,main,20211128,2,0.9952283338048873,271,10,84,365
8187,dark,main,20211128,3,0.9902039760120867,251,11,97,359
8187,dark,main,20211128,4,0.9916788934456843,206,13,76,295
8187,dark,main,20211128,5,0.9894957718959727,272,11,87,370
8187,dark,main,20211128,6,0.9906603385422266,280,10,90,380
8187,dark,main,20211128,7,0.9897309385825777,236,13,94,343
8187,dark,main,20211128,8,0.9894860546361992,287,12,85,384
8187,dark,main,20211128,9,0.991007839529918,270,12,103,385
10970,dark,main,20211129,0,0.9932111807229905,303,17,57,377
10970,dark,main,20211129,1,0.9923752913925319,250,27,69,346
10970,dark,main,20211129,2,0.9914375169011027,271,23,81,375
10970,dark,main,20211129,3,0.9917369049244535,265,13,70,348
10970,dark,main,20211129,4,0.987952778402234,255,17,66,338
10970,dark,main,20211129,5,0.9914227178350346,293,15,56,364
10970,dark,main,20211129,6,0.9933826089088036,290,19,72,381
10970,dark,main,20211129,7,0.9890604186849755,241,28,68,337
10970,dark,main,20211129,8,0.9886995992355962,291,21,53,365
10970,dark,main,20211129,9,0.9944581225097621,315,14,42,371
2564,dark,main,20211129,0,0.9956633777607958,303,18,57,378
2564,dark,main,20211129,1,0.9913863535885346,279,19,52,350
2564,dark,main,20211129,2,0.9812460258892266,302,15,69,386
2564,dark,main,20211129,3,0.993444418198238,271,23,65,359
2564,dark,main,20211129,4,0.9918291531779226,252,14,63,329
2564,dark,main,20211129,5,0.9896118319542933,287,17,75,379
2564,dark,main,20211129,6,0.9914333254978432,280,19,68,367
2564,dark,main,20211129,7,0.9874402845000502,285,20,26,331
2564,dark,main,20211129,8,0.9935139421242104,290,18,64,372
2564,dark,main,20211129,9,0.9934702328591719,262,17,87,366
2055,dark,main,20211129,0,0.9894671427843741,303,11,68,382
2055,dark,main,20211129,1,0.9925245531952981,282,9,61,352
2055,dark,main,20211129,2,0.9933225879115098,301,13,59,373
2055,dark,main,20211129,3,0.9918436109908904,271,13,72,356
2055,dark,main,20211129,4,0.9944537813347999,250,9,85,344
2055,dark,main,20211129,5,0.9964450755585629,257,11,87,355
2055,dark,main,20211129,6,0.9887425707561579,259,16,101,376
2055,dark,main,20211129,7,0.9911874345840553,246,14,69,329
2055,dark,main,20211129,8,0.9899586025275763,306,12,57,375
2055,dark,main,20211129,9,0.9929085774812823,286,11,51,348
5175,dark,main,20211129,0,0.9955280401236042,310,12,65,387
5175,dark,main,20211129,1,0.9887548997912295,288,14,56,358
5175,dark,main,20211129,2,0.9895081684294552,282,11,80,373
5175,dark,main,20211129,3,0.9839318840383806,271,10,63,344
5175,dark,main,20211129,4,0.9956894807132921,274,10,64,348
5175,dark,main,20211129,5,0.9907879152821449,298,14,50,362
5175,dark,main,20211129,6,0.9957241387343655,293,12,76,381
5175,dark,main,20211129,7,0.9900560922173054,249,11,54,314
5175,dark,main,20211129,8,0.9847637128617142,285,13,77,375
5175,dark,main,20211129,9,0.9901458405801331,300,11,49,360
6053,dark,main,20211129,0,0.9919178436864641,266,15,91,372
6053,dark,main,20211129,1,0.9928083913309926,243,18,82,343
6053,dark,main,20211129,2,0.9919651576658922,270,17,94,381
6053,dark,main,20211129,3,0.9851929846182624,245,16,91,352
6053,dark,main,20211129,4,0.9896023737257001,253,16,71,340
6053,dark,main,20211129,5,0.993741389439764,271,11,83,365
6053,dark,main,20211129,6,0.9858022633344413,261,14,98,373
6053,dark,main,20211129,7,0.9901588218859327,228,17,80,325
6053,dark,main,20211129,8,0.9869197860660843,248,18,103,369
6053,dark,main,20211129,9,0.9933149853683774,269,11,85,365
10362,dark,main,20211129,0,0.9942570940260029,305,19,59,383
10362,dark,main,20211129,1,0.9926926303905181,282,11,61,354
10362,dark,main,20211129,2,0.9922293577074416,305,16,68,389
10362,dark,main,20211129,3,0.9900722153083656,261,21,70,352
10362,dark,main,20211129,4,0.9873325336483452,244,15,73,332
10362,dark,main,20211129,5,0.9873917354751736,255,17,88,360
10362,dark,main,20211129,6,0.9911253802497553,281,17,99,397
10362,dark,main,20211129,7,0.9904653392006997,243,17,75,335
10362,dark,main,20211129,8,0.9901867279073208,252,21,110,383
10362,dark,main,20211129,9,0.9949241946185892,279,16,77,372
5689,dark,main,20211129,0,0.9873102385368677,270,22,93,385
5689,dark,main,20211129,1,0.9898574065363506,232,17,94,343
5689,dark,main,20211129,2,0.9956879183260348,283,23,96,402
5689,dark,main,20211129,3,0.9882655537505829,274,16,63,353
5689,dark,main,20211129,4,0.9922117027535627,265,13,49,327
5689,dark,main,20211129,5,0.9949697047730872,290,15,46,351
5689,dark,main,20211129,6,0.9918492611043485,292,15,60,367
5689,dark,main,20211129,7,0.9921487867500793,253,17,43,313
5689,dark,main,20211129,8,0.9956480050770025,297,16,61,374
5689,dark,main,20211129,9,0.990983800174413,263,15,89,367
11621,dark,main,20211129,0,0.9912669255487563,337,11,47,395
11621,dark,main,20211129,1,0.9928351638898899,266,30,55,351
11621,dark,main,20211129,2,0.99480348347459,321,15,57,393
11621,dark,main,20211129,3,0.9920066357894378,271,15,84,370
11621,dark,main,20211129,4,0.9934570694411655,243,17,79,339
11621,dark,main,20211129,5,0.9910805199285386,244,21,107,372
11621,dark,main,20211129,6,0.9965318077120364,277,16,91,384
11621,dark,main,20211129,7,0.9932327082278724,244,11,70,325
11621,dark,main,20211129,8,0.9954137523332852,292,13,67,372
11621,dark,main,20211129,9,0.9922490564794377,334,11,38,383
2383,dark,main,20211129,0,0.9939898012084308,285,19,75,379
2383,dark,main,20211129,1,0.9797070905838875,277,22,51,350
2383,dark,main,20211129,2,0.9925636466224617,285,24,90,399
2383,dark,main,20211129,3,0.9942331962861845,249,20,94,363
2383,dark,main,20211129,4,0.9925947691301743,259,17,59,335
2383,dark,main,20211129,5,0.9875737749536662,258,19,78,355
2383,dark,main,20211129,6,0.9947127175175748,272,22,80,374
2383,dark,main,20211129,7,0.9937065301211606,223,22,83,328
2383,dark,main,20211129,8,0.9889532314242487,281,23,76,380
2383,dark,main,20211129,9,0.9872072171686739,267,20,87,374
5130,dark,main,20211129,0,0.9954168132544714,324,15,46,385
5130,dark,main,20211129,1,0.9891807525627219,266,12,73,351
5130,dark,main,20211129,2,0.9957999470273536,315,15,67,397
5130,dark,main,20211129,3,0.9933921479967446,302,14,38,354
5130,dark,main,20211129,4,0.9919891854422437,281,12,46,339
5130,dark,main,20211129,5,0.9921317340529835,301,13,39,353
5130,dark,main,20211129,6,0.9897849326201044,310,10,52,372
5130,dark,main,20211129,7,0.9923560092887637,257,11,55,323
5130,dark,main,20211129,8,0.9936326633769467,299,10,62,371
5130,dark,main,20211129,9,0.9888840251740322,299,12,52,363
5150,dark,main,20211129,0,0.9956319124295088,313,10,58,381
5150,dark,main,20211129,1,0.9882255248258519,289,10,54,353
5150,dark,main,20211129,2,0.9885496952011488,318,12,51,381
5150,dark,main,20211129,3,0.9854196974287768,291,13,39,343
5150,dark,main,20211129,4,0.9942355345426473,280,12,48,340
5150,dark,main,20211129,5,0.9905052910126706,280,12,58,350
5150,dark,main,20211129,6,0.9936451553002811,297,12,63,372
5150,dark,main,20211129,7,0.9864118367425031,235,13,75,323
5150,dark,main,20211129,8,0.9891490694965094,267,13,85,365
5150,dark,main,20211129,9,0.9904520827504393,289,11,63,363
7178,dark,main,20211129,0,0.9866307862399389,316,11,58,385
7178,dark,main,20211129,1,0.992594570872093,295,12,50,357
7178,dark,main,20211129,2,0.9923568874321895,334,10,52,396
7178,dark,main,20211129,3,0.9930706953911992,298,16,35,349
7178,dark,main,20211129,4,0.989223749893612,293,10,35,338
7178,dark,main,20211129,5,0.9903691415992041,327,12,36,375
7178,dark,main,20211129,6,0.9919517898132412,348,16,32,396
7178,dark,main,20211129,7,0.9866660194729348,287,14,35,336
7178,dark,main,20211129,8,0.989372714105325,316,14,45,375
7178,dark,main,20211129,9,0.9862531612332145,312,11,39,362
25332,bright,main,20211129,0,0.9881805609293534,331,79,3,413
25332,bright,main,20211129,1,0.9948726459955751,305,55,5,365
25332,bright,main,20211129,2,0.991300199267276,353,58,3,414
25332,bright,main,20211129,3,0.9895674695948788,313,65,3,381
25332,bright,main,20211129,4,0.992619563685059,306,52,1,359
25332,bright,main,20211129,5,0.9881311504817576,304,76,2,382
25332,bright,main,20211129,6,0.9945846393491518,315,67,9,391
25332,bright,main,20211129,7,0.9924198598788395,292,51,1,344
25332,bright,main,20211129,8,0.9931822571350764,305,66,5,376
25332,bright,main,20211129,9,0.9911695914283606,333,65,4,402
10236,dark,main,20211129,0,0.9957992493672454,309,15,51,375
10236,dark,main,20211129,1,0.9894293547519525,276,13,53,342
10236,dark,main,20211129,2,0.991038239623694,294,18,52,364
10236,dark,main,20211129,3,0.9959062141972939,273,28,32,333
10236,dark,main,20211129,4,0.9827761678752946,277,16,41,334
10236,dark,main,20211129,5,0.9962015675031767,302,16,36,354
10236,dark,main,20211129,6,0.9843418899200749,300,28,50,378
10236,dark,main,20211129,7,0.9859407637324668,251,18,48,317
10236,dark,main,20211129,8,0.9940672128497454,279,44,42,365
10236,dark,main,20211129,9,0.9916907105553785,312,16,48,376
22834,bright,main,20211129,0,0.9983788743697862,204,229,6,439
22834,bright,main,20211129,1,0.988893672233378,240,152,5,397
22834,bright,main,20211129,2,0.994130511832183,224,212,4,440
22834,bright,main,20211129,3,0.9891393159753856,213,176,2,391
22834,bright,main,20211129,4,0.9930165064503276,248,133,3,384
22834,bright,main,20211129,5,0.9908819242274987,262,139,5,406
22834,bright,main,20211129,6,0.9949986703586343,280,143,4,427
22834,bright,main,20211129,7,0.9912034332295524,269,96,3,368
22834,bright,main,20211129,8,0.9878333862985463,310,106,5,421
22834,bright,main,20211129,9,0.9948967289832716,204,221,6,431
22412,bright,main,20211129,0,0.9955294154394585,318,116,9,443
22412,bright,main,20211129,1,0.9921382977457524,305,89,4,398
22412,bright,main,20211129,2,0.9864645142550885,323,109,1,433
22412,bright,main,20211129,3,0.9958769017177821,245,147,6,398
22412,bright,main,20211129,4,0.9867025882537162,303,83,1,387
22412,bright,main,20211129,5,0.9931694362206529,256,153,2,411
22412,bright,main,20211129,6,0.9917750966486716,242,185,3,430
22412,bright,main,20211129,7,0.9961036162350876,260,108,3,371
22412,bright,main,20211129,8,0.9900346743267581,289,123,6,418
22412,bright,main,20211129,9,0.9883483170716022,278,141,6,425
5576,dark,main,20211129,0,0.994940655836752,327,15,54,396
5576,dark,main,20211129,1,0.9924338262190567,275,11,74,360
5576,dark,main,20211129,2,0.9841081620288149,312,10,80,402
5576,dark,main,20211129,3,0.9910435996128575,261,15,89,365
5576,dark,main,20211129,4,0.9926802564029314,269,12,68,349
5576,dark,main,20211129,5,0.9953675295949802,285,11,76,372
5576,dark,main,20211129,6,0.9865558745067272,321,11,52,384
5576,dark,main,20211129,7,0.9904298007759391,278,12,46,336
5576,dark,main,20211129,8,0.989900237666359,324,10,53,387
5576,dark,main,20211129,9,0.9825475541483515,304,12,75,391
10088,dark,main,20211129,0,0.9936721682282659,281,18,94,393
10088,dark,main,20211129,1,0.9901036716756746,245,19,90,354
10088,dark,main,20211129,2,0.9926326628275388,267,24,98,389
10088,dark,main,20211129,3,0.9860553953462695,252,19,75,346
10088,dark,main,20211129,4,0.9901797629053912,269,12,61,342
10088,dark,main,20211129,5,0.9898457602215658,297,11,61,369
10088,dark,main,20211129,6,0.9957539668706514,308,13,61,382
10088,dark,main,20211129,7,0.9839406548115222,271,13,32,316
10088,dark,main,20211129,8,0.9901138924349727,291,11,49,351
10088,dark,main,20211129,9,0.990518663424638,292,10,67,369
7968,dark,main,20211129,0,0.9904604918864499,319,16,53,388
7968,dark,main,20211129,1,0.9937397847999929,280,13,62,355
7968,dark,main,20211129,2,0.9918404597651889,315,11,61,387
7968,dark,main,20211129,3,0.9915447921926317,298,13,30,341
7968,dark,main,20211129,4,0.9923795011177399,286,10,33,329
7968,dark,main,20211129,5,0.9879442891391741,295,9,40,344
7968,dark,main,20211129,6,0.9953082915500676,313,12,47,372
7968,dark,main,20211129,7,0.9929792826386722,259,13,56,328
7968,dark,main,20211129,8,0.9922570060750231,322,12,41,375
7968,dark,main,20211129,9,0.992238661030009,317,10,38,365
3254,dark,main,20211129,0,0.9947430283139151,342,11,37,390
3254,dark,main,20211129,1,0.994293005232186,287,11,55,353
3254,dark,main,20211129,2,0.9914994734687008,305,19,65,389
3254,dark,main,20211129,3,0.9898513880340566,287,11,51,349
3254,dark,main,20211129,4,0.990729855502999,289,11,41,341
3254,dark,main,20211129,5,0.9875460548199914,297,9,40,346
3254,dark,main,20211129,6,0.9911198468251697,308,12,57,377
3254,dark,main,20211129,7,0.9917279852013071,274,11,48,333
3254,dark,main,20211129,8,0.9883618198152652,309,14,64,387
3254,dark,main,20211129,9,0.9854546783515441,329,10,40,379
5667,dark,main,20211129,0,0.988414436738572,253,13,43,309
5667,dark,main,20211129,1,0.9911348922360258,211,15,50,276
5667,dark,main,20211129,2,0.9840264709403638,260,12,45,317
5667,dark,main,20211129,3,0.9891099696895203,241,13,66,320
5667,dark,main,20211129,4,0.9921875309105275,226,10,71,307
5667,dark,main,20211129,5,0.9860164231617214,230,12,79,321
5667,dark,main,20211129,6,0.9860164231617214,230,12,79,321
5667,dark,main,20211129,7,0.9785910878520294,174,11,76,261
5667,dark,main,20211129,8,0.9860407891165497,224,12,75,311
5667,dark,main,20211129,9,0.9882864306663881,234,12,73,319
3266,dark,main,20211129,0,0.9934978820660239,320,13,50,383
3266,dark,main,20211129,1,0.9964345789477118,305,10,36,351
3266,dark,main,20211129,2,0.9920389571164352,288,15,70,373
3266,dark,main,20211129,3,0.9887985738906472,299,14,47,360
3266,dark,main,20211129,4,0.985299319304025,284,8,40,332
3266,dark,main,20211129,5,0.9883552361638956,278,13,64,355
3266,dark,main,20211129,6,0.9904606932296335,314,10,48,372
3266,dark,main,20211129,7,0.9922853406801962,285,10,31,326
3266,dark,main,20211129,8,0.9947308222253919,306,10,53,369
3266,dark,main,20211129,9,0.9905489189470736,290,13,60,363
9846,dark,main,20211129,0,0.9876679438114012,283,18,97,398
9846,dark,main,20211129,1,0.9899718040138779,271,13,61,345
9846,dark,main,20211129,2,0.9957480518284131,296,13,63,372
9846,dark,main,20211129,3,0.9807615459527977,269,11,57,337
9846,dark,main,20211129,4,0.9855067414033362,284,12,49,345
9846,dark,main,20211129,5,0.9896829360946902,275,15,61,351
9846,dark,main,20211129,6,0.9918946410872236,309,17,51,377
9846,dark,main,20211129,7,0.9931830549080312,271,10,50,331
9846,dark,main,20211129,8,0.9896523276796462,292,11,55,358
9846,dark,main,20211129,9,0.9908909409498091,280,15,63,358
10714,dark,main,20211129,0,0.9967726062809293,284,18,90,392
10714,dark,main,20211129,1,0.9872299257497564,259,15,84,358
10714,dark,main,20211129,2,0.9915284547394535,268,15,95,378
10714,dark,main,20211129,3,0.993570307847812,250,16,92,358
10714,dark,main,20211129,4,0.9919697269039703,223,17,96,336
10714,dark,main,20211129,5,0.9785894967895155,263,15,84,362
10714,dark,main,20211129,6,0.9884205558167082,292,16,91,399
10714,dark,main,20211129,7,0.9887711243783693,233,16,68,317
10714,dark,main,20211129,8,0.9923588274118704,272,13,96,381
10714,dark,main,20211129,9,0.9925473410536505,291,15,76,382
8791,dark,main,20211129,0,0.9908199395289495,302,12,45,359
8791,dark,main,20211129,1,0.9888869478076607,278,19,33,330
8791,dark,main,20211129,2,0.9890422381370468,308,17,51,376
8791,dark,main,20211129,3,0.9790343734888933,282,14,57,353
8791,dark,main,20211129,4,0.9887591976116535,285,10,42,337
8791,dark,main,20211129,5,0.9871971031705807,295,12,56,363
8791,dark,main,20211129,6,0.9856043193488446,303,17,56,376
8791,dark,main,20211129,7,0.989517361331827,262,20,53,335
8791,dark,main,20211129,8,0.9929270987126549,293,15,59,367
8791,dark,main,20211129,9,0.9926419708516185,317,13,40,370
6257,dark,main,20211129,0,0.9855956259628689,311,14,54,379
6257,dark,main,20211129,1,0.9868483916321137,251,16,84,351
6257,dark,main,20211129,2,0.9903101625904926,274,14,93,381
6257,dark,main,20211129,3,0.9920810067699534,259,14,57,330
6257,dark,main,20211129,4,0.9925715040212515,232,14,72,318
6257,dark,main,20211129,5,0.9897714615525067,252,13,88,353
6257,dark,main,20211129,6,0.9913692072427824,281,14,89,384
6257,dark,main,20211129,7,0.9865119892498816,261,14,53,328
6257,dark,main,20211129,8,0.9895774573355333,293,14,61,368
6257,dark,main,20211129,9,0.990066359780966,316,12,54,382
20603,bright,main,20211129,0,0.9948746585042483,356,60,2,418
20603,bright,main,20211129,1,0.993237776103723,332,55,3,390
20603,bright,main,20211129,2,0.9911724853181171,348,60,9,417
20603,bright,main,20211129,3,0.9949891753212854,317,49,6,372
20603,bright,main,20211129,4,0.9949108749761323,307,60,5,372
20603,bright,main,20211129,5,0.9874418882336258,340,55,5,400
20603,bright,main,20211129,6,0.987679994151607,337,65,5,407
20603,bright,main,20211129,7,0.9917733567995188,315,38,5,358
20603,bright,main,20211129,8,0.9918507256952368,340,54,7,401
20603,bright,main,20211129,9,0.9934780014497179,343,54,7,404
5122,dark,main,20211129,0,0.9937579833841083,307,15,54,376
5122,dark,main,20211129,1,0.9945153443803566,262,10,62,334
5122,dark,main,20211129,2,0.988365400779842,288,15,70,373
5122,dark,main,20211129,3,0.9955388513814303,252,12,77,341
5122,dark,main,20211129,4,0.9943525309189623,258,12,61,331
5122,dark,main,20211129,5,0.9910092920039222,295,12,54,361
5122,dark,main,20211129,6,0.992455314865443,296,15,56,367
5122,dark,main,20211129,7,0.991404186492123,241,14,68,323
5122,dark,main,20211129,8,0.9913801544255699,282,13,81,376
5122,dark,main,20211129,9,0.9951001412807539,291,9,74,374
2224,dark,main,20211129,0,0.9902206452894775,281,20,84,385
2224,dark,main,20211129,1,0.9892468048213484,271,28,38,337
2224,dark,main,20211129,2,0.9931007487202537,297,24,54,375
2224,dark,main,20211129,3,0.9945201568802879,279,20,51,350
2224,dark,main,20211129,4,0.989257551428058,268,19,61,348
2224,dark,main,20211129,5,0.9905587844233283,292,15,50,357
2224,dark,main,20211129,6,0.9941151979087445,303,24,46,373
2224,dark,main,20211129,7,0.9923443033808166,270,10,34,314
2224,dark,main,20211129,8,0.992317735373077,300,13,51,364
2224,dark,main,20211129,9,0.9918028631969177,288,12,78,378
3795,dark,main,20211129,0,0.9940432054617344,306,14,51,371
3795,dark,main,20211129,1,0.9941066826756072,286,11,58,355
3795,dark,main,20211129,2,0.9901318869183607,290,20,76,386
3795,dark,main,20211129,3,0.9941602776742743,278,15,60,353
3795,dark,main,20211129,4,0.99015605686295,287,11,50,348
3795,dark,main,20211129,5,0.9879297906633924,296,15,57,368
3795,dark,main,20211129,6,0.9958748525171687,293,19,72,384
3795,dark,main,20211129,7,0.9922279559081126,248,13,54,315
3795,dark,main,20211129,8,0.9875265400733638,304,10,58,372
3795,dark,main,20211129,9,0.9898575977617678,294,14,59,367
2896,dark,main,20211129,0,0.9963808083138234,304,14,81,399
2896,dark,main,20211129,1,0.9922505749680722,259,16,83,358
2896,dark,main,20211129,2,0.9933273004118142,292,15,89,396
2896,dark,main,20211129,3,0.9876691236488588,252,15,93,360
2896,dark,main,20211129,4,0.9895859418833398,232,12,101,345
2896,dark,main,20211129,5,0.9927715045759147,265,13,93,371
2896,dark,main,20211129,6,0.9946307783193254,262,13,111,386
2896,dark,main,20211129,7,0.992418843905184,247,13,69,329
2896,dark,main,20211129,8,0.991463086642359,265,17,99,381
2896,dark,main,20211129,9,0.9832404986585369,293,16,83,392
4095,dark,main,20211129,0,0.9924126369926882,308,22,62,392
4095,dark,main,20211129,1,0.9899360133782942,284,21,49,354
4095,dark,main,20211129,2,0.988464662498694,298,19,72,389
4095,dark,main,20211129,3,0.9840898561644715,251,19,68,338
4095,dark,main,20211129,4,0.9838308046948807,255,16,50,321
4095,dark,main,20211129,5,0.9904577246838718,296,13,62,371
4095,dark,main,20211129,6,0.9892950873467717,298,16,57,371
4095,dark,main,20211129,7,0.9854040762859813,241,22,60,323
4095,dark,main,20211129,8,0.9954049009405814,319,21,49,389
4095,dark,main,20211129,9,0.9855176811651205,294,19,67,380
9841,dark,main,20211129,0,0.9900601548741613,311,17,44,372
9841,dark,main,20211129,1,0.9935162954896664,288,11,43,342
9841,dark,main,20211129,2,0.9887917115542469,314,11,54,379
9841,dark,main,20211129,3,0.9924075431918203,280,11,52,343
9841,dark,main,20211129,4,0.9794436981277022,266,10,46,322
9841,dark,main,20211129,5,0.9886239392674405,297,12,42,351
9841,dark,main,20211129,6,0.9930121648016398,293,14,60,367
9841,dark,main,20211129,7,0.9911846428104325,250,13,51,314
9841,dark,main,20211129,8,0.994803781091847,310,16,55,381
9841,dark,main,20211129,9,0.9911015392206746,297,12,56,365
23480,bright,main,20211129,0,0.9972461457034014,329,73,4,406
23480,bright,main,20211129,1,0.995563258730259,323,45,3,371
23480,bright,main,20211129,2,0.9861691328294786,357,55,4,416
23480,bright,main,20211129,3,0.9891698676900187,345,38,8,391
23480,bright,main,20211129,4,0.9912216376374676,303,56,4,363
23480,bright,main,20211129,5,0.9902307306166062,315,62,5,382
23480,bright,main,20211129,6,0.9938696782284621,333,66,0,399
23480,bright,main,20211129,7,0.9898085817820016,302,43,8,353
23480,bright,main,20211129,8,0.9951214002979977,324,59,6,389
23480,bright,main,20211129,9,0.9936294772249904,345,51,5,401
9839,dark,main,20211129,0,0.9926736459821871,302,13,78,393
9839,dark,main,20211129,1,0.9932075555604942,293,14,59,366
9839,dark,main,20211129,2,0.9940485587215403,309,15,79,403
9839,dark,main,20211129,3,0.9913805621309598,258,10,88,356
9839,dark,main,20211129,4,0.9928138951914164,245,10,78,333
9839,dark,main,20211129,5,0.9922024021501672,286,10,81,377
9839,dark,main,20211129,6,0.991073936613817,304,10,64,378
9839,dark,main,20211129,7,0.991479903932419,250,14,59,323
9839,dark,main,20211129,8,0.9875771876920818,296,13,53,362
9839,dark,main,20211129,9,0.9887511229661284,283,11,60,354
20484,bright,main,20211130,0,0.9961997543200817,369,58,6,433
20484,bright,main,20211130,1,0.9959261368300699,303,73,5,381
20484,bright,main,20211130,2,0.9908810970486852,340,74,10,424
20484,bright,main,20211130,3,0.9923020603272162,301,71,4,376
20484,bright,main,20211130,4,0.9923346238815628,292,68,2,362
20484,bright,main,20211130,5,0.9834049004474789,321,77,4,402
20484,bright,main,20211130,6,0.9926616063374571,311,93,3,407
20484,bright,main,20211130,7,0.9911203657157464,271,79,3,353
20484,bright,main,20211130,8,0.9892020115933939,308,96,5,409
20484,bright,main,20211130,9,0.9902411678843615,310,91,6,407
2557,dark,main,20211130,0,0.9928822074772987,247,24,71,342
2557,dark,main,20211130,1,0.9874783059716254,264,17,66,347
2557,dark,main,20211130,2,0.9953392802551618,302,20,55,377
2557,dark,main,20211130,3,0.9930053038691027,266,16,60,342
2557,dark,main,20211130,4,0.9946353073472852,264,10,53,327
2557,dark,main,20211130,5,0.9916486680185425,291,12,74,377
2557,dark,main,20211130,6,0.992837251391504,265,22,93,380
2557,dark,main,20211130,7,0.9861582662603525,229,16,83,328
2557,dark,main,20211130,8,0.9942856745204709,263,22,87,372
2557,dark,main,20211130,9,0.9932572077467995,266,21,92,379
5120,dark,main,20211130,0,0.993329942635654,302,10,81,393
5120,dark,main,20211130,1,0.9949029785539932,250,16,72,338
5120,dark,main,20211130,2,0.9877274233178004,305,14,67,386
5120,dark,main,20211130,3,0.98365530030749,270,14,51,335
5120,dark,main,20211130,4,0.9931024851495177,254,11,62,327
5120,dark,main,20211130,5,0.9901964967962034,287,12,54,353
5120,dark,main,20211130,6,0.9863607214992943,284,11,74,369
5120,dark,main,20211130,7,0.9933378305740652,232,14,82,328
5120,dark,main,20211130,8,0.9946060306154558,293,10,79,382
5120,dark,main,20211130,9,0.993856982785356,323,10,61,394
9840,dark,main,20211130,0,0.9976755759876292,276,12,89,377
9840,dark,main,20211130,1,0.9888559579054832,265,13,68,346
9840,dark,main,20211130,2,0.990907628256083,312,10,72,394
9840,dark,main,20211130,3,0.9843345104453932,279,11,54,344
9840,dark,main,20211130,4,0.9934464735056028,269,11,50,330
9840,dark,main,20211130,5,0.9868340525257555,288,12,60,360
9840,dark,main,20211130,6,0.9887363526053286,277,17,86,380
9840,dark,main,20211130,7,0.9888258399160058,255,13,65,333
9840,dark,main,20211130,8,0.9927576230397934,283,12,85,380
9840,dark,main,20211130,9,0.9920803785561998,275,11,90,376
5149,dark,main,20211130,0,0.9886707874379214,271,13,105,389
5149,dark,main,20211130,1,0.992291188392884,251,10,90,351
5149,dark,main,20211130,2,0.9916638403045485,318,13,62,393
5149,dark,main,20211130,3,0.9925546471832968,309,10,49,368
5149,dark,main,20211130,4,0.9922464891575213,282,8,37,327
5149,dark,main,20211130,5,0.9963321340358807,292,11,53,356
5149,dark,main,20211130,6,0.9922162127285543,276,13,91,380
5149,dark,main,20211130,7,0.9848674468099418,232,14,90,336
5149,dark,main,20211130,8,0.99468423037376,261,11,111,383
5149,dark,main,20211130,9,0.992771826840569,267,16,107,390
5568,dark,main,20211130,0,0.9917745100272625,326,11,62,399
5568,dark,main,20211130,1,0.9849712640716141,285,20,47,352
5568,dark,main,20211130,2,0.993457583154459,328,11,39,378
5568,dark,main,20211130,3,0.9938935553890693,284,12,48,344
5568,dark,main,20211130,4,0.99562787826063,274,14,54,342
5568,dark,main,20211130,5,0.9940124470579412,276,20,70,366
5568,dark,main,20211130,6,0.98983598470338,307,10,68,385
5568,dark,main,20211130,7,0.9828628499548188,285,12,36,333
5568,dark,main,20211130,8,0.9897258345161815,303,11,60,374
5568,dark,main,20211130,9,0.9917587679649403,314,13,49,376
5129,dark,main,20211130,0,0.9849039833917853,332,12,44,388
5129,dark,main,20211130,1,0.9884277577726892,259,13,84,356
5129,dark,main,20211130,2,0.9883739610896115,294,11,80,385
5129,dark,main,20211130,3,0.9894579390499532,248,12,85,345
5129,dark,main,20211130,4,0.9935317311235816,254,9,75,338
5129,dark,main,20211130,5,0.995111441695076,244,11,111,366
5129,dark,main,20211130,6,0.9854568495302043,293,11,80,384
5129,dark,main,20211130,7,0.9849853294418263,231,13,81,325
5129,dark,main,20211130,8,0.9865084346897832,289,15,73,377
5129,dark,main,20211130,9,0.9840294408321806,298,14,66,378
9392,dark,main,20211130,0,0.9875544175274662,279,25,74,378
9392,dark,main,20211130,1,0.9903356056028877,251,23,69,343
9392,dark,main,20211130,2,0.9930298207976842,266,17,98,381
9392,dark,main,20211130,3,0.9908715380506357,245,17,76,338
9392,dark,main,20211130,4,0.9886127149946485,270,10,57,337
9392,dark,main,20211130,5,0.9859282739933181,280,22,56,358
9392,dark,main,20211130,6,0.9939460801468706,303,12,52,367
9392,dark,main,20211130,7,0.9885657328226131,266,17,58,341
9392,dark,main,20211130,8,0.9942713789132155,306,12,50,368
9392,dark,main,20211130,9,0.9926994732660245,286,24,53,363
11923,dark,main,20211130,0,0.9900441424539623,288,20,76,384
11923,dark,main,20211130,1,0.9915839350839635,283,21,55,359
11923,dark,main,20211130,2,0.9936842417511731,296,33,65,394
11923,dark,main,20211130,3,0.9736998890438403,101,1,19,121
11923,dark,main,20211130,4,0.9934963081639145,270,19,38,327
11923,dark,main,20211130,5,0.9899866179529733,284,15,63,362
11923,dark,main,20211130,6,0.9944084834740319,278,23,71,372
11923,dark,main,20211130,7,0.9893497590654291,277,14,29,320
11923,dark,main,20211130,8,0.9914046972743499,312,13,43,368
11923,dark,main,20211130,9,0.9900974128506045,290,17,75,382
2530,dark,main,20211130,0,0.9958134353009365,263,21,98,382
2530,dark,main,20211130,1,0.9898807123513268,250,26,66,342
2530,dark,main,20211130,2,0.9904278722188355,292,28,56,376
2530,dark,main,20211130,3,0.9901763875536015,258,16,58,332
2530,dark,main,20211130,4,0.9907713986639954,231,15,95,341
2530,dark,main,20211130,5,0.9957079306313097,277,19,77,373
2530,dark,main,20211130,6,0.9899951538069365,302,13,67,382
2530,dark,main,20211130,7,0.9947810765185059,234,14,84,332
2530,dark,main,20211130,8,0.9924550112248878,281,18,58,357
2530,dark,main,20211130,9,0.9935338448649942,287,15,59,361
5186,dark,main,20211130,0,0.996066387690682,316,14,50,380
5186,dark,main,20211130,1,0.9910534302193623,288,12,58,358
5186,dark,main,20211130,2,0.9947283805690503,284,14,85,383
5186,dark,main,20211130,3,0.9854993470240452,286,14,50,350
5186,dark,main,20211130,4,0.9930283585491383,272,11,54,337
5186,dark,main,20211130,5,0.9939674631715097,303,10,53,366
5186,dark,main,20211130,6,0.9907978909140216,285,16,78,379
5186,dark,main,20211130,7,0.9908945822319787,265,9,53,327
5186,dark,main,20211130,8,0.9928986058214159,281,11,69,361
5186,dark,main,20211130,9,0.9905706256095907,301,14,49,364
4049,dark,main,20211130,0,0.9878966271802363,287,14,109,410
4049,dark,main,20211130,1,0.98412024306628,266,14,70,350
4049,dark,main,20211130,2,0.9953110609746907,293,15,95,403
4049,dark,main,20211130,3,0.9904728207727407,263,16,66,345
4049,dark,main,20211130,4,0.9911457510177002,238,14,92,344
4049,dark,main,20211130,5,0.9940108901851479,258,10,100,368
4049,dark,main,20211130,6,0.9831877713297063,305,15,71,391
4049,dark,main,20211130,7,0.9878899402009186,263,14,46,323
4049,dark,main,20211130,8,0.9924046081472038,310,14,61,385
4049,dark,main,20211130,9,0.9857887376262023,302,11,83,396
7251,dark,main,20211130,0,0.9893228173693175,192,20,61,273
7251,dark,main,20211130,1,0.9910811483129509,247,15,69,331
7251,dark,main,20211130,2,0.9930752312610407,321,14,46,381
7251,dark,main,20211130,3,0.9833476976000358,299,13,30,342
7251,dark,main,20211130,4,0.9886148760678776,267,16,46,329
7251,dark,main,20211130,5,0.9924778979042131,277,19,65,361
7251,dark,main,20211130,6,0.994176788348144,306,20,53,379
7251,dark,main,20211130,7,0.9887341272488973,254,17,58,329
7251,dark,main,20211130,8,0.9903667504660278,291,17,50,358
7251,dark,main,20211130,9,0.9916086685827928,258,15,72,345
5131,dark,main,20211130,0,0.9936754238881673,304,15,75,394
5131,dark,main,20211130,1,0.9879420203021363,282,13,62,357
5131,dark,main,20211130,2,0.9904131754644683,297,13,70,380
5131,dark,main,20211130,3,0.9880331501015756,273,13,69,355
5131,dark,main,20211130,4,0.9901656622700948,264,10,56,330
5131,dark,main,20211130,5,0.9964267425095125,307,8,53,368
5131,dark,main,20211130,6,0.9942756805817455,323,13,54,390
5131,dark,main,20211130,7,0.9899292207571895,271,11,55,337
5131,dark,main,20211130,8,0.9894719806110922,303,13,63,379
5131,dark,main,20211130,9,0.9909768619885039,298,12,66,376
8636,dark,main,20211130,0,0.9943282847609524,325,19,49,393
8636,dark,main,20211130,1,0.9883185281598805,303,15,40,358
8636,dark,main,20211130,2,0.9899363144082028,329,17,35,381
8636,dark,main,20211130,3,0.988944114410064,264,15,44,323
8636,dark,main,20211130,4,0.9936973739482773,248,14,52,314
8636,dark,main,20211130,5,0.9920538736778908,304,14,56,374
8636,dark,main,20211130,6,0.9932005192067078,307,17,60,384
8636,dark,main,20211130,7,0.9885470571086112,260,19,54,333
8636,dark,main,20211130,8,0.9952461652394905,305,18,56,379
8636,dark,main,20211130,9,0.9951374255455422,298,18,56,372
2222,dark,main,20211130,0,0.9890644020643997,317,12,49,378
2222,dark,main,20211130,1,0.9941876618959306,286,14,52,352
2222,dark,main,20211130,2,0.9921082348587619,298,14,73,385
2222,dark,main,20211130,3,0.9945027088423868,279,12,49,340
2222,dark,main,20211130,4,0.9890308172068246,273,13,46,332
2222,dark,main,20211130,5,0.9898485747173147,283,13,54,350
2222,dark,main,20211130,6,0.9932135548958531,297,13,77,387
2222,dark,main,20211130,7,0.984942464710964,256,13,59,328
2222,dark,main,20211130,8,0.9859358270804173,306,16,52,374
2222,dark,main,20211130,9,0.9912346932492315,302,11,50,363
22837,bright,main,20211130,0,0.9946205373365052,302,127,7,436
22837,bright,main,20211130,1,0.991702860669494,286,111,1,398
22837,bright,main,20211130,2,0.9912301271294521,317,111,7,435
22837,bright,main,20211130,3,0.9915856530536203,268,113,4,385
22837,bright,main,20211130,4,0.9943527765429709,273,109,6,388
22837,bright,main,20211130,5,0.9951065137194733,308,100,8,416
22837,bright,main,20211130,6,0.9939684012400126,279,140,6,425
22837,bright,main,20211130,7,0.9920836691162288,262,101,4,367
22837,bright,main,20211130,8,0.9886270648214173,284,130,4,418
22837,bright,main,20211130,9,0.9959072540024863,282,142,7,431
7970,dark,main,20211130,0,0.9923214583267136,270,15,100,385
7970,dark,main,20211130,1,0.9931453044850287,244,15,78,337
7970,dark,main,20211130,2,0.9955078174122074,282,15,89,386
7970,dark,main,20211130,3,0.9926035687884276,251,16,70,337
7970,dark,main,20211130,4,0.9945078476496565,265,9,76,350
7970,dark,main,20211130,5,0.9949234073014807,306,14,50,370
7970,dark,main,20211130,6,0.9896364017478924,313,11,63,387
7970,dark,main,20211130,7,0.9903334806746258,261,12,51,324
7970,dark,main,20211130,8,0.9912216916705102,307,12,57,376
7970,dark,main,20211130,9,0.9914559352440546,276,13,88,377
9807,dark,main,20211130,0,0.9935317715112812,293,12,90,395
9807,dark,main,20211130,1,0.9875218712939915,267,13,70,350
9807,dark,main,20211130,2,0.9874346838039182,321,13,57,391
9807,dark,main,20211130,3,0.9928486458307105,283,14,49,346
9807,dark,main,20211130,4,0.9915255221017814,244,12,78,334
9807,dark,main,20211130,5,0.9945947623419538,261,14,87,362
9807,dark,main,20211130,6,0.987403404287098,267,12,103,382
9807,dark,main,20211130,7,0.9948301870500407,234,10,87,331
9807,dark,main,20211130,8,0.9936589774556539,272,16,93,381
9807,dark,main,20211130,9,0.9936647579148196,291,11,86,388
2223,dark,main,20211130,0,0.989561484786522,329,14,57,400
2223,dark,main,20211130,1,0.9916017319103244,265,23,54,342
2223,dark,main,20211130,2,0.995061492296304,310,12,55,377
2223,dark,main,20211130,3,0.9925030054984436,275,14,44,333
2223,dark,main,20211130,4,0.9878342128060219,262,15,50,327
2223,dark,main,20211130,5,0.9923620747256272,282,13,72,367
2223,dark,main,20211130,6,0.9901403024449942,296,16,70,382
2223,dark,main,20211130,7,0.9925255466495035,260,16,49,325
2223,dark,main,20211130,8,0.9918162959499464,290,13,78,381
2223,dark,main,20211130,9,0.9921677596318919,311,18,61,390
5396,dark,main,20211130,0,0.9962863147814338,320,23,60,403
5396,dark,main,20211130,1,0.9929535029022759,298,15,42,355
5396,dark,main,20211130,2,0.9915092931304085,315,14,54,383
5396,dark,main,20211130,3,0.9864176045145682,263,18,54,335
5396,dark,main,20211130,4,0.9892809514639812,263,12,52,327
5396,dark,main,20211130,5,0.9897147082823086,295,17,60,372
5396,dark,main,20211130,6,0.9905528659263912,313,15,58,386
5396,dark,main,20211130,7,0.9802190945248074,251,16,62,329
5396,dark,main,20211130,8,0.9950386695832171,304,13,55,372
5396,dark,main,20211130,9,0.9858305908547438,293,18,77,388
4827,dark,main,20211130,0,0.9920379135718301,299,13,68,380
4827,dark,main,20211130,1,0.9901795880486536,284,14,58,356
4827,dark,main,20211130,2,0.9920748729853025,267,15,95,377
4827,dark,main,20211130,3,0.9884685434141877,262,13,61,336
4827,dark,main,20211130,4,0.9909032866710588,271,12,49,332
4827,dark,main,20211130,5,0.9911534974326452,322,11,34,367
4827,dark,main,20211130,6,0.9891590031102327,323,12,40,375
4827,dark,main,20211130,7,0.9933367555269466,268,13,42,323
4827,dark,main,20211130,8,0.9902802896835089,301,11,46,358
4827,dark,main,20211130,9,0.9917895468751127,303,10,57,370
2066,dark,main,20211130,0,0.9928549778008898,289,12,92,393
2066,dark,main,20211130,1,0.9890324916270252,252,18,86,356
2066,dark,main,20211130,2,0.9899424678452793,277,15,87,379
2066,dark,main,20211130,3,0.9905499439530265,258,16,75,349
2066,dark,main,20211130,4,0.9900374175023142,258,11,70,339
2066,dark,main,20211130,5,0.9952350878002726,285,13,67,365
2066,dark,main,20211130,6,0.9971321582767897,315,13,60,388
2066,dark,main,20211130,7,0.9890859176996974,260,13,64,337
2066,dark,main,20211130,8,0.9930768246663833,308,13,64,385
2066,dark,main,20211130,9,0.9867488824102562,285,14,63,362
5662,dark,main,20211130,0,0.9903172635340798,310,20,63,393
5662,dark,main,20211130,1,0.9950767582538469,285,14,56,355
5662,dark,main,20211130,2,0.9975841185707381,290,15,66,371
5662,dark,main,20211130,3,0.990621018850318,275,10,52,337
5662,dark,main,20211130,4,0.9936026313949953,277,11,48,336
5662,dark,main,20211130,5,0.9906898756024093,296,13,39,348
5662,dark,main,20211130,6,0.9854674367870221,306,11,45,362
5662,dark,main,20211130,7,0.9903866829979507,251,16,63,330
5662,dark,main,20211130,8,0.9920262337905352,286,12,69,367
5662,dark,main,20211130,9,0.9876100984006967,266,15,85,366
10060,dark,main,20211130,0,0.9938512273711964,323,13,46,382
10060,dark,main,20211130,1,0.9895000338051422,292,13,54,359
10060,dark,main,20211130,2,0.9952176743913892,286,12,80,378
10060,dark,main,20211130,3,0.990625570038907,258,16,70,344
10060,dark,main,20211130,4,0.9876767551262067,258,12,55,325
10060,dark,main,20211130,5,0.9897175426428897,260,13,99,372
10060,dark,main,20211130,6,0.9912430818122473,308,14,55,377
10060,dark,main,20211130,7,0.9935440967305077,244,11,56,311
10060,dark,main,20211130,8,0.9932552035862878,303,13,51,367
10060,dark,main,20211130,9,0.9897800115096105,303,11,52,366
6255,dark,main,20211130,0,0.9897751730887054,298,14,74,386
6255,dark,main,20211130,1,0.9865020281057156,244,13,56,313
6255,dark,main,20211130,2,0.9936043336417788,260,14,87,361
6255,dark,main,20211130,3,0.9898895349430963,263,17,67,347
6255,dark,main,20211130,4,0.9838406479207862,270,14,65,349
6255,dark,main,20211130,5,0.9883168135182218,261,13,87,361
6255,dark,main,20211130,6,0.9901322433212965,279,13,91,383
6255,dark,main,20211130,7,0.9924950245121302,257,10,61,328
6255,dark,main,20211130,8,0.9897288214926426,300,14,70,384
6255,dark,main,20211130,9,0.9919151286162224,277,15,81,373
10073,dark,main,20211130,0,0.9932690711880531,311,14,67,392
10073,dark,main,20211130,1,0.9909993330373172,278,10,56,344
10073,dark,main,20211130,2,0.9875180869805033,303,14,54,371
10073,dark,main,20211130,3,0.9933985817958685,284,14,52,350
10073,dark,main,20211130,4,0.9911536163917787,259,12,71,342
10073,dark,main,20211130,5,0.9918940428887024,272,11,77,360
10073,dark,main,20211130,6,0.9904741912234885,280,12,85,377
10073,dark,main,20211130,7,0.9860209510552779,254,11,57,322
10073,dark,main,20211130,8,0.9855856829182865,287,15,69,371
10073,dark,main,20211130,9,0.9873567414020049,309,11,63,383
11528,dark,main,20211130,0,0.9937446962141618,309,16,43,368
11528,dark,main,20211130,1,0.9887833548146607,272,16,53,341
11528,dark,main,20211130,2,0.9911307051190734,301,17,42,360
11528,dark,main,20211130,3,0.9939911251464084,287,23,30,340
11528,dark,main,20211130,4,0.9902013610484719,272,25,34,331
11528,dark,main,20211130,5,0.991768034000936,327,16,31,374
11528,dark,main,20211130,6,0.9949128763118208,312,17,48,377
11528,dark,main,20211130,7,0.98164700623065,267,22,40,329
11528,dark,main,20211130,8,0.995604811782443,291,25,39,355
11528,dark,main,20211130,9,0.9906576323824023,294,22,32,348
7841,dark,main,20211130,0,0.9817872268935101,295,18,52,365
7841,dark,main,20211130,1,0.995721704235196,283,26,44,353
7841,dark,main,20211130,2,0.9885001742487032,271,27,69,367
7841,dark,main,20211130,3,0.9927399171651218,249,21,76,346
7841,dark,main,20211130,4,0.9948380189139584,252,27,71,350
7841,dark,main,20211130,5,0.9829149042752097,277,18,62,357
7841,dark,main,20211130,6,0.9934295954980168,283,31,66,380
7841,dark,main,20211130,7,0.9903875537104022,264,21,51,336
7841,dark,main,20211130,8,0.9862738380423866,278,19,78,375
7841,dark,main,20211130,9,0.9951400718494184,284,27,56,367
5674,dark,main,20211130,0,0.9927340185823034,283,24,78,385
5674,dark,main,20211130,1,0.984946308293543,249,18,93,360
5674,dark,main,20211130,2,0.996230543173368,270,14,103,387
5674,dark,main,20211130,3,0.9913262206403374,259,15,82,356
5674,dark,main,20211130,4,0.9920738996970346,241,15,89,345
5674,dark,main,20211130,5,0.992407957924067,273,20,81,374
5674,dark,main,20211130,6,0.9958281351522871,254,22,100,376
5674,dark,main,20211130,7,0.9954480471751009,227,14,89,330
5674,dark,main,20211130,8,0.9893634149001991,287,13,80,380
5674,dark,main,20211130,9,0.9822309990535788,283,16,86,385
4096,dark,main,20211130,0,0.9928552837787745,309,14,50,373
4096,dark,main,20211130,1,0.9930917199295322,271,28,42,341
4096,dark,main,20211130,2,0.9910422896495934,324,18,48,390
4096,dark,main,20211130,3,0.9854779458570905,276,15,45,336
4096,dark,main,20211130,4,0.9919099484944722,266,20,53,339
4096,dark,main,20211130,5,0.9930798258424898,275,17,67,359
4096,dark,main,20211130,6,0.9878250682962522,283,17,76,376
4096,dark,main,20211130,7,0.985718673480196,241,19,62,322
4096,dark,main,20211130,8,0.9920231860357479,267,25,79,371
4096,dark,main,20211130,9,0.992362577821419,293,17,55,365
6506,dark,main,20211130,0,0.9939724666944167,303,15,59,377
6506,dark,main,20211130,1,0.9927565367836857,296,12,51,359
6506,dark,main,20211130,2,0.9960984966820317,307,16,62,385
6506,dark,main,20211130,3,0.9899067974146621,289,15,36,340
6506,dark,main,20211130,4,0.9928918721055836,280,15,42,337
6506,dark,main,20211130,5,0.9933995868733423,286,10,50,346
6506,dark,main,20211130,6,0.9965181731237828,264,24,67,355
6506,dark,main,20211130,7,0.9937865667464827,206,16,48,270
6506,dark,main,20211130,8,0.9907671175373743,311,12,55,378
6506,dark,main,20211130,9,0.9934309113986248,307,14,43,364
22049,bright,main,20211130,0,0.9901484256788325,362,63,2,427
22049,bright,main,20211130,1,0.9939447927388838,355,30,8,393
22049,bright,main,20211130,2,0.993507958084779,362,60,4,426
22049,bright,main,20211130,3,0.9928318072132846,304,75,2,381
22049,bright,main,20211130,4,0.988101180014661,326,39,5,370
22049,bright,main,20211130,5,0.9919778562897457,347,56,2,405
22049,bright,main,20211130,6,0.9941062953023844,350,57,4,411
22049,bright,main,20211130,7,0.9919200421948671,282,61,8,351
22049,bright,main,20211130,8,0.9961535299079314,354,52,5,411
22049,bright,main,20211130,9,0.9888199843586329,368,51,1,420
3981,dark,main,20211130,0,0.9925590175626582,246,28,68,342
3981,dark,main,20211130,1,0.9942943219144773,264,31,56,351
3981,dark,main,20211130,2,0.9953103644658637,306,18,62,386
3981,dark,main,20211130,3,0.9945144862755416,251,14,65,330
3981,dark,main,20211130,4,0.9916407731617088,257,13,61,331
3981,dark,main,20211130,5,0.9908088673241026,254,29,82,365
3981,dark,main,20211130,6,0.9881537496114547,294,16,67,377
3981,dark,main,20211130,7,0.9909669961603319,260,17,34,311
3981,dark,main,20211130,8,0.9914559267264849,298,16,55,369
3981,dark,main,20211130,9,0.9916872038693475,279,25,77,381
3551,dark,main,20211201,0,0.9860919658076756,294,17,58,369
3551,dark,main,20211201,1,0.9940769864016803,282,16,33,331
3551,dark,main,20211201,2,0.9891081739495223,317,14,44,375
3551,dark,main,20211201,3,0.9956540070600652,290,22,38,350
3551,dark,main,20211201,4,0.9945575466390391,272,18,49,339
3551,dark,main,20211201,5,0.9958388409275504,297,16,63,376
3551,dark,main,20211201,6,0.9933842501136981,269,22,96,387
3551,dark,main,20211201,7,0.9915687077811032,248,22,53,323
3551,dark,main,20211201,8,0.9864186807802329,275,16,69,360
3551,dark,main,20211201,9,0.9917250348281093,299,12,66,377
3239,dark,main,20211201,0,0.9894515034511199,314,13,55,382
3239,dark,main,20211201,1,0.9926698561438736,287,12,43,342
3239,dark,main,20211201,2,0.9922449273686526,319,11,55,385
3239,dark,main,20211201,3,0.9923932790359904,281,15,49,345
3239,dark,main,20211201,4,0.9903665060423538,276,13,45,334
3239,dark,main,20211201,5,0.9928895552923578,272,14,69,355
3239,dark,main,20211201,6,0.9937456436380856,281,16,77,374
3239,dark,main,20211201,7,0.9930831431181559,241,13,56,310
3239,dark,main,20211201,8,0.995606147401483,300,11,73,384
3239,dark,main,20211201,9,0.9896866266030399,282,10,67,359
5678,dark,main,20211201,0,0.9926258113029435,277,18,94,389
5678,dark,main,20211201,1,0.9888847426169495,254,20,76,350
5678,dark,main,20211201,2,0.9926482369106916,286,19,82,387
5678,dark,main,20211201,3,0.9905201974696968,269,15,76,360
5678,dark,main,20211201,4,0.9924228673218172,195,13,84,292
5678,dark,main,20211201,5,0.9905669985433158,272,17,89,378
5678,dark,main,20211201,6,0.9938508277414144,274,13,104,391
5678,dark,main,20211201,7,0.9904482290077042,238,16,80,334
5678,dark,main,20211201,8,0.9914842927996494,263,18,90,371
5678,dark,main,20211201,9,0.9892934702930145,248,15,106,369
21838,bright,main,20211201,0,0.9904829430763693,351,75,3,429
21838,bright,main,20211201,1,0.9930679970393737,291,82,9,382
21838,bright,main,20211201,2,0.9906796789979505,328,93,4,425
21838,bright,main,20211201,3,0.9845776526128281,300,80,3,383
21838,bright,main,20211201,4,0.9907664014456533,275,62,4,341
21838,bright,main,20211201,5,0.9929005708262553,315,69,6,390
21838,bright,main,20211201,6,0.9923019496384118,348,66,4,418
21838,bright,main,20211201,7,0.994291110675161,304,49,8,361
21838,bright,main,20211201,8,0.996118093489838,332,79,3,414
21838,bright,main,20211201,9,0.9958021941789189,350,60,4,414
6935,dark,main,20211201,0,0.9923677309451822,293,13,74,380
6935,dark,main,20211201,1,0.9888327393168224,276,14,61,351
6935,dark,main,20211201,2,0.9926206465341908,305,17,63,385
6935,dark,main,20211201,3,0.9939347209870368,275,13,61,349
6935,dark,main,20211201,4,0.9938518051219456,232,21,71,324
6935,dark,main,20211201,5,0.9896456786495282,260,16,84,360
6935,dark,main,20211201,6,0.9933704375534428,273,13,80,366
6935,dark,main,20211201,7,0.9886176725408795,253,14,58,325
6935,dark,main,20211201,8,0.9953730787857168,301,14,51,366
6935,dark,main,20211201,9,0.989685009653714,305,10,55,370
1672,dark,main,20211201,0,0.9855138220408828,268,20,84,372
1672,dark,main,20211201,1,0.9875220428545439,258,15,63,336
1672,dark,main,20211201,2,0.9927098795178823,293,14,81,388
1672,dark,main,20211201,3,0.9924802924174664,279,15,59,353
1672,dark,main,20211201,4,0.9932289505242423,274,11,52,337
1672,dark,main,20211201,5,0.991084118977317,275,13,70,358
1672,dark,main,20211201,6,0.9921410141451826,330,13,41,384
1672,dark,main,20211201,7,0.9936819918083041,256,16,60,332
1672,dark,main,20211201,8,0.9887296304577927,295,13,82,390
1672,dark,main,20211201,9,0.9927918555234819,277,10,93,380
1699,dark,main,20211201,0,0.9950939262588574,291,17,74,382
1699,dark,main,20211201,1,0.9948624373533678,249,16,84,349
1699,dark,main,20211201,2,0.9920618272944904,294,17,70,381
1699,dark,main,20211201,3,0.9930903332895094,275,15,61,351
1699,dark,main,20211201,4,0.9876550481807606,260,10,57,327
1699,dark,main,20211201,5,0.9935214339705906,284,17,62,363
1699,dark,main,20211201,6,0.9907485472800449,292,14,80,386
1699,dark,main,20211201,7,0.9874303868750711,254,14,64,332
1699,dark,main,20211201,8,0.9951501025354645,317,13,48,378
1699,dark,main,20211201,9,0.9885934522669386,291,16,70,377
5418,dark,main,20211201,0,0.9941370453477191,303,15,68,386
5418,dark,main,20211201,1,0.9895701209559332,286,14,37,337
5418,dark,main,20211201,2,0.9953787807204935,300,14,55,369
5418,dark,main,20211201,3,0.98833733518213,270,16,42,328
5418,dark,main,20211201,4,0.9885750223297852,247,11,59,317
5418,dark,main,20211201,5,0.9845422854732138,253,15,70,338
5418,dark,main,20211201,6,0.9913969515690664,273,18,90,381
5418,dark,main,20211201,7,0.9843459641697577,234,19,64,317
5418,dark,main,20211201,8,0.9935734090820975,311,15,47,373
5418,dark,main,20211201,9,0.9935823117543738,293,16,60,369
22830,bright,main,20211201,0,0.9863673207769837,284,146,7,437
22830,bright,main,20211201,1,0.9936501152891138,268,122,2,392
22830,bright,main,20211201,2,0.9942258496795945,260,171,4,435
22830,bright,main,20211201,3,0.9903285528190409,258,133,3,394
22830,bright,main,20211201,4,0.9914769959141713,317,64,1,382
22830,bright,main,20211201,5,0.9917084601548098,343,66,3,412
22830,bright,main,20211201,6,0.9914924578204519,349,74,7,430
22830,bright,main,20211201,7,0.9937997898183177,308,55,4,367
22830,bright,main,20211201,8,0.9919682514510666,343,78,2,423
22830,bright,main,20211201,9,0.9905550858991391,316,103,6,425
7842,dark,main,20211201,0,0.9912902545699839,298,18,46,362
7842,dark,main,20211201,1,0.9960011094342633,287,14,46,347
7842,dark,main,20211201,2,0.9912963180002493,309,17,48,374
7842,dark,main,20211201,3,0.9809947127181694,261,18,54,333
7842,dark,main,20211201,4,0.9967946682253941,262,17,56,335
7842,dark,main,20211201,5,0.9917153585173657,274,15,74,363
7842,dark,main,20211201,6,0.9916992375542751,306,21,56,383
7842,dark,main,20211201,7,0.9875052342203584,279,17,27,323
7842,dark,main,20211201,8,0.9939819255803215,295,16,35,346
7842,dark,main,20211201,9,0.9934473521634504,290,14,54,358
10328,dark,main,20211201,0,0.9903892326102682,325,14,58,397
10328,dark,main,20211201,1,0.99007210246362,292,11,49,352
10328,dark,main,20211201,2,0.9931666809690565,294,13,74,381
10328,dark,main,20211201,3,0.9872735210984698,286,16,47,349
10328,dark,main,20211201,4,0.987658597571413,253,13,68,334
10328,dark,main,20211201,5,0.9923061638036524,282,11,72,365
10328,dark,main,20211201,6,0.9945364510058834,286,12,73,371
10328,dark,main,20211201,7,0.9943485477795196,240,15,68,323
10328,dark,main,20211201,8,0.9908116649896674,284,12,84,380
10328,dark,main,20211201,9,0.9948519034708944,292,16,77,385
4077,dark,main,20211201,0,0.9940997994423333,281,16,102,399
4077,dark,main,20211201,1,0.9949407310428093,258,12,88,358
4077,dark,main,20211201,2,0.9931467437193643,260,19,97,376
4077,dark,main,20211201,3,0.9826628109660243,242,23,83,348
4077,dark,main,20211201,4,0.9843194576149694,239,13,65,317
4077,dark,main,20211201,5,0.9922961214480888,265,14,83,362
4077,dark,main,20211201,6,0.9924070643751121,245,19,110,374
4077,dark,main,20211201,7,0.9956452591152244,223,15,88,326
4077,dark,main,20211201,8,0.9947314052077973,266,14,98,378
4077,dark,main,20211201,9,0.9906761984991947,271,13,82,366
22839,bright,main,20211201,0,0.9939665232057089,336,96,5,437
22839,bright,main,20211201,1,0.9895100085801976,301,96,3,400
22839,bright,main,20211201,2,0.9921289184245821,321,113,5,439
22839,bright,main,20211201,3,0.9907912703510949,310,85,4,399
22839,bright,main,20211201,4,0.9949239586378741,304,84,0,388
22839,bright,main,20211201,5,0.9919034991927077,304,110,3,417
22839,bright,main,20211201,6,0.9915846681973682,298,125,7,430
22839,bright,main,20211201,7,0.9925929245893492,260,109,2,371
22839,bright,main,20211201,8,0.9892288896306052,321,99,5,425
22839,bright,main,20211201,9,0.9925987835317129,297,121,7,425
5600,dark,main,20211201,0,0.9874680297964518,283,17,86,386
5600,dark,main,20211201,1,0.9878792739123513,252,11,92,355
5600,dark,main,20211201,2,0.9901920833577379,257,16,109,382
5600,dark,main,20211201,3,0.9891864374386063,255,11,89,355
5600,dark,main,20211201,4,0.9849584768448304,268,13,55,336
5600,dark,main,20211201,5,0.9934635878604637,302,13,58,373
5600,dark,main,20211201,6,0.9858538581476768,300,12,80,392
5600,dark,main,20211201,7,0.9889418466673113,228,10,100,338
5600,dark,main,20211201,8,0.9916779020032767,261,14,104,379
5600,dark,main,20211201,9,0.9962665501195969,262,13,110,385
5647,dark,main,20211201,0,0.9892437744233148,278,13,93,384
5647,dark,main,20211201,1,0.9923307624702123,256,20,79,355
5647,dark,main,20211201,2,0.9948287519888585,302,16,72,390
5647,dark,main,20211201,3,0.9869197837928483,259,16,84,359
5647,dark,main,20211201,4,0.9819659210859357,243,11,52,306
5647,dark,main,20211201,5,0.9911259384816727,283,19,56,358
5647,dark,main,20211201,6,0.9893286553740344,300,14,64,378
5647,dark,main,20211201,7,0.986642199130989,250,14,58,322
5647,dark,main,20211201,8,0.9881114545840551,278,14,72,364
5647,dark,main,20211201,9,0.9815550998841945,262,15,91,368
1694,dark,main,20211201,0,0.994295698439352,252,13,112,377
1694,dark,main,20211201,1,0.9917439647678042,248,12,95,355
1694,dark,main,20211201,2,0.9942756724867966,277,9,109,395
1694,dark,main,20211201,3,0.9894794495147711,285,9,64,358
1694,dark,main,20211201,4,0.9894201519681514,268,13,49,330
1694,dark,main,20211201,5,0.9890988121809222,292,9,61,362
1694,dark,main,20211201,6,0.9888582967825047,290,11,75,376
1694,dark,main,20211201,7,0.9916396645282806,269,13,48,330
1694,dark,main,20211201,8,0.987855933108112,292,14,61,367
1694,dark,main,20211201,9,0.9943029170808524,287,13,83,383
8634,dark,main,20211201,0,0.9941094820929303,294,18,66,378
8634,dark,main,20211201,1,0.9839761478474952,266,14,64,344
8634,dark,main,20211201,2,0.9896989737932282,274,23,82,379
8634,dark,main,20211201,3,0.9922772826030574,274,12,67,353
8634,dark,main,20211201,4,0.9908656100694889,272,18,50,340
8634,dark,main,20211201,5,0.9846166653313263,302,16,61,379
8634,dark,main,20211201,6,0.9904747815377076,304,18,71,393
8634,dark,main,20211201,7,0.992176762332654,261,10,61,332
8634,dark,main,20211201,8,0.9875831070286374,289,14,58,361
8634,dark,main,20211201,9,0.993840668360849,308,18,50,376
21834,bright,main,20211201,0,0.9932359629787993,330,98,7,435
21834,bright,main,20211201,1,0.9918919030135334,317,65,5,387
21834,bright,main,20211201,2,0.9888128876732881,382,50,3,435
21834,bright,main,20211201,3,0.9893376776534626,337,56,3,396
21834,bright,main,20211201,4,0.9890604923754985,292,54,2,348
21834,bright,main,20211201,5,0.9925759948081667,318,82,3,403
21834,bright,main,20211201,6,0.9929341755534402,332,81,5,418
21834,bright,main,20211201,7,0.9884135737766832,255,92,9,356
21834,bright,main,20211201,8,0.989407179476381,279,122,6,407
21834,bright,main,20211201,9,0.9919674965313806,339,80,6,425
11919,dark,main,20211201,0,0.9907888533484919,268,17,90,375
11919,dark,main,20211201,1,0.9885286339692609,236,11,105,352
11919,dark,main,20211201,2,0.9910372099244832,291,15,85,391
11919,dark,main,20211201,3,0.9882907879801313,258,12,74,344
11919,dark,main,20211201,4,0.9925509435064285,226,14,67,307
11919,dark,main,20211201,5,0.9925538704156947,272,12,79,363
11919,dark,main,20211201,6,0.9943211243785588,255,20,107,382
11919,dark,main,20211201,7,0.988650525225609,223,14,91,328
11919,dark,main,20211201,8,0.9923590315081922,266,14,97,377
11919,dark,main,20211201,9,0.9900263692109815,273,13,87,373
7205,dark,main,20211201,0,0.9918184149238921,313,12,49,374
7205,dark,main,20211201,1,0.9943828880292597,301,14,40,355
7205,dark,main,20211201,2,0.9948444519386099,319,13,51,383
7205,dark,main,20211201,3,0.9940034931032615,282,12,52,346
7205,dark,main,20211201,4,0.9902505313074219,256,8,50,314
7205,dark,main,20211201,5,0.9925049944373813,289,13,50,352
7205,dark,main,20211201,6,0.9909459044645332,313,8,58,379
7205,dark,main,20211201,7,0.9911304225001222,250,13,56,319
7205,dark,main,20211201,8,0.9770710568814893,301,15,60,376
7205,dark,main,20211201,9,0.982946156228519,287,15,70,372
10204,dark,main,20211201,0,0.9925188496251662,295,13,66,374
10204,dark,main,20211201,1,0.9909898768854651,285,17,43,345
10204,dark,main,20211201,2,0.9942248596926625,280,22,81,383
10204,dark,main,20211201,3,0.9932827378043313,245,25,83,353
10204,dark,main,20211201,4,0.9928999463600862,199,39,80,318
10204,dark,main,20211201,5,0.9916870859023191,250,18,95,363
10204,dark,main,20211201,6,0.9967220167595615,263,26,93,382
10204,dark,main,20211201,7,0.9899180955730101,227,21,90,338
10204,dark,main,20211201,8,0.9929701622179773,291,15,56,362
10204,dark,main,20211201,9,0.9902414294162899,297,20,64,381
5877,dark,main,20211201,0,0.9947954259071532,274,21,86,381
5877,dark,main,20211201,1,0.9899527277617853,258,17,59,334
5877,dark,main,20211201,2,0.9867374297932544,277,16,86,379
5877,dark,main,20211201,3,0.9962422591715232,270,19,64,353
5877,dark,main,20211201,4,0.9866402533952736,288,10,34,332
5877,dark,main,20211201,5,0.9930526291794101,282,18,57,357
5877,dark,main,20211201,6,0.9939771084761979,297,13,64,374
5877,dark,main,20211201,7,0.9884892220430085,246,13,73,332
5877,dark,main,20211201,8,0.9919869398496941,304,17,58,379
5877,dark,main,20211201,9,0.9893949694995636,270,11,79,360
1664,dark,main,20211201,0,0.9876884927453302,294,11,68,373
1664,dark,main,20211201,1,0.985558580014586,302,14,46,362
1664,dark,main,20211201,2,0.9844116194026298,284,12,75,371
1664,dark,main,20211201,3,0.9937045224514959,287,16,46,349
1664,dark,main,20211201,4,0.989513460484655,249,14,67,330
1664,dark,main,20211201,5,0.9878900758396253,296,15,56,367
1664,dark,main,20211201,6,0.9927002164814991,329,12,52,393
1664,dark,main,20211201,7,0.9846357653646437,262,11,58,331
1664,dark,main,20211201,8,0.9935692179704525,304,13,46,363
1664,dark,main,20211201,9,0.9867294423921148,302,11,49,362
10200,dark,main,20211201,0,0.9906720174254833,295,17,65,377
10200,dark,main,20211201,1,0.9906887652099854,274,18,58,350
10200,dark,main,20211201,2,0.9868387007780555,314,15,57,386
10200,dark,main,20211201,3,0.9944389962520723,248,17,83,348
10200,dark,main,20211201,4,0.9903309278227768,240,15,73,328
10200,dark,main,20211201,5,0.9908980026672087,302,20,50,372
10200,dark,main,20211201,6,0.9966541623323628,292,25,57,374
10200,dark,main,20211201,7,0.9916306174014207,233,18,63,314
10200,dark,main,20211201,8,0.9924384297008897,274,16,82,372
10200,dark,main,20211201,9,0.9925399353861551,311,13,65,389
22597,bright,main,20211201,0,0.9949606847545233,283,128,8,419
22597,bright,main,20211201,1,0.9844056559138046,236,128,2,366
22597,bright,main,20211201,2,0.9918019841852598,222,184,11,417
22597,bright,main,20211201,3,0.9894985649064485,194,172,8,374
22597,bright,main,20211201,4,0.9902760081727545,200,156,3,359
22597,bright,main,20211201,5,0.9936110986391631,212,169,4,385
22597,bright,main,20211201,6,0.9925833662169413,213,176,7,396
22597,bright,main,20211201,7,0.9936417055476702,232,113,5,350
22597,bright,main,20211201,8,0.9941141781146179,296,112,8,416
22597,bright,main,20211201,9,0.9930899101037922,266,136,5,407
2254,dark,main,20211201,0,0.9930256719264866,305,14,77,396
2254,dark,main,20211201,1,0.9929700107735272,288,11,52,351
2254,dark,main,20211201,2,0.9943854615689528,301,16,71,388
2254,dark,main,20211201,3,0.9897182255522713,256,16,81,353
2254,dark,main,20211201,4,0.9898471304099348,235,9,92,336
2254,dark,main,20211201,5,0.9897077960352142,257,12,89,358
2254,dark,main,20211201,6,0.983555583638975,265,29,71,365
2254,dark,main,20211201,7,0.989026217788756,252,17,60,329
2254,dark,main,20211201,8,0.9861765749749496,296,12,63,371
2254,dark,main,20211201,9,0.9948962850727745,300,15,53,368
11776,dark,main,20211201,0,0.9927997205682856,281,23,79,383
11776,dark,main,20211201,1,0.9874674943628586,259,21,71,351
11776,dark,main,20211201,2,0.9934133359633491,295,23,70,388
11776,dark,main,20211201,3,0.9941093517989769,261,16,71,348
11776,dark,main,20211201,4,0.9898475010225521,253,14,58,325
11776,dark,main,20211201,5,0.9864606529017409,282,15,59,356
11776,dark,main,20211201,6,0.9900910355586091,310,19,40,369
11776,dark,main,20211201,7,0.988943176082096,257,22,29,308
11776,dark,main,20211201,8,0.9896900239131865,295,19,50,364
11776,dark,main,20211201,9,0.9877283567451435,291,17,63,371
7214,dark,main,20211201,0,0.9931031719090623,323,15,55,393
7214,dark,main,20211201,1,0.9931591306456127,262,12,74,348
7214,dark,main,20211201,2,0.9910671071383483,299,13,66,378
7214,dark,main,20211201,3,0.9927762289265573,296,14,50,360
7214,dark,main,20211201,4,0.9924627849480695,237,11,64,312
7214,dark,main,20211201,5,0.9935006572989706,290,9,55,354
7214,dark,main,20211201,6,0.9918255029246108,305,11,54,370
7214,dark,main,20211201,7,0.9892354214026485,267,14,35,316
7214,dark,main,20211201,8,0.9973769283150773,305,17,62,384
7214,dark,main,20211201,9,0.993507924816254,299,12,76,387
7169,dark,main,20211201,0,0.9918062580233149,316,11,62,389
7169,dark,main,20211201,1,0.9902584273091041,281,11,52,344
7169,dark,main,20211201,2,0.9901961924443766,337,13,37,387
7169,dark,main,20211201,3,0.9878942888480252,289,14,43,346
7169,dark,main,20211201,4,0.9935747644426229,280,9,43,332
7169,dark,main,20211201,5,0.9906973852422185,303,17,40,360
7169,dark,main,20211201,6,0.9898622868105192,341,15,38,394
7169,dark,main,20211201,7,0.9860497267254158,247,14,64,325
7169,dark,main,20211201,8,0.9945427894829889,295,13,64,372
7169,dark,main,20211201,9,0.9882568872908968,304,15,58,377
7401,dark,main,20211201,0,0.9871068713875597,316,14,48,378
7401,dark,main,20211201,1,0.9936318567190053,276,10,54,340
7401,dark,main,20211201,2,0.9887826288648535,312,11,58,381
7401,dark,main,20211201,3,0.9931565531937628,280,11,58,349
7401,dark,main,20211201,4,0.98737786393646,264,10,51,325
7401,dark,main,20211201,5,0.9952596560298782,302,10,55,367
7401,dark,main,20211201,6,0.9818409347635702,309,10,56,375
7401,dark,main,20211201,7,0.9901591475625436,257,13,44,314
7401,dark,main,20211201,8,0.988572471001277,322,13,42,377
7401,dark,main,20211201,9,0.9919665433141807,296,14,68,378
4002,dark,main,20211201,0,0.9899693076791783,309,14,72,395
4002,dark,main,20211201,1,0.9914784123273577,298,13,55,366
4002,dark,main,20211201,2,0.9915776880588779,353,10,42,405
4002,dark,main,20211201,3,0.9851761768433146,317,10,40,367
4002,dark,main,20211201,4,0.9833237476715093,289,9,55,353
4002,dark,main,20211201,5,0.9954782990360884,312,10,55,377
4002,dark,main,20211201,6,0.9949593361215142,296,9,78,383
4002,dark,main,20211201,7,0.9918692017279063,238,19,73,330
4002,dark,main,20211201,8,0.9926166540691478,281,11,87,379
4002,dark,main,20211201,9,0.9916262857868454,306,11,66,383
8821,dark,main,20211201,0,0.9867781336743445,267,18,97,382
8821,dark,main,20211201,1,0.9889519214708953,231,22,95,348
8821,dark,main,20211201,2,0.9925230937986814,263,18,100,381
8821,dark,main,20211201,3,0.994923772885847,250,18,75,343
8821,dark,main,20211201,4,0.9915693926824359,212,15,67,294
8821,dark,main,20211201,5,0.9915191990425866,273,19,90,382
8821,dark,main,20211201,6,0.9909489218206347,283,17,83,383
8821,dark,main,20211201,7,0.9897434999867609,228,13,87,328
8821,dark,main,20211201,8,0.9862498351192881,263,17,92,372
8821,dark,main,20211201,9,0.996387296056492,253,22,100,375
7944,dark,main,20211201,0,0.9917838859968117,285,14,91,390
7944,dark,main,20211201,1,0.9962681370901589,234,14,96,344
7944,dark,main,20211201,2,0.990240940366678,297,12,65,374
7944,dark,main,20211201,3,0.9906162432608436,266,21,45,332
7944,dark,main,20211201,4,0.9924878373340622,261,12,54,327
7944,dark,main,20211201,5,0.9943457334655013,295,13,54,362
7944,dark,main,20211201,6,0.9913959587470397,311,11,56,378
7944,dark,main,20211201,7,0.9907735666605736,259,12,43,314
7944,dark,main,20211201,8,0.9918487973342496,283,16,87,386
7944,dark,main,20211201,9,0.99397494056677,268,13,92,373
11537,dark,main,20211201,0,0.9927733453396694,293,16,74,383
11537,dark,main,20211201,1,0.9871888957007234,289,12,63,364
11537,dark,main,20211201,2,0.9951341931668167,269,23,78,370
11537,dark,main,20211201,3,0.989956643890413,223,23,82,328
11537,dark,main,20211201,4,0.9910257082334983,221,26,91,338
11537,dark,main,20211201,5,0.9882388477400411,276,17,79,372
11537,dark,main,20211201,6,0.9926620373354124,277,29,56,362
11537,dark,main,20211201,7,0.9865557826049473,257,14,48,319
11537,dark,main,20211201,8,0.986261406063605,265,20,83,368
11537,dark,main,20211201,9,0.9921594495875199,267,20,86,373
10075,dark,main,20211202,0,0.9950068216999925,256,13,71,340
10075,dark,main,20211202,1,0.9787194232564927,239,12,59,310
10075,dark,main,20211202,2,0.9914344455251719,292,13,42,347
10075,dark,main,20211202,3,0.9925338660372856,258,15,55,328
10075,dark,main,20211202,4,0.990654820480655,239,11,56,306
10075,dark,main,20211202,5,0.9910930713615904,279,16,51,346
10075,dark,main,20211202,6,0.9893272796345536,244,20,81,345
10075,dark,main,20211202,7,0.9929040280509436,208,15,70,293
10075,dark,main,20211202,8,0.9918927496846626,235,12,74,321
10075,dark,main,20211202,9,0.9926379417418141,216,56,69,341
5146,dark,main,20211202,0,0.9895270875290294,312,10,60,382
5146,dark,main,20211202,1,0.9885059689653661,282,10,62,354
5146,dark,main,20211202,2,0.9881996545959472,310,12,69,391
5146,dark,main,20211202,3,0.9843749214670348,277,10,59,346
5146,dark,main,20211202,4,0.9895304863674877,267,9,67,343
5146,dark,main,20211202,5,0.99242678309181,289,13,57,359
5146,dark,main,20211202,6,0.9814542969512874,299,10,65,374
5146,dark,main,20211202,7,0.9866942138827675,259,10,65,334
5146,dark,main,20211202,8,0.990978178314212,289,10,79,378
5146,dark,main,20211202,9,0.9928473355395786,281,11,76,368
2227,dark,main,20211202,0,0.9921602958215242,321,12,54,387
2227,dark,main,20211202,1,0.9939408722026383,285,17,33,335
2227,dark,main,20211202,2,0.994032298993652,311,14,59,384
2227,dark,main,20211202,3,0.9942470887705641,253,14,79,346
2227,dark,main,20211202,4,0.9896207705342633,234,13,81,328
2227,dark,main,20211202,5,0.990917513416222,273,15,75,363
2227,dark,main,20211202,6,0.9963504412281728,302,11,74,387
2227,dark,main,20211202,7,0.9858405242556433,258,12,51,321
2227,dark,main,20211202,8,0.9917250949602477,259,21,84,364
2227,dark,main,20211202,9,0.9912286384452387,298,14,56,368
1259,dark,main,20211202,0,0.9879088626394278,188,14,66,268
1259,dark,main,20211202,1,0.9929456660025018,217,18,80,315
1259,dark,main,20211202,2,0.9885028047226385,271,18,99,388
1259,dark,main,20211202,3,0.9927473629248319,239,20,89,348
1259,dark,main,20211202,4,0.9955668792108049,240,14,75,329
1259,dark,main,20211202,5,0.9807498089389256,248,16,90,354
1259,dark,main,20211202,6,0.9897573327839962,271,21,94,386
1259,dark,main,20211202,7,0.9909708774284943,246,10,74,330
1259,dark,main,20211202,8,0.991954974809894,260,20,101,381
1259,dark,main,20211202,9,0.9899480433846625,233,20,79,332
3103,dark,main,20211202,0,0.9930081496863422,294,16,66,376
3103,dark,main,20211202,1,0.988979496523745,269,13,81,363
3103,dark,main,20211202,2,0.9926156385921046,268,18,94,380
3103,dark,main,20211202,3,0.9965752715110007,259,15,83,357
3103,dark,main,20211202,4,0.9865320270895295,261,13,71,345
3103,dark,main,20211202,5,0.9935049753363595,286,14,68,368
3103,dark,main,20211202,6,0.9968037498290834,300,12,60,372
3103,dark,main,20211202,7,0.9950548953533557,254,12,65,331
3103,dark,main,20211202,8,0.9926442399762808,278,12,83,373
3103,dark,main,20211202,9,0.9934744143396417,299,14,62,375
7059,dark,main,20211202,0,0.9909471115964165,282,20,82,384
7059,dark,main,20211202,1,0.9873164145278153,253,20,79,352
7059,dark,main,20211202,2,0.9912424135335078,275,16,92,383
7059,dark,main,20211202,3,0.9805679336138314,284,17,54,355
7059,dark,main,20211202,4,0.9938076090925818,254,14,65,333
7059,dark,main,20211202,5,0.9932741362951806,277,11,68,356
7059,dark,main,20211202,6,0.9952960120179192,290,16,74,380
7059,dark,main,20211202,7,0.9948027165869345,253,15,54,322
7059,dark,main,20211202,8,0.9901041476011171,283,11,69,363
7059,dark,main,20211202,9,0.9928707767444817,284,12,64,360
25023,bright,main,20211202,0,0.9936941002668906,307,128,5,440
25023,bright,main,20211202,1,0.9921227197731163,248,153,2,403
25023,bright,main,20211202,2,0.9877459889378495,279,155,4,438
25023,bright,main,20211202,3,0.9918667402429626,262,138,1,401
25023,bright,main,20211202,4,0.9917434273671718,200,186,2,388
25023,bright,main,20211202,5,0.9966259128366226,235,171,8,414
25023,bright,main,20211202,6,0.9930079684822267,202,227,6,435
25023,bright,main,20211202,7,0.9894759358937829,197,170,3,370
25023,bright,main,20211202,8,0.9942517221868445,281,138,7,426
25023,bright,main,20211202,9,0.9943414590569021,242,185,5,432
7782,dark,main,20211202,0,0.9896881358529892,258,11,81,350
7782,dark,main,20211202,1,0.9911851673793567,211,14,78,303
7782,dark,main,20211202,2,0.9940842159102163,258,13,80,351
7782,dark,main,20211202,3,0.9937567249376541,227,14,77,318
7782,dark,main,20211202,4,0.9888656591758559,248,10,69,327
7782,dark,main,20211202,5,0.9945429144342812,281,9,60,350
7782,dark,main,20211202,6,0.9888977533278823,273,14,58,345
7782,dark,main,20211202,7,0.985901458951393,245,14,53,312
7782,dark,main,20211202,8,0.990888672026401,266,17,68,351
7782,dark,main,20211202,9,0.9888628215087752,251,22,76,349
6508,dark,main,20211202,0,0.997292530164442,331,9,58,398
6508,dark,main,20211202,1,0.9873625449889292,278,13,46,337
6508,dark,main,20211202,2,0.9918395030359191,326,14,42,382
6508,dark,main,20211202,3,0.9909239087312958,300,14,39,353
6508,dark,main,20211202,4,0.9859381809139292,277,14,46,337
6508,dark,main,20211202,5,0.9930618988495377,305,14,54,373
6508,dark,main,20211202,6,0.9943525718266872,324,12,44,380
6508,dark,main,20211202,7,0.9906338724086702,259,16,54,329
6508,dark,main,20211202,8,0.9914928461092875,281,15,88,384
6508,dark,main,20211202,9,0.994166870954107,315,14,54,383
10270,dark,main,20211202,0,0.9959171816823948,334,12,71,417
10270,dark,main,20211202,1,0.9920008408787182,303,12,52,367
10270,dark,main,20211202,2,0.9905467061283536,335,9,57,401
10270,dark,main,20211202,3,0.9877676090982414,278,13,66,357
10270,dark,main,20211202,4,0.9956877734026951,277,9,71,357
10270,dark,main,20211202,5,0.9891384520615649,292,13,87,392
10270,dark,main,20211202,6,0.9921686833391097,298,12,76,386
10270,dark,main,20211202,7,0.9917715948170125,272,11,53,336
10270,dark,main,20211202,8,0.99111028521312,298,13,84,395
10270,dark,main,20211202,9,0.9908507552371303,292,12,84,388
11097,dark,main,20211202,0,0.9958450065783231,298,16,83,397
11097,dark,main,20211202,1,0.9954380223145762,262,16,77,355
11097,dark,main,20211202,2,0.9916234542564782,307,13,63,383
11097,dark,main,20211202,3,0.9895156686110353,271,11,63,345
11097,dark,main,20211202,4,0.9911000726683297,250,16,61,327
11097,dark,main,20211202,5,0.9906259090469097,285,15,71,371
11097,dark,main,20211202,6,0.9925678993852696,271,14,65,350
11097,dark,main,20211202,7,0.9873992100530057,148,12,43,203
11097,dark,main,20211202,8,0.9964694266119438,267,15,106,388
11097,dark,main,20211202,9,0.9945617243876774,286,12,85,383
5636,dark,main,20211202,0,0.9935276655499886,286,18,84,388
5636,dark,main,20211202,1,0.990597269413757,266,18,69,353
5636,dark,main,20211202,2,0.9892575935096996,285,11,94,390
5636,dark,main,20211202,3,0.9948916853207587,282,12,66,360
5636,dark,main,20211202,4,0.9950100659262484,235,10,98,343
5636,dark,main,20211202,5,0.9913083206038708,266,14,82,362
5636,dark,main,20211202,6,0.9930952379705381,292,13,89,394
5636,dark,main,20211202,7,0.9932180517110898,223,18,79,320
5636,dark,main,20211202,8,0.9927428138814522,268,13,101,382
5636,dark,main,20211202,9,0.9929343772391177,267,22,87,376
3133,dark,main,20211202,0,0.9916077833589467,326,11,53,390
3133,dark,main,20211202,1,0.9949781829555197,282,10,67,359
3133,dark,main,20211202,2,0.9944704153956038,314,12,58,384
3133,dark,main,20211202,3,0.9884156430245872,291,11,55,357
3133,dark,main,20211202,4,0.9886737353351801,270,13,62,345
3133,dark,main,20211202,5,0.9941590270038554,280,12,73,365
3133,dark,main,20211202,6,0.9963932047913564,309,15,56,380
3133,dark,main,20211202,7,0.9938477791509602,287,11,36,334
3133,dark,main,20211202,8,0.9953903207756769,324,10,42,376
3133,dark,main,20211202,9,0.991958158922076,299,9,69,377
5144,dark,main,20211202,0,0.9935954251207928,294,11,81,386
5144,dark,main,20211202,1,0.9837442546723517,291,10,57,358
5144,dark,main,20211202,2,0.9871239465915691,272,14,93,379
5144,dark,main,20211202,3,0.9942929761009849,263,14,81,358
5144,dark,main,20211202,4,0.9896650420476921,241,14,81,336
5144,dark,main,20211202,5,0.9902620275296183,251,18,101,370
5144,dark,main,20211202,6,0.9918863948336044,288,12,74,374
5144,dark,main,20211202,7,0.9935735963004148,245,13,55,313
5144,dark,main,20211202,8,0.9950061543417233,287,12,71,370
5144,dark,main,20211202,9,0.9913689932356179,278,11,84,373
7215,dark,main,20211202,0,0.9940297585004029,305,17,72,394
7215,dark,main,20211202,1,0.9815870593549032,286,16,47,349
7215,dark,main,20211202,2,0.9916599018233182,303,14,69,386
7215,dark,main,20211202,3,0.9928190014812563,254,21,76,351
7215,dark,main,20211202,4,0.9950810514824918,264,11,68,343
7215,dark,main,20211202,5,0.9924336036919238,298,13,55,366
7215,dark,main,20211202,6,0.989627121102394,305,17,55,377
7215,dark,main,20211202,7,0.9922845038835023,255,15,65,335
7215,dark,main,20211202,8,0.9943887108274159,293,22,74,389
7215,dark,main,20211202,9,0.9895946620066558,286,14,79,379
5134,dark,main,20211202,0,0.9956552165968423,312,11,60,383
5134,dark,main,20211202,1,0.9930177524905063,280,14,53,347
5134,dark,main,20211202,2,0.9922930243639226,288,15,82,385
5134,dark,main,20211202,3,0.995621025527451,287,11,59,357
5134,dark,main,20211202,4,0.9943046397290887,268,14,57,339
5134,dark,main,20211202,5,0.9922533586377407,293,12,57,362
5134,dark,main,20211202,6,0.989148208597693,277,15,95,387
5134,dark,main,20211202,7,0.9924228151634922,247,10,59,316
5134,dark,main,20211202,8,0.9900148735390928,286,15,86,387
5134,dark,main,20211202,9,0.9907830103278412,301,10,60,371
8698,dark,main,20211202,0,0.9970872797800386,282,13,87,382
8698,dark,main,20211202,1,0.9867605253886153,273,10,85,368
8698,dark,main,20211202,2,0.9924408148094113,306,7,75,388
8698,dark,main,20211202,3,0.9946113753894991,304,10,55,369
8698,dark,main,20211202,4,0.9897286349252926,271,10,48,329
8698,dark,main,20211202,5,0.992106423672057,302,16,49,367
8698,dark,main,20211202,6,0.9943908149780112,278,12,87,377
8698,dark,main,20211202,7,0.9939243070065745,244,11,70,325
8698,dark,main,20211202,8,0.9924080772913804,253,17,96,366
8698,dark,main,20211202,9,0.9925980926910883,276,16,90,382
5515,dark,main,20211202,0,0.9933943689686632,312,20,70,402
5515,dark,main,20211202,1,0.9879937127935783,271,16,65,352
5515,dark,main,20211202,2,0.9913705982309478,287,18,64,369
5515,dark,main,20211202,3,0.9959715367917686,281,15,63,359
5515,dark,main,20211202,4,0.9937368793851489,244,22,56,322
5515,dark,main,20211202,5,0.9860562896820604,303,17,50,370
5515,dark,main,20211202,6,0.9918131007972395,305,18,48,371
5515,dark,main,20211202,7,0.9870486861398368,271,17,32,320
5515,dark,main,20211202,8,0.9896810557366431,275,17,74,366
5515,dark,main,20211202,9,0.9895331779353493,269,21,80,370
3579,dark,main,20211202,0,0.99090153481077,288,13,88,389
3579,dark,main,20211202,1,0.9899683528320056,281,10,63,354
3579,dark,main,20211202,2,0.9884348631384454,305,13,53,371
3579,dark,main,20211202,3,0.9925522433457773,288,10,51,349
3579,dark,main,20211202,4,0.9869196866958494,260,9,66,335
3579,dark,main,20211202,5,0.99464011935022,304,10,73,387
3579,dark,main,20211202,6,0.9878684709802787,314,11,62,387
3579,dark,main,20211202,7,0.9867932997316816,290,11,36,337
3579,dark,main,20211202,8,0.9959656086014089,306,13,51,370
3579,dark,main,20211202,9,0.993896786965945,301,19,55,375
5497,dark,main,20211202,0,0.992272119242545,256,15,100,371
5497,dark,main,20211202,1,0.9942433407029515,259,20,77,356
5497,dark,main,20211202,2,0.9941773494628108,289,17,90,396
5497,dark,main,20211202,3,0.9885953869424575,251,16,86,353
5497,dark,main,20211202,4,0.9877537445936766,228,13,83,324
5497,dark,main,20211202,5,0.9887084860001452,257,20,98,375
5497,dark,main,20211202,6,0.9971849209510248,261,18,104,383
5497,dark,main,20211202,7,0.9834604926366034,219,19,81,319
5497,dark,main,20211202,8,0.9933792535700603,270,17,83,370
5497,dark,main,20211202,9,0.9882666145388012,268,24,71,363
8635,dark,main,20211202,0,0.9870548191134267,294,15,56,365
8635,dark,main,20211202,1,0.9847256671964838,267,13,69,349
8635,dark,main,20211202,2,0.9940849270120317,289,24,65,378
8635,dark,main,20211202,3,0.9870016005245277,251,22,91,364
8635,dark,main,20211202,4,0.9832279943737989,247,13,84,344
8635,dark,main,20211202,5,0.9863102125256243,258,18,80,356
8635,dark,main,20211202,6,0.990701966891682,290,16,73,379
8635,dark,main,20211202,7,0.9941512673399894,230,19,77,326
8635,dark,main,20211202,8,0.9962859979719092,271,27,78,376
8635,dark,main,20211202,9,0.9957066151489072,298,24,44,366
2026,dark,main,20211202,0,0.992466257311587,295,13,85,393
2026,dark,main,20211202,1,0.9889912355615792,284,11,53,348
2026,dark,main,20211202,2,0.9892289591224213,305,13,58,376
2026,dark,main,20211202,3,0.9834933268907657,254,17,54,325
2026,dark,main,20211202,4,0.9901652573147132,233,17,89,339
2026,dark,main,20211202,5,0.9861175513320042,262,20,68,350
2026,dark,main,20211202,6,0.9928619153048166,297,14,71,382
2026,dark,main,20211202,7,0.9920932842978322,235,13,67,315
2026,dark,main,20211202,8,0.9919847118885421,276,12,74,362
2026,dark,main,20211202,9,0.9942625514103542,278,15,67,360
5677,dark,main,20211202,0,0.9926723597578233,279,14,89,382
5677,dark,main,20211202,1,0.9888609523801902,275,14,81,370
5677,dark,main,20211202,2,0.9932204485922177,267,22,113,402
5677,dark,main,20211202,3,0.9947073715548409,246,18,85,349
5677,dark,main,20211202,4,0.9845469997686896,251,14,84,349
5677,dark,main,20211202,5,0.991713927400403,282,18,77,377
5677,dark,main,20211202,6,0.992304635348943,275,18,94,387
5677,dark,main,20211202,7,0.9888783846185224,241,15,73,329
5677,dark,main,20211202,8,0.9929448476377508,270,18,94,382
5677,dark,main,20211202,9,0.9808525197216039,258,29,87,374
3541,dark,main,20211202,0,0.9946102665346261,297,18,69,384
3541,dark,main,20211202,1,0.9923418427797572,262,23,55,340
3541,dark,main,20211202,2,0.992847118297036,309,12,61,382
3541,dark,main,20211202,3,0.9951217158012283,276,24,50,350
3541,dark,main,20211202,4,0.9824308560511512,252,15,62,329
3541,dark,main,20211202,5,0.9922320557729607,296,23,50,369
3541,dark,main,20211202,6,0.9917658543729565,314,11,64,389
3541,dark,main,20211202,7,0.9924365628018993,243,20,54,317
3541,dark,main,20211202,8,0.9916387329369388,277,19,81,377
3541,dark,main,20211202,9,0.9940311636372504,271,16,89,376
5133,dark,main,20211202,0,0.9834933552030921,289,12,89,390
5133,dark,main,20211202,1,0.987877416748939,248,14,80,342
5133,dark,main,20211202,2,0.9908389569295316,292,13,70,375
5133,dark,main,20211202,3,0.9975144356633506,264,13,68,345
5133,dark,main,20211202,4,0.9933803731187018,262,11,67,340
5133,dark,main,20211202,5,0.9926678870128213,284,16,65,365
5133,dark,main,20211202,6,0.99167540154642,308,17,62,387
5133,dark,main,20211202,7,0.9928655720664383,237,12,66,315
5133,dark,main,20211202,8,0.9963679275684054,287,16,65,368
5133,dark,main,20211202,9,0.9926008583897964,248,15,94,357
7204,dark,main,20211202,0,0.9949706793013455,299,18,78,395
7204,dark,main,20211202,1,0.9923941139743084,288,16,58,362
7204,dark,main,20211202,2,0.9896927080954656,304,13,67,384
7204,dark,main,20211202,3,0.9906542188766995,265,15,83,363
7204,dark,main,20211202,4,0.991063844375716,261,12,72,345
7204,dark,main,20211202,5,0.9893009612762559,274,13,87,374
7204,dark,main,20211202,6,0.9938156487277826,286,15,84,385
7204,dark,main,20211202,7,0.9898897826501137,241,14,77,332
7204,dark,main,20211202,8,0.992047923105061,274,12,83,369
7204,dark,main,20211202,9,0.9954408772286718,274,14,98,386
2523,dark,main,20211202,0,0.9898474900115908,294,12,91,397
2523,dark,main,20211202,1,0.9888820183803286,252,13,91,356
2523,dark,main,20211202,2,0.9896056699318739,270,11,84,365
2523,dark,main,20211202,3,0.9829629621973747,238,16,105,359
2523,dark,main,20211202,4,0.9911006936129344,238,12,85,335
2523,dark,main,20211202,5,0.9924408436448239,248,23,91,362
2523,dark,main,20211202,6,0.9952259981755107,263,22,97,382
2523,dark,main,20211202,7,0.9913912636577832,235,15,74,324
2523,dark,main,20211202,8,0.994457070504468,254,15,101,370
2523,dark,main,20211202,9,0.9910556884398883,261,14,109,384
11527,dark,main,20211202,0,0.9889457235557682,326,19,36,381
11527,dark,main,20211202,1,0.9853686562607576,281,22,50,353
11527,dark,main,20211202,2,0.993298487602086,304,23,60,387
11527,dark,main,20211202,3,0.993970148911282,297,16,46,359
11527,dark,main,20211202,4,0.993894046786775,262,17,58,337
11527,dark,main,20211202,5,0.9959549142754238,285,17,42,344
11527,dark,main,20211202,6,0.9893555788577274,321,20,37,378
11527,dark,main,20211202,7,0.9857847361107017,260,18,37,315
11527,dark,main,20211202,8,0.9940560833186407,306,15,49,370
11527,dark,main,20211202,9,0.9931903838998564,321,21,21,363
11353,dark,main,20211202,0,0.9924519927381505,322,12,64,398
11353,dark,main,20211202,1,0.9865935791627782,303,14,41,358
11353,dark,main,20211202,2,0.9907304932875153,283,18,79,380
11353,dark,main,20211202,3,0.9912970759056998,274,13,68,355
11353,dark,main,20211202,4,0.9923207547956175,235,28,58,321
11353,dark,main,20211202,5,0.990043557537622,247,22,89,358
11353,dark,main,20211202,6,0.9900284372343288,247,17,110,374
11353,dark,main,20211202,7,0.9895749610609287,239,16,85,340
11353,dark,main,20211202,8,0.9838316068348127,269,16,65,350
11353,dark,main,20211202,9,0.9902086135783995,321,10,47,378
3580,dark,main,20211202,0,0.9936319539256715,309,12,63,384
3580,dark,main,20211202,1,0.9935946239050201,277,16,59,352
3580,dark,main,20211202,2,0.9908230744453901,308,12,48,368
3580,dark,main,20211202,3,0.9931342821593593,298,15,41,354
3580,dark,main,20211202,4,0.9955883057416407,259,11,59,329
3580,dark,main,20211202,5,0.9885183738526565,302,12,57,371
3580,dark,main,20211202,6,0.9896041291226372,300,13,63,376
3580,dark,main,20211202,7,0.994387858394337,274,15,40,329
3580,dark,main,20211202,8,0.9872548899761546,291,12,67,370
3580,dark,main,20211202,9,0.9915164809332816,284,15,68,367
26239,bright,main,20211203,0,0.9876596768910176,343,78,6,427
26239,bright,main,20211203,1,0.9864839058573345,288,67,4,359
26239,bright,main,20211203,2,0.994235043549796,315,91,5,411
26239,bright,main,20211203,3,0.9905806143603895,308,73,5,386
26239,bright,main,20211203,4,0.9920980545726851,322,62,7,391
26239,bright,main,20211203,5,0.9950984024532633,340,58,4,402
26239,bright,main,20211203,6,0.9864555954694539,333,66,1,400
26239,bright,main,20211203,7,0.9873117661658825,275,74,3,352
26239,bright,main,20211203,8,0.9897715999883355,336,65,3,404
26239,bright,main,20211203,9,0.9964425509379928,332,78,3,413
22603,bright,main,20211203,0,0.9951064709780887,351,68,6,425
22603,bright,main,20211203,1,0.9892520104513189,312,64,4,380
22603,bright,main,20211203,2,0.9943094750140581,351,59,10,420
22603,bright,main,20211203,3,0.9926312070301444,298,71,0,369
22603,bright,main,20211203,4,0.9937769801136463,282,83,1,366
22603,bright,main,20211203,5,0.9943905563317637,325,64,6,395
22603,bright,main,20211203,6,0.9956610860062958,343,62,6,411
22603,bright,main,20211203,7,0.9934838009692599,309,44,2,355
22603,bright,main,20211203,8,0.9935144399187014,361,48,3,412
22603,bright,main,20211203,9,0.995458585488505,331,70,4,405
2552,dark,main,20211203,0,0.9952662119359923,277,15,87,379
2552,dark,main,20211203,1,0.9879455629016035,239,20,84,343
2552,dark,main,20211203,2,0.9931971008420911,264,20,96,380
2552,dark,main,20211203,3,0.9877723431474303,263,13,69,345
2552,dark,main,20211203,4,0.9902948306963889,253,11,81,345
2552,dark,main,20211203,5,0.9943577912108199,277,12,79,368
2552,dark,main,20211203,6,0.9899331828665551,269,15,98,382
2552,dark,main,20211203,7,0.9843306950566193,246,11,76,333
2552,dark,main,20211203,8,0.9879342261298886,269,18,82,369
2552,dark,main,20211203,9,0.9902649789028758,276,16,77,369
1673,dark,main,20211203,0,0.9956732258513445,282,12,62,356
1673,dark,main,20211203,1,0.9935517208343645,226,11,60,297
1673,dark,main,20211203,2,0.9900761653315264,233,8,57,298
1673,dark,main,20211203,3,0.9879014928014682,252,13,52,317
1673,dark,main,20211203,4,0.9964564520193365,246,12,78,336
1673,dark,main,20211203,5,0.9925079387014538,282,11,78,371
1673,dark,main,20211203,6,0.9889736219936406,287,12,72,371
1673,dark,main,20211203,7,0.9891107215953666,264,13,64,341
1673,dark,main,20211203,8,0.9927772586319985,290,12,80,382
1673,dark,main,20211203,9,0.9860554769431118,294,10,63,367
5579,dark,main,20211203,0,0.9913391011007888,328,17,54,399
5579,dark,main,20211203,1,0.9934778421599674,295,15,59,369
5579,dark,main,20211203,2,0.9948263225213942,306,11,78,395
5579,dark,main,20211203,3,0.9948711903752957,277,12,73,362
5579,dark,main,20211203,4,0.9905159261325265,295,10,59,364
5579,dark,main,20211203,5,0.9933311473603881,328,13,52,393
5579,dark,main,20211203,6,0.9952379628275152,322,13,68,403
5579,dark,main,20211203,7,0.9926484910790522,272,11,58,341
5579,dark,main,20211203,8,0.9938217384783403,306,14,56,376
5579,dark,main,20211203,9,0.9829175101307779,318,10,56,384
7953,dark,main,20211203,0,0.993113137172901,322,10,59,391
7953,dark,main,20211203,1,0.9911941973123878,298,10,42,350
7953,dark,main,20211203,2,0.9971030533607722,310,11,49,370
7953,dark,main,20211203,3,0.9946768988775986,270,12,75,357
7953,dark,main,20211203,4,0.9951087191435662,227,13,99,339
7953,dark,main,20211203,5,0.9861694225809858,281,13,76,370
7953,dark,main,20211203,6,0.9930271241197259,281,10,95,386
7953,dark,main,20211203,7,0.9917567537970077,268,13,67,348
7953,dark,main,20211203,8,0.9860166182909755,303,10,73,386
7953,dark,main,20211203,9,0.9916762603432284,308,15,62,385
9499,dark,main,20211203,0,0.9923430742411745,311,12,72,395
9499,dark,main,20211203,1,0.9915528201948332,287,10,55,352
9499,dark,main,20211203,2,0.9869703818755419,305,17,61,383
9499,dark,main,20211203,3,0.9858759415170912,253,17,73,343
9499,dark,main,20211203,4,0.9908912706165574,243,12,71,326
9499,dark,main,20211203,5,0.9944473036531591,262,10,86,358
9499,dark,main,20211203,6,0.9906587975647111,272,14,90,376
9499,dark,main,20211203,7,0.9937802418661135,251,14,65,330
9499,dark,main,20211203,8,0.9926827120872341,270,13,83,366
9499,dark,main,20211203,9,0.9932295792174504,293,12,70,375
5868,dark,main,20211203,0,0.9930298811348617,318,15,64,397
5868,dark,main,20211203,1,0.9839597003284096,291,11,46,348
5868,dark,main,20211203,2,0.9924716465259287,317,11,53,381
5868,dark,main,20211203,3,0.992560720611155,276,15,57,348
5868,dark,main,20211203,4,0.9889190195412735,254,15,69,338
5868,dark,main,20211203,5,0.9909218309379547,279,9,68,356
5868,dark,main,20211203,6,0.9941865500676502,302,13,63,378
5868,dark,main,20211203,7,0.9889339692951764,260,15,49,324
5868,dark,main,20211203,8,0.9934920857870824,300,14,51,365
5868,dark,main,20211203,9,0.9933847190260975,301,17,47,365
5872,dark,main,20211203,0,0.9925693174910001,259,15,98,372
5872,dark,main,20211203,1,0.994087120124495,265,15,69,349
5872,dark,main,20211203,2,0.989491228864872,285,16,75,376
5872,dark,main,20211203,3,0.9904476881727051,278,11,60,349
5872,dark,main,20211203,4,0.9844384554598447,200,9,36,245
5872,dark,main,20211203,5,0.9962185524379705,258,12,47,317
5872,dark,main,20211203,6,0.9871468693502812,202,6,54,262
5872,dark,main,20211203,7,0.9940954869839508,235,8,34,277
5872,dark,main,20211203,8,0.9945850432218798,305,12,63,380
5872,dark,main,20211203,9,0.9938656387678908,299,12,68,379
20008,bright,main,20211203,0,0.99703933193305,311,109,6,426
20008,bright,main,20211203,1,0.9928936184035757,309,78,5,392
20008,bright,main,20211203,2,0.994354281051116,322,96,3,421
20008,bright,main,20211203,3,0.9869874996700383,272,96,4,372
20008,bright,main,20211203,4,0.9952533241970977,284,87,6,377
20008,bright,main,20211203,5,0.9928882480834244,303,90,3,396
20008,bright,main,20211203,6,0.9973683716191055,351,63,3,417
20008,bright,main,20211203,7,0.9915943836596083,274,84,2,360
20008,bright,main,20211203,8,0.9932860146705603,315,89,6,410
20008,bright,main,20211203,9,0.9964094773803414,349,63,4,416
10072,dark,main,20211204,0,0.9897618786560989,322,15,60,397
10072,dark,main,20211204,1,0.993904531589188,293,12,56,361
10072,dark,main,20211204,2,0.9933536025031714,316,15,55,386
10072,dark,main,20211204,3,0.9883228989864294,278,13,58,349
10072,dark,main,20211204,4,0.9949397355750332,265,21,46,332
10072,dark,main,20211204,5,0.9883554422667448,286,14,56,356
10072,dark,main,20211204,6,0.9942119548334439,273,13,83,369
10072,dark,main,20211204,7,0.979930171696622,234,15,73,322
10072,dark,main,20211204,8,0.9959213293327951,264,13,95,372
10072,dark,main,20211204,9,0.9917957510323063,280,17,75,372
5156,dark,main,20211204,0,0.9614128408979037,93,7,31,131
5156,dark,main,20211204,1,0.9904113697567989,270,13,68,351
5156,dark,main,20211204,2,0.9915632307829276,305,11,67,383
5156,dark,main,20211204,3,0.9929820273888531,286,12,44,342
5156,dark,main,20211204,4,0.9911249674368392,283,11,60,354
5156,dark,main,20211204,5,0.9954431949641454,305,11,50,366
5156,dark,main,20211204,6,0.9921979144393738,297,15,68,380
5156,dark,main,20211204,7,0.9922647947626263,269,13,44,326
5156,dark,main,20211204,8,0.9899605547735076,308,12,48,368
5156,dark,main,20211204,9,0.9959577673022614,275,18,72,365
11428,dark,main,20211204,0,0.9946465297123952,320,15,50,385
11428,dark,main,20211204,1,0.9870111240595807,246,14,71,331
11428,dark,main,20211204,2,0.9899097800719234,295,17,84,396
11428,dark,main,20211204,3,0.9929743844058101,269,11,69,349
11428,dark,main,20211204,4,0.9933614119967734,255,12,84,351
11428,dark,main,20211204,5,0.9942978707827768,266,19,80,365
11428,dark,main,20211204,6,0.9960026032714686,268,14,94,376
11428,dark,main,20211204,7,0.9888248673970548,248,15,66,329
11428,dark,main,20211204,8,0.9877059348084202,297,13,65,375
11428,dark,main,20211204,9,0.9893088423883153,304,15,62,381
11756,dark,main,20211204,0,0.9922792476845589,258,21,109,388
11756,dark,main,20211204,1,0.9922138025858358,253,20,70,343
11756,dark,main,20211204,2,0.9906904697562389,258,26,112,396
11756,dark,main,20211204,3,0.9919716435594562,267,15,70,352
11756,dark,main,20211204,4,0.9912861272981681,250,21,67,338
11756,dark,main,20211204,5,0.9937509416163425,228,57,69,354
11756,dark,main,20211204,6,0.994746461681048,306,22,70,398
11756,dark,main,20211204,7,0.9934036888917384,263,17,59,339
11756,dark,main,20211204,8,0.9904940269171509,295,18,57,370
11756,dark,main,20211204,9,0.993057767808091,270,19,77,366
21885,bright,main,20211204,0,0.9938977916698288,328,111,3,442
21885,bright,main,20211204,1,0.9893327733660497,282,112,8,402
21885,bright,main,20211204,2,0.992240917488191,269,160,7,436
21885,bright,main,20211204,3,0.990991502324699,261,133,3,397
21885,bright,main,20211204,4,0.9908911137867309,258,127,2,387
21885,bright,main,20211204,5,0.9933106637962302,249,161,1,411
21885,bright,main,20211204,6,0.9925040906874009,279,147,4,430
21885,bright,main,20211204,7,0.9913006256986384,234,140,2,376
21885,bright,main,20211204,8,0.9927958930795813,267,159,1,427
21885,bright,main,20211204,9,0.9910112526083228,282,142,6,430
5369,dark,main,20211204,0,0.9898664876470351,299,16,69,384
5369,dark,main,20211204,1,0.9962694272544305,245,20,76,341
5369,dark,main,20211204,2,0.9928173360846129,269,16,97,382
5369,dark,main,20211204,3,0.9878974206540552,259,27,68,354
5369,dark,main,20211204,4,0.9897026000894501,244,11,78,333
5369,dark,main,20211204,5,0.993838934318245,264,12,88,364
5369,dark,main,20211204,6,0.9861807627541233,268,13,97,378
5369,dark,main,20211204,7,0.9898426473626107,237,14,78,329
5369,dark,main,20211204,8,0.9908837006167474,272,23,83,378
5369,dark,main,20211204,9,0.9870097747786736,291,16,59,366
9607,dark,main,20211204,0,0.9909831426268075,280,11,100,391
9607,dark,main,20211204,1,0.9943012671076804,262,15,80,357
9607,dark,main,20211204,2,0.989894205161385,235,44,61,340
9607,dark,main,20211204,3,0.9891628223954183,257,11,82,350
9607,dark,main,20211204,4,0.9943165161918638,260,19,70,349
9607,dark,main,20211204,5,0.988831687426481,280,20,63,363
9607,dark,main,20211204,6,0.9917372973695513,306,20,55,381
9607,dark,main,20211204,7,0.9935449998603755,261,12,48,321
9607,dark,main,20211204,8,0.9929088653787927,307,11,58,376
9607,dark,main,20211204,9,0.9838898209165713,305,13,59,377
3068,dark,main,20211204,0,0.9912537925548791,280,17,86,383
3068,dark,main,20211204,1,0.9819473057068797,254,15,78,347
3068,dark,main,20211204,2,0.9925724342361152,281,14,92,387
3068,dark,main,20211204,3,0.9839617038580916,251,12,84,347
3068,dark,main,20211204,4,0.9925399138147152,230,16,89,335
3068,dark,main,20211204,5,0.9892989510055742,285,11,76,372
3068,dark,main,20211204,6,0.9899606797047521,258,18,95,371
3068,dark,main,20211204,7,0.9940893815413205,237,17,74,328
3068,dark,main,20211204,8,0.9865571911686104,264,19,88,371
3068,dark,main,20211204,9,0.9947247967482601,284,14,82,380
11767,dark,main,20211204,0,0.9909449977076623,333,12,48,393
11767,dark,main,20211204,1,0.9857283226584509,281,16,57,354
11767,dark,main,20211204,2,0.9882997929872455,280,18,75,373
11767,dark,main,20211204,3,0.9946350055007516,289,11,54,354
11767,dark,main,20211204,4,0.9851847189164765,260,13,67,340
11767,dark,main,20211204,5,0.9912013460246103,276,10,79,365
11767,dark,main,20211204,6,0.9937798578250716,311,13,63,387
11767,dark,main,20211204,7,0.9928039121883229,253,17,58,328
11767,dark,main,20211204,8,0.9936111101377337,276,21,61,358
11767,dark,main,20211204,9,0.9914980577363224,284,15,75,374
2470,dark,main,20211204,0,0.9958474402855395,333,15,48,396
2470,dark,main,20211204,1,0.9922981138081901,276,13,72,361
2470,dark,main,20211204,2,0.9920630481921748,275,16,104,395
2470,dark,main,20211204,3,0.9943797781617979,265,13,84,362
2470,dark,main,20211204,4,0.9932166965362842,239,10,74,323
2470,dark,main,20211204,5,0.993070142632499,265,12,91,368
2470,dark,main,20211204,6,0.992066041616888,300,12,73,385
2470,dark,main,20211204,7,0.9823041235471519,269,13,45,327
2470,dark,main,20211204,8,0.9911984976199628,307,12,69,388
2470,dark,main,20211204,9,0.9905624007158477,291,12,78,381
8788,dark,main,20211204,0,0.9918155200510144,311,17,58,386
8788,dark,main,20211204,1,0.9872643004003059,286,15,44,345
8788,dark,main,20211204,2,0.9920396813871292,285,18,60,363
8788,dark,main,20211204,3,0.9854987870893492,240,15,85,340
8788,dark,main,20211204,4,0.9973300906200288,272,10,53,335
8788,dark,main,20211204,5,0.9874322758581159,298,21,39,358
8788,dark,main,20211204,6,0.9856802637259944,307,20,49,376
8788,dark,main,20211204,7,0.9864190747638972,249,15,49,313
8788,dark,main,20211204,8,0.9943699402334911,319,14,47,380
8788,dark,main,20211204,9,0.9881341379425645,307,10,62,379
3533,dark,main,20211204,0,0.9911917831491646,325,10,61,396
3533,dark,main,20211204,1,0.9920864943039728,288,12,52,352
3533,dark,main,20211204,2,0.9893991814614261,314,12,53,379
3533,dark,main,20211204,3,0.9890431209608292,268,12,77,357
3533,dark,main,20211204,4,0.9873385503235278,266,18,73,357
3533,dark,main,20211204,5,0.98995360465924,266,14,87,367
3533,dark,main,20211204,6,0.992052679801494,278,15,83,376
3533,dark,main,20211204,7,0.9902892614460148,246,14,73,333
3533,dark,main,20211204,8,0.9927099190263372,293,14,75,382
3533,dark,main,20211204,9,0.9923445582879395,296,17,69,382
21835,bright,main,20211204,0,0.9903881297247394,222,111,5,338
21835,bright,main,20211204,1,0.991196830134964,288,93,6,387
21835,bright,main,20211204,2,0.9936740721189057,333,88,7,428
21835,bright,main,20211204,3,0.991214865989743,297,85,4,386
21835,bright,main,20211204,4,0.9963955096003706,303,63,5,371
21835,bright,main,20211204,5,0.9934024559902063,330,68,5,403
21835,bright,main,20211204,6,0.9943978267183194,342,74,4,420
21835,bright,main,20211204,7,0.9892456216853548,267,87,5,359
21835,bright,main,20211204,8,0.9917355665315271,305,95,4,404
21835,bright,main,20211204,9,0.990700782277209,283,120,6,409
5656,dark,main,20211204,0,0.9851426203697724,302,11,80,393
5656,dark,main,20211204,1,0.9940188302074298,260,10,83,353
5656,dark,main,20211204,2,0.9928419236745388,266,19,105,390
5656,dark,main,20211204,3,0.9916859727104387,255,15,84,354
5656,dark,main,20211204,4,0.9916673898168774,253,13,78,344
5656,dark,main,20211204,5,0.9937013604179137,265,11,93,369
5656,dark,main,20211204,6,0.996016229718223,284,11,90,385
5656,dark,main,20211204,7,0.9906288703377557,212,15,99,326
5656,dark,main,20211204,8,0.9923633415441114,278,23,83,384
5656,dark,main,20211204,9,0.9818577182458785,275,11,98,384
5125,dark,main,20211204,0,0.9919458120531228,312,12,75,399
5125,dark,main,20211204,1,0.9898694575279303,280,17,63,360
5125,dark,main,20211204,2,0.9948413448816451,319,16,59,394
5125,dark,main,20211204,3,0.9831146414251541,290,10,49,349
5125,dark,main,20211204,4,0.9929345649811624,282,13,48,343
5125,dark,main,20211204,5,0.993857332329556,300,10,48,358
5125,dark,main,20211204,6,0.9952406908488829,297,13,63,373
5125,dark,main,20211204,7,0.9776108555961093,249,16,59,324
5125,dark,main,20211204,8,0.9945023844019536,299,12,66,377
5125,dark,main,20211204,9,0.9948167646155849,281,13,69,363
3534,dark,main,20211204,0,0.9953293050851759,319,11,55,385
3534,dark,main,20211204,1,0.98740173131165,284,10,53,347
3534,dark,main,20211204,2,0.9931611168321871,307,10,72,389
3534,dark,main,20211204,3,0.9952704738746602,262,18,68,348
3534,dark,main,20211204,4,0.9913068364042253,243,10,80,333
3534,dark,main,20211204,5,0.9898503604332618,262,23,73,358
3534,dark,main,20211204,6,0.981410761713665,264,18,84,366
3534,dark,main,20211204,7,0.9931981423243279,243,11,76,330
3534,dark,main,20211204,8,0.987525081055096,282,15,88,385
3534,dark,main,20211204,9,0.9865546541715401,294,18,63,375
3360,dark,main,20211204,0,0.9904148805609078,306,15,63,384
3360,dark,main,20211204,1,0.9946189444099891,287,14,49,350
3360,dark,main,20211204,2,0.9937627992911321,277,13,96,386
3360,dark,main,20211204,3,0.992494882181654,267,17,72,356
3360,dark,main,20211204,4,0.994343955555665,249,17,66,332
3360,dark,main,20211204,5,0.9930614718030886,255,21,86,362
3360,dark,main,20211204,6,0.9898385520970866,274,18,76,368
3360,dark,main,20211204,7,0.9903317852311201,204,16,68,288
3360,dark,main,20211204,8,0.9749348508945028,226,17,53,296
3360,dark,main,20211204,9,0.9913759859705381,300,12,70,382
1483,dark,main,20211204,0,0.9942028154655728,293,13,83,389
1483,dark,main,20211204,1,0.9910690616525306,247,11,86,344
1483,dark,main,20211204,2,0.991076005310941,262,20,95,377
1483,dark,main,20211204,3,0.990589305697263,246,15,97,358
1483,dark,main,20211204,4,0.9936182108325335,232,13,105,350
1483,dark,main,20211204,5,0.9901372343129887,248,9,102,359
1483,dark,main,20211204,6,0.9917642050539709,263,14,89,366
1483,dark,main,20211204,7,0.992595532980157,210,24,90,324
1483,dark,main,20211204,8,0.9959047421572711,271,15,81,367
1483,dark,main,20211204,9,0.9893626674156274,268,15,96,379
7230,dark,main,20211204,0,0.994052919415754,283,15,103,401
7230,dark,main,20211204,1,0.9942780159683758,249,13,89,351
7230,dark,main,20211204,2,0.9890108737915874,261,22,99,382
7230,dark,main,20211204,3,0.9906357628033076,246,18,94,358
7230,dark,main,20211204,4,0.9904277076377866,247,15,84,346
7230,dark,main,20211204,5,0.993214722131271,265,13,87,365
7230,dark,main,20211204,6,0.9946926371595097,275,15,88,378
7230,dark,main,20211204,7,0.9881040273250891,212,15,92,319
7230,dark,main,20211204,8,0.9910465891471835,277,15,85,377
7230,dark,main,20211204,9,0.9950612254467459,288,14,78,380
5581,dark,main,20211204,0,0.9968845598504199,283,21,85,389
5581,dark,main,20211204,1,0.9934639663915912,284,11,53,348
5581,dark,main,20211204,2,0.98874735265874,315,14,56,385
5581,dark,main,20211204,3,0.9925096397122156,266,12,70,348
5581,dark,main,20211204,4,0.9906980880111546,240,20,85,345
5581,dark,main,20211204,5,0.9913609877666233,268,14,82,364
5581,dark,main,20211204,6,0.992250388814832,289,14,82,385
5581,dark,main,20211204,7,0.9939864895175351,256,15,48,319
5581,dark,main,20211204,8,0.9941769497334673,306,14,59,379
5581,dark,main,20211204,9,0.9950258599942601,297,16,64,377
11757,dark,main,20211204,0,0.9810366742422382,283,21,97,401
11757,dark,main,20211204,1,0.9858320144339825,253,20,77,350
11757,dark,main,20211204,2,0.9932410425828173,298,18,69,385
11757,dark,main,20211204,3,0.990995657115518,276,14,70,360
11757,dark,main,20211204,4,0.9907838659170063,267,17,71,355
11757,dark,main,20211204,5,0.9897332647313026,276,17,88,381
11757,dark,main,20211204,6,0.9869835943854209,289,16,92,397
11757,dark,main,20211204,7,0.9876008747997892,258,15,68,341
11757,dark,main,20211204,8,0.986953925008246,269,16,93,378
11757,dark,main,20211204,9,0.9947483837827056,270,19,90,379
5668,dark,main,20211204,0,0.9873510512134486,293,15,83,391
5668,dark,main,20211204,1,0.9949709372926441,260,17,78,355
5668,dark,main,20211204,2,0.9915755951332099,268,20,97,385
5668,dark,main,20211204,3,0.9910831361938921,225,20,87,332
5668,dark,main,20211204,4,0.9828996327644287,228,36,90,354
5668,dark,main,20211204,5,0.9898579405863428,255,20,85,360
5668,dark,main,20211204,6,0.9896012673347393,261,17,103,381
5668,dark,main,20211204,7,0.9872224618543678,239,12,79,330
5668,dark,main,20211204,8,0.9930383534514238,247,15,99,361
5668,dark,main,20211204,9,0.9922217948288442,271,16,88,375
3592,dark,main,20211204,0,0.9923221083064073,310,13,57,380
3592,dark,main,20211204,1,0.9866884405067671,297,13,50,360
3592,dark,main,20211204,2,0.9850779302134027,307,12,50,369
3592,dark,main,20211204,3,0.9925432436814512,255,20,64,339
3592,dark,main,20211204,4,0.9887106762695257,259,14,62,335
3592,dark,main,20211204,5,0.9886194498555894,250,13,96,359
3592,dark,main,20211204,6,0.993757200703455,295,16,70,381
3592,dark,main,20211204,7,0.9871533320945908,254,12,52,318
3592,dark,main,20211204,8,0.9895682051600988,292,14,60,366
3592,dark,main,20211204,9,0.9882248232329233,306,13,57,376
5135,dark,main,20211205,0,0.989127951058702,316,12,60,388
5135,dark,main,20211205,1,0.991614495128924,263,17,56,336
5135,dark,main,20211205,2,0.9871286016207007,286,14,80,380
5135,dark,main,20211205,3,0.9935240880186326,300,16,49,365
5135,dark,main,20211205,4,0.9919249782039343,275,11,60,346
5135,dark,main,20211205,5,0.9936872703511745,303,11,63,377
5135,dark,main,20211205,6,0.9859801099473162,277,22,72,371
5135,dark,main,20211205,7,0.9916306924785636,267,14,60,341
5135,dark,main,20211205,8,0.9950544121050007,258,16,88,362
5135,dark,main,20211205,9,0.9943925703333056,284,14,72,370
11768,dark,main,20211205,0,0.9902858251800947,277,13,92,382
11768,dark,main,20211205,1,0.981727141146142,264,15,67,346
11768,dark,main,20211205,2,0.9894472902375365,325,13,54,392
11768,dark,main,20211205,3,0.9854548591013542,283,22,52,357
11768,dark,main,20211205,4,0.9889501529806978,271,10,52,333
11768,dark,main,20211205,5,0.9915215521478918,278,16,69,363
11768,dark,main,20211205,6,0.9909070779804049,282,15,79,376
11768,dark,main,20211205,7,0.9821204728703559,250,13,57,320
11768,dark,main,20211205,8,0.9911967193480075,306,11,50,367
11768,dark,main,20211205,9,0.9930535677808986,297,14,65,376
3560,dark,main,20211205,0,0.9895754329366392,307,15,67,389
3560,dark,main,20211205,1,0.9953762104296077,270,18,64,352
3560,dark,main,20211205,2,0.9938024807253515,319,15,51,385
3560,dark,main,20211205,3,0.9920093915169942,281,12,59,352
3560,dark,main,20211205,4,0.9931261253319107,268,10,46,324
3560,dark,main,20211205,5,0.9882014767891232,298,21,48,367
3560,dark,main,20211205,6,0.9933597913660069,301,10,62,373
3560,dark,main,20211205,7,0.9910821345447781,268,12,45,325
3560,dark,main,20211205,8,0.9897619537541766,301,15,64,380
3560,dark,main,20211205,9,0.992196545424299,311,12,56,379
2417,dark,main,20211205,0,0.9917821687881037,291,15,95,401
2417,dark,main,20211205,1,0.9937583390886385,286,15,52,353
2417,dark,main,20211205,2,0.9897228447453157,311,13,73,397
2417,dark,main,20211205,3,0.9925011772351291,271,17,61,349
2417,dark,main,20211205,4,0.9933229739111482,263,20,65,348
2417,dark,main,20211205,5,0.9890590296706966,247,12,106,365
2417,dark,main,20211205,6,0.9902653152235086,270,22,93,385
2417,dark,main,20211205,7,0.988297909065802,229,18,78,325
2417,dark,main,20211205,8,0.987736749436472,272,15,88,375
2417,dark,main,20211205,9,0.9870139959788274,261,15,97,373
11390,dark,main,20211205,0,0.988123008140926,306,13,73,392
11390,dark,main,20211205,1,0.9884105225165937,267,16,69,352
11390,dark,main,20211205,2,0.9909458534557659,291,20,66,377
11390,dark,main,20211205,3,0.9894785255849047,277,12,59,348
11390,dark,main,20211205,4,0.9887283277563886,272,14,52,338
11390,dark,main,20211205,5,0.9876755132943116,284,10,66,360
11390,dark,main,20211205,6,0.9950364149396341,301,14,58,373
11390,dark,main,20211205,7,0.9895846927906292,246,11,71,328
11390,dark,main,20211205,8,0.9958131406807307,275,16,84,375
11390,dark,main,20211205,9,0.9892373753368306,306,11,58,375
2469,dark,main,20211205,0,0.9935677319090152,298,12,67,377
2469,dark,main,20211205,1,0.9830984646488959,278,10,63,351
2469,dark,main,20211205,2,0.9935921594089901,284,12,90,386
2469,dark,main,20211205,3,0.993401700823896,238,14,103,355
2469,dark,main,20211205,4,0.9933506459037106,246,10,72,328
2469,dark,main,20211205,5,0.9910631609737909,292,12,70,374
2469,dark,main,20211205,6,0.993886767883875,290,11,80,381
2469,dark,main,20211205,7,0.9927547287381777,262,13,49,324
2469,dark,main,20211205,8,0.9875533962254384,313,14,52,379
2469,dark,main,20211205,9,0.9897506769438402,279,11,84,374
11391,dark,main,20211205,0,0.9946730593914622,300,17,75,392
11391,dark,main,20211205,1,0.9879614055413923,281,14,52,347
11391,dark,main,20211205,2,0.9937101353696556,298,11,68,377
11391,dark,main,20211205,3,0.9912823188424047,270,17,60,347
11391,dark,main,20211205,4,0.9940674963844085,272,10,66,348
11391,dark,main,20211205,5,0.9945651545653448,273,19,79,371
11391,dark,main,20211205,6,0.9969964094605548,275,11,92,378
11391,dark,main,20211205,7,0.9917003404650554,260,13,62,335
11391,dark,main,20211205,8,0.9916534723814144,264,14,86,364
11391,dark,main,20211205,9,0.9892689271284332,285,11,91,387
1488,dark,main,20211205,0,0.9945337472344327,278,11,101,390
1488,dark,main,20211205,1,0.9954593694693763,266,17,76,359
1488,dark,main,20211205,2,0.9938843339827584,287,22,78,387
1488,dark,main,20211205,3,0.9894692695370245,244,16,82,342
1488,dark,main,20211205,4,0.9869050361710214,237,12,81,330
1488,dark,main,20211205,5,0.993995084095353,243,24,93,360
1488,dark,main,20211205,6,0.994071878219231,260,18,91,369
1488,dark,main,20211205,7,0.9899136046350534,226,14,76,316
1488,dark,main,20211205,8,0.9900712966036324,259,13,98,370
1488,dark,main,20211205,9,0.9915154576288057,259,9,92,360
2236,dark,main,20211205,0,0.991408608394567,284,13,92,389
2236,dark,main,20211205,1,0.9932032232532751,260,13,59,332
2236,dark,main,20211205,2,0.9909617476364329,275,17,61,353
2236,dark,main,20211205,3,0.9903535318512544,281,18,51,350
2236,dark,main,20211205,4,0.9860964743843432,257,16,46,319
2236,dark,main,20211205,5,0.990553474301648,285,12,59,356
2236,dark,main,20211205,6,0.9909996890654797,305,14,63,382
2236,dark,main,20211205,7,0.9948830491485973,278,12,42,332
2236,dark,main,20211205,8,0.9843182787649501,268,13,71,352
2236,dark,main,20211205,9,0.9970363655836377,268,17,73,358
1802,dark,main,20211205,0,0.9964993370428943,278,16,93,387
1802,dark,main,20211205,1,0.9945439242998494,243,15,79,337
1802,dark,main,20211205,2,0.99650708224655,305,14,67,386
1802,dark,main,20211205,3,0.981327519805396,280,16,52,348
1802,dark,main,20211205,4,0.9915110488831802,278,12,44,334
1802,dark,main,20211205,5,0.9957163135480308,257,16,84,357
1802,dark,main,20211205,6,0.9867693879362052,251,23,88,362
1802,dark,main,20211205,7,0.9919066063238555,243,19,58,320
1802,dark,main,20211205,8,0.9895008255656867,262,12,102,376
1802,dark,main,20211205,9,0.9876269862970927,280,13,79,372
2017,dark,main,20211205,0,0.9947081226426635,310,11,74,395
2017,dark,main,20211205,1,0.9909219949845348,291,14,55,360
2017,dark,main,20211205,2,0.9941484084380037,316,14,73,403
2017,dark,main,20211205,3,0.9896827722780094,279,16,44,339
2017,dark,main,20211205,4,0.9872825477008522,254,18,69,341
2017,dark,main,20211205,5,0.9911643171586867,280,12,86,378
2017,dark,main,20211205,6,0.9930726667749862,265,10,99,374
2017,dark,main,20211205,7,0.9895508943314,242,16,71,329
2017,dark,main,20211205,8,0.9908404484144211,296,15,65,376
2017,dark,main,20211205,9,0.9899505685462296,323,14,57,394
10054,dark,main,20211205,0,0.9893366307428162,287,23,90,400
10054,dark,main,20211205,1,0.9886823369689067,246,21,80,347
10054,dark,main,20211205,2,0.9918821315056644,280,14,92,386
10054,dark,main,20211205,3,0.9934558987648803,254,15,85,354
10054,dark,main,20211205,4,0.9918887110047615,252,14,69,335
10054,dark,main,20211205,5,0.9909976773310641,280,16,72,368
10054,dark,main,20211205,6,0.9903771439077034,265,20,87,372
10054,dark,main,20211205,7,0.9863151252327111,209,28,77,314
10054,dark,main,20211205,8,0.993886316558371,257,21,97,375
10054,dark,main,20211205,9,0.9894658602378308,261,13,98,372
8671,dark,main,20211205,0,0.9889870623707352,288,16,86,390
8671,dark,main,20211205,1,0.9924605568647868,252,11,94,357
8671,dark,main,20211205,2,0.9921075993297588,295,19,87,401
8671,dark,main,20211205,3,0.9891313714134699,258,14,79,351
8671,dark,main,20211205,4,0.9882718458298168,240,11,80,331
8671,dark,main,20211205,5,0.9922026083947326,259,20,88,367
8671,dark,main,20211205,6,0.9874229988295165,275,16,91,382
8671,dark,main,20211205,7,0.9896781613405612,216,14,91,321
8671,dark,main,20211205,8,0.991260101973403,277,14,84,375
8671,dark,main,20211205,9,0.9931720952024257,266,18,109,393
20308,bright,main,20211205,0,0.9959970027152272,201,228,1,430
20308,bright,main,20211205,1,0.9950585465472959,179,219,1,399
20308,bright,main,20211205,2,0.9886216212326596,169,263,5,437
20308,bright,main,20211205,3,0.9843719234065557,161,235,5,401
20308,bright,main,20211205,4,0.9836512849405714,179,208,0,387
20308,bright,main,20211205,5,0.9838261022166812,233,173,9,415
20308,bright,main,20211205,6,0.9911769047165777,189,229,9,427
20308,bright,main,20211205,7,0.990106648434452,220,152,1,373
20308,bright,main,20211205,8,0.9909959835686956,268,155,4,427
20308,bright,main,20211205,9,0.9920489200102068,230,191,4,425
8689,dark,main,20211205,0,0.9882449246616944,304,11,72,387
8689,dark,main,20211205,1,0.9915028964856384,276,9,61,346
8689,dark,main,20211205,2,0.9887258914633433,304,14,83,401
8689,dark,main,20211205,3,0.9911834618583284,265,12,78,355
8689,dark,main,20211205,4,0.993548266124566,255,11,79,345
8689,dark,main,20211205,5,0.9964381607658529,276,12,100,388
8689,dark,main,20211205,6,0.9896388609886565,282,12,96,390
8689,dark,main,20211205,7,0.9895305275016676,254,13,72,339
8689,dark,main,20211205,8,0.9953770241378685,263,25,81,369
8689,dark,main,20211205,9,0.9957383702143976,255,17,97,369
21836,bright,main,20211205,0,0.9912865244817642,306,88,4,398
21836,bright,main,20211205,1,0.9933322495810124,280,60,8,348
21836,bright,main,20211205,2,0.9885684394556968,330,64,4,398
21836,bright,main,20211205,3,0.9886590489488362,323,40,3,366
21836,bright,main,20211205,4,0.9910762826476187,267,45,4,316
21836,bright,main,20211205,5,0.9920848765313999,312,59,6,377
21836,bright,main,20211205,6,0.9932544121103463,315,58,5,378
21836,bright,main,20211205,7,0.9919528661941661,279,34,2,315
21836,bright,main,20211205,8,0.9906922806636473,287,82,4,373
21836,bright,main,20211205,9,0.9913579194454725,297,76,3,376
5379,dark,main,20211205,0,0.9935152109877382,275,16,85,376
5379,dark,main,20211205,1,0.9942014194669582,251,14,84,349
5379,dark,main,20211205,2,0.988701383211568,279,17,83,379
5379,dark,main,20211205,3,0.9917108757024381,243,15,100,358
5379,dark,main,20211205,4,0.9911897878755754,237,17,84,338
5379,dark,main,20211205,5,0.9895717838998856,273,15,73,361
5379,dark,main,20211205,6,0.9914318705595645,264,23,85,372
5379,dark,main,20211205,7,0.994255120171211,236,17,80,333
5379,dark,main,20211205,8,0.9901763002526904,271,15,81,367
5379,dark,main,20211205,9,0.9910743612705578,275,17,87,379
11350,dark,main,20211205,0,0.9905514465118469,329,12,52,393
11350,dark,main,20211205,1,0.991562838001207,275,12,56,343
11350,dark,main,20211205,2,0.9905371348344691,297,12,68,377
11350,dark,main,20211205,3,0.9911980547729332,304,16,41,361
11350,dark,main,20211205,4,0.9925971012093342,270,11,46,327
11350,dark,main,20211205,5,0.9938352303871016,284,16,76,376
11350,dark,main,20211205,6,0.9819516506281174,268,14,94,376
11350,dark,main,20211205,7,0.9901881853070775,229,11,86,326
11350,dark,main,20211205,8,0.9927024107115399,275,13,79,367
11350,dark,main,20211205,9,0.994122097488801,299,10,53,362
11324,dark,main,20211205,0,0.9776542591801718,282,16,92,390
11324,dark,main,20211205,1,0.9933851662524072,267,15,66,348
11324,dark,main,20211205,2,0.9938375259103593,303,19,63,385
11324,dark,main,20211205,3,0.9882016041352835,293,11,58,362
11324,dark,main,20211205,4,0.993196561482014,294,15,37,346
11324,dark,main,20211205,5,0.9928839765976266,309,12,40,361
11324,dark,main,20211205,6,0.9921182889109953,288,16,62,366
11324,dark,main,20211205,7,0.9922325474713379,260,12,49,321
11324,dark,main,20211205,8,0.9883733608443909,265,13,83,361
11324,dark,main,20211205,9,0.9957753283225154,249,16,97,362
5964,dark,main,20211205,0,0.9949792613707499,224,12,85,321
5964,dark,main,20211205,1,0.9836333000088829,213,11,57,281
5964,dark,main,20211205,2,0.9854536024601056,228,14,85,327
5964,dark,main,20211205,3,0.9967893905385967,227,14,70,311
5964,dark,main,20211205,4,0.9934271619098329,211,18,68,297
5964,dark,main,20211205,5,0.9909933536435515,225,12,73,310
5964,dark,main,20211205,6,0.9966016465111427,226,14,88,328
5964,dark,main,20211205,7,0.9922368777108589,199,11,73,283
5964,dark,main,20211205,8,0.9885344323602965,235,13,76,324
5964,dark,main,20211205,9,0.9918695063871562,232,15,80,327
6985,dark,main,20211205,0,0.9902761025221094,264,15,105,384
6985,dark,main,20211205,1,0.9872811930654688,279,11,62,352
6985,dark,main,20211205,2,0.9880019005760912,309,16,55,380
6985,dark,main,20211205,3,0.982196062923616,295,13,49,357
6985,dark,main,20211205,4,0.9903930818331149,253,11,60,324
6985,dark,main,20211205,5,0.9912218493563347,268,16,75,359
6985,dark,main,20211205,6,0.9920915864137778,287,17,53,357
6985,dark,main,20211205,7,0.9907072789782037,244,11,54,309
6985,dark,main,20211205,8,0.9889332159367165,244,11,43,298
6985,dark,main,20211205,9,0.9940510514539438,271,14,73,358
3543,dark,main,20211205,0,0.9959449822269876,281,10,102,393
3543,dark,main,20211205,1,0.9918407863911786,249,12,83,344
3543,dark,main,20211205,2,0.9956567661677755,277,16,96,389
3543,dark,main,20211205,3,0.9906390356859294,262,14,87,363
3543,dark,main,20211205,4,0.991557303456387,257,14,70,341
3543,dark,main,20211205,5,0.9895046495951682,298,12,48,358
3543,dark,main,20211205,6,0.9922878792627943,285,11,64,360
3543,dark,main,20211205,7,0.9863843771249519,260,11,50,321
3543,dark,main,20211205,8,0.9969296460318492,284,12,78,374
3543,dark,main,20211205,9,0.9934628036755617,297,16,80,393
10253,dark,main,20211205,0,0.9887646772539719,276,26,82,384
10253,dark,main,20211205,1,0.990620730284099,249,15,98,362
10253,dark,main,20211205,2,0.985211509354208,288,13,100,401
10253,dark,main,20211205,3,0.9946916021378606,239,15,95,349
10253,dark,main,20211205,4,0.9898388393564627,237,12,95,344
10253,dark,main,20211205,5,0.988927632198148,288,12,82,382
10253,dark,main,20211205,6,0.9933899679202632,294,10,98,402
10253,dark,main,20211205,7,0.9924425501698337,234,12,73,319
10253,dark,main,20211205,8,0.9958043600608094,299,12,71,382
10253,dark,main,20211205,9,0.9893195468287073,270,13,98,381
5645,dark,main,20211205,0,0.9962530966387507,294,15,81,390
5645,dark,main,20211205,1,0.9929741506660423,262,17,73,352
5645,dark,main,20211205,2,0.9929825628285605,271,18,90,379
5645,dark,main,20211205,3,0.9928193958293616,253,12,87,352
5645,dark,main,20211205,4,0.9695317458899654,231,16,85,332
5645,dark,main,20211205,5,0.990640167908573,255,11,91,357
5645,dark,main,20211205,6,0.9942174874032091,288,14,83,385
5645,dark,main,20211205,7,0.9927577748959837,217,14,82,313
5645,dark,main,20211205,8,0.997592285273882,268,17,73,358
5645,dark,main,20211205,9,0.9930472239804493,277,18,88,383
7223,dark,main,20211205,0,0.9899846647961967,278,16,93,387
7223,dark,main,20211205,1,0.9917147377411579,248,13,89,350
7223,dark,main,20211205,2,0.9928549152195103,257,16,117,390
7223,dark,main,20211205,3,0.9866755714894673,249,17,94,360
7223,dark,main,20211205,4,0.9917948355201103,246,13,73,332
7223,dark,main,20211205,5,0.983118195910565,274,18,77,369
7223,dark,main,20211205,6,0.9874360085427987,258,18,89,365
7223,dark,main,20211205,7,0.9924299588358814,220,13,94,327
7223,dark,main,20211205,8,0.9961146280632944,258,15,85,358
7223,dark,main,20211205,9,0.9896287734799402,241,15,109,365
7746,dark,main,20211205,0,0.9907814893653586,270,23,100,393
7746,dark,main,20211205,1,0.9915522315870913,267,9,80,356
7746,dark,main,20211205,2,0.9936979293231913,300,14,73,387
7746,dark,main,20211205,3,0.9902143668326995,243,14,94,351
7746,dark,main,20211205,4,0.9938036751531868,232,15,78,325
7746,dark,main,20211205,5,0.9893674644547751,286,14,72,372
7746,dark,main,20211205,6,0.9958787690783419,273,16,94,383
7746,dark,main,20211205,7,0.9907737235454739,227,17,75,319
7746,dark,main,20211205,8,0.9899293170688395,253,16,89,358
7746,dark,main,20211205,9,0.9891786542168319,277,14,86,377
6503,dark,main,20211205,0,0.993956120204285,282,17,102,401
6503,dark,main,20211205,1,0.9967095206045768,240,15,79,334
6503,dark,main,20211205,2,0.9953122724528018,282,12,84,378
6503,dark,main,20211205,3,0.9853176570646731,272,12,75,359
6503,dark,main,20211205,4,0.9866889689580893,242,17,72,331
6503,dark,main,20211205,5,0.9874845149031153,300,12,55,367
6503,dark,main,20211205,6,0.9913596628788587,303,16,55,374
6503,dark,main,20211205,7,0.9853471359619645,177,9,31,217
6503,dark,main,20211205,8,0.9910994521189284,299,13,56,368
6503,dark,main,20211205,9,0.9911046492090894,286,14,71,371
21888,bright,main,20211205,0,0.9917752448914079,252,189,2,443
21888,bright,main,20211205,1,0.993831944895936,234,156,5,395
21888,bright,main,20211205,2,0.9942842432914182,281,154,1,436
21888,bright,main,20211205,3,0.9931755289498244,246,145,4,395
21888,bright,main,20211205,4,0.992201754508537,266,116,1,383
21888,bright,main,20211205,5,0.9821545881672795,328,83,4,415
21888,bright,main,20211205,6,0.9949446970772962,363,61,4,428
21888,bright,main,20211205,7,0.9941654356875284,268,103,3,374
21888,bright,main,20211205,8,0.9972430606447439,281,137,5,423
21888,bright,main,20211205,9,0.9945827644047726,268,159,2,429
8626,dark,main,20211205,0,0.9862444740543368,281,15,94,390
8626,dark,main,20211205,1,0.9929308137774784,252,18,82,352
8626,dark,main,20211205,2,0.9950613807237746,282,21,86,389
8626,dark,main,20211205,3,0.9913276818128179,266,22,78,366
8626,dark,main,20211205,4,0.9916817235688388,240,14,86,340
8626,dark,main,20211205,5,0.9938020115466258,253,13,90,356
8626,dark,main,20211205,6,0.9876593449387228,280,13,84,377
8626,dark,main,20211205,7,0.9929021599922073,232,13,70,315
8626,dark,main,20211205,8,0.9918349477248896,278,19,80,377
8626,dark,main,20211205,9,0.9902739759005176,256,16,101,373
5540,dark,main,20211205,0,0.9947482343651457,276,26,81,383
5540,dark,main,20211205,1,0.988204336605069,241,16,93,350
5540,dark,main,20211205,2,0.9859751899907627,274,10,92,376
5540,dark,main,20211205,3,0.9935855058549423,236,17,85,338
5540,dark,main,20211205,4,0.9891550098448314,241,15,80,336
5540,dark,main,20211205,5,0.9906942990551102,278,13,61,352
5540,dark,main,20211205,6,0.9895687097946765,277,17,86,380
5540,dark,main,20211205,7,0.9905899204325701,234,18,81,333
5540,dark,main,20211205,8,0.9944019617061096,230,31,95,356
5540,dark,main,20211205,9,0.9929231800478427,257,31,91,379
3594,dark,main,20211205,0,0.9926857471509383,285,14,76,375
3594,dark,main,20211205,1,0.9951174879424365,273,10,56,339
3594,dark,main,20211205,2,0.9916032463705754,310,15,34,359
3594,dark,main,20211205,3,0.9943576262834917,281,12,49,342
3594,dark,main,20211205,4,0.9835846995721732,247,12,55,314
3594,dark,main,20211205,5,0.9950113954861974,268,11,96,375
3594,dark,main,20211205,6,0.9855941866351071,267,20,95,382
3594,dark,main,20211205,7,0.9873902557044122,229,14,82,325
3594,dark,main,20211205,8,0.9899375249265285,265,10,92,367
3594,dark,main,20211205,9,0.9878272608566009,284,12,80,376
8682,dark,main,20211205,0,0.9924097448951148,277,14,92,383
8682,dark,main,20211205,1,0.9921106166698916,258,17,70,345
8682,dark,main,20211205,2,0.9912466041461919,295,15,82,392
8682,dark,main,20211205,3,0.9807829230315287,256,17,82,355
8682,dark,main,20211205,4,0.990731343524572,246,12,65,323
8682,dark,main,20211205,5,0.9911453260084294,300,12,69,381
8682,dark,main,20211205,6,0.9882857716828782,278,13,87,378
8682,dark,main,20211205,7,0.9791257907145651,227,13,78,318
8682,dark,main,20211205,8,0.9872775848792061,255,21,95,371
8682,dark,main,20211205,9,0.9942538219632486,260,17,94,371
6502,dark,main,20211205,0,0.9927891701259686,307,15,62,384
6502,dark,main,20211205,1,0.9894664857857142,264,12,64,340
6502,dark,main,20211205,2,0.9934615151110947,311,13,54,378
6502,dark,main,20211205,3,0.9873839591905831,274,16,66,356
6502,dark,main,20211205,4,0.9932309614490221,241,11,77,329
6502,dark,main,20211205,5,0.9931287400648018,271,12,86,369
6502,dark,main,20211205,6,0.993568681740584,285,15,90,390
6502,dark,main,20211205,7,0.9931317894453636,234,13,71,318
6502,dark,main,20211205,8,0.9858012352988604,284,15,66,365
6502,dark,main,20211205,9,0.9890174848072303,300,16,58,374
5108,dark,main,20211205,0,0.9930437406531523,291,21,84,396
5108,dark,main,20211205,1,0.987174500542089,237,18,79,334
5108,dark,main,20211205,2,0.9903177086095395,262,22,95,379
5108,dark,main,20211205,3,0.9913562262451048,258,21,77,356
5108,dark,main,20211205,4,0.9861102120845032,256,18,65,339
5108,dark,main,20211205,5,0.99013666556264,276,19,74,369
5108,dark,main,20211205,6,0.9931240510477707,277,20,80,377
5108,dark,main,20211205,7,0.9924739034652791,249,13,47,309
5108,dark,main,20211205,8,0.9951931814465079,297,17,54,368
5108,dark,main,20211205,9,0.9856162510553176,279,19,80,378
22595,bright,main,20211206,0,0.9884822409785312,305,112,2,419
22595,bright,main,20211206,1,0.9952666991100598,230,134,3,367
22595,bright,main,20211206,2,0.9919012957636756,250,149,8,407
22595,bright,main,20211206,3,0.9879113302504622,277,107,4,388
22595,bright,main,20211206,4,0.9899962867247202,299,75,5,379
22595,bright,main,20211206,5,0.9920454467530732,310,76,10,396
22595,bright,main,20211206,6,0.9898022747211817,326,80,7,413
22595,bright,main,20211206,7,0.9886584070185418,244,100,6,350
22595,bright,main,20211206,8,0.9912374678720679,293,108,4,405
22595,bright,main,20211206,9,0.9958050730261673,299,104,2,405
26218,bright,main,20211206,0,0.9844302361063223,320,92,5,417
26218,bright,main,20211206,1,0.9945910939961168,257,99,2,358
26218,bright,main,20211206,2,0.9928190112908271,320,91,7,418
26218,bright,main,20211206,3,0.990877057037824,279,97,4,380
26218,bright,main,20211206,4,0.9813016110028785,282,96,10,388
26218,bright,main,20211206,5,0.9939953956047556,297,89,3,389
26218,bright,main,20211206,6,0.9939953956047556,297,89,3,389
26218,bright,main,20211206,7,0.9947854919661837,285,54,4,343
26218,bright,main,20211206,8,0.9911294092510226,334,63,8,405
26218,bright,main,20211206,9,0.9909389126675727,295,93,9,397
21223,bright,main,20211206,0,0.996700514790335,335,101,1,437
21223,bright,main,20211206,1,0.9931284779233606,298,87,1,386
21223,bright,main,20211206,2,0.9940141583386728,355,64,7,426
21223,bright,main,20211206,3,0.9954362640152853,336,51,2,389
21223,bright,main,20211206,4,0.9917557157926962,321,69,2,392
21223,bright,main,20211206,5,0.9922357289419103,328,73,5,406
21223,bright,main,20211206,6,0.9892976251062994,314,87,11,412
21223,bright,main,20211206,7,0.9867581102999216,265,90,3,358
21223,bright,main,20211206,8,0.9907940083556105,308,99,4,411
21223,bright,main,20211206,9,0.9867211175610032,297,120,5,422
22832,bright,main,20211206,0,0.9940374523650068,359,76,5,440
22832,bright,main,20211206,1,0.9887191478271795,317,65,6,388
22832,bright,main,20211206,2,0.9942180129029872,321,105,9,435
22832,bright,main,20211206,3,0.9908280070020583,335,68,1,404
22832,bright,main,20211206,4,0.992804611380941,323,63,3,389
22832,bright,main,20211206,5,0.9935400837316544,353,60,4,417
22832,bright,main,20211206,6,0.9883805299641597,357,64,6,427
22832,bright,main,20211206,7,0.9916755775883315,326,40,3,369
22832,bright,main,20211206,8,0.9952885965198108,348,62,6,416
22832,bright,main,20211206,9,0.9968291966992577,334,83,6,423
41712,backup,main,20211206,0,0.987525766007091,4,360,1,365
41712,backup,main,20211206,1,0.989759876311713,5,311,3,319
41712,backup,main,20211206,2,0.9937227479983762,6,339,1,346
41712,backup,main,20211206,3,0.9872020551588436,5,309,1,315
41712,backup,main,20211206,4,0.9905373430122612,11,326,1,338
41712,backup,main,20211206,5,0.9954191129870222,4,317,2,323
41712,backup,main,20211206,6,0.9893897547033826,5,334,1,340
41712,backup,main,20211206,7,0.9884701861724617,1,305,2,308
41712,backup,main,20211206,8,0.9866884740374857,5,323,1,329
41712,backup,main,20211206,9,0.9927830439102446,3,335,2,340
42821,backup,main,20211206,0,0.9932841726232202,4,431,0,435
42821,backup,main,20211206,1,0.9911331551005528,2,373,1,376
42821,backup,main,20211206,2,0.9877166813987142,6,413,0,419
42821,backup,main,20211206,3,0.9909557857852201,2,382,0,384
42821,backup,main,20211206,4,0.9913304523195529,12,372,0,384
42821,backup,main,20211206,5,0.9929743690800636,4,403,0,407
42821,backup,main,20211206,6,0.9959052079806168,13,400,0,413
42821,backup,main,20211206,7,0.9891846816643798,7,359,0,366
42821,backup,main,20211206,8,0.9937340490476982,5,413,0,418
42821,backup,main,20211206,9,0.9941541543702642,9,407,1,417
41501,backup,main,20211206,0,0.9921762858446754,24,424,0,448
41501,backup,main,20211206,1,0.984071510631823,5,393,0,398
41501,backup,main,20211206,2,0.9927632685951447,6,434,0,440
41501,backup,main,20211206,3,0.9917043409082432,39,366,0,405
41501,backup,main,20211206,4,0.9926355270765131,38,359,0,397
41501,backup,main,20211206,5,0.9944835356801025,21,398,0,419
41501,backup,main,20211206,6,0.9906467516499737,3,432,0,435
41501,backup,main,20211206,7,0.9953544279393444,7,370,0,377
41501,backup,main,20211206,8,0.9891322683210431,6,423,0,429
41501,backup,main,20211206,9,0.9952814741234385,2,430,0,432
23854,bright,main,20211206,0,0.9975088945715437,334,101,0,435
23854,bright,main,20211206,1,0.9925802028216952,294,103,1,398
23854,bright,main,20211206,2,0.9927178695273682,363,74,5,442
23854,bright,main,20211206,3,0.9861305509157735,308,96,3,407
23854,bright,main,20211206,4,0.9935291595370264,310,76,4,390
23854,bright,main,20211206,5,0.9937964446239542,298,112,6,416
23854,bright,main,20211206,6,0.9861169704002737,315,113,3,431
23854,bright,main,20211206,7,0.9891767917906453,280,95,2,377
23854,bright,main,20211206,8,0.9901891646316484,305,111,4,420
23854,bright,main,20211206,9,0.9831718720491585,314,111,4,429
41713,backup,main,20211206,0,0.9792337959353202,3,358,1,362
41713,backup,main,20211206,1,0.9934501636589216,5,325,0,330
41713,backup,main,20211206,2,0.9896797286313518,3,355,1,359
41713,backup,main,20211206,3,0.9927945890510314,5,319,2,326
41713,backup,main,20211206,4,0.9899256523024242,8,310,1,319
41713,backup,main,20211206,5,0.9944546573612052,4,322,2,328
41713,backup,main,20211206,6,0.9866453478599345,3,349,4,356
41713,backup,main,20211206,7,0.9930429273343515,5,314,1,320
41713,backup,main,20211206,8,0.9802393846354139,6,321,0,327
41713,backup,main,20211206,9,0.9874041118350025,6,337,0,343
22598,bright,main,20211206,0,0.9904966899004087,310,110,5,425
22598,bright,main,20211206,1,0.992389683602243,294,66,3,363
22598,bright,main,20211206,2,0.9954113837605166,312,92,8,412
22598,bright,main,20211206,3,0.9934828015105581,308,77,3,388
22598,bright,main,20211206,4,0.9932479928097309,319,60,6,385
22598,bright,main,20211206,5,0.9948316925338805,328,61,7,396
22598,bright,main,20211206,6,0.9917698300332913,311,86,9,406
22598,bright,main,20211206,7,0.9880899780813442,248,99,4,351
22598,bright,main,20211206,8,0.995143439308684,286,107,4,397
22598,bright,main,20211206,9,0.9938414050201181,309,97,4,410
22797,bright,main,20211207,0,0.9866643281075232,316,115,5,436
22797,bright,main,20211207,1,0.9897303507764139,315,73,3,391
22797,bright,main,20211207,2,0.9910687557220174,321,99,5,425
22797,bright,main,20211207,3,0.9929505236140045,278,108,5,391
22797,bright,main,20211207,4,0.9927961143321737,227,146,4,377
22797,bright,main,20211207,5,0.9888925974656807,235,162,3,400
22797,bright,main,20211207,6,0.9962256968947134,250,150,6,406
22797,bright,main,20211207,7,0.9952369130953781,249,100,2,351
22797,bright,main,20211207,8,0.9948662236978199,300,109,7,416
22797,bright,main,20211207,9,0.9936009688852722,307,100,4,411
5843,dark,main,20211207,0,0.983188122671143,262,25,86,373
5843,dark,main,20211207,1,0.9893654284957307,220,22,91,333
5843,dark,main,20211207,2,0.9841190856411274,271,20,88,379
5843,dark,main,20211207,3,0.9935070532930169,267,18,68,353
5843,dark,main,20211207,4,0.9892486980942228,286,12,55,353
5843,dark,main,20211207,5,0.9892967982898448,297,13,52,362
5843,dark,main,20211207,6,0.996122311527524,296,18,61,375
5843,dark,main,20211207,7,0.992574606408107,247,15,62,324
5843,dark,main,20211207,8,0.9803492252191721,316,18,54,388
5843,dark,main,20211207,9,0.9887801435648433,297,15,52,364
8945,dark,main,20211207,0,0.9944953402213096,275,20,95,390
8945,dark,main,20211207,1,0.9807734654457873,272,16,64,352
8945,dark,main,20211207,2,0.9924731108916744,314,12,49,375
8945,dark,main,20211207,3,0.9935047940972785,288,12,52,352
8945,dark,main,20211207,4,0.9933960922342902,277,12,47,336
8945,dark,main,20211207,5,0.9878204587234698,303,13,46,362
8945,dark,main,20211207,6,0.9949265738740831,329,16,47,392
8945,dark,main,20211207,7,0.9868744718314199,221,16,93,330
8945,dark,main,20211207,8,0.9916405950459872,253,18,105,376
8945,dark,main,20211207,9,0.9921726788982239,272,17,102,391
3948,dark,main,20211207,0,0.9833635875123871,240,14,49,303
3948,dark,main,20211207,1,0.9895762335369233,206,18,60,284
3948,dark,main,20211207,2,0.9886250490317618,216,13,69,298
3948,dark,main,20211207,3,0.9925837090707369,196,15,75,286
3948,dark,main,20211207,4,0.9895298989398916,200,15,57,272
3948,dark,main,20211207,5,0.9833175884152524,209,12,72,293
3948,dark,main,20211207,6,0.990571467593887,203,12,65,280
3948,dark,main,20211207,7,0.9882592336544784,186,15,56,257
3948,dark,main,20211207,8,0.990606673063711,203,14,74,291
3948,dark,main,20211207,9,0.9913378234521533,241,9,64,314
11538,dark,main,20211207,0,0.9932179877028312,273,25,89,387
11538,dark,main,20211207,1,0.9943230548456589,262,23,76,361
11538,dark,main,20211207,2,0.9922925546711561,272,26,87,385
11538,dark,main,20211207,3,0.9880307983519266,235,41,82,358
11538,dark,main,20211207,4,0.991812291572676,259,16,71,346
11538,dark,main,20211207,5,0.9894800173136228,261,41,65,367
11538,dark,main,20211207,6,0.9886662545222491,278,25,76,379
11538,dark,main,20211207,7,0.9943468989790167,222,21,92,335
11538,dark,main,20211207,8,0.9940121303529127,264,18,94,376
11538,dark,main,20211207,9,0.9953597665084999,259,30,87,376
6185,dark,main,20211207,0,0.9884764478705717,281,15,92,388
6185,dark,main,20211207,1,0.991938138953223,245,13,98,356
6185,dark,main,20211207,2,0.9954825960369518,312,13,72,397
6185,dark,main,20211207,3,0.9927480348724272,240,15,84,339
6185,dark,main,20211207,4,0.9827081761981675,240,16,72,328
6185,dark,main,20211207,5,0.9942398441313444,262,16,82,360
6185,dark,main,20211207,6,0.9910677901245535,256,15,106,377
6185,dark,main,20211207,7,0.9862573693670388,224,23,73,320
6185,dark,main,20211207,8,0.9864374187828931,253,15,98,366
6185,dark,main,20211207,9,0.9946727296405163,263,20,96,379
3495,dark,main,20211207,0,0.9900294256152303,294,15,63,372
3495,dark,main,20211207,1,0.9884352111030295,285,11,56,352
3495,dark,main,20211207,2,0.9892380424372953,287,14,73,374
3495,dark,main,20211207,3,0.9897409279276621,277,16,81,374
3495,dark,main,20211207,4,0.9905720102648614,265,13,60,338
3495,dark,main,20211207,5,0.9958526288078265,250,17,94,361
3495,dark,main,20211207,6,0.9872557294374357,281,16,86,383
3495,dark,main,20211207,7,0.9952816094212439,238,18,85,341
3495,dark,main,20211207,8,0.9899376596936222,272,15,78,365
3495,dark,main,20211207,9,0.9895052763207063,260,12,95,367
24358,bright,main,20211207,0,0.98604411381867,313,117,3,433
24358,bright,main,20211207,1,0.992149189360333,229,157,3,389
24358,bright,main,20211207,2,0.9918627343960338,253,170,2,425
24358,bright,main,20211207,3,0.9935103117790788,279,112,4,395
24358,bright,main,20211207,4,0.9889588627854888,340,51,3,394
24358,bright,main,20211207,5,0.9925778181377531,317,86,4,407
24358,bright,main,20211207,6,0.9918497774383732,279,138,2,419
24358,bright,main,20211207,7,0.9910469880556346,296,68,2,366
24358,bright,main,20211207,8,0.9954110999254394,329,82,6,417
24358,bright,main,20211207,9,0.9903638762347121,290,118,2,410
24410,bright,main,20211207,0,0.9926679107333028,336,102,4,442
24410,bright,main,20211207,1,0.993189017114202,306,88,6,400
24410,bright,main,20211207,2,0.9904270679374584,335,98,6,439
24410,bright,main,20211207,3,0.9933968151785716,263,128,4,395
24410,bright,main,20211207,4,0.9868129915286366,274,117,1,392
24410,bright,main,20211207,5,0.9937677592759242,319,97,2,418
24410,bright,main,20211207,6,0.9944567034002809,311,114,3,428
24410,bright,main,20211207,7,0.9937621954239849,295,79,4,378
24410,bright,main,20211207,8,0.9926560883757682,207,78,3,288
24410,bright,main,20211207,9,0.9926137344277635,292,119,8,419
7108,dark,main,20211207,0,0.9916908894541834,296,15,88,399
7108,dark,main,20211207,1,0.9935432301520356,244,21,89,354
7108,dark,main,20211207,2,0.9900574778779299,268,13,105,386
7108,dark,main,20211207,3,0.9911268618606538,240,21,102,363
7108,dark,main,20211207,4,0.9946148589509697,244,14,78,336
7108,dark,main,20211207,5,0.9855648183174823,256,16,84,356
7108,dark,main,20211207,6,0.988354427061721,264,19,96,379
7108,dark,main,20211207,7,0.9938340351472624,227,13,87,327
7108,dark,main,20211207,8,0.9901866085611505,252,16,102,370
7108,dark,main,20211207,9,0.9904997546268679,253,15,109,377
1685,dark,main,20211207,0,0.9949493246803155,348,12,53,413
1685,dark,main,20211207,1,0.9908314413171094,289,12,60,361
1685,dark,main,20211207,2,0.9895841589051708,311,11,66,388
1685,dark,main,20211207,3,0.9936121781018443,292,11,67,370
1685,dark,main,20211207,4,0.993466518226651,276,10,67,353
1685,dark,main,20211207,5,0.9958364290318905,278,16,83,377
1685,dark,main,20211207,6,0.9925634972826956,318,12,62,392
1685,dark,main,20211207,7,0.9906407958175913,247,11,81,339
1685,dark,main,20211207,8,0.9879167937065416,304,14,73,391
1685,dark,main,20211207,9,0.9943165525728697,318,11,66,395
6642,dark,main,20211207,0,0.9954771936516599,320,12,67,399
6642,dark,main,20211207,1,0.9943052570212596,304,12,35,351
6642,dark,main,20211207,2,0.9927547400158647,293,12,66,371
6642,dark,main,20211207,3,0.9917959890782888,294,14,48,356
6642,dark,main,20211207,4,0.9951125087087823,270,20,53,343
6642,dark,main,20211207,5,0.9943985058491189,288,12,65,365
6642,dark,main,20211207,6,0.9935236433728972,291,16,76,383
6642,dark,main,20211207,7,0.9847055150268179,251,13,67,331
6642,dark,main,20211207,8,0.9940617729480619,265,20,91,376
6642,dark,main,20211207,9,0.9917235056040649,291,17,63,371
22795,bright,main,20211207,0,0.994390081079768,296,123,4,423
22795,bright,main,20211207,1,0.9910150125949234,319,62,7,388
22795,bright,main,20211207,2,0.9952856710139601,370,59,2,431
22795,bright,main,20211207,3,0.9922673246317277,332,55,8,395
22795,bright,main,20211207,4,0.9868986561297177,331,52,3,386
22795,bright,main,20211207,5,0.9951892126221488,329,71,2,402
22795,bright,main,20211207,6,0.9830946363994886,336,72,6,414
22795,bright,main,20211207,7,0.9909337726874784,318,47,1,366
22795,bright,main,20211207,8,0.9931618782493636,327,80,5,412
22795,bright,main,20211207,9,0.995462949503108,285,117,7,409
11348,dark,main,20211207,0,0.9918941042502616,319,12,56,387
11348,dark,main,20211207,1,0.9911792113677353,267,12,67,346
11348,dark,main,20211207,2,0.9914301964699253,305,13,73,391
11348,dark,main,20211207,3,0.990214059139418,282,14,59,355
11348,dark,main,20211207,4,0.9901282933576248,282,11,53,346
11348,dark,main,20211207,5,0.9892238324333972,275,13,66,354
11348,dark,main,20211207,6,0.9916136746386439,281,17,87,385
11348,dark,main,20211207,7,0.9915581596408449,273,16,52,341
11348,dark,main,20211207,8,0.988365269020677,290,12,64,366
11348,dark,main,20211207,9,0.9911142066311713,302,12,57,371
1674,dark,main,20211207,0,0.9918904789019471,276,24,96,396
1674,dark,main,20211207,1,0.9924371530685642,240,18,78,336
1674,dark,main,20211207,2,0.9868728881791455,270,18,90,378
1674,dark,main,20211207,3,0.990618509244631,269,15,90,374
1674,dark,main,20211207,4,0.9882188295146205,251,11,85,347
1674,dark,main,20211207,5,0.9913857731791174,258,17,96,371
1674,dark,main,20211207,6,0.9944774125546334,259,14,96,369
1674,dark,main,20211207,7,0.9904120363525724,218,14,94,326
1674,dark,main,20211207,8,0.9918097225495988,279,16,90,385
1674,dark,main,20211207,9,0.9908556467158031,262,15,107,384
5686,dark,main,20211207,0,0.9917203439017581,284,15,99,398
5686,dark,main,20211207,1,0.9919871097407056,259,14,82,355
5686,dark,main,20211207,2,0.9956881008793691,272,18,107,397
5686,dark,main,20211207,3,0.9843623429537964,253,17,83,353
5686,dark,main,20211207,4,0.993181875583525,234,11,86,331
5686,dark,main,20211207,5,0.990049509723145,255,22,90,367
5686,dark,main,20211207,6,0.9928551273239398,266,18,100,384
5686,dark,main,20211207,7,0.9869393808961526,217,13,94,324
5686,dark,main,20211207,8,0.9917186262385357,277,15,85,377
5686,dark,main,20211207,9,0.9882895142166984,263,13,82,358
5525,dark,main,20211207,0,0.9897442493029887,261,16,105,382
5525,dark,main,20211207,1,0.9822623824490069,251,15,73,339
5525,dark,main,20211207,2,0.9906632921484901,284,18,76,378
5525,dark,main,20211207,3,0.9871916217387761,260,14,92,366
5525,dark,main,20211207,4,0.9893437949079649,261,10,77,348
5525,dark,main,20211207,5,0.9937517382485656,256,16,89,361
5525,dark,main,20211207,6,0.987894206553635,275,20,86,381
5525,dark,main,20211207,7,0.9927132773227878,244,15,72,331
5525,dark,main,20211207,8,0.995568064566512,257,13,104,374
5525,dark,main,20211207,9,0.987631060840868,254,17,91,362
5875,dark,main,20211207,0,0.9931649697095757,303,16,86,405
5875,dark,main,20211207,1,0.981789766422821,294,14,46,354
5875,dark,main,20211207,2,0.9923532504851169,310,13,58,381
5875,dark,main,20211207,3,0.9880321531016479,278,12,63,353
5875,dark,main,20211207,4,0.9779845218056566,270,13,77,360
5875,dark,main,20211207,5,0.9943285831762111,264,14,84,362
5875,dark,main,20211207,6,0.9907355334696393,253,18,104,375
5875,dark,main,20211207,7,0.9958430983736646,239,14,76,329
5875,dark,main,20211207,8,0.9946882951619109,291,15,72,378
5875,dark,main,20211207,9,0.9910841185933478,306,13,65,384
25387,bright,main,20211207,0,0.9958711045600396,335,83,7,425
25387,bright,main,20211207,1,0.9938119658271412,318,60,9,387
25387,bright,main,20211207,2,0.9865887750122214,326,97,3,426
25387,bright,main,20211207,3,0.9933420847251003,302,81,7,390
25387,bright,main,20211207,4,0.9910006928375245,266,108,1,375
25387,bright,main,20211207,5,0.9829261642622553,285,111,4,400
25387,bright,main,20211207,6,0.9934619255990393,302,107,4,413
25387,bright,main,20211207,7,0.9885007641178237,307,56,3,366
25387,bright,main,20211207,8,0.9928010945469237,347,55,7,409
25387,bright,main,20211207,9,0.991832330167372,344,59,6,409
5079,dark,main,20211207,0,0.9938385127507675,287,26,77,390
5079,dark,main,20211207,1,0.9904911604357416,250,30,69,349
5079,dark,main,20211207,2,0.9961551204955249,266,40,73,379
5079,dark,main,20211207,3,0.994265086219587,238,17,98,353
5079,dark,main,20211207,4,0.9935803051614293,263,32,53,348
5079,dark,main,20211207,5,0.9908912840978696,246,14,85,345
5079,dark,main,20211207,6,0.9929037961612965,272,21,87,380
5079,dark,main,20211207,7,0.9848474222122048,230,20,76,326
5079,dark,main,20211207,8,0.9880126678193962,291,13,52,356
5079,dark,main,20211207,9,0.9885810208045208,304,19,52,375
9772,dark,main,20211208,0,0.9952237561713333,303,16,85,404
9772,dark,main,20211208,1,0.9896096043881761,272,14,76,362
9772,dark,main,20211208,2,0.9947726344365333,302,16,77,395
9772,dark,main,20211208,3,0.9875997365995465,257,13,85,355
9772,dark,main,20211208,4,0.9942923619933316,270,15,72,357
9772,dark,main,20211208,5,0.9929501572154799,195,8,65,268
9772,dark,main,20211208,6,0.9911066348776111,267,13,102,382
9772,dark,main,20211208,7,0.988793894127719,253,14,71,338
9772,dark,main,20211208,8,0.9934314202457795,272,13,91,376
9772,dark,main,20211208,9,0.9906843131341464,264,13,97,374
4937,dark,main,20211208,0,0.9954917633002954,330,14,44,388
4937,dark,main,20211208,1,0.9913865475249991,283,11,46,340
4937,dark,main,20211208,2,0.9945910950570626,311,18,58,387
4937,dark,main,20211208,3,0.9919628517363569,268,13,64,345
4937,dark,main,20211208,4,0.9940333028831664,261,17,59,337
4937,dark,main,20211208,5,0.9924374509541911,228,9,48,285
4937,dark,main,20211208,6,0.9940654882942985,297,14,66,377
4937,dark,main,20211208,7,0.990117040527791,258,13,52,323
4937,dark,main,20211208,8,0.9832491278793494,276,20,58,354
4937,dark,main,20211208,9,0.9897492993742038,299,20,58,377
21920,bright,main,20211208,0,0.993448455063761,358,60,5,423
21920,bright,main,20211208,1,0.989396679563401,317,46,5,368
21920,bright,main,20211208,2,0.9901704653693678,340,59,3,402
21920,bright,main,20211208,3,0.9949146869852326,308,66,4,378
21920,bright,main,20211208,4,0.9917810039068755,323,51,5,379
21920,bright,main,20211208,5,0.9874539012039728,250,33,2,285
21920,bright,main,20211208,6,0.995095924125955,349,57,6,412
21920,bright,main,20211208,7,0.9928178958702844,268,71,9,348
21920,bright,main,20211208,8,0.9902231422428723,321,68,4,393
21920,bright,main,20211208,9,0.9918096515289082,325,62,6,393
9176,dark,main,20211208,0,0.9950568517134726,267,21,85,373
9176,dark,main,20211208,1,0.9893351313893719,236,14,85,335
9176,dark,main,20211208,2,0.9948476401790234,276,15,87,378
9176,dark,main,20211208,3,0.9907736937057139,250,14,88,352
9176,dark,main,20211208,4,0.9933760378348557,272,9,76,357
9176,dark,main,20211208,5,0.9854716655834217,195,10,70,275
9176,dark,main,20211208,6,0.9913285326586212,256,16,105,377
9176,dark,main,20211208,7,0.9927534060162271,229,14,97,340
9176,dark,main,20211208,8,0.9938005463265047,258,14,102,374
9176,dark,main,20211208,9,0.9888085774265218,269,10,92,371
4928,dark,main,20211208,0,0.9887075408726067,292,13,69,374
4928,dark,main,20211208,1,0.9862282079674559,243,20,81,344
4928,dark,main,20211208,2,0.9946950036452215,273,19,95,387
4928,dark,main,20211208,3,0.9921840897077874,258,15,86,359
4928,dark,main,20211208,4,0.9908415928020619,283,12,54,349
4928,dark,main,20211208,5,0.9911610259818171,222,11,40,273
4928,dark,main,20211208,6,0.9920325036406289,295,12,56,363
4928,dark,main,20211208,7,0.9939420390441326,277,14,41,332
4928,dark,main,20211208,8,0.9920096061444351,294,18,48,360
4928,dark,main,20211208,9,0.9867004535674964,308,14,45,367
8058,dark,main,20211208,0,0.9886835787397718,300,13,56,369
8058,dark,main,20211208,1,0.9892784615497078,298,11,40,349
8058,dark,main,20211208,2,0.9957874952904001,336,15,33,384
8058,dark,main,20211208,3,0.985682655255394,307,12,44,363
8058,dark,main,20211208,4,0.987746685911922,296,15,49,360
8058,dark,main,20211208,5,0.994014621007828,225,11,34,270
8058,dark,main,20211208,6,0.9938096496283314,322,16,47,385
8058,dark,main,20211208,7,0.9820850613305526,252,12,54,318
8058,dark,main,20211208,8,0.9953483930054204,289,15,65,369
8058,dark,main,20211208,9,0.9898174687099964,280,15,70,365
6671,dark,main,20211208,0,0.9879226210960409,311,13,67,391
6671,dark,main,20211208,1,0.9928111538249431,246,11,88,345
6671,dark,main,20211208,2,0.9892399964731027,316,14,58,388
6671,dark,main,20211208,3,0.9918527604548006,292,13,52,357
6671,dark,main,20211208,4,0.9895413307951813,285,11,49,345
6671,dark,main,20211208,5,0.9869136665159055,218,7,44,269
6671,dark,main,20211208,6,0.9878529906182868,316,15,54,385
6671,dark,main,20211208,7,0.9948260049932713,255,18,67,340
6671,dark,main,20211208,8,0.9911079764972067,309,17,53,379
6671,dark,main,20211208,9,0.9959599483335396,311,16,54,381
23457,bright,main,20211208,0,0.995963721674267,328,107,10,445
23457,bright,main,20211208,1,0.9899520548808475,267,115,4,386
23457,bright,main,20211208,2,0.9865985371588033,326,104,7,437
23457,bright,main,20211208,3,0.9911639053012214,290,107,2,399
23457,bright,main,20211208,4,0.9945716518327811,265,128,1,394
23457,bright,main,20211208,5,0.9823673447755676,132,63,2,197
23457,bright,main,20211208,6,0.9934862676120336,339,88,3,430
23457,bright,main,20211208,7,0.9851975781429756,246,115,4,365
23457,bright,main,20211208,8,0.994755921899717,307,118,1,426
23457,bright,main,20211208,9,0.9897942521311842,295,123,2,420
3714,dark,main,20211208,0,0.9932334358780627,281,43,72,396
3714,dark,main,20211208,1,0.9909917602958609,263,23,71,357
3714,dark,main,20211208,2,0.9966705963981548,259,34,85,378
3714,dark,main,20211208,3,0.9868573853447377,267,24,72,363
3714,dark,main,20211208,4,0.9892845132547374,256,23,65,344
3714,dark,main,20211208,5,0.9955144435867177,204,11,54,269
3714,dark,main,20211208,6,0.9873061590895643,301,21,59,381
3714,dark,main,20211208,7,0.9890835140592305,242,33,55,330
3714,dark,main,20211208,8,0.9928443913763004,294,26,47,367
3714,dark,main,20211208,9,0.9919300502590881,301,16,54,371
1815,dark,main,20211208,0,0.9889179365653267,308,12,62,382
1815,dark,main,20211208,1,0.9868613253815275,270,14,54,338
1815,dark,main,20211208,2,0.9801823763868476,254,19,87,360
1815,dark,main,20211208,3,0.9868522967873494,243,18,83,344
1815,dark,main,20211208,4,0.9913574010646885,261,14,86,361
1815,dark,main,20211208,5,0.9956997988058146,203,9,52,264
1815,dark,main,20211208,6,0.9875010354435626,248,21,91,360
1815,dark,main,20211208,7,0.994178015757031,219,14,71,304
1815,dark,main,20211208,8,0.9921231055019194,254,14,104,372
1815,dark,main,20211208,9,0.9891545488778387,266,11,93,370
5110,dark,main,20211208,0,0.9881797453293766,325,11,52,388
5110,dark,main,20211208,1,0.986417203664373,263,19,59,341
5110,dark,main,20211208,2,0.9899255066962512,281,14,84,379
5110,dark,main,20211208,3,0.988936479301416,281,18,58,357
5110,dark,main,20211208,4,0.9905569909931601,247,16,68,331
5110,dark,main,20211208,5,0.989130876584929,206,7,47,260
5110,dark,main,20211208,6,0.9858775760218367,290,28,61,379
5110,dark,main,20211208,7,0.978951718870835,244,19,58,321
5110,dark,main,20211208,8,0.9863143077601333,299,11,65,375
5110,dark,main,20211208,9,0.9842377678718424,282,24,56,362
4473,dark,main,20211208,0,0.9913990177312254,274,14,96,384
4473,dark,main,20211208,1,0.9870417172844008,245,13,74,332
4473,dark,main,20211208,2,0.990232505659044,276,9,98,383
4473,dark,main,20211208,3,0.9888428390504816,236,13,96,345
4473,dark,main,20211208,4,0.9904236266620599,271,11,75,357
4473,dark,main,20211208,5,0.9914565350132429,191,9,62,262
4473,dark,main,20211208,6,0.9884365514230326,288,14,84,386
4473,dark,main,20211208,7,0.9890307769579335,243,15,84,342
4473,dark,main,20211208,8,0.9830613673580199,266,14,89,369
4473,dark,main,20211208,9,0.9907261925748123,282,12,81,375
4769,dark,main,20211208,0,0.9950613939630735,280,16,100,396
4769,dark,main,20211208,1,0.9899169561137435,257,13,76,346
4769,dark,main,20211208,2,0.9944039775503372,287,12,92,391
4769,dark,main,20211208,3,0.9906829903940603,264,15,80,359
4769,dark,main,20211208,4,0.9896864470906055,283,12,71,366
4769,dark,main,20211208,5,0.9900296965907318,259,9,97,365
4769,dark,main,20211208,6,0.9914754199290559,270,17,99,386
4769,dark,main,20211208,7,0.9915198288873934,259,16,68,343
4769,dark,main,20211208,8,0.9926260023513663,255,14,114,383
4769,dark,main,20211208,9,0.98409686559902,280,12,96,388
1795,dark,main,20211208,0,0.9880546408763557,298,18,65,381
1795,dark,main,20211208,1,0.9930924604977214,276,14,52,342
1795,dark,main,20211208,2,0.9915425234875355,270,15,84,369
1795,dark,main,20211208,3,0.9952903380828519,250,15,87,352
1795,dark,main,20211208,4,0.9962462015261097,267,13,64,344
1795,dark,main,20211208,5,0.9809552768127678,200,28,48,276
1795,dark,main,20211208,6,0.9947421955805513,281,20,86,387
1795,dark,main,20211208,7,0.988802142326901,235,18,80,333
1795,dark,main,20211208,8,0.9895459956895049,284,17,83,384
1795,dark,main,20211208,9,0.9918563490877145,282,20,76,378
5082,dark,main,20211208,0,0.9954009486452501,286,21,95,402
5082,dark,main,20211208,1,0.9937768425711551,270,18,71,359
5082,dark,main,20211208,2,0.9916756133882487,303,15,72,390
5082,dark,main,20211208,3,0.987769672735473,249,13,76,338
5082,dark,main,20211208,4,0.9832810849480942,267,14,68,349
5082,dark,main,20211208,5,0.9846115872316623,199,5,54,258
5082,dark,main,20211208,6,0.987894951325728,281,16,90,387
5082,dark,main,20211208,7,0.9899005450433181,270,11,46,327
5082,dark,main,20211208,8,0.9893140581730054,301,13,63,377
5082,dark,main,20211208,9,0.9867256447098227,297,16,69,382
11641,dark,main,20211208,0,0.9882376396433729,306,22,60,388
11641,dark,main,20211208,1,0.9898148035977844,268,15,66,349
11641,dark,main,20211208,2,0.9931745021833858,283,11,85,379
11641,dark,main,20211208,3,0.9955947304919559,271,16,62,349
11641,dark,main,20211208,4,0.9932936067912603,304,11,38,353
11641,dark,main,20211208,5,0.9914003937160918,226,9,41,276
11641,dark,main,20211208,6,0.9937581176227172,308,11,54,373
11641,dark,main,20211208,7,0.9899756595774843,259,11,51,321
11641,dark,main,20211208,8,0.987218775191466,299,13,54,366
11641,dark,main,20211208,9,0.9931926295504988,290,18,62,370
23445,bright,main,20211208,0,0.9886477746498359,247,180,2,429
23445,bright,main,20211208,1,0.9965487999862018,117,262,3,382
23445,bright,main,20211208,2,0.9908811765763926,131,281,4,416
23445,bright,main,20211208,3,0.99100222826381,146,247,3,396
23445,bright,main,20211208,4,0.9884891534185872,134,241,5,380
23445,bright,main,20211208,5,0.994855622361662,90,257,6,353
23445,bright,main,20211208,6,0.9943082556331264,119,302,1,422
23445,bright,main,20211208,7,0.9886295803343499,86,273,6,365
23445,bright,main,20211208,8,0.9938515554052144,125,294,3,422
23445,bright,main,20211208,9,0.9925147454239134,184,166,2,352
4474,dark,main,20211208,0,0.987931452974006,283,12,94,389
4474,dark,main,20211208,1,0.9954639719850342,258,11,76,345
4474,dark,main,20211208,2,0.9932668432287023,284,14,85,383
4474,dark,main,20211208,3,0.9947827771489414,264,12,78,354
4474,dark,main,20211208,4,0.9931545884425296,270,11,66,347
4474,dark,main,20211208,5,0.990096380706044,203,5,70,278
4474,dark,main,20211208,6,0.9924674834696515,276,11,105,392
4474,dark,main,20211208,7,0.9869841878404609,224,13,96,333
4474,dark,main,20211208,8,0.9944571873622957,265,27,83,375
4474,dark,main,20211208,9,0.9934893174617511,284,16,86,386
1382,dark,main,20211208,0,0.988791447665741,294,12,89,395
1382,dark,main,20211208,1,0.9940108110376524,253,13,79,345
1382,dark,main,20211208,2,0.9935712029373504,270,10,95,375
1382,dark,main,20211208,3,0.9883621295542406,264,24,76,364
1382,dark,main,20211208,4,0.9899031133286793,256,18,71,345
1382,dark,main,20211208,5,0.9924864360631998,199,9,59,267
1382,dark,main,20211208,6,0.9945508956231996,289,12,84,385
1382,dark,main,20211208,7,0.9901055195396296,262,12,69,343
1382,dark,main,20211208,8,0.9937057809719905,272,12,95,379
1382,dark,main,20211208,9,0.9877510975882389,274,14,98,386
21911,bright,main,20211208,0,0.9947735484223957,370,43,10,423
21911,bright,main,20211208,1,0.9944454389961226,309,60,7,376
21911,bright,main,20211208,2,0.9935329854131542,364,49,4,417
21911,bright,main,20211208,3,0.9935792329864325,338,37,1,376
21911,bright,main,20211208,4,0.9832716484753309,321,47,6,374
21911,bright,main,20211208,5,0.9887118727454884,257,29,2,288
21911,bright,main,20211208,6,0.9923655225708016,379,35,3,417
21911,bright,main,20211208,7,0.9889381971495504,318,30,7,355
21911,bright,main,20211208,8,0.9958566244529752,374,32,3,409
21911,bright,main,20211208,9,0.9845926993442965,352,46,6,404
4930,dark,main,20211208,0,0.9913172717944455,307,18,62,387
4930,dark,main,20211208,1,0.9942720449559727,277,16,37,330
4930,dark,main,20211208,2,0.989666881780418,309,14,44,367
4930,dark,main,20211208,3,0.9925594413171632,296,11,48,355
4930,dark,main,20211208,4,0.990409037484338,289,15,48,352
4930,dark,main,20211208,5,0.9870844306792437,219,12,42,273
4930,dark,main,20211208,6,0.9954151504052993,303,17,54,374
4930,dark,main,20211208,7,0.9958611706261176,272,13,41,326
4930,dark,main,20211208,8,0.9907887786587085,285,18,54,357
4930,dark,main,20211208,9,0.9946464957014179,294,14,60,368
11625,dark,main,20211208,0,0.9946787232451678,305,14,51,370
11625,dark,main,20211208,1,0.9906830071805086,281,16,58,355
11625,dark,main,20211208,2,0.9902052969121077,275,17,95,387
11625,dark,main,20211208,3,0.9947462578811497,260,14,77,351
11625,dark,main,20211208,4,0.9895021177438481,260,14,82,356
11625,dark,main,20211208,5,0.9829172560685107,203,15,59,277
11625,dark,main,20211208,6,0.9928247553986063,258,31,80,369
11625,dark,main,20211208,7,0.9859529342000859,224,13,77,314
11625,dark,main,20211208,8,0.9924859356696918,287,17,73,377
11625,dark,main,20211208,9,0.9917705212976605,280,14,43,337
1376,dark,main,20211208,0,0.9932461790240699,279,13,99,391
1376,dark,main,20211208,1,0.9937564155031285,254,14,85,353
1376,dark,main,20211208,2,0.9934544363281057,292,17,74,383
1376,dark,main,20211208,3,0.98459180734382,270,14,80,364
1376,dark,main,20211208,4,0.9923014491269624,245,11,86,342
1376,dark,main,20211208,5,0.9949246728824521,180,9,75,264
1376,dark,main,20211208,6,0.9863783195783409,270,12,97,379
1376,dark,main,20211208,7,0.9884680917422186,240,12,83,335
1376,dark,main,20211208,8,0.9900049243074869,267,11,82,360
1376,dark,main,20211208,9,0.9930357522418776,270,14,99,383
4925,dark,main,20211208,0,0.9950678467091305,331,15,52,398
4925,dark,main,20211208,1,0.9937256416416305,285,17,56,358
4925,dark,main,20211208,2,0.9941464496658097,316,14,50,380
4925,dark,main,20211208,3,0.9897658621372545,292,14,50,356
4925,dark,main,20211208,4,0.9883361417145126,282,16,53,351
4925,dark,main,20211208,5,0.9864629629507584,163,15,45,223
4925,dark,main,20211208,6,0.983697398944177,242,20,83,345
4925,dark,main,20211208,7,0.9911142437145396,236,18,77,331
4925,dark,main,20211208,8,0.9949749174624429,294,16,82,392
4925,dark,main,20211208,9,0.9941187386398959,301,15,66,382
9182,dark,main,20211208,0,0.9932889037587463,282,13,103,398
9182,dark,main,20211208,1,0.9903978186422245,241,15,88,344
9182,dark,main,20211208,2,0.994555169082176,283,12,85,380
9182,dark,main,20211208,3,0.9914219641868439,243,12,101,356
9182,dark,main,20211208,4,0.995249946778888,262,14,81,357
9182,dark,main,20211208,5,0.9914548082363787,188,10,62,260
9182,dark,main,20211208,6,0.9912533105878046,290,15,92,397
9182,dark,main,20211208,7,0.9893927842051504,239,13,83,335
9182,dark,main,20211208,8,0.9907815391739901,284,14,79,377
9182,dark,main,20211208,9,0.9969236054403415,263,15,88,366
22135,bright,main,20211210,0,0.9936642818907027,345,94,4,443
22135,bright,main,20211210,1,0.9935330362703307,313,82,3,398
22135,bright,main,20211210,2,0.9917814360869383,353,84,4,441
22135,bright,main,20211210,3,0.9940785205833076,266,132,1,399
22135,bright,main,20211210,4,0.9915966277138777,245,148,3,396
22135,bright,main,20211210,5,0.9958666737193946,262,149,2,413
22135,bright,main,20211210,6,0.9878074590375678,270,157,2,429
22135,bright,main,20211210,7,0.996054278471368,265,110,3,378
22135,bright,main,20211210,8,0.9959645269560634,312,113,0,425
22135,bright,main,20211210,9,0.9943784445867931,339,87,3,429
21842,bright,main,20211210,0,0.9945241472054729,340,84,8,432
21842,bright,main,20211210,1,0.993352293712423,310,77,5,392
21842,bright,main,20211210,2,0.991407920123516,322,92,5,419
21842,bright,main,20211210,3,0.9953233185869711,307,79,5,391
21842,bright,main,20211210,4,0.9899051562595841,312,62,0,374
21842,bright,main,20211210,5,0.9923421244037336,310,82,3,395
21842,bright,main,20211210,6,0.9864783686343158,290,121,3,414
21842,bright,main,20211210,7,0.9911372940196612,264,86,4,354
21842,bright,main,20211210,8,0.9939505585947401,332,76,2,410
21842,bright,main,20211210,9,0.9922099383424948,347,64,5,416
20262,bright,main,20211210,0,0.9935847554807272,330,101,4,435
20262,bright,main,20211210,1,0.9929796530139609,226,145,9,380
20262,bright,main,20211210,2,0.9934250220995533,293,134,2,429
20262,bright,main,20211210,3,0.9933210995455761,262,114,5,381
20262,bright,main,20211210,4,0.995150397613584,334,53,4,391
20262,bright,main,20211210,5,0.9947810587167345,359,51,0,410
20262,bright,main,20211210,6,0.9898004694788792,374,42,8,424
20262,bright,main,20211210,7,0.9945853085158973,310,49,4,363
20262,bright,main,20211210,8,0.9857776511906721,355,61,1,417
20262,bright,main,20211210,9,0.9966609971154164,339,72,4,415
4856,dark,main,20211210,0,0.9921554086916816,315,18,46,379
4856,dark,main,20211210,1,0.9925213881177875,280,18,41,339
4856,dark,main,20211210,2,0.9867631281025253,326,22,38,386
4856,dark,main,20211210,3,0.991415366353459,277,15,41,333
4856,dark,main,20211210,4,0.9902147405489368,270,20,41,331
4856,dark,main,20211210,5,0.9929702459730878,271,15,72,358
4856,dark,main,20211210,6,0.9927942051338652,305,15,75,395
4856,dark,main,20211210,7,0.9859369303890686,263,23,46,332
4856,dark,main,20211210,8,0.9931122912993705,304,22,46,372
4856,dark,main,20211210,9,0.9955476522758615,288,17,52,357
10357,dark,main,20211210,0,0.9922904324294424,319,16,37,372
10357,dark,main,20211210,1,0.9867956147892664,265,12,45,322
10357,dark,main,20211210,2,0.9935495023818038,328,15,39,382
10357,dark,main,20211210,3,0.9919189167911037,284,19,46,349
10357,dark,main,20211210,4,0.9868545665134288,284,13,41,338
10357,dark,main,20211210,5,0.995518862219229,299,17,44,360
10357,dark,main,20211210,6,0.993529905497978,303,17,66,386
10357,dark,main,20211210,7,0.982560529434033,187,7,32,226
10357,dark,main,20211210,8,0.9865206336579752,295,11,44,350
10357,dark,main,20211210,9,0.9831065298022431,297,14,44,355
10378,dark,main,20211210,0,0.9958660872832257,282,16,81,379
10378,dark,main,20211210,1,0.9921479751618353,262,17,80,359
10378,dark,main,20211210,2,0.9941837312241684,309,13,71,393
10378,dark,main,20211210,3,0.9940370476564575,274,12,73,359
10378,dark,main,20211210,4,0.9849614656503611,266,14,68,348
10378,dark,main,20211210,5,0.9938806575925428,296,14,47,357
10378,dark,main,20211210,6,0.9889902831909428,311,15,62,388
10378,dark,main,20211210,7,0.9844343951040816,260,15,53,328
10378,dark,main,20211210,8,0.9834353021815313,274,13,69,356
10378,dark,main,20211210,9,0.9845491838814806,268,21,86,375
11922,dark,main,20211210,0,0.9920195872373496,324,14,47,385
11922,dark,main,20211210,1,0.9900850188564353,271,13,53,337
11922,dark,main,20211210,2,0.9943690228522677,326,12,35,373
11922,dark,main,20211210,3,0.985443408351201,306,13,35,354
11922,dark,main,20211210,4,0.987234478177592,286,12,52,350
11922,dark,main,20211210,5,0.9927829816684792,297,14,45,356
11922,dark,main,20211210,6,0.9908003111308079,306,10,63,379
11922,dark,main,20211210,7,0.9818031727115244,259,12,42,313
11922,dark,main,20211210,8,0.9942845835654978,296,13,62,371
11922,dark,main,20211210,9,0.9910408573806405,307,16,50,373
2431,dark,main,20211211,0,0.9897997838115835,290,13,95,398
2431,dark,main,20211211,1,0.9945019987352114,265,12,78,355
2431,dark,main,20211211,2,0.9920100200070384,282,11,106,399
2431,dark,main,20211211,3,0.9921971141006025,276,11,84,371
2431,dark,main,20211211,4,0.992865356697717,267,12,73,352
2431,dark,main,20211211,5,0.9871275734738292,251,9,83,343
2431,dark,main,20211211,6,0.9938202169127573,269,10,87,366
2431,dark,main,20211211,7,0.9946451212767873,255,10,69,334
2431,dark,main,20211211,8,0.9948069773430137,275,14,89,378
2431,dark,main,20211211,9,0.9921011189601704,287,12,90,389
24771,bright,main,20211211,0,0.9960442464558665,320,110,4,434
24771,bright,main,20211211,1,0.9900373138167409,287,98,9,394
24771,bright,main,20211211,2,0.992887039257737,295,126,4,425
24771,bright,main,20211211,3,0.9930817764883991,182,218,3,403
24771,bright,main,20211211,4,0.9932460755926599,213,175,2,390
24771,bright,main,20211211,5,0.9950103483738139,260,141,3,404
24771,bright,main,20211211,6,0.9940558398336969,323,102,4,429
24771,bright,main,20211211,7,0.9952965940341981,272,97,7,376
24771,bright,main,20211211,8,0.9912003279785809,297,123,5,425
24771,bright,main,20211211,9,0.9947104024690543,309,116,2,427
8679,dark,main,20211211,0,0.9961889761425637,322,11,56,389
8679,dark,main,20211211,1,0.99129775326229,263,16,80,359
8679,dark,main,20211211,2,0.9974241895195449,298,15,85,398
8679,dark,main,20211211,3,0.9897146146236979,295,17,41,353
8679,dark,main,20211211,4,0.9864985253966772,283,19,38,340
8679,dark,main,20211211,5,0.9943617856280663,305,10,49,364
8679,dark,main,20211211,6,0.9797651657015141,288,14,80,382
8679,dark,main,20211211,7,0.99357284959122,274,11,49,334
8679,dark,main,20211211,8,0.9897729409096045,296,17,61,374
8679,dark,main,20211211,9,0.9936339484324412,273,26,64,363
10974,dark,main,20211211,0,0.9949517059892539,272,23,70,365
10974,dark,main,20211211,1,0.9971503353916963,270,17,46,333
10974,dark,main,20211211,2,0.9927263582079957,298,14,49,361
10974,dark,main,20211211,3,0.9906892841507022,287,18,41,346
10974,dark,main,20211211,4,0.9927681391076457,286,16,38,340
10974,dark,main,20211211,5,0.9929357329979458,271,21,61,353
10974,dark,main,20211211,6,0.9949145771786507,244,26,79,349
10974,dark,main,20211211,7,0.9952869184048028,229,20,60,309
10974,dark,main,20211211,8,0.9876599017438955,268,37,59,364
10974,dark,main,20211211,9,0.9953069508044171,267,18,75,360
5606,dark,main,20211211,0,0.9946442556868663,323,10,72,405
5606,dark,main,20211211,1,0.9941535471203283,280,10,48,338
5606,dark,main,20211211,2,0.9900914236406595,319,13,55,387
5606,dark,main,20211211,3,0.9894992476121264,299,12,38,349
5606,dark,main,20211211,4,0.990664032551813,280,10,29,319
5606,dark,main,20211211,5,0.9924124636210806,325,11,34,370
5606,dark,main,20211211,6,0.9910297783556501,322,13,38,373
5606,dark,main,20211211,7,0.9884673106087509,285,9,28,322
5606,dark,main,20211211,8,0.9945869606694613,318,11,48,377
5606,dark,main,20211211,9,0.9918561566277443,300,10,60,370
8780,dark,main,20211211,0,0.9912472327943825,295,16,80,391
8780,dark,main,20211211,1,0.9917978946284759,235,17,88,340
8780,dark,main,20211211,2,0.9745814163043941,227,25,88,340
8780,dark,main,20211211,3,0.9931822213528292,194,22,80,296
8780,dark,main,20211211,4,0.9882307331372128,259,14,66,339
8780,dark,main,20211211,5,0.992519012908791,254,16,101,371
8780,dark,main,20211211,6,0.993336573876433,281,17,87,385
8780,dark,main,20211211,7,0.9842634419234437,262,17,50,329
8780,dark,main,20211211,8,0.9945360514095667,317,15,49,381
8780,dark,main,20211211,9,0.9902028362841713,290,11,61,362
9076,dark,main,20211211,0,0.9928192406310469,315,13,64,392
9076,dark,main,20211211,1,0.9939373823514045,290,13,46,349
9076,dark,main,20211211,2,0.9846065303877964,212,13,56,281
9076,dark,main,20211211,3,0.9830958329155957,192,14,45,251
9076,dark,main,20211211,4,0.9915093270579767,284,10,47,341
9076,dark,main,20211211,5,0.9906727852630275,287,12,49,348
9076,dark,main,20211211,6,0.9788218886476511,136,9,48,193
9076,dark,main,20211211,7,0.9907256188838135,225,15,63,303
9076,dark,main,20211211,8,0.9959493696057743,284,14,75,373
9076,dark,main,20211211,9,0.9880030142103885,304,22,57,383
9963,dark,main,20211211,0,0.9904213091864711,314,22,48,384
9963,dark,main,20211211,1,0.9891419711647109,289,23,45,357
9963,dark,main,20211211,2,0.9912993678393525,330,13,41,384
9963,dark,main,20211211,3,0.9912366935766306,294,20,30,344
9963,dark,main,20211211,4,0.9958373821904195,304,14,33,351
9963,dark,main,20211211,5,0.9886887741600049,302,18,54,374
9963,dark,main,20211211,6,0.9937385896478541,297,21,57,375
9963,dark,main,20211211,7,0.9909567359853004,266,19,50,335
9963,dark,main,20211211,8,0.9958370544249485,305,17,45,367
9963,dark,main,20211211,9,0.9844918492340633,309,17,33,359
20682,bright,main,20211211,0,0.9882867417860506,336,94,5,435
20682,bright,main,20211211,1,0.9944343055744196,266,110,3,379
20682,bright,main,20211211,2,0.993451655753107,297,113,9,419
20682,bright,main,20211211,3,0.9893801562381341,279,109,2,390
20682,bright,main,20211211,4,0.9929635342848517,236,117,9,362
20682,bright,main,20211211,5,0.9899742440006846,179,59,3,241
20682,bright,main,20211211,6,0.9873151426457653,274,63,4,341
20682,bright,main,20211211,7,0.9909595318874758,294,61,5,360
20682,bright,main,20211211,8,0.9911363599969512,294,104,5,403
20682,bright,main,20211211,9,0.9797720055039655,339,76,1,416
8790,dark,main,20211211,0,0.9913161245315484,297,17,64,378
8790,dark,main,20211211,1,0.9914318106198704,263,18,63,344
8790,dark,main,20211211,2,0.9917442785714341,310,16,64,390
8790,dark,main,20211211,3,0.9908956052799984,285,16,57,358
8790,dark,main,20211211,4,0.993327813428934,274,12,60,346
8790,dark,main,20211211,5,0.9895427320476498,288,18,42,348
8790,dark,main,20211211,6,0.9898933130927855,295,14,71,380
8790,dark,main,20211211,7,0.9791004208956574,245,17,54,316
8790,dark,main,20211211,8,0.9939951586829636,294,12,66,372
8790,dark,main,20211211,9,0.9931667282714322,279,14,46,339
7220,dark,main,20211211,0,0.9930229811105393,296,13,57,366
7220,dark,main,20211211,1,0.9948488558989836,282,29,39,350
7220,dark,main,20211211,2,0.9902316733803642,305,20,60,385
7220,dark,main,20211211,3,0.9943626677534827,292,16,51,359
7220,dark,main,20211211,4,0.9834228115529341,292,20,42,354
7220,dark,main,20211211,5,0.9855821360880151,287,22,54,363
7220,dark,main,20211211,6,0.9917734826835893,284,20,66,370
7220,dark,main,20211211,7,0.9936627721809825,263,17,55,335
7220,dark,main,20211211,8,0.9901374362565167,311,19,37,367
7220,dark,main,20211211,9,0.99110807719791,280,17,50,347
10366,dark,main,20211211,0,0.9938280379114409,304,14,63,381
10366,dark,main,20211211,1,0.9888158158607315,263,15,67,345
10366,dark,main,20211211,2,0.992676808051457,314,12,43,369
10366,dark,main,20211211,3,0.9886213254609908,273,23,46,342
10366,dark,main,20211211,4,0.9926165269147058,255,14,83,352
10366,dark,main,20211211,5,0.9910798532159039,285,23,60,368
10366,dark,main,20211211,6,0.9905962029841952,297,27,56,380
10366,dark,main,20211211,7,0.9896449113150841,265,14,52,331
10366,dark,main,20211211,8,0.9894262179358958,298,15,47,360
10366,dark,main,20211211,9,0.9933820454942086,302,16,52,370
2542,dark,main,20211211,0,0.9939529333149458,305,17,47,369
2542,dark,main,20211211,1,0.9860556973616492,273,14,54,341
2542,dark,main,20211211,2,0.9947839413573584,299,16,54,369
2542,dark,main,20211211,3,0.9933736448730072,284,15,38,337
2542,dark,main,20211211,4,0.9948960167519448,261,17,58,336
2542,dark,main,20211211,5,0.9920310346398812,266,13,77,356
2542,dark,main,20211211,6,0.9922928886871779,294,13,72,379
2542,dark,main,20211211,7,0.988046739800859,248,11,54,313
2542,dark,main,20211211,8,0.9915938822995527,290,16,58,364
2542,dark,main,20211211,9,0.9912801162768428,313,11,32,356
10379,dark,main,20211211,0,0.9894460552020699,244,24,109,377
10379,dark,main,20211211,1,0.9957738312810046,241,16,90,347
10379,dark,main,20211211,2,0.9941531108142972,284,13,92,389
10379,dark,main,20211211,3,0.9935824225188794,255,14,84,353
10379,dark,main,20211211,4,0.9941242691821593,249,15,89,353
10379,dark,main,20211211,5,0.9882762679800289,267,16,83,366
10379,dark,main,20211211,6,0.9952578401072083,275,16,94,385
10379,dark,main,20211211,7,0.9880909475076369,232,14,82,328
10379,dark,main,20211211,8,0.9953814025075524,265,20,96,381
10379,dark,main,20211211,9,0.9913569437114996,270,25,92,387
7525,dark,main,20211211,0,0.99155280772454,283,14,85,382
7525,dark,main,20211211,1,0.9826281069316796,258,12,81,351
7525,dark,main,20211211,2,0.9852516481073582,262,19,106,387
7525,dark,main,20211211,3,0.9932779701786657,248,16,91,355
7525,dark,main,20211211,4,0.9913635739309643,271,13,72,356
7525,dark,main,20211211,5,0.9907511749122929,269,15,89,373
7525,dark,main,20211211,6,0.9923852274000976,272,15,100,387
7525,dark,main,20211211,7,0.9817081462377047,242,18,85,345
7525,dark,main,20211211,8,0.9920237292455948,265,25,79,369
7525,dark,main,20211211,9,0.9922983551200016,274,23,84,381
25506,bright,main,20211211,0,0.9968956791364555,340,92,1,433
25506,bright,main,20211211,1,0.9913262961303924,318,73,3,394
25506,bright,main,20211211,2,0.995370482385178,355,84,0,439
25506,bright,main,20211211,3,0.9895641851919619,315,72,2,389
25506,bright,main,20211211,4,0.9903610625863802,300,89,3,392
25506,bright,main,20211211,5,0.9954666801925075,305,95,5,405
25506,bright,main,20211211,6,0.9939121752618458,324,96,5,425
25506,bright,main,20211211,7,0.9777198694218936,237,68,4,309
25506,bright,main,20211211,8,0.9889733073073866,331,80,4,415
25506,bright,main,20211211,9,0.9928381139873564,324,86,3,413
23405,bright,main,20211211,0,0.9964425330746167,305,95,6,406
23405,bright,main,20211211,1,0.9955220603278814,270,92,4,366
23405,bright,main,20211211,2,0.9881345160086668,356,73,4,433
23405,bright,main,20211211,3,0.9938558512314498,309,80,7,396
23405,bright,main,20211211,4,0.995001805144639,308,74,4,386
23405,bright,main,20211211,5,0.9942213618280243,316,88,4,408
23405,bright,main,20211211,6,0.9890410787772101,330,90,4,424
23405,bright,main,20211211,7,0.9864857623022663,312,23,3,338
23405,bright,main,20211211,8,0.9914676486687222,324,86,4,414
23405,bright,main,20211211,9,0.9930960651682695,311,92,7,410
2443,dark,main,20211211,0,0.9904644483575658,296,12,99,407
2443,dark,main,20211211,1,0.993303412640756,273,13,76,362
2443,dark,main,20211211,2,0.9907124395880211,294,11,92,397
2443,dark,main,20211211,3,0.9954974491129442,264,13,81,358
2443,dark,main,20211211,4,0.9930137606400953,260,12,89,361
2443,dark,main,20211211,5,0.9889109186225383,282,12,93,387
2443,dark,main,20211211,6,0.9872264100038254,279,12,90,381
2443,dark,main,20211211,7,0.9878592240525871,252,13,72,337
2443,dark,main,20211211,8,0.9893521862798912,271,13,98,382
2443,dark,main,20211211,9,0.9946792785518689,269,12,104,385
2519,dark,main,20211211,0,0.9878233370458561,259,22,99,380
2519,dark,main,20211211,1,0.9925956180663423,243,16,89,348
2519,dark,main,20211211,2,0.9909553905860269,310,12,56,378
2519,dark,main,20211211,3,0.991111354486093,284,11,56,351
2519,dark,main,20211211,4,0.9898863242618962,275,10,49,334
2519,dark,main,20211211,5,0.994000435385532,303,14,43,360
2519,dark,main,20211211,6,0.9879205061812114,293,13,55,361
2519,dark,main,20211211,7,0.9946196852273603,242,11,70,323
2519,dark,main,20211211,8,0.9945888812697518,272,22,71,365
2519,dark,main,20211211,9,0.9900800548761799,270,14,96,380
7250,dark,main,20211211,0,0.9842757738651681,310,12,53,375
7250,dark,main,20211211,1,0.9899558534915891,284,13,40,337
7250,dark,main,20211211,2,0.9901691375309956,309,15,45,369
7250,dark,main,20211211,3,0.9909626893762775,299,11,40,350
7250,dark,main,20211211,4,0.9889037404357951,269,11,47,327
7250,dark,main,20211211,5,0.9935897792762955,290,16,40,346
7250,dark,main,20211211,6,0.9920219473363674,315,15,62,392
7250,dark,main,20211211,7,0.9889688041713368,275,12,54,341
7250,dark,main,20211211,8,0.9856491883658106,290,16,70,376
7250,dark,main,20211211,9,0.9921272472524448,290,12,56,358
24774,bright,main,20211211,0,0.9909107395049818,252,175,2,429
24774,bright,main,20211211,1,0.9877924095003128,229,166,1,396
24774,bright,main,20211211,2,0.9884736355638384,237,191,4,432
24774,bright,main,20211211,3,0.989295864466624,251,143,3,397
24774,bright,main,20211211,4,0.9944178465395965,205,192,3,400
24774,bright,main,20211211,5,0.9957674858692458,248,164,2,414
24774,bright,main,20211211,6,0.9908361243994386,249,173,3,425
24774,bright,main,20211211,7,0.9941692038890504,200,176,0,376
24774,bright,main,20211211,8,0.9961118525248027,230,189,3,422
24774,bright,main,20211211,9,0.9933071799740566,202,225,2,429
8814,dark,main,20211211,0,0.9966605942400683,309,13,56,378
8814,dark,main,20211211,1,0.9933910703564642,275,16,63,354
8814,dark,main,20211211,2,0.9955358496703204,321,13,51,385
8814,dark,main,20211211,3,0.9920980296175825,287,12,49,348
8814,dark,main,20211211,4,0.9891313460581558,265,12,67,344
8814,dark,main,20211211,5,0.9918094774051744,269,14,79,362
8814,dark,main,20211211,6,0.9966674664324129,268,22,90,380
8814,dark,main,20211211,7,0.9850309310976528,236,17,82,335
8814,dark,main,20211211,8,0.988187843866436,282,19,81,382
8814,dark,main,20211211,9,0.9871307017704645,309,14,63,386
7261,dark,main,20211211,0,0.994652595754499,295,22,76,393
7261,dark,main,20211211,1,0.995406515457911,252,24,77,353
7261,dark,main,20211211,2,0.9911986809820224,259,31,87,377
7261,dark,main,20211211,3,0.990779992359439,253,22,59,334
7261,dark,main,20211211,4,0.9940049584353289,263,23,55,341
7261,dark,main,20211211,5,0.9937625593728228,286,17,61,364
7261,dark,main,20211211,6,0.9860615833375412,281,28,76,385
7261,dark,main,20211211,7,0.9937845896415265,262,20,39,321
7261,dark,main,20211211,8,0.9867524978695771,285,18,57,360
7261,dark,main,20211211,9,0.9914850186435803,296,18,61,375
4450,dark,main,20211211,0,0.9914332799040688,272,28,72,372
4450,dark,main,20211211,1,0.9900627565136427,246,38,70,354
4450,dark,main,20211211,2,0.9899282006948676,255,28,88,371
4450,dark,main,20211211,3,0.9856449769254345,248,30,64,342
4450,dark,main,20211211,4,0.9824582492075165,183,29,68,280
4450,dark,main,20211211,5,0.9853684007278878,149,23,40,212
4450,dark,main,20211211,6,0.9917738957628482,251,30,85,366
4450,dark,main,20211211,7,0.9908560639223053,249,32,49,330
4450,dark,main,20211211,8,0.9945803987549136,251,33,83,367
4450,dark,main,20211211,9,0.9947464148797887,266,23,76,365
2445,dark,main,20211211,0,0.993631763261971,331,10,53,394
2445,dark,main,20211211,1,0.9970503048552398,315,13,36,364
2445,dark,main,20211211,2,0.9945574540948214,339,10,48,397
2445,dark,main,20211211,3,0.9902647096416181,311,13,32,356
2445,dark,main,20211211,4,0.9908791826937134,305,9,42,356
2445,dark,main,20211211,5,0.987853505377327,299,9,73,381
2445,dark,main,20211211,6,0.9907857045689545,313,12,66,391
2445,dark,main,20211211,7,0.9934646432312053,271,12,62,345
2445,dark,main,20211211,8,0.9892519386053292,297,14,74,385
2445,dark,main,20211211,9,0.9917338999280384,312,10,65,387
1262,dark,main,20211211,0,0.9879178977372589,280,15,108,403
1262,dark,main,20211211,1,0.9927819325319215,247,18,89,354
1262,dark,main,20211211,2,0.994137496224373,261,23,112,396
1262,dark,main,20211211,3,0.9937059583439833,257,17,80,354
1262,dark,main,20211211,4,0.9881623201719099,252,16,81,349
1262,dark,main,20211211,5,0.9913442023779965,279,14,88,381
1262,dark,main,20211211,6,0.9875919012031569,279,17,90,386
1262,dark,main,20211211,7,0.9885135790415851,241,15,76,332
1262,dark,main,20211211,8,0.9904868659822283,279,13,90,382
1262,dark,main,20211211,9,0.9788716583671621,271,14,85,370
7242,dark,main,20211211,0,0.9969350172461521,304,21,57,382
7242,dark,main,20211211,1,0.9895097507523659,288,14,45,347
7242,dark,main,20211211,2,0.985962982177472,321,13,41,375
7242,dark,main,20211211,3,0.9921959364479453,273,15,59,347
7242,dark,main,20211211,4,0.9842817506672483,263,12,71,346
7242,dark,main,20211211,5,0.9793109490802043,270,20,86,376
7242,dark,main,20211211,6,0.9938036811063657,277,20,86,383
7242,dark,main,20211211,7,0.9918632648581962,232,19,79,330
7242,dark,main,20211211,8,0.9905764075449386,302,15,46,363
7242,dark,main,20211211,9,0.9959609150792382,301,14,57,372
41977,backup,main,20211212,0,0.9953490841030701,1,446,0,447
41977,backup,main,20211212,1,0.9907634100789984,0,397,0,397
41977,backup,main,20211212,2,0.9915606801975652,3,442,0,445
41977,backup,main,20211212,3,0.9945470349407344,2,399,0,401
41977,backup,main,20211212,4,0.9947607493491781,1,400,0,401
41977,backup,main,20211212,5,0.9932203331790694,2,414,0,416
41977,backup,main,20211212,6,0.9952380056522847,5,430,0,435
41977,backup,main,20211212,7,0.9954363261114944,3,373,0,376
41977,backup,main,20211212,8,0.9922468921707,2,428,0,430
41977,backup,main,20211212,9,0.9919925211926153,0,434,0,434
7207,dark,main,20211212,0,0.9925580671248785,268,23,90,381
7207,dark,main,20211212,1,0.989064388596433,258,16,66,340
7207,dark,main,20211212,2,0.9937803151598902,344,11,48,403
7207,dark,main,20211212,3,0.9939764976893203,298,12,57,367
7207,dark,main,20211212,4,0.9961978762441025,275,15,46,336
7207,dark,main,20211212,5,0.9934264159917557,266,11,91,368
7207,dark,main,20211212,6,0.9946369900972218,261,18,105,384
7207,dark,main,20211212,7,0.9876422899510329,254,15,62,331
7207,dark,main,20211212,8,0.9969485059723132,277,17,83,377
7207,dark,main,20211212,9,0.9928130054988318,254,15,96,365
8621,dark,main,20211212,0,0.9911878494354833,332,16,49,397
8621,dark,main,20211212,1,0.9906573971749164,276,12,57,345
8621,dark,main,20211212,2,0.9942108399306973,291,17,69,377
8621,dark,main,20211212,3,0.9948262289101694,264,13,72,349
8621,dark,main,20211212,4,0.9862970592698974,253,17,81,351
8621,dark,main,20211212,5,0.9901906869663082,268,23,89,380
8621,dark,main,20211212,6,0.9918681565030275,265,14,103,382
8621,dark,main,20211212,7,0.9824281920105048,264,13,53,330
8621,dark,main,20211212,8,0.9910428326138241,316,12,46,374
8621,dark,main,20211212,9,0.9912907739064061,320,14,47,381
10376,dark,main,20211212,0,0.9942276386405831,319,10,64,393
10376,dark,main,20211212,1,0.9912557043896235,276,15,65,356
10376,dark,main,20211212,2,0.9924953359955888,310,12,61,383
10376,dark,main,20211212,3,0.9937909872112476,278,12,58,348
10376,dark,main,20211212,4,0.989492356315545,266,12,72,350
10376,dark,main,20211212,5,0.9932323356726602,260,15,82,357
10376,dark,main,20211212,6,0.996529607041059,274,12,84,370
10376,dark,main,20211212,7,0.9901753230039507,243,17,68,328
10376,dark,main,20211212,8,0.9965071979802091,251,15,103,369
10376,dark,main,20211212,9,0.9959068704514219,297,12,63,372
40726,backup,main,20211212,0,0.98983050097533,3,444,0,447
40726,backup,main,20211212,1,0.9924490148072808,6,394,0,400
40726,backup,main,20211212,2,0.9937611054754261,2,442,0,444
40726,backup,main,20211212,3,0.986728348940935,0,397,0,397
40726,backup,main,20211212,4,0.993457766442854,3,396,0,399
40726,backup,main,20211212,5,0.9970083766381151,8,408,0,416
40726,backup,main,20211212,6,0.995672228536691,5,427,0,432
40726,backup,main,20211212,7,0.9896226468534831,4,302,0,306
40726,backup,main,20211212,8,0.9937601340348355,4,422,0,426
40726,backup,main,20211212,9,0.9927137649622065,3,429,0,432
41973,backup,main,20211212,0,0.9965757365941426,1,448,0,449
41973,backup,main,20211212,1,0.9928022652662434,0,400,0,400
41973,backup,main,20211212,2,0.9942988228648952,2,441,1,444
41973,backup,main,20211212,3,0.9946272171956384,7,390,0,397
41973,backup,main,20211212,4,0.9940501384157693,2,399,0,401
41973,backup,main,20211212,5,0.9894870677420979,5,413,0,418
41973,backup,main,20211212,6,0.9889969457261515,3,431,0,434
41973,backup,main,20211212,7,0.9927574095906119,1,375,0,376
41973,backup,main,20211212,8,0.9955552431696629,4,425,0,429
41973,backup,main,20211212,9,0.9946041923452349,6,427,0,433
26075,bright,main,20211212,0,0.99111359567518,304,130,3,437
26075,bright,main,20211212,1,0.989797121218199,257,127,5,389
26075,bright,main,20211212,2,0.9912386217125935,325,107,5,437
26075,bright,main,20211212,3,0.9918172428861559,282,104,5,391
26075,bright,main,20211212,4,0.9938633144836867,296,92,3,391
26075,bright,main,20211212,5,0.9889609337196024,304,100,5,409
26075,bright,main,20211212,6,0.9958777436339482,310,111,5,426
26075,bright,main,20211212,7,0.9879025251103808,279,87,3,369
26075,bright,main,20211212,8,0.9933990264125926,319,101,3,423
26075,bright,main,20211212,9,0.9942724812062039,284,121,2,407
40715,backup,main,20211212,0,0.9943145046777184,1,444,0,445
40715,backup,main,20211212,1,0.993151376059778,0,398,0,398
40715,backup,main,20211212,2,0.9824653451836379,1,127,0,128
40715,backup,main,20211212,3,0.9903905839704084,5,396,0,401
40715,backup,main,20211212,4,0.9917026298521454,8,391,0,399
40715,backup,main,20211212,5,0.9928847969800988,6,411,0,417
40715,backup,main,20211212,6,0.9945023212013521,10,425,0,435
40715,backup,main,20211212,7,0.990098323684523,8,365,0,373
40715,backup,main,20211212,8,0.9930583631379768,4,426,0,430
40715,backup,main,20211212,9,0.9963550926395582,4,428,0,432
23406,bright,main,20211212,0,0.9875967005179485,297,89,10,396
23406,bright,main,20211212,1,0.9894570903546777,304,65,6,375
23406,bright,main,20211212,2,0.9956672799040949,322,71,2,395
23406,bright,main,20211212,3,0.9912699785626722,299,60,7,366
23406,bright,main,20211212,4,0.9923113308864636,311,60,5,376
23406,bright,main,20211212,5,0.9934637267743491,324,54,5,383
23406,bright,main,20211212,6,0.9902578389352807,330,61,10,401
23406,bright,main,20211212,7,0.992000390149096,245,98,4,347
23406,bright,main,20211212,8,0.9879477730695327,290,100,6,396
23406,bright,main,20211212,9,0.9834809983058214,271,107,7,385
5642,dark,main,20211212,0,0.9937013382462534,309,13,70,392
5642,dark,main,20211212,1,0.9917837570619719,253,14,76,343
5642,dark,main,20211212,2,0.9887989447955683,322,11,57,390
5642,dark,main,20211212,3,0.9936415245111686,290,13,54,357
5642,dark,main,20211212,4,0.9878771220963263,256,12,78,346
5642,dark,main,20211212,5,0.9872679725669419,268,17,77,362
5642,dark,main,20211212,6,0.9919209065305279,297,12,67,376
5642,dark,main,20211212,7,0.9861620295864494,259,12,58,329
5642,dark,main,20211212,8,0.9908715434005687,302,13,65,380
5642,dark,main,20211212,9,0.9937664343849996,286,16,73,375
24518,bright,main,20211212,0,0.9937742237272693,236,201,1,438
24518,bright,main,20211212,1,0.9947671133560635,223,169,2,394
24518,bright,main,20211212,2,0.9890517448158804,305,134,1,440
24518,bright,main,20211212,3,0.9907788270331669,296,97,3,396
24518,bright,main,20211212,4,0.9888353045932383,282,102,5,389
24518,bright,main,20211212,5,0.9958693815511568,273,134,3,410
24518,bright,main,20211212,6,0.9914620389568131,331,93,2,426
24518,bright,main,20211212,7,0.994848296777619,282,83,5,370
24518,bright,main,20211212,8,0.9901147231175594,295,123,3,421
24518,bright,main,20211212,9,0.991494630396878,263,166,1,430
41975,backup,main,20211212,0,0.9935733326893994,0,448,0,448
41975,backup,main,20211212,1,0.9924592068214266,1,398,0,399
41975,backup,main,20211212,2,0.9897955076430591,3,441,0,444
41975,backup,main,20211212,3,0.9943315338502379,5,394,0,399
41975,backup,main,20211212,4,0.9925050043270731,2,399,0,401
41975,backup,main,20211212,5,0.988393989496403,0,417,0,417
41975,backup,main,20211212,6,0.9955397342910456,3,432,0,435
41975,backup,main,20211212,7,0.9867379179821234,1,373,0,374
41975,backup,main,20211212,8,0.994505154573873,1,428,1,430
41975,backup,main,20211212,9,0.991233739167703,0,431,1,432
40717,backup,main,20211212,0,0.995897396947502,34,413,0,447
40717,backup,main,20211212,1,0.991828895276654,37,360,0,397
40717,backup,main,20211212,2,0.989289458848471,61,384,0,445
40717,backup,main,20211212,3,0.993157538523129,57,341,0,398
40717,backup,main,20211212,4,0.9856828418151314,57,343,0,400
40717,backup,main,20211212,5,0.9911189828529268,48,368,0,416
40717,backup,main,20211212,6,0.9957510158397859,33,400,0,433
40717,backup,main,20211212,7,0.9908437277932494,37,338,0,375
40717,backup,main,20211212,8,0.9942701421441987,46,384,0,430
40717,backup,main,20211212,9,0.9831863477350662,35,393,0,428
21386,bright,main,20211212,0,0.9848407154143621,347,88,2,437
21386,bright,main,20211212,1,0.988131660739759,302,87,5,394
21386,bright,main,20211212,2,0.9933664597916815,357,78,4,439
21386,bright,main,20211212,3,0.9914796278521142,264,131,3,398
21386,bright,main,20211212,4,0.9941046644680605,267,123,2,392
21386,bright,main,20211212,5,0.9896354717540635,231,182,5,418
21386,bright,main,20211212,6,0.9941793332555732,299,124,3,426
21386,bright,main,20211212,7,0.9924617182640431,255,117,1,373
21386,bright,main,20211212,8,0.9899988283969153,258,166,5,429
21386,bright,main,20211212,9,0.9920771538120111,357,71,3,431
2526,dark,main,20211212,0,0.9945715610970176,327,13,48,388
2526,dark,main,20211212,1,0.987825833208517,276,13,46,335
2526,dark,main,20211212,2,0.9896180908618272,312,15,50,377
2526,dark,main,20211212,3,0.9961388770198187,302,17,32,351
2526,dark,main,20211212,4,0.9834773630432362,275,17,52,344
2526,dark,main,20211212,5,0.9880834836971869,290,11,64,365
2526,dark,main,20211212,6,0.990477418071035,302,15,53,370
2526,dark,main,20211212,7,0.9967923371962587,262,10,59,331
2526,dark,main,20211212,8,0.9954627672820435,305,14,56,375
2526,dark,main,20211212,9,0.9951182632020125,298,17,56,371
23414,bright,main,20211212,0,0.9904042571476919,392,36,2,430
23414,bright,main,20211212,1,0.9942708805623648,329,52,1,382
23414,bright,main,20211212,2,0.9950087903598663,366,58,3,427
23414,bright,main,20211212,3,0.9900495942037618,313,65,4,382
23414,bright,main,20211212,4,0.9887812061091609,320,61,2,383
23414,bright,main,20211212,5,0.9926676914558442,316,72,5,393
23414,bright,main,20211212,6,0.9883607310347718,360,63,3,426
23414,bright,main,20211212,7,0.9899876527573844,317,44,2,363
23414,bright,main,20211212,8,0.9941910136475397,353,53,3,409
23414,bright,main,20211212,9,0.9892700509577761,371,43,3,417
22541,bright,main,20211212,0,0.9967453958291718,361,77,1,439
22541,bright,main,20211212,1,0.9936413096527652,300,88,5,393
22541,bright,main,20211212,2,0.9928266259582837,372,63,7,442
22541,bright,main,20211212,3,0.9901727008357424,329,68,5,402
22541,bright,main,20211212,4,0.9850658927390306,294,96,4,394
22541,bright,main,20211212,5,0.9932492401247424,347,68,3,418
22541,bright,main,20211212,6,0.990289922311219,359,71,0,430
22541,bright,main,20211212,7,0.996588188342894,298,68,4,370
22541,bright,main,20211212,8,0.990070798839608,327,92,4,423
22541,bright,main,20211212,9,0.9907702821181896,352,67,3,422
10380,dark,main,20211212,0,0.9965189090962432,284,16,100,400
10380,dark,main,20211212,1,0.9889782412651651,224,17,101,342
10380,dark,main,20211212,2,0.9934526896540546,289,16,82,387
10380,dark,main,20211212,3,0.9842324980387674,271,16,72,359
10380,dark,main,20211212,4,0.990431463700028,284,17,55,356
10380,dark,main,20211212,5,0.9946549272680036,300,11,57,368
10380,dark,main,20211212,6,0.9956399700057728,304,22,63,389
10380,dark,main,20211212,7,0.9886841364052648,260,16,60,336
10380,dark,main,20211212,8,0.9910038647298387,285,18,69,372
10380,dark,main,20211212,9,0.9936796486552695,278,15,91,384
2842,dark,main,20211212,0,0.9915057047020699,258,13,93,364
2842,dark,main,20211212,1,0.9888788796669602,211,12,87,310
2842,dark,main,20211212,2,0.9889649599704098,262,16,84,362
2842,dark,main,20211212,3,0.9881242993095737,226,14,82,322
2842,dark,main,20211212,4,0.9872674589530868,228,13,71,312
2842,dark,main,20211212,5,0.9909928249748267,233,13,98,344
2842,dark,main,20211212,6,0.9902448573800383,267,15,81,363
2842,dark,main,20211212,7,0.9925271874442411,220,19,76,315
2842,dark,main,20211212,8,0.9931212953766683,252,17,82,351
2842,dark,main,20211212,9,0.9825871225892641,253,14,75,342
41961,backup,main,20211212,0,0.9879306899874938,2,446,0,448
41961,backup,main,20211212,1,0.9914274659826391,0,398,0,398
41961,backup,main,20211212,2,0.9944768363261417,4,437,1,442
41961,backup,main,20211212,3,0.9924015479562718,4,395,0,399
41961,backup,main,20211212,4,0.9935441507604137,4,395,0,399
41961,backup,main,20211212,5,0.9914758146803874,6,409,0,415
41961,backup,main,20211212,6,0.9916044784019193,1,433,1,435
41961,backup,main,20211212,7,0.9829942921936707,2,371,1,374
41961,backup,main,20211212,8,0.9923901854699767,0,429,1,430
41961,backup,main,20211212,9,0.9974378146219682,5,424,0,429
24567,bright,main,20211212,0,0.9914253912134929,223,191,9,423
24567,bright,main,20211212,1,0.9915549595068796,250,132,2,384
24567,bright,main,20211212,2,0.9933737578216724,241,178,3,422
24567,bright,main,20211212,3,0.9915315302196813,240,141,3,384
24567,bright,main,20211212,4,0.9954489968591487,218,161,6,385
24567,bright,main,20211212,5,0.9900306718735837,249,150,3,402
24567,bright,main,20211212,6,0.98595258293598,266,140,8,414
24567,bright,main,20211212,7,0.9892932400631692,204,149,7,360
24567,bright,main,20211212,8,0.9928058747999342,236,169,4,409
24567,bright,main,20211212,9,0.9931023463601855,247,157,7,411
40718,backup,main,20211212,0,0.9925636052850422,2,446,0,448
40718,backup,main,20211212,1,0.9902107099771038,1,398,0,399
40718,backup,main,20211212,2,0.9911969512708845,2,442,0,444
40718,backup,main,20211212,3,0.9929775351032157,9,391,0,400
40718,backup,main,20211212,4,0.9921531691402481,4,397,0,401
40718,backup,main,20211212,5,0.9914908290941923,11,406,0,417
40718,backup,main,20211212,6,0.9976757196675518,16,418,0,434
40718,backup,main,20211212,7,0.9771802483554067,3,373,0,376
40718,backup,main,20211212,8,0.9934393389976298,5,425,0,430
40718,backup,main,20211212,9,0.9941576728704596,4,429,0,433
41949,backup,main,20211212,0,0.9964112657212595,1,448,0,449
41949,backup,main,20211212,1,0.9917421288861633,2,397,0,399
41949,backup,main,20211212,2,0.9908647692500883,3,442,0,445
41949,backup,main,20211212,3,0.9906642741274427,5,392,0,397
41949,backup,main,20211212,4,0.997245424971469,5,396,0,401
41949,backup,main,20211212,5,0.9875500319433508,5,411,0,416
41949,backup,main,20211212,6,0.9936989372014872,7,426,0,433
41949,backup,main,20211212,7,0.9942980132940827,1,371,0,372
41949,backup,main,20211212,8,0.9897186909072633,4,424,0,428
41949,backup,main,20211212,9,0.9909749047523876,3,429,0,432
2840,dark,main,20211212,0,0.991487388742534,284,16,70,370
2840,dark,main,20211212,1,0.9901074283409813,282,13,50,345
2840,dark,main,20211212,2,0.9904036093711804,307,17,59,383
2840,dark,main,20211212,3,0.9907306636938901,275,14,65,354
2840,dark,main,20211212,4,0.9940214370183149,244,15,81,340
2840,dark,main,20211212,5,0.9933618120435613,273,16,71,360
2840,dark,main,20211212,6,0.9907016150095883,279,17,82,378
2840,dark,main,20211212,7,0.9896296629920358,230,16,72,318
2840,dark,main,20211212,8,0.9931823079947576,276,16,81,373
2840,dark,main,20211212,9,0.9907003676231183,290,14,69,373
25266,bright,main,20211212,0,0.9932345716027886,337,102,4,443
25266,bright,main,20211212,1,0.9946543152275863,316,76,3,395
25266,bright,main,20211212,2,0.9953995614664335,354,81,3,438
25266,bright,main,20211212,3,0.990662673284533,306,95,0,401
25266,bright,main,20211212,4,0.9923020890063623,281,112,4,397
25266,bright,main,20211212,5,0.9924655696310176,293,114,7,414
25266,bright,main,20211212,6,0.9933418668269112,326,101,2,429
25266,bright,main,20211212,7,0.9954247910349021,293,78,2,373
25266,bright,main,20211212,8,0.9908642027441886,309,114,7,430
25266,bright,main,20211212,9,0.9871212593926245,324,100,3,427
26052,bright,main,20211215,0,0.9899161158623596,194,242,5,441
26052,bright,main,20211215,1,0.9933036798685364,230,170,3,403
26052,bright,main,20211215,2,0.9903833553149833,284,140,10,434
26052,bright,main,20211215,3,0.9876468031848421,290,95,5,390
26052,bright,main,20211215,4,0.9921190090947647,313,68,4,385
26052,bright,main,20211215,5,0.994060655934717,235,175,3,413
26052,bright,main,20211215,6,0.9859934219009745,208,152,6,366
26052,bright,main,20211215,7,0.9952025616049593,245,125,3,373
26052,bright,main,20211215,8,0.9878057777506306,287,124,5,416
26052,bright,main,20211215,9,0.9944687156987515,270,160,2,432
23101,bright,main,20211215,0,0.9932454305448172,281,158,3,442
23101,bright,main,20211215,1,0.988692854095266,294,107,4,405
23101,bright,main,20211215,2,0.9941240478381886,289,147,4,440
23101,bright,main,20211215,3,0.9925721312785915,301,90,5,396
23101,bright,main,20211215,4,0.9935532081220435,280,107,2,389
23101,bright,main,20211215,5,0.9919127605410228,327,86,3,416
23101,bright,main,20211215,6,0.9913671636447029,343,81,5,429
23101,bright,main,20211215,7,0.9949283233153599,271,101,4,376
23101,bright,main,20211215,8,0.9939093833569357,335,86,4,425
23101,bright,main,20211215,9,0.9903459352283089,332,101,2,435
26007,bright,main,20211215,0,0.9923945460672408,253,185,3,441
26007,bright,main,20211215,1,0.9855071507541614,228,168,5,401
26007,bright,main,20211215,2,0.9928403445912779,270,156,4,430
26007,bright,main,20211215,3,0.990185052572578,264,128,5,397
26007,bright,main,20211215,4,0.9862540425212877,259,133,4,396
26007,bright,main,20211215,5,0.99527003229767,320,88,2,410
26007,bright,main,20211215,6,0.9950446432313415,277,145,6,428
26007,bright,main,20211215,7,0.9911404853254174,236,134,4,374
26007,bright,main,20211215,8,0.9939622189076885,220,196,5,421
26007,bright,main,20211215,9,0.9902780949917136,242,191,2,435
24685,bright,main,20211215,0,0.9926894282633171,347,97,0,444
24685,bright,main,20211215,1,0.987050855757917,313,86,3,402
24685,bright,main,20211215,2,0.9939076486067316,327,104,2,433
24685,bright,main,20211215,3,0.993689216793492,270,128,1,399
24685,bright,main,20211215,4,0.9933622861788463,260,137,2,399
24685,bright,main,20211215,5,0.9862393168277577,330,83,5,418
24685,bright,main,20211215,6,0.9923858132817475,248,177,5,430
24685,bright,main,20211215,7,0.9930617351874464,247,123,6,376
24685,bright,main,20211215,8,0.9947133345733356,242,170,11,423
24685,bright,main,20211215,9,0.9940232222235086,286,143,3,432
23413,bright,main,20211215,0,0.9779478773351499,361,72,6,439
23413,bright,main,20211215,1,0.9936005505957971,304,89,5,398
23413,bright,main,20211215,2,0.9923245695411061,269,154,6,429
23413,bright,main,20211215,3,0.9881576075995468,304,92,2,398
23413,bright,main,20211215,4,0.986821253006629,290,90,7,387
23413,bright,main,20211215,5,0.996746616793755,343,64,3,410
23413,bright,main,20211215,6,0.9956172227714346,336,83,3,422
23413,bright,main,20211215,7,0.9938570285575885,267,102,3,372
23413,bright,main,20211215,8,0.9881153590096815,265,152,3,420
23413,bright,main,20211215,9,0.9922653194374222,282,137,0,419
9296,dark,main,20211215,0,0.9949681925482077,281,12,89,382
9296,dark,main,20211215,1,0.9879809138134626,264,15,75,354
9296,dark,main,20211215,2,0.9894805646799435,296,12,89,397
9296,dark,main,20211215,3,0.9872905774172366,282,10,58,350
9296,dark,main,20211215,4,0.9935078200733827,262,20,53,335
9296,dark,main,20211215,5,0.9874248564065708,288,15,68,371
9296,dark,main,20211215,6,0.9958082952026649,273,15,95,383
9296,dark,main,20211215,7,0.9888899488963215,238,13,81,332
9296,dark,main,20211215,8,0.9859969340229663,254,13,100,367
9296,dark,main,20211215,9,0.9838832924434047,292,14,86,392
25648,bright,main,20211215,0,0.9944614306450209,306,125,5,436
25648,bright,main,20211215,1,0.9900062239999514,254,146,1,401
25648,bright,main,20211215,2,0.9910477161337938,293,132,4,429
25648,bright,main,20211215,3,0.9855253602076232,262,137,1,400
25648,bright,main,20211215,4,0.9896281117814376,247,144,5,396
25648,bright,main,20211215,5,0.9884327332928221,269,142,4,415
25648,bright,main,20211215,6,0.9949057248543142,262,166,5,433
25648,bright,main,20211215,7,0.987196704197909,233,129,7,369
25648,bright,main,20211215,8,0.9927868818079407,268,148,6,422
25648,bright,main,20211215,9,0.9954204388338618,292,135,5,432
23682,bright,main,20211215,0,0.993335575084644,342,73,7,422
23682,bright,main,20211215,1,0.9845200113767231,295,79,5,379
23682,bright,main,20211215,2,0.9892373337797343,312,82,5,399
23682,bright,main,20211215,3,0.9939094269528257,288,86,6,380
23682,bright,main,20211215,4,0.993065168410242,273,88,9,370
23682,bright,main,20211215,5,0.9889597516662383,292,86,2,380
23682,bright,main,20211215,6,0.9954290924547871,277,106,9,392
23682,bright,main,20211215,7,0.9922380091269705,274,75,7,356
23682,bright,main,20211215,8,0.9931259432377322,296,90,5,391
23682,bright,main,20211215,9,0.9946170671251013,353,60,6,419
7733,dark,main,20211215,0,0.9863366940313465,282,19,95,396
7733,dark,main,20211215,1,0.9904946314071734,253,18,77,348
7733,dark,main,20211215,2,0.9909818943560629,266,18,99,383
7733,dark,main,20211215,3,0.9905329646536397,240,19,79,338
7733,dark,main,20211215,4,0.9797965106100494,242,15,85,342
7733,dark,main,20211215,5,0.99290155875955,244,19,93,356
7733,dark,main,20211215,6,0.9933042875128076,261,14,94,369
7733,dark,main,20211215,7,0.9892035201509324,238,16,69,323
7733,dark,main,20211215,8,0.9903413254388618,273,16,83,372
7733,dark,main,20211215,9,0.9943746121667669,267,13,95,375
7697,dark,main,20211215,0,0.9880175175652756,290,14,83,387
7697,dark,main,20211215,1,0.985170413239991,267,15,78,360
7697,dark,main,20211215,2,0.996663935245661,289,19,94,402
7697,dark,main,20211215,3,0.994458243858831,257,15,83,355
7697,dark,main,20211215,4,0.9911604246046168,249,12,97,358
7697,dark,main,20211215,5,0.99135733259077,275,16,71,362
7697,dark,main,20211215,6,0.993897757003205,274,18,94,386
7697,dark,main,20211215,7,0.9908440914551669,231,18,87,336
7697,dark,main,20211215,8,0.9943836947796076,253,18,98,369
7697,dark,main,20211215,9,0.9889934091144301,263,17,91,371
24689,bright,main,20211215,0,0.9904258136538318,327,108,7,442
24689,bright,main,20211215,1,0.9887522409444244,250,139,4,393
24689,bright,main,20211215,2,0.9927971181626253,267,165,5,437
24689,bright,main,20211215,3,0.9922867866852938,272,117,5,394
24689,bright,main,20211215,4,0.9956959540325896,289,105,4,398
24689,bright,main,20211215,5,0.9917537502548823,318,96,1,415
24689,bright,main,20211215,6,0.9962500455563251,308,116,3,427
24689,bright,main,20211215,7,0.9919924172058787,287,79,6,372
24689,bright,main,20211215,8,0.9930952968457007,323,95,4,422
24689,bright,main,20211215,9,0.9964328589624137,345,83,2,430
4137,dark,main,20211215,0,0.9873105077527389,303,12,76,391
4137,dark,main,20211215,1,0.9929734938298742,264,16,84,364
4137,dark,main,20211215,2,0.9924048050539073,290,12,94,396
4137,dark,main,20211215,3,0.9872333803737235,252,18,96,366
4137,dark,main,20211215,4,0.991578626670689,265,14,71,350
4137,dark,main,20211215,5,0.9964026718020658,262,13,97,372
4137,dark,main,20211215,6,0.9910407376463474,285,18,85,388
4137,dark,main,20211215,7,0.9861456322783576,219,23,86,328
4137,dark,main,20211215,8,0.995415558579005,275,17,83,375
4137,dark,main,20211215,9,0.9942851010973932,287,12,91,390
10851,dark,main,20211215,0,0.9898759814217207,276,14,107,397
10851,dark,main,20211215,1,0.9820575072898148,233,21,91,345
10851,dark,main,20211215,2,0.9955793407056509,263,21,101,385
10851,dark,main,20211215,3,0.9895419115418366,257,19,86,362
10851,dark,main,20211215,4,0.9867934707367283,254,15,93,362
10851,dark,main,20211215,5,0.9956476912654938,290,18,67,375
10851,dark,main,20211215,6,0.9864828510320078,290,18,84,392
10851,dark,main,20211215,7,0.9904941377841754,228,18,87,333
10851,dark,main,20211215,8,0.9944266696886506,267,14,105,386
10851,dark,main,20211215,9,0.996427969930739,282,19,83,384
7210,dark,main,20211215,0,0.9858173944684566,288,14,67,369
7210,dark,main,20211215,1,0.9898785244157475,281,11,58,350
7210,dark,main,20211215,2,0.9936564204861458,312,13,70,395
7210,dark,main,20211215,3,0.9865610030688226,294,11,63,368
7210,dark,main,20211215,4,0.9864561696356887,265,16,78,359
7210,dark,main,20211215,5,0.9855934675702963,270,12,92,374
7210,dark,main,20211215,6,0.9924329885829036,254,30,63,347
7210,dark,main,20211215,7,0.9933026253447546,236,26,58,320
7210,dark,main,20211215,8,0.9916029648732064,279,14,86,379
7210,dark,main,20211215,9,0.9911107575367458,283,15,69,367
24684,bright,main,20211215,0,0.9961623394722902,310,123,4,437
24684,bright,main,20211215,1,0.993249033287195,277,125,4,406
24684,bright,main,20211215,2,0.9915620433217527,302,132,6,440
24684,bright,main,20211215,3,0.9929032175406654,305,90,3,398
24684,bright,main,20211215,4,0.9915210451617162,296,95,5,396
24684,bright,main,20211215,5,0.9924945393608092,285,132,3,420
24684,bright,main,20211215,6,0.9925327403992539,253,167,7,427
24684,bright,main,20211215,7,0.9942358772431379,217,157,1,375
24684,bright,main,20211215,8,0.9944413594633005,265,160,2,427
24684,bright,main,20211215,9,0.9949692585479918,354,78,3,435
20135,bright,main,20211215,0,0.9888566325772201,360,49,6,415
20135,bright,main,20211215,1,0.9939529090758883,314,54,5,373
20135,bright,main,20211215,2,0.9909849121418594,332,70,5,407
20135,bright,main,20211215,3,0.9924389915087448,315,61,5,381
20135,bright,main,20211215,4,0.9930566825447459,313,55,5,373
20135,bright,main,20211215,5,0.9944915064692688,338,59,4,401
20135,bright,main,20211215,6,0.9958636910535423,367,47,2,416
20135,bright,main,20211215,7,0.9800758323576305,294,58,3,355
20135,bright,main,20211215,8,0.9942010768128913,324,73,2,399
20135,bright,main,20211215,9,0.9884564072181445,346,62,6,414
23709,bright,main,20211215,0,0.9903661129283461,312,98,8,418
23709,bright,main,20211215,1,0.9915215561448596,217,145,2,364
23709,bright,main,20211215,2,0.9927010978629959,274,162,0,436
23709,bright,main,20211215,3,0.99404869018677,244,155,5,404
23709,bright,main,20211215,4,0.994026369223107,259,89,1,349
23709,bright,main,20211215,5,0.9944467286559507,341,66,4,411
23709,bright,main,20211215,6,0.9909499992124293,313,116,2,431
23709,bright,main,20211215,7,0.9916919884257217,253,119,5,377
23709,bright,main,20211215,8,0.9966583465039067,297,130,1,428
23709,bright,main,20211215,9,0.9961564143872058,329,100,4,433
21061,bright,main,20211215,0,0.9942022889481558,336,80,9,425
21061,bright,main,20211215,1,0.9961841789944059,313,68,5,386
21061,bright,main,20211215,2,0.9932213064828087,346,69,8,423
21061,bright,main,20211215,3,0.9920865140573526,310,67,4,381
21061,bright,main,20211215,4,0.9922195292404091,298,64,10,372
21061,bright,main,20211215,5,0.9920644444902034,279,105,10,394
21061,bright,main,20211215,6,0.9965056525742577,289,125,4,418
21061,bright,main,20211215,7,0.9908504018459774,204,139,6,349
21061,bright,main,20211215,8,0.9938150017311927,284,114,6,404
21061,bright,main,20211215,9,0.9931100570101971,361,50,4,415
24661,bright,main,20211215,0,0.9968930658583888,357,81,2,440
24661,bright,main,20211215,1,0.9909392037890773,333,67,4,404
24661,bright,main,20211215,2,0.9943342645539488,354,84,4,442
24661,bright,main,20211215,3,0.9951059823425485,327,59,10,396
24661,bright,main,20211215,4,0.9927152206944367,290,107,4,401
24661,bright,main,20211215,5,0.9873886169209216,319,88,6,413
24661,bright,main,20211215,6,0.9933862405364607,340,87,1,428
24661,bright,main,20211215,7,0.986945204937618,271,96,7,374
24661,bright,main,20211215,8,0.9967653033590791,321,102,4,427
24661,bright,main,20211215,9,0.9867505945854801,350,82,1,433
22928,bright,main,20211215,0,0.9884250983490801,339,86,6,431
22928,bright,main,20211215,1,0.991163898851013,319,74,8,401
22928,bright,main,20211215,2,0.9939050221272153,315,106,3,424
22928,bright,main,20211215,3,0.9932215240783514,299,90,7,396
22928,bright,main,20211215,4,0.9930368248088128,326,80,3,409
22928,bright,main,20211215,5,0.9905918520091517,310,99,3,412
22928,bright,main,20211215,6,0.9913605599794876,337,85,3,425
22928,bright,main,20211215,7,0.9955728271419892,280,82,3,365
22928,bright,main,20211215,8,0.9938250285055392,322,86,2,410
22928,bright,main,20211215,9,0.988848471246715,340,78,5,423
7009,dark,main,20211215,0,0.9922270857668831,306,21,56,383
7009,dark,main,20211215,1,0.9904561761629338,254,16,43,313
7009,dark,main,20211215,2,0.9882114535444007,222,23,38,283
7009,dark,main,20211215,3,0.9846339319087885,281,12,45,338
7009,dark,main,20211215,4,0.9925362085444508,287,17,46,350
7009,dark,main,20211215,5,0.9916421715291656,278,13,69,360
7009,dark,main,20211215,6,0.984045390113152,292,18,55,365
7009,dark,main,20211215,7,0.9862552127312613,249,19,45,313
7009,dark,main,20211215,8,0.9902732547762528,276,17,45,338
7009,dark,main,20211215,9,0.9903646681283231,309,15,41,365
23286,bright,main,20211215,0,0.9923797004456265,359,56,4,419
23286,bright,main,20211215,1,0.9885981477356199,289,55,3,347
23286,bright,main,20211215,2,0.9844089940177635,164,40,2,206
23286,bright,main,20211215,3,0.9851093971865501,280,73,2,355
23286,bright,main,20211215,4,0.9887611255926642,325,56,4,385
23286,bright,main,20211215,5,0.9937283059875435,320,61,4,385
23286,bright,main,20211215,6,0.9960783295645236,351,57,8,416
23286,bright,main,20211215,7,0.9895614451188868,314,41,8,363
23286,bright,main,20211215,8,0.9935221010469425,351,50,3,404
23286,bright,main,20211215,9,0.9950697729104923,348,67,2,417
22788,bright,main,20211216,0,0.9899723989856114,280,146,5,431
22788,bright,main,20211216,1,0.9865407360597314,271,113,2,386
22788,bright,main,20211216,2,0.9872241959439577,275,140,2,417
22788,bright,main,20211216,3,0.9883488494211391,286,93,8,387
22788,bright,main,20211216,4,0.9892268053758663,255,128,2,385
22788,bright,main,20211216,5,0.9926414195035101,251,141,4,396
22788,bright,main,20211216,6,0.9894045372550316,225,181,5,411
22788,bright,main,20211216,7,0.9906208198549019,243,111,3,357
22788,bright,main,20211216,8,0.9922974823149675,317,92,4,413
22788,bright,main,20211216,9,0.9935701496104656,268,144,6,418
21371,bright,main,20211216,0,0.9915552422355265,362,71,5,438
21371,bright,main,20211216,1,0.9884786212863849,331,63,3,397
21371,bright,main,20211216,2,0.9911037188081209,366,63,4,433
21371,bright,main,20211216,3,0.9921492182388496,317,71,6,394
21371,bright,main,20211216,4,0.9893954301049441,267,121,4,392
21371,bright,main,20211216,5,0.9943695191735855,261,146,5,412
21371,bright,main,20211216,6,0.9821167596002264,240,186,5,431
21371,bright,main,20211216,7,0.9790899379265697,233,137,3,373
21371,bright,main,20211216,8,0.9901771025517782,346,73,5,424
21371,bright,main,20211216,9,0.9935406398493377,342,82,1,425
42977,backup,main,20211216,0,0.9949617384591102,26,418,0,444
42977,backup,main,20211216,1,0.9920705606325487,8,387,0,395
42977,backup,main,20211216,2,0.9955094163170061,10,432,0,442
42977,backup,main,20211216,3,0.9935005410545398,10,383,0,393
42977,backup,main,20211216,4,0.989174099896571,7,387,0,394
42977,backup,main,20211216,5,0.9855115054740569,8,406,0,414
42977,backup,main,20211216,6,0.9958872543882354,3,426,0,429
42977,backup,main,20211216,7,0.9922988212830313,5,364,0,369
42977,backup,main,20211216,8,0.9908080391659867,5,420,0,425
42977,backup,main,20211216,9,0.9925805848886989,23,406,0,429
22822,bright,main,20211216,0,0.9972553457770028,308,106,8,422
22822,bright,main,20211216,1,0.9947033239392649,288,91,1,380
22822,bright,main,20211216,2,0.9935984167663735,318,109,5,432
22822,bright,main,20211216,3,0.995525189687995,253,120,5,378
22822,bright,main,20211216,4,0.9922941212849714,268,103,6,377
22822,bright,main,20211216,5,0.9926684508305205,242,144,6,392
22822,bright,main,20211216,6,0.9931927247418062,258,143,6,407
22822,bright,main,20211216,7,0.9834208490240569,239,106,4,349
22822,bright,main,20211216,8,0.9915062584251852,310,88,6,404
22822,bright,main,20211216,9,0.9964531913147137,332,83,3,418
21520,bright,main,20211216,0,0.9935842350381348,262,157,9,428
21520,bright,main,20211216,1,0.9904985268872246,276,109,4,389
21520,bright,main,20211216,2,0.9934763777084316,312,112,6,430
21520,bright,main,20211216,3,0.9926400128925988,307,75,9,391
21520,bright,main,20211216,4,0.9925322133811783,275,101,1,377
21520,bright,main,20211216,5,0.9866623756995785,308,95,5,408
21520,bright,main,20211216,6,0.9959608806010847,313,104,3,420
21520,bright,main,20211216,7,0.9824684153796649,238,117,7,362
21520,bright,main,20211216,8,0.9925393232582966,255,157,2,414
21520,bright,main,20211216,9,0.9951488301944725,298,113,3,414
24871,bright,main,20211216,0,0.9946961710229584,358,58,5,421
24871,bright,main,20211216,1,0.985772624525107,330,47,4,381
24871,bright,main,20211216,2,0.9950940606055303,345,68,5,418
24871,bright,main,20211216,3,0.9811530082936909,306,66,7,379
24871,bright,main,20211216,4,0.9925040284606098,298,60,6,364
24871,bright,main,20211216,5,0.9908939334540809,313,64,8,385
24871,bright,main,20211216,6,0.9903268638843925,346,53,9,408
24871,bright,main,20211216,7,0.9886614013534254,293,51,4,348
24871,bright,main,20211216,8,0.9942262464837798,342,50,6,398
24871,bright,main,20211216,9,0.9895138732458915,347,50,5,402
21560,bright,main,20211216,0,0.9874435429247926,356,69,3,428
21560,bright,main,20211216,1,0.994083585667454,311,71,6,388
21560,bright,main,20211216,2,0.9907770610094052,338,91,2,431
21560,bright,main,20211216,3,0.9900665443598208,290,93,2,385
21560,bright,main,20211216,4,0.9911667875490199,297,80,4,381
21560,bright,main,20211216,5,0.9908860279371949,351,51,3,405
21560,bright,main,20211216,6,0.9895412898614824,352,63,0,415
21560,bright,main,20211216,7,0.9868496377269329,320,43,3,366
21560,bright,main,20211216,8,0.992551529779356,354,61,4,419
21560,bright,main,20211216,9,0.9920275342416524,316,96,6,418
23088,bright,main,20211216,0,0.9905003617765218,271,168,3,442
23088,bright,main,20211216,1,0.9953166960312425,281,101,6,388
23088,bright,main,20211216,2,0.9874815474338053,340,91,4,435
23088,bright,main,20211216,3,0.9913752046269835,259,127,1,387
23088,bright,main,20211216,4,0.9852632903152508,285,102,4,391
23088,bright,main,20211216,5,0.990808693282375,277,130,3,410
23088,bright,main,20211216,6,0.990297955327294,302,120,3,425
23088,bright,main,20211216,7,0.9922608077335144,280,79,5,364
23088,bright,main,20211216,8,0.9920319952374451,294,117,5,416
23088,bright,main,20211216,9,0.9949806583280585,286,131,4,421
25943,bright,main,20211216,0,0.9923370002552049,307,111,6,424
25943,bright,main,20211216,1,0.9923495368661829,239,141,4,384
25943,bright,main,20211216,2,0.991371891113598,277,131,5,413
25943,bright,main,20211216,3,0.9970534305732028,285,87,4,376
25943,bright,main,20211216,4,0.98414378258733,301,66,6,373
25943,bright,main,20211216,5,0.9921023825399645,300,92,7,399
25943,bright,main,20211216,6,0.996121688193664,267,59,2,328
25943,bright,main,20211216,7,0.989205709908953,294,57,6,357
25943,bright,main,20211216,8,0.9897284267374632,248,72,1,321
25943,bright,main,20211216,9,0.9948731134898029,295,101,4,400
21744,bright,main,20211216,0,0.9922863137584363,349,66,2,417
21744,bright,main,20211216,1,0.9936176610872526,308,69,4,381
21744,bright,main,20211216,2,0.9944519034741156,331,74,6,411
21744,bright,main,20211216,3,0.9895815480413237,277,76,3,356
21744,bright,main,20211216,4,0.9885803968168014,301,62,4,367
21744,bright,main,20211216,5,0.991375333244347,332,54,5,391
21744,bright,main,20211216,6,0.9938043773159752,343,53,2,398
21744,bright,main,20211216,7,0.9924657642097291,305,42,8,355
21744,bright,main,20211216,8,0.9802717804068204,328,64,5,397
21744,bright,main,20211216,9,0.9946328736086805,347,53,5,405
21757,bright,main,20211216,0,0.991047768963605,353,55,9,417
21757,bright,main,20211216,1,0.9854407051395258,326,42,5,373
21757,bright,main,20211216,2,0.9965198362647558,327,71,3,401
21757,bright,main,20211216,3,0.9941185379966082,336,41,2,379
21757,bright,main,20211216,4,0.9905263509292924,312,55,4,371
21757,bright,main,20211216,5,0.9931763534437373,312,67,6,385
21757,bright,main,20211216,6,0.9903623298499775,355,51,6,412
21757,bright,main,20211216,7,0.9917527960984488,323,33,4,360
21757,bright,main,20211216,8,0.9865412169600472,346,52,5,403
21757,bright,main,20211216,9,0.9944645015717457,334,55,5,394
26245,bright,main,20211217,0,0.9960847499130057,349,71,4,424
26245,bright,main,20211217,1,0.9926662908863557,290,78,3,371
26245,bright,main,20211217,2,0.9913536356281298,361,61,3,425
26245,bright,main,20211217,3,0.9921107440115192,289,96,1,386
26245,bright,main,20211217,4,0.9934017542525737,331,58,1,390
26245,bright,main,20211217,5,0.9928317513040997,344,53,6,403
26245,bright,main,20211217,6,0.9898069146398507,332,78,3,413
26245,bright,main,20211217,7,0.9912895094323748,272,87,1,360
26245,bright,main,20211217,8,0.9872694667548767,341,65,5,411
26245,bright,main,20211217,9,0.992319896731567,337,79,5,421
41296,backup,main,20211217,0,0.991085195654322,5,444,0,449
41296,backup,main,20211217,1,0.9913792805175557,1,399,0,400
41296,backup,main,20211217,2,0.990216651667719,15,430,0,445
41296,backup,main,20211217,3,0.9952529144554669,6,394,0,400
41296,backup,main,20211217,4,0.996777818500758,15,382,0,397
41296,backup,main,20211217,5,0.9892113708333344,6,411,0,417
41296,backup,main,20211217,6,0.9912882767974504,8,426,0,434
41296,backup,main,20211217,7,0.9894783298309616,4,371,0,375
41296,backup,main,20211217,8,0.9920083580016118,3,424,0,427
41296,backup,main,20211217,9,0.9984929662097665,0,431,0,431
42807,backup,main,20211217,0,0.9822727550617514,15,326,5,346
42807,backup,main,20211217,1,0.9864588000017697,5,283,1,289
42807,backup,main,20211217,2,0.9928125601465697,11,314,1,326
42807,backup,main,20211217,3,0.9834489330997982,13,299,0,312
42807,backup,main,20211217,4,0.9914845869514859,11,285,1,297
42807,backup,main,20211217,5,0.9880598080915944,10,312,3,325
42807,backup,main,20211217,6,0.9954779423967738,13,309,1,323
42807,backup,main,20211217,7,0.9894405073166591,9,271,0,280
42807,backup,main,20211217,8,0.9860294636593472,8,310,1,319
42807,backup,main,20211217,9,0.9920185417809622,8,304,2,314
41695,backup,main,20211217,0,0.9924380221898993,15,313,1,329
41695,backup,main,20211217,1,0.9923450457455224,5,298,3,306
41695,backup,main,20211217,2,0.9840228117325296,13,311,3,327
41695,backup,main,20211217,3,0.9898763148008575,9,303,2,314
41695,backup,main,20211217,4,0.9889169684170942,5,307,0,312
41695,backup,main,20211217,5,0.9905794960898301,10,299,0,309
41695,backup,main,20211217,6,0.9937675445481239,9,319,1,329
41695,backup,main,20211217,7,0.9912861441605723,10,281,1,292
41695,backup,main,20211217,8,0.9889670534679059,8,295,0,303
41695,backup,main,20211217,9,0.9899592421591734,12,322,2,336
41681,backup,main,20211217,0,0.9897872472824379,25,297,3,325
41681,backup,main,20211217,1,0.9887705804740393,12,279,3,294
41681,backup,main,20211217,2,0.9773327999322917,15,305,2,322
41681,backup,main,20211217,3,0.9941502120455461,25,281,2,308
41681,backup,main,20211217,4,0.9899618492926364,26,285,1,312
41681,backup,main,20211217,5,0.9881081369350176,17,302,0,319
41681,backup,main,20211217,6,0.9869762447045102,19,312,2,333
41681,backup,main,20211217,7,0.9922282292797252,30,266,0,296
41681,backup,main,20211217,8,0.9909222183710575,20,301,0,321
41681,backup,main,20211217,9,0.9913460422542005,14,295,2,311
42782,backup,main,20211217,0,0.9937070203978996,20,323,1,344
42782,backup,main,20211217,1,0.9948605368542798,11,299,0,310
42782,backup,main,20211217,2,0.9949198938650484,20,308,1,329
42782,backup,main,20211217,3,0.9791114203682059,16,298,2,316
42782,backup,main,20211217,4,0.9907720773914286,13,302,1,316
42782,backup,main,20211217,5,0.9932759345384409,11,295,1,307
42782,backup,main,20211217,6,0.9925890750538809,10,326,7,343
42782,backup,main,20211217,7,0.9888192451809049,8,273,3,284
42782,backup,main,20211217,8,0.9928369327883355,16,318,3,337
42782,backup,main,20211217,9,0.9918268336683103,20,327,1,348
24682,bright,main,20211217,0,0.9902777401166323,333,97,2,432
24682,bright,main,20211217,1,0.9879507562226473,337,50,3,390
24682,bright,main,20211217,2,0.9931230570960855,379,50,7,436
24682,bright,main,20211217,3,0.989594093458555,313,67,7,387
24682,bright,main,20211217,4,0.9894719274184877,349,29,3,381
24682,bright,main,20211217,5,0.9941038784718413,326,74,1,401
24682,bright,main,20211217,6,0.9944903419074785,313,99,2,414
24682,bright,main,20211217,7,0.9911498379581507,297,72,5,374
24682,bright,main,20211217,8,0.9933209693989876,333,82,3,418
24682,bright,main,20211217,9,0.9923718343296785,343,73,1,417
42259,backup,main,20211217,0,0.9933087098086575,6,342,2,350
42259,backup,main,20211217,1,0.9922553686770784,3,307,4,314
42259,backup,main,20211217,2,0.9904435495193796,4,353,3,360
42259,backup,main,20211217,3,0.9921370818274132,6,321,2,329
42259,backup,main,20211217,4,0.9850090916109582,6,335,0,341
42259,backup,main,20211217,5,0.9926933095329187,2,328,0,330
42259,backup,main,20211217,6,0.9918383756800951,2,345,0,347
42259,backup,main,20211217,7,0.9888201757588163,2,295,3,300
42259,backup,main,20211217,8,0.9942718523855055,3,323,0,326
42259,backup,main,20211217,9,0.991150801936034,3,333,1,337
41761,backup,main,20211217,0,0.9964732286301505,3,443,0,446
41761,backup,main,20211217,1,0.9948063288046296,10,391,0,401
41761,backup,main,20211217,2,0.9955916458307686,7,438,0,445
41761,backup,main,20211217,3,0.9898771165947597,5,395,0,400
41761,backup,main,20211217,4,0.9930679992613917,1,395,0,396
41761,backup,main,20211217,5,0.9970612858116659,5,413,0,418
41761,backup,main,20211217,6,0.9852564536729483,2,432,0,434
41761,backup,main,20211217,7,0.9916003245919839,5,369,0,374
41761,backup,main,20211217,8,0.9925465632002359,3,426,0,429
41761,backup,main,20211217,9,0.9949019668974562,2,430,0,432
42794,backup,main,20211217,0,0.9880408872175094,9,326,4,339
42794,backup,main,20211217,1,0.9932351090786584,13,298,2,313
42794,backup,main,20211217,2,0.9853060919723522,15,318,1,334
42794,backup,main,20211217,3,0.9929976738857681,16,280,0,296
42794,backup,main,20211217,4,0.9905826555558965,9,287,0,296
42794,backup,main,20211217,5,0.993917072682621,15,300,2,317
42794,backup,main,20211217,6,0.9895907851847693,27,312,0,339
42794,backup,main,20211217,7,0.9892073479835393,8,290,2,300
42794,backup,main,20211217,8,0.9886403913028298,12,326,1,339
42794,backup,main,20211217,9,0.9919629815777696,10,326,1,337
41754,backup,main,20211218,0,0.9928340005027102,1,446,0,447
41754,backup,main,20211218,1,0.9911361799908341,2,396,0,398
41754,backup,main,20211218,2,0.9898096911750308,3,441,0,444
41754,backup,main,20211218,3,0.9940529610982786,2,400,0,402
41754,backup,main,20211218,4,0.992873463082999,4,395,0,399
41754,backup,main,20211218,5,0.9901072428330832,4,416,0,420
41754,backup,main,20211218,6,0.9945537807608518,7,425,0,432
41754,backup,main,20211218,7,0.9859465297791806,7,365,0,372
41754,backup,main,20211218,8,0.9950630523794872,2,425,0,427
41754,backup,main,20211218,9,0.9840487654397089,2,419,0,421
23401,bright,main,20211218,0,0.9864855161840783,218,56,1,275
23401,bright,main,20211218,1,0.9863690445487705,286,58,0,344
23401,bright,main,20211218,2,0.9926364087632055,361,74,2,437
23401,bright,main,20211218,3,0.9904154903996526,302,72,4,378
23401,bright,main,20211218,4,0.9938103224877005,344,40,3,387
23401,bright,main,20211218,5,0.9957225145273432,324,69,4,397
23401,bright,main,20211218,6,0.9850653752502053,350,68,2,420
23401,bright,main,20211218,7,0.9918662508325956,286,76,2,364
23401,bright,main,20211218,8,0.9949092258343092,323,84,5,412
23401,bright,main,20211218,9,0.9825234249037943,257,75,3,335
42617,backup,main,20211218,0,0.9940679129786931,6,432,1,439
42617,backup,main,20211218,1,0.9918927858172636,7,381,0,388
42617,backup,main,20211218,2,0.9910109466947838,8,424,0,432
42617,backup,main,20211218,3,0.9932128279283968,5,383,1,389
42617,backup,main,20211218,4,0.9895715275134709,3,384,0,387
42617,backup,main,20211218,5,0.9912037971354973,7,395,0,402
42617,backup,main,20211218,6,0.99065877495191,4,410,0,414
42617,backup,main,20211218,7,0.9903846899684914,4,360,2,366
42617,backup,main,20211218,8,0.9920573651053659,7,410,0,417
42617,backup,main,20211218,9,0.9960237115947724,8,394,1,403
41721,backup,main,20211218,0,0.9803203943378971,8,328,0,336
41721,backup,main,20211218,1,0.99064627301132,7,311,1,319
41721,backup,main,20211218,2,0.9910318395922862,3,339,1,343
41721,backup,main,20211218,3,0.9839684947514318,7,304,0,311
41721,backup,main,20211218,4,0.9743009310368512,3,316,4,323
41721,backup,main,20211218,5,0.9948207640247849,1,333,0,334
41721,backup,main,20211218,6,0.9912754650316498,1,340,1,342
41721,backup,main,20211218,7,0.9884156934669996,3,296,2,301
41721,backup,main,20211218,8,0.9899895799929579,4,347,2,353
41721,backup,main,20211218,9,0.9915259940300132,5,335,7,347
41257,backup,main,20211218,0,0.9893603357271372,16,431,0,447
41257,backup,main,20211218,1,0.9944181163264701,11,386,0,397
41257,backup,main,20211218,2,0.9892251968266982,20,419,0,439
41257,backup,main,20211218,3,0.993411239398012,36,358,1,395
41257,backup,main,20211218,4,0.9923430671635493,53,343,0,396
41257,backup,main,20211218,5,0.9870160994892421,27,388,0,415
41257,backup,main,20211218,6,0.991604741868311,41,389,0,430
41257,backup,main,20211218,7,0.9925353907486368,45,325,1,371
41257,backup,main,20211218,8,0.9957513261314052,26,396,0,422
41257,backup,main,20211218,9,0.9894264075869057,28,389,0,417
25151,bright,main,20211218,0,0.9926661431777725,360,65,3,428
25151,bright,main,20211218,1,0.983322615853863,317,60,3,380
25151,bright,main,20211218,2,0.9930309175571527,349,64,5,418
25151,bright,main,20211218,3,0.9852305859455087,333,48,4,385
25151,bright,main,20211218,4,0.9960073917775313,299,67,4,370
25151,bright,main,20211218,5,0.9889681544297142,283,93,6,382
25151,bright,main,20211218,6,0.9947620785039927,298,91,1,390
25151,bright,main,20211218,7,0.9933387795122256,263,82,6,351
25151,bright,main,20211218,8,0.9887261967991402,307,86,5,398
25151,bright,main,20211218,9,0.9923831013627022,311,80,6,397
40422,backup,main,20211218,0,0.9858567298010404,6,335,1,342
40422,backup,main,20211218,1,0.9913926697410753,6,292,1,299
40422,backup,main,20211218,2,0.9927365177817803,7,335,1,343
40422,backup,main,20211218,3,0.9869255876583488,4,314,3,321
40422,backup,main,20211218,4,0.9935584896791791,4,316,2,322
40422,backup,main,20211218,5,0.9899273202797589,3,330,0,333
40422,backup,main,20211218,6,0.9944163660074782,4,337,3,344
40422,backup,main,20211218,7,0.9868776568301204,3,293,2,298
40422,backup,main,20211218,8,0.9927922788867445,7,305,3,315
40422,backup,main,20211218,9,0.9954241636839158,6,319,1,326
23415,bright,main,20211218,0,0.991516676001604,370,51,4,425
23415,bright,main,20211218,1,0.991144312413521,291,84,5,380
23415,bright,main,20211218,2,0.9924346730564795,311,104,5,420
23415,bright,main,20211218,3,0.9931772649033971,273,115,2,390
23415,bright,main,20211218,4,0.9882291529216505,285,90,6,381
23415,bright,main,20211218,5,0.9870278382026973,290,97,4,391
23415,bright,main,20211218,6,0.9929042931747752,337,73,2,412
23415,bright,main,20211218,7,0.9887675457814765,307,48,5,360
23415,bright,main,20211218,8,0.9946881539744375,350,54,5,409
23415,bright,main,20211218,9,0.9936682738200732,324,74,4,402
42759,backup,main,20211218,0,0.9848840370604304,16,358,1,375
42759,backup,main,20211218,1,0.9898866813943925,5,312,2,319
42759,backup,main,20211218,2,0.991806197008028,23,342,3,368
42759,backup,main,20211218,3,0.9931218762832369,15,306,3,324
42759,backup,main,20211218,4,0.9872203313905533,12,303,0,315
42759,backup,main,20211218,5,0.9806623417575421,19,315,1,335
42759,backup,main,20211218,6,0.9928792216435568,12,353,0,365
42759,backup,main,20211218,7,0.9917672204093178,13,283,2,298
42759,backup,main,20211218,8,0.9887824804090733,17,348,0,365
42759,backup,main,20211218,9,0.9841158721895449,14,332,1,347
23126,bright,main,20211218,0,0.9946258777168437,354,71,6,431
23126,bright,main,20211218,1,0.9948464915852248,280,92,1,373
23126,bright,main,20211218,2,0.9938829938774552,318,105,6,429
23126,bright,main,20211218,3,0.9944839772635667,272,102,3,377
23126,bright,main,20211218,4,0.9931726501251295,302,73,4,379
23126,bright,main,20211218,5,0.993978309485396,302,93,2,397
23126,bright,main,20211218,6,0.9940739643070237,351,65,4,420
23126,bright,main,20211218,7,0.9915530593201267,286,68,4,358
23126,bright,main,20211218,8,0.9904692917440566,332,66,10,408
23126,bright,main,20211218,9,0.9923045170071486,313,80,7,400
42873,backup,main,20211218,0,0.9935044794542404,40,349,4,393
42873,backup,main,20211218,1,0.9886316787308224,23,322,0,345
42873,backup,main,20211218,2,0.9890753092473412,25,364,1,390
42873,backup,main,20211218,3,0.9896406672285704,41,306,1,348
42873,backup,main,20211218,4,0.9869530138842426,20,332,1,353
42873,backup,main,20211218,5,0.9940936019812612,15,351,0,366
42873,backup,main,20211218,6,0.9911105589026031,16,361,3,380
42873,backup,main,20211218,7,0.9933324260512524,21,313,1,335
42873,backup,main,20211218,8,0.9925792774874157,33,349,0,382
42873,backup,main,20211218,9,0.9939615011005901,30,350,2,382
41680,backup,main,20211218,0,0.986128528282385,9,340,1,350
41680,backup,main,20211218,1,0.9906921112589056,11,301,2,314
41680,backup,main,20211218,2,0.9901864974370801,12,334,4,350
41680,backup,main,20211218,3,0.9929947012500323,15,295,0,310
41680,backup,main,20211218,4,0.983317981390778,11,293,2,306
41680,backup,main,20211218,5,0.99424327674067,10,334,1,345
41680,backup,main,20211218,6,0.9937313583582329,11,336,0,347
41680,backup,main,20211218,7,0.9798341460488078,7,282,2,291
41680,backup,main,20211218,8,0.9847641338567901,10,317,0,327
41680,backup,main,20211218,9,0.9857675242608218,8,319,2,329
42250,backup,main,20211218,0,0.9941810092587257,2,365,1,368
42250,backup,main,20211218,1,0.9918332605772404,3,325,1,329
42250,backup,main,20211218,2,0.9960516155282667,3,362,1,366
42250,backup,main,20211218,3,0.9885519838768174,2,322,1,325
42250,backup,main,20211218,4,0.9904428677246268,4,336,2,342
42250,backup,main,20211218,5,0.9931500206107091,1,325,0,326
42250,backup,main,20211218,6,0.9894422472091967,4,341,3,348
42250,backup,main,20211218,7,0.9892678628805582,2,304,0,306
42250,backup,main,20211218,8,0.9908640652000283,3,342,2,347
42250,backup,main,20211218,9,0.9848862038352386,1,348,0,349
41756,backup,main,20211218,0,0.9919617534339414,1,447,0,448
41756,backup,main,20211218,1,0.9928355474696544,4,396,0,400
41756,backup,main,20211218,2,0.9942395390056215,3,441,0,444
41756,backup,main,20211218,3,0.9919278340471607,5,391,0,396
41756,backup,main,20211218,4,0.9927752930070343,10,390,0,400
41756,backup,main,20211218,5,0.986501723503173,3,417,0,420
41756,backup,main,20211218,6,0.99568597184459,2,434,0,436
41756,backup,main,20211218,7,0.9915970740559975,3,376,0,379
41756,backup,main,20211218,8,0.9944038704891125,2,425,0,427
41756,backup,main,20211218,9,0.9958957029745912,3,431,0,434
25168,bright,main,20211218,0,0.9923989972304047,354,69,5,428
25168,bright,main,20211218,1,0.9960437976427844,284,87,8,379
25168,bright,main,20211218,2,0.9868107124752445,327,81,7,415
25168,bright,main,20211218,3,0.9926500331673614,320,57,6,383
25168,bright,main,20211218,4,0.9907770525936864,333,47,7,387
25168,bright,main,20211218,5,0.9905099228762426,312,76,7,395
25168,bright,main,20211218,6,0.9897364804907213,339,71,5,415
25168,bright,main,20211218,7,0.9910581999144867,270,75,7,352
25168,bright,main,20211218,8,0.9911686618629422,331,72,6,409
25168,bright,main,20211218,9,0.9941549145046256,327,63,10,400
42866,backup,main,20211218,0,0.993929301649928,43,375,0,418
42866,backup,main,20211218,1,0.9937449441524121,33,343,1,377
42866,backup,main,20211218,2,0.9914755017401818,25,386,0,411
42866,backup,main,20211218,3,0.9935533278538895,22,353,2,377
42866,backup,main,20211218,4,0.9873871809978796,17,355,0,372
42866,backup,main,20211218,5,0.9857523676342458,27,383,0,410
42866,backup,main,20211218,6,0.9952598465836776,22,401,0,423
42866,backup,main,20211218,7,0.9920746931970819,23,333,0,356
42866,backup,main,20211218,8,0.9877638185001234,26,386,0,412
42866,backup,main,20211218,9,0.9848676762604048,29,376,2,407
42757,backup,main,20211218,0,0.9948763029824929,16,368,2,386
42757,backup,main,20211218,1,0.9886331153390464,19,308,0,327
42757,backup,main,20211218,2,0.9879788218680297,13,356,1,370
42757,backup,main,20211218,3,0.9978129884113747,19,319,0,338
42757,backup,main,20211218,4,0.9911073501387198,12,329,1,342
42757,backup,main,20211218,5,0.9876190243312,20,326,0,346
42757,backup,main,20211218,6,0.9878295690280912,10,353,1,364
42757,backup,main,20211218,7,0.996419998692439,13,316,1,330
42757,backup,main,20211218,8,0.9911444003296294,15,347,2,364
42757,backup,main,20211218,9,0.9916661236473978,19,364,1,384
41771,backup,main,20211218,0,0.9961056349448407,6,440,0,446
41771,backup,main,20211218,1,0.9951825180866161,3,396,0,399
41771,backup,main,20211218,2,0.9888628968834936,3,442,0,445
41771,backup,main,20211218,3,0.9918921676290524,5,397,0,402
41771,backup,main,20211218,4,0.9888126828922403,2,397,0,399
41771,backup,main,20211218,5,0.9923555466697341,3,417,0,420
41771,backup,main,20211218,6,0.9956431193108376,1,434,0,435
41771,backup,main,20211218,7,0.9969831064071268,1,376,0,377
41771,backup,main,20211218,8,0.9879804278470384,0,426,0,426
41771,backup,main,20211218,9,0.9922119535046532,6,427,0,433
41726,backup,main,20211218,0,0.9932466943499092,1,347,2,350
41726,backup,main,20211218,1,0.9800230100779901,3,324,0,327
41726,backup,main,20211218,2,0.9948479588631206,3,359,0,362
41726,backup,main,20211218,3,0.987754925764205,4,343,1,348
41726,backup,main,20211218,4,0.9918931963508298,5,339,1,345
41726,backup,main,20211218,5,0.9900588130692749,2,340,3,345
41726,backup,main,20211218,6,0.992860480889887,5,355,0,360
41726,backup,main,20211218,7,0.9880663635296181,2,310,1,313
41726,backup,main,20211218,8,0.9922240229885677,4,338,2,344
41726,backup,main,20211218,9,0.9889836996513297,2,372,1,375
41678,backup,main,20211218,0,0.9908358871885606,5,358,0,363
41678,backup,main,20211218,1,0.9901029358077417,1,341,0,342
41678,backup,main,20211218,2,0.9914503953347509,3,344,1,348
41678,backup,main,20211218,3,0.9825304542684741,4,318,0,322
41678,backup,main,20211218,4,0.9912024039313331,6,328,1,335
41678,backup,main,20211218,5,0.9869617896043557,1,347,0,348
41678,backup,main,20211218,6,0.990564443827604,5,354,2,361
41678,backup,main,20211218,7,0.9888717445129539,1,297,3,301
41678,backup,main,20211218,8,0.9885973709558964,2,350,0,352
41678,backup,main,20211218,9,0.9895859801929956,5,353,2,360
24637,bright,main,20211218,0,0.9938193237289731,346,75,10,431
24637,bright,main,20211218,1,0.9960136538726859,288,86,5,379
24637,bright,main,20211218,2,0.9932114978453387,264,152,3,419
24637,bright,main,20211218,3,0.9941155657663246,312,68,7,387
24637,bright,main,20211218,4,0.9939216727078916,322,71,3,396
24637,bright,main,20211218,5,0.9927912531539604,338,59,3,400
24637,bright,main,20211218,6,0.9954203427554368,344,70,5,419
24637,bright,main,20211218,7,0.9858010106338333,294,64,3,361
24637,bright,main,20211218,8,0.9895302092785396,347,57,4,408
24637,bright,main,20211218,9,0.9935071970929834,348,58,4,410
20675,bright,main,20211219,0,0.9916303190963156,222,184,6,412
20675,bright,main,20211219,1,0.9875304908546428,238,130,5,373
20675,bright,main,20211219,2,0.9861147324563244,293,105,16,414
20675,bright,main,20211219,3,0.988754583816516,229,127,5,361
20675,bright,main,20211219,4,0.9960196135075425,235,137,3,375
20675,bright,main,20211219,5,0.9891990924544798,279,106,5,390
20675,bright,main,20211219,6,0.9882008219548527,313,86,5,404
20675,bright,main,20211219,7,0.9943118281969551,227,121,5,353
20675,bright,main,20211219,8,0.9891740853573667,215,175,8,398
20675,bright,main,20211219,9,0.9901448671116759,207,194,3,404
20701,bright,main,20211219,0,0.9912962966038724,318,95,4,417
20701,bright,main,20211219,1,0.993274005327645,299,76,5,380
20701,bright,main,20211219,2,0.9916230790897618,363,55,6,424
20701,bright,main,20211219,3,0.9917767345626104,275,88,4,367
20701,bright,main,20211219,4,0.9872876534649742,224,131,2,357
20701,bright,main,20211219,5,0.9924295893504912,245,132,8,385
20701,bright,main,20211219,6,0.9921752781538282,304,93,2,399
20701,bright,main,20211219,7,0.9954837072143395,268,79,7,354
20701,bright,main,20211219,8,0.9915166784441524,326,65,6,397
20701,bright,main,20211219,9,0.9893744794299204,308,91,4,403
21488,bright,main,20211219,0,0.9938899389549514,311,113,5,429
21488,bright,main,20211219,1,0.9917903079230315,293,76,6,375
21488,bright,main,20211219,2,0.9931703353222233,287,131,3,421
21488,bright,main,20211219,3,0.9930465340910751,268,117,3,388
21488,bright,main,20211219,4,0.9889139125188512,253,129,7,389
21488,bright,main,20211219,5,0.9938483944025072,287,106,12,405
21488,bright,main,20211219,6,0.9876793032571272,327,87,7,421
21488,bright,main,20211219,7,0.9924389735024631,310,49,1,360
21488,bright,main,20211219,8,0.9928991988656096,333,62,3,398
21488,bright,main,20211219,9,0.9939261049837105,321,81,7,409
24644,bright,main,20211219,0,0.9929554389426437,355,60,6,421
24644,bright,main,20211219,1,0.9906200634976963,301,73,6,380
24644,bright,main,20211219,2,0.9918957143469003,339,81,5,425
24644,bright,main,20211219,3,0.987821012787269,283,81,6,370
24644,bright,main,20211219,4,0.9939007310335451,300,74,6,380
24644,bright,main,20211219,5,0.9944687642390786,327,61,9,397
24644,bright,main,20211219,6,0.9864975759234221,347,57,8,412
24644,bright,main,20211219,7,0.9854190986822864,292,61,6,359
24644,bright,main,20211219,8,0.9968189174539238,337,65,5,407
24644,bright,main,20211219,9,0.9921856260824202,343,67,4,414
23417,bright,main,20211219,0,0.9947472273770648,348,83,4,435
23417,bright,main,20211219,1,0.9958362712556321,322,60,4,386
23417,bright,main,20211219,2,0.9950278840919224,352,67,3,422
23417,bright,main,20211219,3,0.9946813551200652,324,59,5,388
23417,bright,main,20211219,4,0.9885580492636538,319,63,3,385
23417,bright,main,20211219,5,0.9914316226512977,315,84,3,402
23417,bright,main,20211219,6,0.9952075996985427,348,68,2,418
23417,bright,main,20211219,7,0.9889219753933992,305,48,6,359
23417,bright,main,20211219,8,0.9943852248877393,326,76,7,409
23417,bright,main,20211219,9,0.9933320263513975,351,64,5,420
26248,bright,main,20211219,0,0.9908986056129215,380,50,3,433
26248,bright,main,20211219,1,0.9896956138566632,324,57,4,385
26248,bright,main,20211219,2,0.9942991618429292,372,53,6,431
26248,bright,main,20211219,3,0.9880818238392853,305,76,5,386
26248,bright,main,20211219,4,0.9900093422331288,326,54,1,381
26248,bright,main,20211219,5,0.9898534973940417,326,65,4,395
26248,bright,main,20211219,6,0.9914707052943819,336,71,4,411
26248,bright,main,20211219,7,0.9910209024521838,312,47,3,362
26248,bright,main,20211219,8,0.9897802192539831,356,48,5,409
26248,bright,main,20211219,9,0.996497014541432,356,62,2,420
24633,bright,main,20211219,0,0.994240508311,380,47,4,431
24633,bright,main,20211219,1,0.9949194636344099,324,54,1,379
24633,bright,main,20211219,2,0.9942013200420526,335,84,6,425
24633,bright,main,20211219,3,0.9933715012623786,316,63,6,385
24633,bright,main,20211219,4,0.9953011336716088,317,59,5,381
24633,bright,main,20211219,5,0.9935352395717989,315,77,6,398
24633,bright,main,20211219,6,0.9930034794229783,348,58,6,412
24633,bright,main,20211219,7,0.9923605799334367,291,69,5,365
24633,bright,main,20211219,8,0.9944850602828784,300,87,7,394
24633,bright,main,20211219,9,0.9966385529495999,307,83,5,395
23318,bright,main,20211219,0,0.9914782764903054,318,90,2,410
23318,bright,main,20211219,1,0.9931478960965594,252,111,6,369
23318,bright,main,20211219,2,0.9919928497233463,212,178,10,400
23318,bright,main,20211219,3,0.9915141247530671,266,106,4,376
23318,bright,main,20211219,4,0.9842567563480272,241,120,5,366
23318,bright,main,20211219,5,0.9873233541198566,264,131,2,397
23318,bright,main,20211219,6,0.9953756755628425,231,146,9,386
23318,bright,main,20211219,7,0.9911846919368306,257,93,3,353
23318,bright,main,20211219,8,0.9936111365249418,288,88,10,386
23318,bright,main,20211219,9,0.993450847604445,320,71,7,398
24168,bright,main,20211219,0,0.9931263060565246,289,118,8,415
24168,bright,main,20211219,1,0.9897004365427702,319,48,3,370
24168,bright,main,20211219,2,0.9933800050928723,352,58,4,414
24168,bright,main,20211219,3,0.9906052927548983,324,50,6,380
24168,bright,main,20211219,4,0.992338860181487,300,65,2,367
24168,bright,main,20211219,5,0.9865156131619524,261,115,10,386
24168,bright,main,20211219,6,0.9943066728252115,282,121,6,409
24168,bright,main,20211219,7,0.9941824626568602,266,81,3,350
24168,bright,main,20211219,8,0.9942298476348403,262,123,6,391
24168,bright,main,20211219,9,0.9929193695352544,304,99,4,407
20268,bright,main,20211219,0,0.9931176157382658,353,71,4,428
20268,bright,main,20211219,1,0.9905198711057304,276,84,3,363
20268,bright,main,20211219,2,0.992408459444965,362,62,4,428
20268,bright,main,20211219,3,0.9934111949253016,305,63,8,376
20268,bright,main,20211219,4,0.9923499091858805,298,69,2,369
20268,bright,main,20211219,5,0.9941134077229055,315,78,8,401
20268,bright,main,20211219,6,0.9954137471817459,312,89,7,408
20268,bright,main,20211219,7,0.9840684379520157,305,51,4,360
20268,bright,main,20211219,8,0.9916289574632051,321,78,6,405
20268,bright,main,20211219,9,0.9901327282753196,357,53,6,416
24173,bright,main,20211219,0,0.9941303158515451,319,102,0,421
24173,bright,main,20211219,1,0.9952168439856808,303,71,2,376
24173,bright,main,20211219,2,0.9911447258306122,351,67,5,423
24173,bright,main,20211219,3,0.9942802558707875,320,56,7,383
24173,bright,main,20211219,4,0.9920175451594978,239,122,6,367
24173,bright,main,20211219,5,0.9899287144460861,236,133,8,377
24173,bright,main,20211219,6,0.9959533565563412,276,124,10,410
24173,bright,main,20211219,7,0.9932805122006984,251,98,3,352
24173,bright,main,20211219,8,0.9909600130797334,330,65,3,398
24173,bright,main,20211219,9,0.9933626397550134,311,91,6,408
20707,bright,main,20211219,0,0.9955947124321944,264,144,8,416
20707,bright,main,20211219,1,0.9946108412973839,241,123,5,369
20707,bright,main,20211219,2,0.9918075356587187,363,54,7,424
20707,bright,main,20211219,3,0.9931963694129667,304,71,4,379
20707,bright,main,20211219,4,0.9908466847227575,287,68,6,361
20707,bright,main,20211219,5,0.9955440025016108,326,70,1,397
20707,bright,main,20211219,6,0.993871098617554,319,88,5,412
20707,bright,main,20211219,7,0.9875592251726741,252,105,3,360
20707,bright,main,20211219,8,0.9925298479998442,249,136,6,391
20707,bright,main,20211219,9,0.9873871401501323,270,129,6,405
25971,bright,main,20211219,0,0.9959623363497223,258,168,4,430
25971,bright,main,20211219,1,0.9916395020174068,182,198,2,382
25971,bright,main,20211219,2,0.9936395659644827,224,188,5,417
25971,bright,main,20211219,3,0.9926194416193975,246,125,6,377
25971,bright,main,20211219,4,0.9888473229612997,290,90,2,382
25971,bright,main,20211219,5,0.99189068383554,263,121,11,395
25971,bright,main,20211219,6,0.9916192587383127,226,181,8,415
25971,bright,main,20211219,7,0.9861182603499193,184,171,4,359
25971,bright,main,20211219,8,0.99623013190182,207,193,2,402
25971,bright,main,20211219,9,0.9894455911316592,257,153,6,416
23815,bright,main,20211219,0,0.9948096301759396,353,68,8,429
23815,bright,main,20211219,1,0.9939258296164686,314,61,4,379
23815,bright,main,20211219,2,0.9942935916056544,357,64,7,428
23815,bright,main,20211219,3,0.9960537990848255,303,79,3,385
23815,bright,main,20211219,4,0.9936409377538034,284,96,4,384
23815,bright,main,20211219,5,0.9946404702263348,281,112,4,397
23815,bright,main,20211219,6,0.9902832044424548,260,142,8,410
23815,bright,main,20211219,7,0.9948602977211953,257,91,3,351
23815,bright,main,20211219,8,0.990012433438246,321,78,2,401
23815,bright,main,20211219,9,0.9862121843426898,326,75,6,407
20668,bright,main,20211219,0,0.9937242496206717,278,121,6,405
20668,bright,main,20211219,1,0.9945793013140155,250,115,7,372
20668,bright,main,20211219,2,0.99406460454351,332,70,5,407
20668,bright,main,20211219,3,0.9881747766163576,295,77,6,378
20668,bright,main,20211219,4,0.9881093889673677,270,95,4,369
20668,bright,main,20211219,5,0.9920077606801176,282,109,6,397
20668,bright,main,20211219,6,0.9885357899321764,289,123,4,416
20668,bright,main,20211219,7,0.9952226312173331,263,94,8,365
20668,bright,main,20211219,8,0.9825532734556972,254,134,5,393
20668,bright,main,20211219,9,0.9963131276389742,268,127,6,401
24171,bright,main,20211219,0,0.9913641948565722,351,73,5,429
24171,bright,main,20211219,1,0.9948074378014043,290,80,5,375
24171,bright,main,20211219,2,0.9902836162234205,314,88,10,412
24171,bright,main,20211219,3,0.9941514714587103,319,61,4,384
24171,bright,main,20211219,4,0.9900530235383223,285,89,5,379
24171,bright,main,20211219,5,0.9963295655973008,302,83,1,386
24171,bright,main,20211219,6,0.9943633494380238,324,78,8,410
24171,bright,main,20211219,7,0.9886752929149264,295,52,2,349
24171,bright,main,20211219,8,0.9860160806730796,342,53,6,401
24171,bright,main,20211219,9,0.9916776287992836,334,66,5,405
24642,bright,main,20211219,0,0.9894029406317113,366,59,5,430
24642,bright,main,20211219,1,0.9899869528867625,307,73,3,383
24642,bright,main,20211219,2,0.9955499024262316,350,73,5,428
24642,bright,main,20211219,3,0.9893994216065818,316,65,3,384
24642,bright,main,20211219,4,0.9931267454086619,300,79,7,386
24642,bright,main,20211219,5,0.995760395809605,321,72,4,397
24642,bright,main,20211219,6,0.9819561460995792,350,63,3,416
24642,bright,main,20211219,7,0.9863435751259386,277,77,6,360
24642,bright,main,20211219,8,0.9928584685056352,315,80,4,399
24642,bright,main,20211219,9,0.9939790105668118,315,84,10,409
24640,bright,main,20211219,0,0.9949077408581355,320,108,4,432
24640,bright,main,20211219,1,0.9925810151764676,312,71,6,389
24640,bright,main,20211219,2,0.9912141478184633,368,55,8,431
24640,bright,main,20211219,3,0.9864652665970788,317,71,3,391
24640,bright,main,20211219,4,0.9883384846818367,326,54,5,385
24640,bright,main,20211219,5,0.9896861076012696,329,69,1,399
24640,bright,main,20211219,6,0.9966725079030999,368,52,7,427
24640,bright,main,20211219,7,0.9879863561122725,305,55,6,366
24640,bright,main,20211219,8,0.9924966042916744,333,73,3,409
24640,bright,main,20211219,9,0.9896576768402886,331,77,5,413
22571,bright,main,20211219,0,0.994947817758694,303,128,4,435
22571,bright,main,20211219,1,0.9917659406456707,277,96,2,375
22571,bright,main,20211219,2,0.991423311662986,344,88,4,436
22571,bright,main,20211219,3,0.9944215101988445,276,101,4,381
22571,bright,main,20211219,4,0.9957693262725144,283,99,5,387
22571,bright,main,20211219,5,0.9933549436858562,323,71,7,401
22571,bright,main,20211219,6,0.9935313265517137,359,62,3,424
22571,bright,main,20211219,7,0.9814432274245002,277,76,8,361
22571,bright,main,20211219,8,0.9921094505184075,348,70,0,418
22571,bright,main,20211219,9,0.9948204134191082,314,103,5,422
21840,bright,main,20211219,0,0.9940238598299127,355,79,3,437
21840,bright,main,20211219,1,0.9887192118134962,268,101,1,370
21840,bright,main,20211219,2,0.9938917563788442,309,114,5,428
21840,bright,main,20211219,3,0.9887000058895266,341,42,3,386
21840,bright,main,20211219,4,0.9891703485016959,315,66,1,382
21840,bright,main,20211219,5,0.9882029271620139,306,91,5,402
21840,bright,main,20211219,6,0.9898997533310447,319,94,4,417
21840,bright,main,20211219,7,0.9955647135221205,317,50,3,370
21840,bright,main,20211219,8,0.9945646270195849,333,77,4,414
21840,bright,main,20211219,9,0.9906632318036493,351,59,3,413
20264,bright,main,20211219,0,0.9904141840793295,356,63,11,430
20264,bright,main,20211219,1,0.9941579580902109,316,64,5,385
20264,bright,main,20211219,2,0.9942863719018727,305,111,5,421
20264,bright,main,20211219,3,0.9914321575563065,264,112,5,381
20264,bright,main,20211219,4,0.9925829526737318,273,106,4,383
20264,bright,main,20211219,5,0.9943004127017319,324,78,2,404
20264,bright,main,20211219,6,0.9941081963541939,365,55,7,427
20264,bright,main,20211219,7,0.9930081197778785,286,80,3,369
20264,bright,main,20211219,8,0.9942998980719263,332,76,7,415
20264,bright,main,20211219,9,0.9925316070667328,355,62,2,419
26147,bright,main,20211219,0,0.9952726891525495,356,73,6,435
26147,bright,main,20211219,1,0.9921009193266838,298,75,4,377
26147,bright,main,20211219,2,0.9866002928546694,318,98,7,423
26147,bright,main,20211219,3,0.9896805008117161,238,126,5,369
26147,bright,main,20211219,4,0.9965001622245461,206,169,1,376
26147,bright,main,20211219,5,0.9860758121372059,285,105,2,392
26147,bright,main,20211219,6,0.9918913619423492,290,121,8,419
26147,bright,main,20211219,7,0.9911716248593966,248,113,2,363
26147,bright,main,20211219,8,0.9921042076468994,297,106,3,406
26147,bright,main,20211219,9,0.9930468457842491,347,57,5,409
20669,bright,main,20211219,0,0.9939175030351096,293,126,5,424
20669,bright,main,20211219,1,0.9936429300250286,240,119,9,368
20669,bright,main,20211219,2,0.9926205218482905,309,99,4,412
20669,bright,main,20211219,3,0.9952030513588688,280,92,3,375
20669,bright,main,20211219,4,0.9912836523070562,272,102,4,378
20669,bright,main,20211219,5,0.992118542425926,264,116,8,388
20669,bright,main,20211219,6,0.994359823937379,304,101,6,411
20669,bright,main,20211219,7,0.9886775397074518,235,113,7,355
20669,bright,main,20211219,8,0.9919285127842713,298,103,2,403
20669,bright,main,20211219,9,0.9928117446851402,268,121,7,396
24634,bright,main,20211219,0,0.9943522440120965,347,82,3,432
24634,bright,main,20211219,1,0.9923391718924977,316,67,3,386
24634,bright,main,20211219,2,0.9929278739574978,353,68,0,421
24634,bright,main,20211219,3,0.9825801855518369,302,79,5,386
24634,bright,main,20211219,4,0.9932962250930405,321,60,4,385
24634,bright,main,20211219,5,0.9938866550111105,332,69,2,403
24634,bright,main,20211219,6,0.9907997600377172,308,97,5,410
24634,bright,main,20211219,7,0.9904328521047423,285,70,5,360
24634,bright,main,20211219,8,0.9965875005324989,338,69,5,412
24634,bright,main,20211219,9,0.9948136728170878,329,77,2,408
24185,bright,main,20211219,0,0.9933814865258261,332,72,5,409
24185,bright,main,20211219,1,0.9887718864115469,265,101,5,371
24185,bright,main,20211219,2,0.9919567714290723,275,134,4,413
24185,bright,main,20211219,3,0.9903595892197313,285,91,4,380
24185,bright,main,20211219,4,0.9929009739193403,301,67,9,377
24185,bright,main,20211219,5,0.9931435719427368,295,92,6,393
24185,bright,main,20211219,6,0.9918716409869485,300,107,10,417
24185,bright,main,20211219,7,0.9912334938400352,283,68,2,353
24185,bright,main,20211219,8,0.9898457984498599,319,85,3,407
24185,bright,main,20211219,9,0.995837783630667,302,88,12,402
20687,bright,main,20211219,0,0.9839931465142274,251,150,5,406
20687,bright,main,20211219,1,0.9878027192398622,243,127,3,373
20687,bright,main,20211219,2,0.9933090635007207,302,106,5,413
20687,bright,main,20211219,3,0.9922689049572702,274,96,6,376
20687,bright,main,20211219,4,0.9936445295521901,259,108,12,379
20687,bright,main,20211219,5,0.9907255961838718,317,86,4,407
20687,bright,main,20211219,6,0.9941686350314122,308,87,8,403
20687,bright,main,20211219,7,0.9920594160260763,282,72,2,356
20687,bright,main,20211219,8,0.9935944988990735,288,119,1,408
20687,bright,main,20211219,9,0.9936954860695092,273,138,4,415
22015,bright,main,20211219,0,0.9860567150523203,338,75,5,418
22015,bright,main,20211219,1,0.9957869128113896,289,80,7,376
22015,bright,main,20211219,2,0.9922880588545042,335,81,6,422
22015,bright,main,20211219,3,0.9951987724561686,282,94,6,382
22015,bright,main,20211219,4,0.9942143761052458,322,56,2,380
22015,bright,main,20211219,5,0.992140316109532,327,71,5,403
22015,bright,main,20211219,6,0.9945338686853127,293,98,7,398
22015,bright,main,20211219,7,0.9914458236687105,267,84,5,356
22015,bright,main,20211219,8,0.9931157797658604,291,111,2,404
22015,bright,main,20211219,9,0.989300477701437,311,86,5,402
22113,bright,main,20211220,0,0.9939644118210448,319,105,6,430
22113,bright,main,20211220,1,0.9823214241493446,342,50,2,394
22113,bright,main,20211220,2,0.9928045024392316,362,66,5,433
22113,bright,main,20211220,3,0.992610362013618,317,62,7,386
22113,bright,main,20211220,4,0.9876500508551641,322,55,4,381
22113,bright,main,20211220,5,0.9936680798705143,295,88,6,389
22113,bright,main,20211220,6,0.9904331080784267,332,74,5,411
22113,bright,main,20211220,7,0.9776496150669487,267,90,3,360
22113,bright,main,20211220,8,0.9950615810474015,268,116,10,394
22113,bright,main,20211220,9,0.9895624967384703,310,99,2,411
20700,bright,main,20211220,0,0.9876237173966675,340,80,5,425
20700,bright,main,20211220,1,0.9867849220794901,325,64,4,393
20700,bright,main,20211220,2,0.993491177466098,308,109,2,419
20700,bright,main,20211220,3,0.9939227549944262,238,141,3,382
20700,bright,main,20211220,4,0.9936785819761603,249,128,4,381
20700,bright,main,20211220,5,0.993223494355103,226,150,8,384
20700,bright,main,20211220,6,0.995188835147625,304,97,5,406
20700,bright,main,20211220,7,0.9935127277162371,250,107,4,361
20700,bright,main,20211220,8,0.9966971815390749,318,84,4,406
20700,bright,main,20211220,9,0.9925791110717914,287,123,3,413
20670,bright,main,20211220,0,0.9962895593214686,377,41,9,427
20670,bright,main,20211220,1,0.9953227684009767,332,45,9,386
20670,bright,main,20211220,2,0.9939308186872219,356,55,5,416
20670,bright,main,20211220,3,0.9934791236561992,319,59,5,383
20670,bright,main,20211220,4,0.9901226265870026,283,88,6,377
20670,bright,main,20211220,5,0.9920322751364088,289,97,5,391
20670,bright,main,20211220,6,0.9913306728442952,295,111,5,411
20670,bright,main,20211220,7,0.9897336606744298,314,48,3,365
20670,bright,main,20211220,8,0.9967755324964208,353,51,7,411
20670,bright,main,20211220,9,0.9909466896698098,347,65,7,419
41701,backup,main,20211220,0,0.9889592589773192,3,359,1,363
41701,backup,main,20211220,1,0.9913408144687125,2,335,0,337
41701,backup,main,20211220,2,0.9924010503433024,2,359,1,362
41701,backup,main,20211220,3,0.9912792013728293,5,334,0,339
41701,backup,main,20211220,4,0.9911646160695923,1,333,1,335
41701,backup,main,20211220,5,0.9885193721883908,4,349,0,353
41701,backup,main,20211220,6,0.9909321233762234,1,362,1,364
41701,backup,main,20211220,7,0.9881897900763246,4,306,1,311
41701,backup,main,20211220,8,0.993442605987242,1,352,1,354
41701,backup,main,20211220,9,0.9936222860875289,1,359,2,362
41687,backup,main,20211220,0,0.9905087237323825,12,343,1,356
41687,backup,main,20211220,1,0.9765357716256508,11,309,2,322
41687,backup,main,20211220,2,0.9899092905409391,9,351,1,361
41687,backup,main,20211220,3,0.9915998673217731,13,308,1,322
41687,backup,main,20211220,4,0.9870037241239256,7,322,1,330
41687,backup,main,20211220,5,0.9952146977962021,9,331,0,340
41687,backup,main,20211220,6,0.987780862340113,11,348,1,360
41687,backup,main,20211220,7,0.9934018221567349,15,292,2,309
41687,backup,main,20211220,8,0.995860347635164,17,326,1,344
41687,backup,main,20211220,9,0.9860765101194524,11,333,1,345
42260,backup,main,20211220,0,0.9911953763463738,15,345,1,361
42260,backup,main,20211220,1,0.990597316060224,9,322,1,332
42260,backup,main,20211220,2,0.9927477387601801,9,350,0,359
42260,backup,main,20211220,3,0.9892179471775521,12,295,0,307
42260,backup,main,20211220,4,0.9913635309795384,7,317,1,325
42260,backup,main,20211220,5,0.9876188389154651,8,307,1,316
42260,backup,main,20211220,6,0.9875404160633019,5,344,0,349
42260,backup,main,20211220,7,0.9957223528148036,12,283,2,297
42260,backup,main,20211220,8,0.9927734224534183,9,336,1,346
42260,backup,main,20211220,9,0.9919000525643141,10,340,2,352
21474,bright,main,20211220,0,0.988707164218147,330,88,5,423
21474,bright,main,20211220,1,0.9871696112035221,330,56,3,389
21474,bright,main,20211220,2,0.9935118857939228,313,93,5,411
21474,bright,main,20211220,3,0.9846772444234378,274,104,9,387
21474,bright,main,20211220,4,0.9859730239354233,241,140,2,383
21474,bright,main,20211220,5,0.9957699301629334,272,123,6,401
21474,bright,main,20211220,6,0.9927352542740149,293,125,5,423
21474,bright,main,20211220,7,0.9893249415019993,242,105,9,356
21474,bright,main,20211220,8,0.9966703514606091,302,101,6,409
21474,bright,main,20211220,9,0.9940404147172001,308,103,6,417
41719,backup,main,20211220,0,0.9920613244019303,9,344,0,353
41719,backup,main,20211220,1,0.9851017330785785,8,301,0,309
41719,backup,main,20211220,2,0.9911519983052749,10,343,1,354
41719,backup,main,20211220,3,0.9921234036302847,4,298,3,305
41719,backup,main,20211220,4,0.9877480762567045,9,304,1,314
41719,backup,main,20211220,5,0.9933364999673032,7,326,0,333
41719,backup,main,20211220,6,0.9938479474501688,5,329,0,334
41719,backup,main,20211220,7,0.990963012667272,7,285,1,293
41719,backup,main,20211220,8,0.9919714225509909,9,324,1,334
41719,backup,main,20211220,9,0.9925723258297798,14,334,0,348
41737,backup,main,20211220,0,0.9910102720910339,5,334,3,342
41737,backup,main,20211220,1,0.9929380179828705,11,300,1,312
41737,backup,main,20211220,2,0.9861448331573588,9,331,3,343
41737,backup,main,20211220,3,0.9786916791744583,7,308,1,316
41737,backup,main,20211220,4,0.9947781488500498,7,301,2,310
41737,backup,main,20211220,5,0.9889281606434182,5,330,2,337
41737,backup,main,20211220,6,0.9895035334527125,9,328,0,337
41737,backup,main,20211220,7,0.9871849340459169,8,293,2,303
41737,backup,main,20211220,8,0.993487491446854,8,329,1,338
41737,backup,main,20211220,9,0.9825828032609895,10,333,0,343
42261,backup,main,20211220,0,0.98986342418271,4,348,2,354
42261,backup,main,20211220,1,0.9878248086499266,4,309,1,314
42261,backup,main,20211220,2,0.9884996362471677,5,326,2,333
42261,backup,main,20211220,3,0.9878389084723355,6,306,1,313
42261,backup,main,20211220,4,0.9942956334728136,9,333,1,343
42261,backup,main,20211220,5,0.9905233195187412,3,347,0,350
42261,backup,main,20211220,6,0.9917687124346294,1,343,1,345
42261,backup,main,20211220,7,0.9811452442007059,4,285,2,291
42261,backup,main,20211220,8,0.9944630064494288,5,338,0,343
42261,backup,main,20211220,9,0.9940573884784065,5,338,2,345
42618,backup,main,20211220,0,0.9963963600862956,43,381,3,427
42618,backup,main,20211220,1,0.9949104266811958,43,339,0,382
42618,backup,main,20211220,2,0.9885376958640624,43,369,7,419
42618,backup,main,20211220,3,0.9828979442592504,42,339,2,383
42618,backup,main,20211220,4,0.9925874699176145,35,332,1,368
42618,backup,main,20211220,5,0.9925736430401967,32,362,1,395
42618,backup,main,20211220,6,0.9940579969632278,35,366,0,401
42618,backup,main,20211220,7,0.9878555741226891,78,248,4,330
42618,backup,main,20211220,8,0.9941553542391107,42,350,3,395
42618,backup,main,20211220,9,0.9944261508037959,48,356,5,409
20315,bright,main,20211220,0,0.9863569653500566,338,97,3,438
20315,bright,main,20211220,1,0.9952893215216728,282,115,6,403
20315,bright,main,20211220,2,0.9915676053203876,266,170,5,441
20315,bright,main,20211220,3,0.9909782838102678,234,161,3,398
20315,bright,main,20211220,4,0.9936866482419563,229,162,3,394
20315,bright,main,20211220,5,0.9922297828735768,301,103,7,411
20315,bright,main,20211220,6,0.9903880240471721,307,63,3,373
20315,bright,main,20211220,7,0.9879924190314123,298,69,4,371
20315,bright,main,20211220,8,0.9910587169950791,340,80,3,423
20315,bright,main,20211220,9,0.9939012849864383,329,102,4,435
20714,bright,main,20211220,0,0.9954164347433635,267,150,8,425
20714,bright,main,20211220,1,0.9951287419191931,208,157,8,373
20714,bright,main,20211220,2,0.9949283836785006,272,141,4,417
20714,bright,main,20211220,3,0.9945752601449731,277,93,4,374
20714,bright,main,20211220,4,0.9896461560275461,264,106,4,374
20714,bright,main,20211220,5,0.993507733786306,295,84,8,387
20714,bright,main,20211220,6,0.9904443401086248,323,86,6,415
20714,bright,main,20211220,7,0.9928171509799405,266,79,5,350
20714,bright,main,20211220,8,0.9929605327074623,264,129,9,402
20714,bright,main,20211220,9,0.9923359186887849,243,161,9,413
22111,bright,main,20211220,0,0.9935497472872424,275,142,5,422
22111,bright,main,20211220,1,0.9962755606082481,246,127,6,379
22111,bright,main,20211220,2,0.9954419926197369,201,202,7,410
22111,bright,main,20211220,3,0.9937394168125784,212,170,8,390
22111,bright,main,20211220,4,0.9910087635736426,231,146,2,379
22111,bright,main,20211220,5,0.989448920997361,197,183,7,387
22111,bright,main,20211220,6,0.9896669779532568,222,183,4,409
22111,bright,main,20211220,7,0.9936177987288597,251,102,5,358
22111,bright,main,20211220,8,0.9915214293771354,264,133,7,404
22111,bright,main,20211220,9,0.9896336174207074,320,97,3,420
41702,backup,main,20211220,0,0.9921252614009022,2,371,0,373
41702,backup,main,20211220,1,0.9908493212434517,3,331,1,335
41702,backup,main,20211220,2,0.9881024313305535,2,357,0,359
41702,backup,main,20211220,3,0.9942516673190748,5,330,0,335
41702,backup,main,20211220,4,0.9850294118693914,3,336,0,339
41702,backup,main,20211220,5,0.9921751065665664,2,348,1,351
41702,backup,main,20211220,6,0.9909539248940386,4,346,2,352
41702,backup,main,20211220,7,0.9890797264385842,5,319,0,324
41702,backup,main,20211220,8,0.990060865780722,8,351,1,360
41702,backup,main,20211220,9,0.9939079569603881,0,353,1,354
20706,bright,main,20211220,0,0.9908315132843881,332,86,8,426
20706,bright,main,20211220,1,0.9923498525084137,290,92,8,390
20706,bright,main,20211220,2,0.9918825618884138,363,58,1,422
20706,bright,main,20211220,3,0.9915441552438069,292,89,5,386
20706,bright,main,20211220,4,0.9898808689321876,294,86,6,386
20706,bright,main,20211220,5,0.9910031027525665,328,72,6,406
20706,bright,main,20211220,6,0.9868709648810365,302,110,5,417
20706,bright,main,20211220,7,0.991923387248192,275,75,6,356
20706,bright,main,20211220,8,0.988045721603441,290,116,3,409
20706,bright,main,20211220,9,0.9931532939608034,333,76,7,416
20702,bright,main,20211220,0,0.9898074426600957,244,160,6,410
20702,bright,main,20211220,1,0.9921214078646874,254,119,6,379
20702,bright,main,20211220,2,0.992163223279151,308,108,4,420
20702,bright,main,20211220,3,0.986855186393114,270,98,3,371
20702,bright,main,20211220,4,0.9870998286923449,278,97,2,377
20702,bright,main,20211220,5,0.9885323996607848,318,80,6,404
20702,bright,main,20211220,6,0.9944174893964491,300,99,5,404
20702,bright,main,20211220,7,0.9866555404621383,261,83,2,346
20702,bright,main,20211220,8,0.9865327289309068,321,88,4,413
20702,bright,main,20211220,9,0.9927564071261166,287,106,6,399
41686,backup,main,20211220,0,0.9963997576363419,19,352,1,372
41686,backup,main,20211220,1,0.9948419646310387,6,320,1,327
41686,backup,main,20211220,2,0.9833542538167074,12,344,1,357
41686,backup,main,20211220,3,0.9920522853000703,7,319,1,327
41686,backup,main,20211220,4,0.9913567106275664,18,313,1,332
41686,backup,main,20211220,5,0.9922089659144371,15,325,1,341
41686,backup,main,20211220,6,0.9917387941215614,5,336,1,342
41686,backup,main,20211220,7,0.9876533133772885,7,292,0,299
41686,backup,main,20211220,8,0.9945256002993014,13,331,0,344
41686,backup,main,20211220,9,0.9927099125305443,9,347,1,357
23055,bright,main,20211220,0,0.9944839987515338,352,82,3,437
23055,bright,main,20211220,1,0.9819320752681587,299,104,0,403
23055,bright,main,20211220,2,0.9945912466732145,313,117,8,438
23055,bright,main,20211220,3,0.9931826336896858,262,127,5,394
23055,bright,main,20211220,4,0.9955304108697917,282,113,3,398
23055,bright,main,20211220,5,0.9922730873618323,271,140,4,415
23055,bright,main,20211220,6,0.9899642849945999,282,145,4,431
23055,bright,main,20211220,7,0.9914096721342178,269,95,4,368
23055,bright,main,20211220,8,0.9946687314332681,315,99,1,415
23055,bright,main,20211220,9,0.9914394879864735,311,116,8,435
21286,bright,main,20211222,0,0.9943051882021116,268,146,7,421
21286,bright,main,20211222,1,0.9901556340148662,261,121,6,388
21286,bright,main,20211222,2,0.9945238782791083,281,136,5,422
21286,bright,main,20211222,3,0.9946802291546454,275,105,5,385
21286,bright,main,20211222,4,0.9878862495833949,280,100,3,383
21286,bright,main,20211222,5,0.9940915923956543,329,60,3,392
21286,bright,main,20211222,6,0.9934295943691349,355,56,5,416
21286,bright,main,20211222,7,0.9887188246970355,297,56,4,357
21286,bright,main,20211222,8,0.9911550631355815,329,77,4,410
21286,bright,main,20211222,9,0.9935492537140656,288,119,5,412
7454,dark,main,20211222,0,0.9872862777291851,311,11,49,371
7454,dark,main,20211222,1,0.9931029670351507,282,15,47,344
7454,dark,main,20211222,2,0.9891094687333909,300,14,68,382
7454,dark,main,20211222,3,0.9955830225197518,281,15,59,355
7454,dark,main,20211222,4,0.996250577181196,261,9,73,343
7454,dark,main,20211222,5,0.9887169261323823,297,10,79,386
7454,dark,main,20211222,6,0.9965847161344077,280,14,81,375
7454,dark,main,20211222,7,0.9927227379428326,264,11,48,323
7454,dark,main,20211222,8,0.9906070503734932,292,13,55,360
7454,dark,main,20211222,9,0.9943720670224667,293,14,79,386
22798,bright,main,20211222,0,0.9883501840011941,341,84,4,429
22798,bright,main,20211222,1,0.9955225311538118,276,105,5,386
22798,bright,main,20211222,2,0.9897334138796692,292,126,6,424
22798,bright,main,20211222,3,0.9938888026067245,222,161,3,386
22798,bright,main,20211222,4,0.9892993363590661,243,126,6,375
22798,bright,main,20211222,5,0.9894316630374543,277,124,1,402
22798,bright,main,20211222,6,0.9873567475537932,305,113,3,421
22798,bright,main,20211222,7,0.9899683699961438,240,111,7,358
22798,bright,main,20211222,8,0.9868759653985956,312,94,4,410
22798,bright,main,20211222,9,0.9904473231082825,312,106,5,423
6750,dark,main,20211222,0,0.9914256758245188,309,10,60,379
6750,dark,main,20211222,1,0.9957144295891318,290,11,56,357
6750,dark,main,20211222,2,0.9862407803438819,275,13,92,380
6750,dark,main,20211222,3,0.984429111220771,275,16,67,358
6750,dark,main,20211222,4,0.9903674048171986,292,12,48,352
6750,dark,main,20211222,5,0.9963460561270975,290,12,71,373
6750,dark,main,20211222,6,0.995111564185588,275,19,79,373
6750,dark,main,20211222,7,0.9889414610801902,266,13,59,338
6750,dark,main,20211222,8,0.9892612965110849,292,13,66,371
6750,dark,main,20211222,9,0.9948832376425218,306,12,69,387
20188,bright,main,20211222,0,0.9902815815367352,270,144,3,417
20188,bright,main,20211222,1,0.9889638661155009,288,98,6,392
20188,bright,main,20211222,2,0.9931503028968969,321,94,10,425
20188,bright,main,20211222,3,0.9880836727237625,275,109,5,389
20188,bright,main,20211222,4,0.9945709799173985,315,65,0,380
20188,bright,main,20211222,5,0.9947095989483985,332,66,8,406
20188,bright,main,20211222,6,0.99096312552582,336,73,6,415
20188,bright,main,20211222,7,0.9937267428576614,283,68,3,354
20188,bright,main,20211222,8,0.9882171304358104,308,89,3,400
20188,bright,main,20211222,9,0.985000053919186,276,125,1,402
6739,dark,main,20211222,0,0.9892472619679363,287,16,70,373
6739,dark,main,20211222,1,0.9892267542217531,264,11,71,346
6739,dark,main,20211222,2,0.9928136661048889,309,13,62,384
6739,dark,main,20211222,3,0.9889177375172793,297,11,46,354
6739,dark,main,20211222,4,0.99128407246653,265,11,70,346
6739,dark,main,20211222,5,0.9935431815556628,294,12,65,371
6739,dark,main,20211222,6,0.9886222252457028,300,12,61,373
6739,dark,main,20211222,7,0.9896448652897782,281,12,48,341
6739,dark,main,20211222,8,0.9911720262046473,305,12,57,374
6739,dark,main,20211222,9,0.9862335677379096,245,16,85,346
22796,bright,main,20211223,0,0.9925784291304145,289,125,3,417
22796,bright,main,20211223,1,0.9831650031511132,325,64,2,391
22796,bright,main,20211223,2,0.9916454739955518,295,133,0,428
22796,bright,main,20211223,3,0.9954500770513298,294,93,2,389
22796,bright,main,20211223,4,0.9951474150487766,239,128,6,373
22796,bright,main,20211223,5,0.9922212476969031,277,120,5,402
22796,bright,main,20211223,6,0.9899401357468226,301,114,6,421
22796,bright,main,20211223,7,0.9936011664230194,259,100,5,364
22796,bright,main,20211223,8,0.9888850128578672,322,87,2,411
22796,bright,main,20211223,9,0.9875002380614204,311,101,3,415
24146,bright,main,20211226,0,0.9924875981524462,327,90,5,422
24146,bright,main,20211226,1,0.9922956956393354,305,77,7,389
24146,bright,main,20211226,2,0.9940726509594322,329,87,4,420
24146,bright,main,20211226,3,0.994206586452143,304,69,5,378
24146,bright,main,20211226,4,0.9921763486564188,313,72,5,390
24146,bright,main,20211226,5,0.9924721137297087,332,67,3,402
24146,bright,main,20211226,6,0.9944594790027983,336,74,8,418
24146,bright,main,20211226,7,0.9887254552655085,249,85,10,344
24146,bright,main,20211226,8,0.9911158049358514,325,77,8,410
24146,bright,main,20211226,9,0.9911547968522789,325,79,6,410
6028,dark,main,20211226,0,0.9963891244284749,288,16,64,368
6028,dark,main,20211226,1,0.9945046162460479,282,13,56,351
6028,dark,main,20211226,2,0.9906881914692731,285,14,73,372
6028,dark,main,20211226,3,0.9888165304340817,274,16,55,345
6028,dark,main,20211226,4,0.993698653691222,287,13,45,345
6028,dark,main,20211226,5,0.991982457130051,270,13,50,333
6028,dark,main,20211226,6,0.9897743880420988,309,14,47,370
6028,dark,main,20211226,7,0.99281152360574,262,12,59,333
6028,dark,main,20211226,8,0.9862860829021555,307,14,53,374
6028,dark,main,20211226,9,0.9934043371664765,287,14,50,351
3270,dark,main,20211226,0,0.9897901543332921,270,11,81,362
3270,dark,main,20211226,1,0.9922604715784327,243,18,87,348
3270,dark,main,20211226,2,0.9927140929258845,285,10,75,370
3270,dark,main,20211226,3,0.9873440426997603,256,16,76,348
3270,dark,main,20211226,4,0.9926863951767081,242,11,77,330
3270,dark,main,20211226,5,0.9910179184204762,262,15,78,355
3270,dark,main,20211226,6,0.9935557031046391,283,11,91,385
3270,dark,main,20211226,7,0.9956726685511816,246,18,65,329
3270,dark,main,20211226,8,0.9925763656918772,296,19,61,376
3270,dark,main,20211226,9,0.9905968360469498,259,14,83,356
2576,dark,main,20211226,0,0.991943054769692,309,9,49,367
2576,dark,main,20211226,1,0.9933169170959215,280,12,45,337
2576,dark,main,20211226,2,0.9921608799758245,317,12,51,380
2576,dark,main,20211226,3,0.9880043110837339,277,14,53,344
2576,dark,main,20211226,4,0.9887359953750898,276,17,54,347
2576,dark,main,20211226,5,0.9943675496511143,284,12,72,368
2576,dark,main,20211226,6,0.9901696093728798,284,18,82,384
2576,dark,main,20211226,7,0.9925242944510454,260,15,45,320
2576,dark,main,20211226,8,0.9876020636436412,288,16,64,368
2576,dark,main,20211226,9,0.9906346092791463,295,10,62,367
6744,dark,main,20211226,0,0.99524667954744,264,11,88,363
6744,dark,main,20211226,1,0.9922942483177041,268,14,78,360
6744,dark,main,20211226,2,0.9942471317478727,275,12,107,394
6744,dark,main,20211226,3,0.9916876384112218,270,12,70,352
6744,dark,main,20211226,4,0.9907828259534919,264,11,59,334
6744,dark,main,20211226,5,0.9948658757749794,319,14,35,368
6744,dark,main,20211226,6,0.9907427341728705,307,12,57,376
6744,dark,main,20211226,7,0.983295304190996,238,12,77,327
6744,dark,main,20211226,8,0.9886222103624828,253,16,105,374
6744,dark,main,20211226,9,0.9936183668637819,255,15,108,378
23474,bright,main,20211226,0,0.9883868845604344,340,66,8,414
23474,bright,main,20211226,1,0.9945958577490914,297,67,3,367
23474,bright,main,20211226,2,0.9905861343957901,332,68,4,404
23474,bright,main,20211226,3,0.9856105866544024,324,47,2,373
23474,bright,main,20211226,4,0.9889103073268081,303,60,8,371
23474,bright,main,20211226,5,0.9909441961972143,346,50,8,404
23474,bright,main,20211226,6,0.9938497954160802,349,51,4,404
23474,bright,main,20211226,7,0.9939827216356973,298,56,2,356
23474,bright,main,20211226,8,0.9910542142891351,306,82,7,395
23474,bright,main,20211226,9,0.9885453775535804,338,67,4,409
3238,dark,main,20211226,0,0.996302712898417,265,14,91,370
3238,dark,main,20211226,1,0.9950460603926128,263,12,71,346
3238,dark,main,20211226,2,0.9851679464223705,310,15,42,367
3238,dark,main,20211226,3,0.9916514897681389,307,13,44,364
3238,dark,main,20211226,4,0.9916027012543737,266,12,55,333
3238,dark,main,20211226,5,0.9912801718384106,300,12,59,371
3238,dark,main,20211226,6,0.9884348197862034,295,16,77,388
3238,dark,main,20211226,7,0.9905549734804062,287,13,41,341
3238,dark,main,20211226,8,0.9931951123596159,278,13,82,373
3238,dark,main,20211226,9,0.995781894124024,236,13,105,354
3607,dark,main,20211226,0,0.9897239174728162,294,10,58,362
3607,dark,main,20211226,1,0.9958624726825719,291,13,41,345
3607,dark,main,20211226,2,0.9929517333236015,313,14,36,363
3607,dark,main,20211226,3,0.9930889276091277,298,13,50,361
3607,dark,main,20211226,4,0.9935096293335925,291,12,38,341
3607,dark,main,20211226,5,0.9904874364682758,277,12,56,345
3607,dark,main,20211226,6,0.9928132221245757,297,16,63,376
3607,dark,main,20211226,7,0.9902354465319032,261,11,51,323
3607,dark,main,20211226,8,0.9921090681539971,307,14,53,374
3607,dark,main,20211226,9,0.9879443318482833,260,12,74,346
6376,dark,main,20211226,0,0.9949803789032794,284,16,81,381
6376,dark,main,20211226,1,0.9950143974653631,246,12,80,338
6376,dark,main,20211226,2,0.9907088381707788,288,11,68,367
6376,dark,main,20211226,3,0.9884288941450894,284,13,59,356
6376,dark,main,20211226,4,0.9920102216900077,286,15,47,348
6376,dark,main,20211226,5,0.9906956271359116,273,11,75,359
6376,dark,main,20211226,6,0.9958960097069587,319,12,50,381
6376,dark,main,20211226,7,0.9875133519109176,263,13,39,315
6376,dark,main,20211226,8,0.9878195936576736,305,10,55,370
6376,dark,main,20211226,9,0.9944147549444136,257,13,80,350
11778,dark,main,20211226,0,0.9975138323917847,266,20,103,389
11778,dark,main,20211226,1,0.9682914435562926,129,12,28,169
11778,dark,main,20211226,2,0.9945092985418003,246,16,95,357
11778,dark,main,20211226,3,0.9941754293985865,242,28,74,344
11778,dark,main,20211226,4,0.9848298047702648,134,10,36,180
11778,dark,main,20211226,5,0.98887752734704,246,24,94,364
11778,dark,main,20211226,6,0.9885093562146677,246,23,83,352
11778,dark,main,20211226,7,0.9908674189493246,236,12,79,327
11778,dark,main,20211226,8,0.9908932761327993,259,17,84,360
11778,dark,main,20211226,9,0.9951180756764741,265,21,83,369
25715,bright,main,20211226,0,0.9928748942179803,340,73,6,419
25715,bright,main,20211226,1,0.9896377596442538,297,94,7,398
25715,bright,main,20211226,2,0.9934132593163995,262,147,6,415
25715,bright,main,20211226,3,0.9908496433344975,264,129,2,395
25715,bright,main,20211226,4,0.9882764646594738,291,91,6,388
25715,bright,main,20211226,5,0.9886371106522889,300,98,4,402
25715,bright,main,20211226,6,0.9926036284270897,309,108,5,422
25715,bright,main,20211226,7,0.9964406083562948,206,88,57,351
25715,bright,main,20211226,8,0.9946070562546602,287,123,5,415
25715,bright,main,20211226,9,0.985942302488074,312,77,12,401
8764,dark,main,20211226,0,0.9949485544790354,295,12,69,376
8764,dark,main,20211226,1,0.9946260827609972,259,14,75,348
8764,dark,main,20211226,2,0.9926742256367366,274,16,79,369
8764,dark,main,20211226,3,0.9889399246352621,277,11,54,342
8764,dark,main,20211226,4,0.9880297963754976,292,13,46,351
8764,dark,main,20211226,5,0.9883306808447782,290,10,38,338
8764,dark,main,20211226,6,0.9926143226544617,311,9,54,374
8764,dark,main,20211226,7,0.9936408558625633,260,12,46,318
8764,dark,main,20211226,8,0.9855081051848946,322,16,55,393
8764,dark,main,20211226,9,0.9909175657477074,270,17,77,364
22955,bright,main,20211226,0,0.9924250828642369,344,90,4,438
22955,bright,main,20211226,1,0.9918971348145469,287,114,4,405
22955,bright,main,20211226,2,0.9925167972284292,324,100,5,429
22955,bright,main,20211226,3,0.9944400590003223,275,121,2,398
22955,bright,main,20211226,4,0.9958166014933981,280,132,3,415
22955,bright,main,20211226,5,0.9973268334477774,336,85,4,425
22955,bright,main,20211226,6,0.9921889621418002,348,82,2,432
22955,bright,main,20211226,7,0.9886429982154559,293,85,2,380
22955,bright,main,20211226,8,0.9942155920711117,347,79,3,429
22955,bright,main,20211226,9,0.9905868384143581,297,134,7,438
21571,bright,main,20220101,0,0.990083764015691,385,39,5,429
21571,bright,main,20220101,1,0.9926329036908297,347,38,4,389
21571,bright,main,20220101,2,0.9942628812714623,354,61,4,419
21571,bright,main,20220101,3,0.9920088738488217,285,46,5,336
21571,bright,main,20220101,4,0.9955373407720929,345,35,5,385
21571,bright,main,20220101,5,0.9958824588715184,353,46,6,405
21571,bright,main,20220101,6,0.9928224357063187,365,48,3,416
21571,bright,main,20220101,7,0.9849584503387389,314,41,2,357
21571,bright,main,20220101,8,0.9938501036851142,356,48,4,408
21571,bright,main,20220101,9,0.9909288985058439,373,43,7,423
4929,dark,main,20220101,0,0.9917445979832369,291,14,68,373
4929,dark,main,20220101,1,0.9905658803301162,266,14,69,349
4929,dark,main,20220101,2,0.9902557906193538,273,14,69,356
4929,dark,main,20220101,3,0.9929480887589162,284,12,49,345
4929,dark,main,20220101,4,0.9931197615730956,273,12,48,333
4929,dark,main,20220101,5,0.9916271301586249,211,10,37,258
4929,dark,main,20220101,6,0.9954577519892935,289,16,48,353
4929,dark,main,20220101,7,0.9905573233042676,255,12,35,302
4929,dark,main,20220101,8,0.988994870542854,274,13,56,343
4929,dark,main,20220101,9,0.9917947208408907,291,14,58,363
41685,backup,main,20220101,0,0.9908015876783468,18,341,0,359
41685,backup,main,20220101,1,0.9923536028010896,13,310,0,323
41685,backup,main,20220101,2,0.9941373601727672,9,360,0,369
41685,backup,main,20220101,3,0.9929524864434884,15,310,2,327
41685,backup,main,20220101,4,0.9942266432409379,9,312,0,321
41685,backup,main,20220101,5,0.988308892712437,12,323,2,337
41685,backup,main,20220101,6,0.9913405716654179,15,359,1,375
41685,backup,main,20220101,7,0.9926127509692647,6,309,2,317
41685,backup,main,20220101,8,0.993506487067796,20,339,1,360
41685,backup,main,20220101,9,0.9904286506670293,5,331,2,338
5966,dark,main,20220101,0,0.9924740159301573,326,12,54,392
5966,dark,main,20220101,1,0.9895054698597424,261,12,54,327
5966,dark,main,20220101,2,0.9920454814492105,283,26,85,394
5966,dark,main,20220101,3,0.9899994521065274,230,14,70,314
5966,dark,main,20220101,4,0.9926305658735078,250,18,77,345
5966,dark,main,20220101,5,0.9888905390619306,258,14,101,373
5966,dark,main,20220101,6,0.9922096440715003,260,15,99,374
5966,dark,main,20220101,7,0.9900471395729422,251,16,64,331
5966,dark,main,20220101,8,0.9917424160446227,294,11,51,356
5966,dark,main,20220101,9,0.9914008239514451,303,16,58,377
21913,bright,main,20220101,0,0.9859947935132483,325,72,7,404
21913,bright,main,20220101,1,0.9891916123617139,298,62,3,363
21913,bright,main,20220101,2,0.9945988763090917,316,68,5,389
21913,bright,main,20220101,3,0.9922273845593982,301,53,3,357
21913,bright,main,20220101,4,0.9867384463266583,298,46,8,352
21913,bright,main,20220101,5,0.9850138958596965,226,39,3,268
21913,bright,main,20220101,6,0.9921689917722116,284,95,3,382
21913,bright,main,20220101,7,0.9914214835512327,244,85,5,334
21913,bright,main,20220101,8,0.9937854365217359,285,54,8,347
21913,bright,main,20220101,9,0.989381660040318,238,96,7,341
9256,dark,main,20220101,0,0.9950681839529751,309,18,72,399
9256,dark,main,20220101,1,0.9914829791551699,257,11,95,363
9256,dark,main,20220101,2,0.9842980299756623,293,17,81,391
9256,dark,main,20220101,3,0.98328605536314,260,22,68,350
9256,dark,main,20220101,4,0.9913062806051438,255,12,77,344
9256,dark,main,20220101,5,0.9920771779587486,263,18,90,371
9256,dark,main,20220101,6,0.9897611448275029,291,14,86,391
9256,dark,main,20220101,7,0.9880039031412423,251,14,77,342
9256,dark,main,20220101,8,0.9925650962420943,254,16,92,362
9256,dark,main,20220101,9,0.9952104222103306,263,26,100,389
10381,dark,main,20220101,0,0.994132046136443,300,19,75,394
10381,dark,main,20220101,1,0.989504728608173,271,12,62,345
10381,dark,main,20220101,2,0.9904518235470153,316,17,53,386
10381,dark,main,20220101,3,0.9869879427408244,221,12,64,297
10381,dark,main,20220101,4,0.9853947000105969,261,18,67,346
10381,dark,main,20220101,5,0.9880401237967911,269,11,87,367
10381,dark,main,20220101,6,0.9904897284633644,291,15,84,390
10381,dark,main,20220101,7,0.9821629520904863,242,17,81,340
10381,dark,main,20220101,8,0.9906475536671003,284,12,84,380
10381,dark,main,20220101,9,0.9945060723349911,293,14,81,388
4707,dark,main,20220101,0,0.9854622263569324,308,18,61,387
4707,dark,main,20220101,1,0.9952515958261213,273,14,56,343
4707,dark,main,20220101,2,0.9954127318634984,310,18,51,379
4707,dark,main,20220101,3,0.991601014597743,261,13,32,306
4707,dark,main,20220101,4,0.990897568532098,268,18,53,339
4707,dark,main,20220101,5,0.9904765233600488,301,20,49,370
4707,dark,main,20220101,6,0.9876897450041737,310,21,47,378
4707,dark,main,20220101,7,0.9866187936430358,245,21,58,324
4707,dark,main,20220101,8,0.9935573159435558,274,17,85,376
4707,dark,main,20220101,9,0.987035894195729,306,16,54,376
10860,dark,main,20220101,0,0.9941034923809026,300,15,65,380
10860,dark,main,20220101,1,0.9947959804775047,276,14,61,351
10860,dark,main,20220101,2,0.9916881599572963,296,14,73,383
10860,dark,main,20220101,3,0.985036950267069,227,14,70,311
10860,dark,main,20220101,4,0.9859803997934671,236,16,75,327
10860,dark,main,20220101,5,0.9929371007422727,279,11,73,363
10860,dark,main,20220101,6,0.9912484360109253,299,12,71,382
10860,dark,main,20220101,7,0.9891923880427047,283,16,50,349
10860,dark,main,20220101,8,0.9921937166488993,316,17,56,389
10860,dark,main,20220101,9,0.9890892398545834,320,13,54,387
24655,bright,main,20220101,0,0.995015901787865,351,78,5,434
24655,bright,main,20220101,1,0.9922954764170219,324,68,4,396
24655,bright,main,20220101,2,0.9942108627904167,356,65,7,428
24655,bright,main,20220101,3,0.9746265874382007,97,21,0,118
24655,bright,main,20220101,4,0.9879072540609914,309,66,7,382
24655,bright,main,20220101,5,0.9901492298421392,324,76,2,402
24655,bright,main,20220101,6,0.991169170561645,327,88,4,419
24655,bright,main,20220101,7,0.9929613313711828,305,54,1,360
24655,bright,main,20220101,8,0.9886535745040828,311,86,5,402
24655,bright,main,20220101,9,0.9937895325857838,329,91,4,424
41777,backup,main,20220101,0,0.9965171968436425,3,440,0,443
41777,backup,main,20220101,1,0.9960395670166343,6,400,0,406
41777,backup,main,20220101,2,0.9977551330008078,4,437,0,441
41777,backup,main,20220101,3,0.991294700685025,6,396,0,402
41777,backup,main,20220101,4,0.9903367055273808,6,392,1,399
41777,backup,main,20220101,5,0.9929895769957384,3,420,0,423
41777,backup,main,20220101,6,0.9938465314320813,1,429,0,430
41777,backup,main,20220101,7,0.9945894903887083,1,373,0,374
41777,backup,main,20220101,8,0.9920788928887444,2,424,0,426
41777,backup,main,20220101,9,0.9952512283153025,1,434,0,435
1687,dark,main,20220101,0,0.9931441166547792,307,16,75,398
1687,dark,main,20220101,1,0.992428984305821,281,14,59,354
1687,dark,main,20220101,2,0.9923509077755828,286,14,85,385
1687,dark,main,20220101,3,0.9930793170722118,263,12,50,325
1687,dark,main,20220101,4,0.9917893142460067,287,12,43,342
1687,dark,main,20220101,5,0.9935931291494139,279,11,79,369
1687,dark,main,20220101,6,0.985877115514943,290,10,64,364
1687,dark,main,20220101,7,0.98958445265085,277,12,46,335
1687,dark,main,20220101,8,0.9851737286590653,320,14,50,384
1687,dark,main,20220101,9,0.9881056760466905,310,11,61,382
2474,dark,main,20220101,0,0.9910162528071772,320,11,71,402
2474,dark,main,20220101,1,0.9935560576770891,290,12,54,356
2474,dark,main,20220101,2,0.9943243478212471,331,13,69,413
2474,dark,main,20220101,3,0.9943587265114295,251,12,47,310
2474,dark,main,20220101,4,0.992444243877676,308,13,34,355
2474,dark,main,20220101,5,0.9904550616104153,298,11,65,374
2474,dark,main,20220101,6,0.9897336812767317,325,17,63,405
2474,dark,main,20220101,7,0.9838384804318637,288,11,42,341
2474,dark,main,20220101,8,0.9932253328951814,310,13,62,385
2474,dark,main,20220101,9,0.9934592922942139,320,12,73,405
40064,backup,main,20220101,0,0.9952646452389846,3,436,0,439
40064,backup,main,20220101,1,0.9896205513479721,3,390,0,393
40064,backup,main,20220101,2,0.9913089307503022,0,437,0,437
40064,backup,main,20220101,3,0.9945124523515723,6,352,1,359
40064,backup,main,20220101,4,0.9888993025004781,4,392,0,396
40064,backup,main,20220101,5,0.9925909221352183,4,417,1,422
40064,backup,main,20220101,6,0.9915515517692653,1,430,0,431
40064,backup,main,20220101,7,0.9950348988544726,1,375,1,377
40064,backup,main,20220101,8,0.9910892240512261,5,409,1,415
40064,backup,main,20220101,9,0.9939663673263861,11,420,0,431
9518,dark,main,20220101,0,0.9928204116764544,313,15,46,374
9518,dark,main,20220101,1,0.9946755929776672,299,13,37,349
9518,dark,main,20220101,2,0.9903353623376747,339,12,39,390
9518,dark,main,20220101,3,0.9858415850115569,268,9,25,302
9518,dark,main,20220101,4,0.9944004162169647,306,11,36,353
9518,dark,main,20220101,5,0.9938194824197955,311,13,41,365
9518,dark,main,20220101,6,0.9893115127017774,320,12,60,392
9518,dark,main,20220101,7,0.986088336731054,298,11,43,352
9518,dark,main,20220101,8,0.9864829133966345,309,10,45,364
9518,dark,main,20220101,9,0.9912164385427858,326,15,37,378
24632,bright,main,20220101,0,0.9955773485494142,366,66,5,437
24632,bright,main,20220101,1,0.99693193592527,301,89,4,394
24632,bright,main,20220101,2,0.9867901581992347,331,89,5,425
24632,bright,main,20220101,3,0.9918888233421393,277,53,4,334
24632,bright,main,20220101,4,0.9952873632163188,337,47,5,389
24632,bright,main,20220101,5,0.9930025637140264,351,52,6,409
24632,bright,main,20220101,6,0.9927138782919962,360,63,3,426
24632,bright,main,20220101,7,0.9967257577457393,323,44,2,369
24632,bright,main,20220101,8,0.9948351787598737,352,59,5,416
24632,bright,main,20220101,9,0.9915778962788232,328,92,6,426
23321,bright,main,20220101,0,0.99455117213795,370,50,4,424
23321,bright,main,20220101,1,0.9924979221400745,264,95,4,363
23321,bright,main,20220101,2,0.9939984924704253,323,88,6,417
23321,bright,main,20220101,3,0.9791803959878709,113,29,0,142
23321,bright,main,20220101,4,0.9944876827240627,313,48,6,367
23321,bright,main,20220101,5,0.9897584622195396,313,72,3,388
23321,bright,main,20220101,6,0.991345515576785,350,63,2,415
23321,bright,main,20220101,7,0.9923429609066504,311,36,4,351
23321,bright,main,20220101,8,0.9956649670661151,374,35,8,417
23321,bright,main,20220101,9,0.9929236721300294,330,59,5,394
8810,dark,main,20220102,0,0.9965001442450465,310,14,64,388
8810,dark,main,20220102,1,0.9878712206696268,282,19,59,360
8810,dark,main,20220102,2,0.9918033525537501,324,15,50,389
8810,dark,main,20220102,3,0.9868308829122964,293,11,56,360
8810,dark,main,20220102,4,0.9952990274872996,243,14,76,333
8810,dark,main,20220102,5,0.9933018849089893,277,19,77,373
8810,dark,main,20220102,6,0.9893623489989278,280,22,81,383
8810,dark,main,20220102,7,0.988506079086319,233,20,71,324
8810,dark,main,20220102,8,0.9912475874088781,285,18,67,370
8810,dark,main,20220102,9,0.9948808285121671,315,14,58,387
7255,dark,main,20220102,0,0.9926887410530248,291,19,48,358
7255,dark,main,20220102,1,0.9916513196894725,231,16,63,310
7255,dark,main,20220102,2,0.9876710324073903,259,15,84,358
7255,dark,main,20220102,3,0.9913114130459271,230,12,57,299
7255,dark,main,20220102,4,0.983827143879983,238,20,59,317
7255,dark,main,20220102,5,0.9871321778092994,252,30,58,340
7255,dark,main,20220102,6,0.9935398480683689,283,13,52,348
7255,dark,main,20220102,7,0.992842838711436,272,11,31,314
7255,dark,main,20220102,8,0.9937730567361994,287,17,44,348
7255,dark,main,20220102,9,0.9909046205639478,300,16,38,354
4604,dark,main,20220102,0,0.9907712405781982,273,20,88,381
4604,dark,main,20220102,1,0.9898530099370902,256,12,81,349
4604,dark,main,20220102,2,0.9965990216954865,263,24,87,374
4604,dark,main,20220102,3,0.9914013898205348,258,12,85,355
4604,dark,main,20220102,4,0.9862424393231357,248,18,81,347
4604,dark,main,20220102,5,0.9930180377005473,248,18,97,363
4604,dark,main,20220102,6,0.9951149601597143,246,12,97,355
4604,dark,main,20220102,7,0.9906330573065709,237,17,72,326
4604,dark,main,20220102,8,0.9922713021887866,234,19,104,357
4604,dark,main,20220102,9,0.9900453235261492,261,22,87,370
11930,dark,main,20220102,0,0.9935185767648644,315,21,41,377
11930,dark,main,20220102,1,0.9892924890336727,270,18,51,339
11930,dark,main,20220102,2,0.9796824599669849,321,15,43,379
11930,dark,main,20220102,3,0.992988212702833,270,23,41,334
11930,dark,main,20220102,4,0.9895279025669239,269,16,49,334
11930,dark,main,20220102,5,0.9940142945835774,308,13,48,369
11930,dark,main,20220102,6,0.9921590659695667,315,17,51,383
11930,dark,main,20220102,7,0.9899786753214854,279,16,37,332
11930,dark,main,20220102,8,0.9946153117859865,333,14,41,388
11930,dark,main,20220102,9,0.9888656100999151,312,18,44,374
24172,bright,main,20220102,0,0.9965716736632152,337,76,6,419
24172,bright,main,20220102,1,0.9914090313073597,332,56,4,392
24172,bright,main,20220102,2,0.9873173640422634,330,82,4,416
24172,bright,main,20220102,3,0.9901324960536079,299,75,8,382
24172,bright,main,20220102,4,0.9940722508956086,269,99,6,374
24172,bright,main,20220102,5,0.9912162632881739,266,126,6,398
24172,bright,main,20220102,6,0.9897220325978346,292,122,5,419
24172,bright,main,20220102,7,0.9928968834832764,262,98,4,364
24172,bright,main,20220102,8,0.9922827299974843,242,153,9,404
24172,bright,main,20220102,9,0.9935715242657707,273,134,7,414
4601,dark,main,20220102,0,0.9941781243674155,261,16,94,371
4601,dark,main,20220102,1,0.9928076713447569,227,15,106,348
4601,dark,main,20220102,2,0.9920117249528672,288,18,84,390
4601,dark,main,20220102,3,0.9832644869710286,230,16,97,343
4601,dark,main,20220102,4,0.9922785067270147,259,15,82,356
4601,dark,main,20220102,5,0.9929264251891069,264,14,81,359
4601,dark,main,20220102,6,0.9917049706951401,260,15,92,367
4601,dark,main,20220102,7,0.9944352802791407,249,14,80,343
4601,dark,main,20220102,8,0.9944922485936382,274,14,73,361
4601,dark,main,20220102,9,0.9935404172773932,266,14,88,368
1269,dark,main,20220102,0,0.9868726410874589,282,17,87,386
1269,dark,main,20220102,1,0.984449539055931,263,14,60,337
1269,dark,main,20220102,2,0.9922026536752603,313,12,54,379
1269,dark,main,20220102,3,0.99180159034302,282,12,53,347
1269,dark,main,20220102,4,0.9942565723542616,280,9,59,348
1269,dark,main,20220102,5,0.9907841349227995,300,11,62,373
1269,dark,main,20220102,6,0.9908774943377443,286,18,77,381
1269,dark,main,20220102,7,0.9936426765332869,242,19,79,340
1269,dark,main,20220102,8,0.9942701375937164,273,18,82,373
1269,dark,main,20220102,9,0.9972454563097992,289,15,85,389
7253,dark,main,20220102,0,0.9945291421936046,311,15,47,373
7253,dark,main,20220102,1,0.989150455596688,265,17,51,333
7253,dark,main,20220102,2,0.9904430041070807,316,18,44,378
7253,dark,main,20220102,3,0.9953448352484783,287,15,40,342
7253,dark,main,20220102,4,0.9913093726104049,279,21,49,349
7253,dark,main,20220102,5,0.9918841139176081,282,22,58,362
7253,dark,main,20220102,6,0.9922337237322936,270,19,86,375
7253,dark,main,20220102,7,0.9936634703247049,278,11,44,333
7253,dark,main,20220102,8,0.9862376783169717,309,21,37,367
7253,dark,main,20220102,9,0.9907947406263217,309,18,44,371
3237,dark,main,20220102,0,0.9929639401156902,297,14,71,382
3237,dark,main,20220102,1,0.9881983594042905,272,13,66,351
3237,dark,main,20220102,2,0.988703414829838,307,15,60,382
3237,dark,main,20220102,3,0.9859698181464875,310,14,35,359
3237,dark,main,20220102,4,0.9883323810969555,271,15,56,342
3237,dark,main,20220102,5,0.9913718748538527,288,15,68,371
3237,dark,main,20220102,6,0.9912728678483559,279,14,76,369
3237,dark,main,20220102,7,0.9882032703300493,270,14,42,326
3237,dark,main,20220102,8,0.9911560277315346,277,18,68,363
3237,dark,main,20220102,9,0.9893573026549137,279,14,83,376
1572,dark,main,20220102,0,0.9974049753317041,251,17,72,340
1572,dark,main,20220102,1,0.9921197028138498,209,18,65,292
1572,dark,main,20220102,2,0.9902680637527308,218,18,80,316
1572,dark,main,20220102,3,0.9934157808320131,166,15,65,246
1572,dark,main,20220102,4,0.9866483927309057,197,14,85,296
1572,dark,main,20220102,5,0.9957237866798233,233,16,73,322
1572,dark,main,20220102,6,0.9927116425798178,240,16,84,340
1572,dark,main,20220102,7,0.9920713323862922,212,15,68,295
1572,dark,main,20220102,8,0.9899276149010707,240,18,81,339
1572,dark,main,20220102,9,0.9865538950398595,242,11,87,340
1723,dark,main,20220102,0,0.9865803589866539,329,15,50,394
1723,dark,main,20220102,1,0.9883809834041719,262,13,70,345
1723,dark,main,20220102,2,0.9908738401889527,322,16,52,390
1723,dark,main,20220102,3,0.9916573429068056,286,14,46,346
1723,dark,main,20220102,4,0.9956041336275763,284,10,38,332
1723,dark,main,20220102,5,0.9797844345384921,304,10,42,356
1723,dark,main,20220102,6,0.9908856760368031,299,15,58,372
1723,dark,main,20220102,7,0.9914288710630494,281,12,41,334
1723,dark,main,20220102,8,0.9926634983160743,305,13,53,371
1723,dark,main,20220102,9,0.9930407556376809,305,14,48,367
6048,dark,main,20220102,0,0.9947263670837934,279,13,104,396
6048,dark,main,20220102,1,0.9912307721906459,255,12,87,354
6048,dark,main,20220102,2,0.9920908004443506,283,14,94,391
6048,dark,main,20220102,3,0.9904398940025844,259,13,89,361
6048,dark,main,20220102,4,0.9885802652690174,268,14,65,347
6048,dark,main,20220102,5,0.990232518316118,285,10,79,374
6048,dark,main,20220102,6,0.9919097164394672,275,13,86,374
6048,dark,main,20220102,7,0.9896916089435943,231,11,85,327
6048,dark,main,20220102,8,0.9897983137562709,251,12,90,353
6048,dark,main,20220102,9,0.9882001165320745,275,12,93,380
2556,dark,main,20220102,0,0.987798619401894,268,17,101,386
2556,dark,main,20220102,1,0.9850625175646016,260,15,68,343
2556,dark,main,20220102,2,0.988215693167107,314,15,65,394
2556,dark,main,20220102,3,0.9855305506354084,289,13,47,349
2556,dark,main,20220102,4,0.9842688640036937,278,13,35,326
2556,dark,main,20220102,5,0.992860025155894,305,12,46,363
2556,dark,main,20220102,6,0.9930663010137337,304,17,61,382
2556,dark,main,20220102,7,0.9867496582525241,276,14,42,332
2556,dark,main,20220102,8,0.993706124806191,311,13,53,377
2556,dark,main,20220102,9,0.9910503685685327,266,23,92,381
8812,dark,main,20220102,0,0.9877540797614475,280,20,74,374
8812,dark,main,20220102,1,0.9926729323320307,251,19,77,347
8812,dark,main,20220102,2,0.9907643640917768,294,22,76,392
8812,dark,main,20220102,3,0.9929604145510391,303,12,48,363
8812,dark,main,20220102,4,0.9902031550103528,294,12,42,348
8812,dark,main,20220102,5,0.987086882415623,294,12,51,357
8812,dark,main,20220102,6,0.9925632074549687,299,13,66,378
8812,dark,main,20220102,7,0.9917555472525086,245,13,68,326
8812,dark,main,20220102,8,0.9893797437838427,266,19,90,375
8812,dark,main,20220102,9,0.99429673035598,254,22,102,378
3272,dark,main,20220102,0,0.9908296909535574,320,12,62,394
3272,dark,main,20220102,1,0.9955760411833271,289,13,61,363
3272,dark,main,20220102,2,0.9919199475389143,323,14,54,391
3272,dark,main,20220102,3,0.9925127259895902,283,14,61,358
3272,dark,main,20220102,4,0.99143036435062,269,10,60,339
3272,dark,main,20220102,5,0.9921126586914811,305,10,61,376
3272,dark,main,20220102,6,0.9867144271965914,281,13,74,368
3272,dark,main,20220102,7,0.9911074583317047,257,11,59,327
3272,dark,main,20220102,8,0.9955860841743619,319,14,54,387
3272,dark,main,20220102,9,0.9885587606957337,326,15,39,380
4483,dark,main,20220102,0,0.9906907505865057,312,15,73,400
4483,dark,main,20220102,1,0.9929198736206034,260,15,87,362
4483,dark,main,20220102,2,0.9907046650878957,260,17,89,366
4483,dark,main,20220102,3,0.9908932774617691,268,13,77,358
4483,dark,main,20220102,4,0.9923734225774787,255,16,77,348
4483,dark,main,20220102,5,0.9940339303947537,267,12,92,371
4483,dark,main,20220102,6,0.9930726800999973,258,13,99,370
4483,dark,main,20220102,7,0.9920093106809522,244,10,74,328
4483,dark,main,20220102,8,0.9888198146540002,264,16,90,370
4483,dark,main,20220102,9,0.9935826698177586,275,12,98,385
5660,dark,main,20220102,0,0.9941673246753241,330,12,46,388
5660,dark,main,20220102,1,0.9956602183672216,297,12,46,355
5660,dark,main,20220102,2,0.9871103335939352,314,16,40,370
5660,dark,main,20220102,3,0.9880668050437803,284,17,54,355
5660,dark,main,20220102,4,0.9933685302601144,264,19,35,318
5660,dark,main,20220102,5,0.9900349837979239,296,17,42,355
5660,dark,main,20220102,6,0.9892259205979659,305,15,45,365
5660,dark,main,20220102,7,0.9933506801552546,278,12,47,337
5660,dark,main,20220102,8,0.9941320896337135,304,17,40,361
5660,dark,main,20220102,9,0.991894903279294,321,15,48,384
11023,dark,main,20220102,0,0.9893348789719019,259,14,86,359
11023,dark,main,20220102,1,0.9871778656062824,239,15,68,322
11023,dark,main,20220102,2,0.990262674168384,246,10,96,352
11023,dark,main,20220102,3,0.9947228321039255,241,14,78,333
11023,dark,main,20220102,4,0.984549725643663,233,12,70,315
11023,dark,main,20220102,5,0.9770852767296562,162,11,46,219
11023,dark,main,20220102,6,0.994180310205015,241,15,94,350
11023,dark,main,20220102,7,0.9778578126631039,228,11,70,309
11023,dark,main,20220102,8,0.9958452562467458,254,13,89,356
11023,dark,main,20220102,9,0.9907215840812359,225,13,100,338
2040,dark,main,20220102,0,0.9909376814921016,323,11,47,381
2040,dark,main,20220102,1,0.989205879552619,263,12,56,331
2040,dark,main,20220102,2,0.9916840412781687,326,16,37,379
2040,dark,main,20220102,3,0.9931473684499365,296,11,42,349
2040,dark,main,20220102,4,0.9851358282998405,298,11,38,347
2040,dark,main,20220102,5,0.9934463089493498,308,13,43,364
2040,dark,main,20220102,6,0.9943630176429518,287,13,62,362
2040,dark,main,20220102,7,0.992785802460248,278,12,42,332
2040,dark,main,20220102,8,0.9939010166464024,284,14,56,354
2040,dark,main,20220102,9,0.9928628251430403,341,10,33,384
10356,dark,main,20220102,0,0.9906438402081982,308,21,52,381
10356,dark,main,20220102,1,0.9856077479446752,262,14,44,320
10356,dark,main,20220102,2,0.9842782291572402,309,15,45,369
10356,dark,main,20220102,3,0.9898035397980246,282,22,45,349
10356,dark,main,20220102,4,0.991474516060452,279,15,47,341
10356,dark,main,20220102,5,0.9912512794262834,293,15,50,358
10356,dark,main,20220102,6,0.9906352473700368,287,20,60,367
10356,dark,main,20220102,7,0.9878074622750961,248,21,42,311
10356,dark,main,20220102,8,0.9887224227941277,289,13,50,352
10356,dark,main,20220102,9,0.9900307004748911,316,14,50,380
4710,dark,main,20220102,0,0.9944721062303354,319,16,57,392
4710,dark,main,20220102,1,0.9882303890848706,269,19,59,347
4710,dark,main,20220102,2,0.981973868536327,305,19,59,383
4710,dark,main,20220102,3,0.9887825733718721,271,18,55,344
4710,dark,main,20220102,4,0.9842722547442101,261,29,52,342
4710,dark,main,20220102,5,0.9929945087415835,305,16,51,372
4710,dark,main,20220102,6,0.9920182983527948,291,29,59,379
4710,dark,main,20220102,7,0.9882288766014676,260,24,56,340
4710,dark,main,20220102,8,0.9895419613832028,276,19,65,360
4710,dark,main,20220102,9,0.9915165893208813,294,19,63,376
8817,dark,main,20220102,0,0.9907663870928078,322,14,50,386
8817,dark,main,20220102,1,0.9877973889944284,305,15,28,348
8817,dark,main,20220102,2,0.991050845398098,317,14,48,379
8817,dark,main,20220102,3,0.9860914915652073,294,14,46,354
8817,dark,main,20220102,4,0.9859084086064801,286,9,45,340
8817,dark,main,20220102,5,0.992657182157485,296,12,60,368
8817,dark,main,20220102,6,0.9926889723392591,288,18,73,379
8817,dark,main,20220102,7,0.9883921196129735,244,19,67,330
8817,dark,main,20220102,8,0.9925810845516877,295,14,71,380
8817,dark,main,20220102,9,0.9946352086026817,327,10,47,384
11929,dark,main,20220102,0,0.9965180614780487,310,21,49,380
11929,dark,main,20220102,1,0.9920146248770387,282,18,53,353
11929,dark,main,20220102,2,0.9906938371278862,299,23,54,376
11929,dark,main,20220102,3,0.9875500872983259,291,16,50,357
11929,dark,main,20220102,4,0.9841168550972845,275,15,44,334
11929,dark,main,20220102,5,0.9903488391257302,288,13,46,347
11929,dark,main,20220102,6,0.9947522862165944,316,21,40,377
11929,dark,main,20220102,7,0.9915423403228649,254,31,43,328
11929,dark,main,20220102,8,0.98747843597259,297,17,61,375
11929,dark,main,20220102,9,0.9935232198637397,295,17,60,372
8750,dark,main,20220102,0,0.9856193651671975,317,11,59,387
8750,dark,main,20220102,1,0.9915441387306089,265,16,53,334
8750,dark,main,20220102,2,0.9890115764125311,307,18,64,389
8750,dark,main,20220102,3,0.9898873969814966,292,17,56,365
8750,dark,main,20220102,4,0.9947011854454023,266,15,49,330
8750,dark,main,20220102,5,0.9959287453652171,291,12,57,360
8750,dark,main,20220102,6,0.9939333521920404,287,15,61,363
8750,dark,main,20220102,7,0.9915136727495035,263,15,42,320
8750,dark,main,20220102,8,0.9932119269632003,286,16,78,380
8750,dark,main,20220102,9,0.9938021394368775,332,10,54,396
23330,bright,main,20220102,0,0.9939358869907016,347,70,6,423
23330,bright,main,20220102,1,0.992306404958238,319,54,6,379
23330,bright,main,20220102,2,0.9940845710172023,382,43,6,431
23330,bright,main,20220102,3,0.9927395572433582,347,46,5,398
23330,bright,main,20220102,4,0.9913217729357453,330,47,4,381
23330,bright,main,20220102,5,0.9927247583765609,338,53,4,395
23330,bright,main,20220102,6,0.9939803309473566,358,48,12,418
23330,bright,main,20220102,7,0.987617974052324,307,53,2,362
23330,bright,main,20220102,8,0.9902002174779249,358,49,5,412
23330,bright,main,20220102,9,0.993381708436876,371,40,6,417
10832,dark,main,20220102,0,0.9854524228361872,279,18,93,390
10832,dark,main,20220102,1,0.9898380857170656,244,14,79,337
10832,dark,main,20220102,2,0.9892503476848564,276,22,86,384
10832,dark,main,20220102,3,0.9887376944058589,244,15,82,341
10832,dark,main,20220102,4,0.9927395527523497,245,15,89,349
10832,dark,main,20220102,5,0.9912528951907149,259,16,88,363
10832,dark,main,20220102,6,0.9954961702150176,273,13,105,391
10832,dark,main,20220102,7,0.9918799837530728,228,18,88,334
10832,dark,main,20220102,8,0.9919590124329539,270,14,89,373
10832,dark,main,20220102,9,0.9944923165078783,264,18,100,382
3246,dark,main,20220102,0,0.9899733069629162,318,14,64,396
3246,dark,main,20220102,1,0.9920982735750125,320,12,34,366
3246,dark,main,20220102,2,0.9879302243768033,301,13,56,370
3246,dark,main,20220102,3,0.9909621308004937,281,10,52,343
3246,dark,main,20220102,4,0.9887264728297788,285,11,48,344
3246,dark,main,20220102,5,0.9905225240803669,317,16,42,375
3246,dark,main,20220102,6,0.9915348892975079,321,11,52,384
3246,dark,main,20220102,7,0.9919221899818372,286,12,38,336
3246,dark,main,20220102,8,0.9944634638885946,318,11,54,383
3246,dark,main,20220102,9,0.9886828762089986,320,13,61,394
7180,dark,main,20220102,0,0.9941660224465516,304,11,71,386
7180,dark,main,20220102,1,0.988968316025223,266,12,54,332
7180,dark,main,20220102,2,0.9912810382519623,309,13,67,389
7180,dark,main,20220102,3,0.9906940780459125,284,12,70,366
7180,dark,main,20220102,4,0.9911699867089774,266,13,56,335
7180,dark,main,20220102,5,0.9948152046335013,313,10,43,366
7180,dark,main,20220102,6,0.9921027936004899,325,10,39,374
7180,dark,main,20220102,7,0.9847684848025151,281,12,37,330
7180,dark,main,20220102,8,0.9861976804968196,286,20,66,372
7180,dark,main,20220102,9,0.9922735929405909,319,12,54,385
23714,bright,main,20220102,0,0.9919861824587489,273,126,5,404
23714,bright,main,20220102,1,0.994926788053531,269,108,4,381
23714,bright,main,20220102,2,0.994666378720888,287,122,5,414
23714,bright,main,20220102,3,0.9938028252448837,222,98,5,325
23714,bright,main,20220102,4,0.9955604455800876,275,86,4,365
23714,bright,main,20220102,5,0.9897086327308305,297,88,5,390
23714,bright,main,20220102,6,0.9950094226472997,302,98,5,405
23714,bright,main,20220102,7,0.9904429981633429,249,103,4,356
23714,bright,main,20220102,8,0.9937141957949062,305,92,6,403
23714,bright,main,20220102,9,0.9943947166330275,283,121,4,408
4700,dark,main,20220102,0,0.992192303594227,308,19,39,366
4700,dark,main,20220102,1,0.9920169131069321,260,14,46,320
4700,dark,main,20220102,2,0.9915742163009235,317,13,53,383
4700,dark,main,20220102,3,0.989248302664504,287,13,48,348
4700,dark,main,20220102,4,0.9935646174496662,270,22,60,352
4700,dark,main,20220102,5,0.9923180025570475,261,29,76,366
4700,dark,main,20220102,6,0.9915021142120037,281,18,86,385
4700,dark,main,20220102,7,0.9940231586470276,251,13,64,328
4700,dark,main,20220102,8,0.9899170832658452,286,26,63,375
4700,dark,main,20220102,9,0.9925624265018503,268,37,59,364
6381,dark,main,20220102,0,0.9897196838338004,302,16,86,404
6381,dark,main,20220102,1,0.9931418718027081,258,13,79,350
6381,dark,main,20220102,2,0.9939204378851674,311,15,70,396
6381,dark,main,20220102,3,0.991972727462402,282,11,62,355
6381,dark,main,20220102,4,0.9953309460154766,286,11,44,341
6381,dark,main,20220102,5,0.9868446481135137,309,10,39,358
6381,dark,main,20220102,6,0.993631721123643,307,11,64,382
6381,dark,main,20220102,7,0.9921183314845203,270,14,51,335
6381,dark,main,20220102,8,0.994720085900326,318,10,46,374
6381,dark,main,20220102,9,0.9932231593794354,308,12,68,388
10642,dark,main,20220103,0,0.9876874405954197,202,21,75,298
10642,dark,main,20220103,1,0.9874375346368216,209,21,69,299
10642,dark,main,20220103,2,0.98913147457212,269,17,97,383
10642,dark,main,20220103,3,0.9911857226650028,249,16,95,360
10642,dark,main,20220103,4,0.9908352309151046,256,17,83,356
10642,dark,main,20220103,5,0.9861694548949687,257,17,81,355
10642,dark,main,20220103,6,0.9930706274786937,261,31,93,385
10642,dark,main,20220103,7,0.9960821155732559,222,27,81,330
10642,dark,main,20220103,8,0.993016693231868,244,22,103,369
10642,dark,main,20220103,9,0.9895206818822649,240,24,78,342
2411,dark,main,20220103,0,0.9951525364142929,285,26,73,384
2411,dark,main,20220103,1,0.9952858160460907,256,34,69,359
2411,dark,main,20220103,2,0.9908061948416824,284,20,92,396
2411,dark,main,20220103,3,0.9840107223472715,252,25,80,357
2411,dark,main,20220103,4,0.9917536693649041,266,26,60,352
2411,dark,main,20220103,5,0.9941313872701277,284,17,68,369
2411,dark,main,20220103,6,0.9883697766709134,266,35,77,378
2411,dark,main,20220103,7,0.9963715164529849,259,27,42,328
2411,dark,main,20220103,8,0.9943652972601471,301,16,66,383
2411,dark,main,20220103,9,0.990770530495485,300,20,55,375
24182,bright,main,20220103,0,0.9936147173557228,359,64,7,430
24182,bright,main,20220103,1,0.9956537220978369,330,49,8,387
24182,bright,main,20220103,2,0.9953848275181704,323,89,5,417
24182,bright,main,20220103,3,0.9901931200719536,264,111,6,381
24182,bright,main,20220103,4,0.9938578426811627,301,80,4,385
24182,bright,main,20220103,5,0.9900809431426416,266,125,7,398
24182,bright,main,20220103,6,0.9943439502303136,311,95,2,408
24182,bright,main,20220103,7,0.9947784310921504,269,81,4,354
24182,bright,main,20220103,8,0.9944363789059524,327,80,5,412
24182,bright,main,20220103,9,0.9915890686158951,336,77,1,414
1994,dark,main,20220103,0,0.9953001102164087,315,18,50,383
1994,dark,main,20220103,1,0.9930460745058127,275,22,42,339
1994,dark,main,20220103,2,0.9942758694464721,332,17,37,386
1994,dark,main,20220103,3,0.9908393204529212,265,22,59,346
1994,dark,main,20220103,4,0.9893081546167602,274,18,50,342
1994,dark,main,20220103,5,0.9881013568601521,290,15,61,366
1994,dark,main,20220103,6,0.9935907721940455,304,22,59,385
1994,dark,main,20220103,7,0.9957587350948054,274,15,47,336
1994,dark,main,20220103,8,0.9948462574341048,292,16,46,354
1994,dark,main,20220103,9,0.9931779469814983,292,19,48,359
2836,dark,main,20220103,0,0.9929470819857708,239,22,121,382
2836,dark,main,20220103,1,0.9848546307882533,231,16,92,339
2836,dark,main,20220103,2,0.9919276182401294,281,20,96,397
2836,dark,main,20220103,3,0.993661565211003,258,14,84,356
2836,dark,main,20220103,4,0.9954709808037764,270,15,69,354
2836,dark,main,20220103,5,0.9874265641858417,265,14,96,375
2836,dark,main,20220103,6,0.9916249688415582,265,15,96,376
2836,dark,main,20220103,7,0.9905768616101718,245,15,82,342
2836,dark,main,20220103,8,0.9912461720764841,262,20,93,375
2836,dark,main,20220103,9,0.9932885236686757,269,22,94,385
23626,bright,main,20220103,0,0.9887107968351183,339,76,3,418
23626,bright,main,20220103,1,0.9896416674533502,308,69,8,385
23626,bright,main,20220103,2,0.9897736995771875,359,64,1,424
23626,bright,main,20220103,3,0.9950835429851818,314,68,2,384
23626,bright,main,20220103,4,0.9895209232617038,321,58,4,383
23626,bright,main,20220103,5,0.9877201434851984,340,61,5,406
23626,bright,main,20220103,6,0.9917990487639602,360,56,5,421
23626,bright,main,20220103,7,0.9902850223491023,291,55,6,352
23626,bright,main,20220103,8,0.9925591572783367,322,82,7,411
23626,bright,main,20220103,9,0.9933847089916279,363,56,7,426
23603,bright,main,20220103,0,0.9958913726754469,356,54,7,417
23603,bright,main,20220103,1,0.9958390751781707,308,62,2,372
23603,bright,main,20220103,2,0.9954479624411747,331,65,4,400
23603,bright,main,20220103,3,0.9882584773426641,291,72,3,366
23603,bright,main,20220103,4,0.99522337428403,287,56,6,349
23603,bright,main,20220103,5,0.9949132624896666,333,52,3,388
23603,bright,main,20220103,6,0.9838663183250363,319,73,8,400
23603,bright,main,20220103,7,0.9898038853429162,271,68,1,340
23603,bright,main,20220103,8,0.9892171766908319,331,55,4,390
23603,bright,main,20220103,9,0.983237663262794,334,70,4,408
7172,dark,main,20220103,0,0.9923671372055138,284,14,91,389
7172,dark,main,20220103,1,0.9908102533489878,248,17,74,339
7172,dark,main,20220103,2,0.991162590705911,295,16,93,404
7172,dark,main,20220103,3,0.9800393195066479,287,14,54,355
7172,dark,main,20220103,4,0.9914626013522663,273,10,58,341
7172,dark,main,20220103,5,0.9924580970777369,298,15,46,359
7172,dark,main,20220103,6,0.986246136577127,307,16,48,371
7172,dark,main,20220103,7,0.9872913892922935,227,14,54,295
7172,dark,main,20220103,8,0.9820026024218108,138,15,35,188
7172,dark,main,20220103,9,0.9910255557224386,258,20,92,370
8772,dark,main,20220103,0,0.9878321910947386,299,13,86,398
8772,dark,main,20220103,1,0.9929647875554763,262,12,84,358
8772,dark,main,20220103,2,0.9966343209529132,309,12,70,391
8772,dark,main,20220103,3,0.9913411782315726,270,17,72,359
8772,dark,main,20220103,4,0.9940097447453768,271,13,56,340
8772,dark,main,20220103,5,0.9912179952042409,305,12,57,374
8772,dark,main,20220103,6,0.9931581087675729,323,11,60,394
8772,dark,main,20220103,7,0.9863981986042769,290,11,35,336
8772,dark,main,20220103,8,0.9905685468768913,311,11,50,372
8772,dark,main,20220103,9,0.9880671292972875,305,16,70,391
2528,dark,main,20220103,0,0.9888088845180459,306,18,54,378
2528,dark,main,20220103,1,0.982943830384494,274,12,56,342
2528,dark,main,20220103,2,0.9924879750856579,273,20,90,383
2528,dark,main,20220103,3,0.989690341878281,265,14,82,361
2528,dark,main,20220103,4,0.9904110871474779,259,16,78,353
2528,dark,main,20220103,5,0.9895880369582276,282,14,84,380
2528,dark,main,20220103,6,0.9915468840949362,280,14,83,377
2528,dark,main,20220103,7,0.9913778037408251,274,10,50,334
2528,dark,main,20220103,8,0.9898148676149955,327,12,45,384
2528,dark,main,20220103,9,0.9928138522329921,309,13,58,380
10852,dark,main,20220103,0,0.9877584966501407,285,19,81,385
10852,dark,main,20220103,1,0.9941880601372369,252,23,65,340
10852,dark,main,20220103,2,0.978703774572891,269,21,89,379
10852,dark,main,20220103,3,0.9919349528689504,245,15,90,350
10852,dark,main,20220103,4,0.9884380532179484,241,21,90,352
10852,dark,main,20220103,5,0.9946484189031315,242,20,96,358
10852,dark,main,20220103,6,0.9937776809923816,260,17,96,373
10852,dark,main,20220103,7,0.9874435313271244,247,15,69,331
10852,dark,main,20220103,8,0.9928318191254006,241,18,97,356
10852,dark,main,20220103,9,0.9890265144636283,291,17,82,390
3231,dark,main,20220103,0,0.9915386072658569,300,14,67,381
3231,dark,main,20220103,1,0.9928169284586157,280,11,57,348
3231,dark,main,20220103,2,0.9865808876913121,310,14,69,393
3231,dark,main,20220103,3,0.9957372858826609,285,15,62,362
3231,dark,main,20220103,4,0.9898301518689863,282,18,46,346
3231,dark,main,20220103,5,0.991224430577955,285,11,74,370
3231,dark,main,20220103,6,0.9943002790395171,289,13,81,383
3231,dark,main,20220103,7,0.9867346753977155,264,17,54,335
3231,dark,main,20220103,8,0.9899215326491525,291,16,76,383
3231,dark,main,20220103,9,0.992039770097422,260,20,85,365
1575,dark,main,20220103,0,0.9893585939548852,271,19,90,380
1575,dark,main,20220103,1,0.9872981510122626,239,17,81,337
1575,dark,main,20220103,2,0.9916787154299622,294,22,75,391
1575,dark,main,20220103,3,0.9889281219254076,252,17,76,345
1575,dark,main,20220103,4,0.9875974543891065,255,15,68,338
1575,dark,main,20220103,5,0.9945322778045621,247,23,89,359
1575,dark,main,20220103,6,0.984929488023417,263,23,95,381
1575,dark,main,20220103,7,0.9846391698735842,237,19,76,332
1575,dark,main,20220103,8,0.9883414392782965,254,20,115,389
1575,dark,main,20220103,9,0.9912744859787334,276,19,87,382
8640,dark,main,20220103,0,0.995334515250373,330,20,44,394
8640,dark,main,20220103,1,0.9923596434899413,261,15,52,328
8640,dark,main,20220103,2,0.9887891961876029,315,12,44,371
8640,dark,main,20220103,3,0.9878778267415923,285,15,40,340
8640,dark,main,20220103,4,0.9913176178943336,288,10,46,344
8640,dark,main,20220103,5,0.988024147726581,303,14,41,358
8640,dark,main,20220103,6,0.9926807109651459,307,14,54,375
8640,dark,main,20220103,7,0.9888034275158383,244,20,67,331
8640,dark,main,20220103,8,0.987610501529647,297,19,63,379
8640,dark,main,20220103,9,0.9949759608169136,309,16,70,395
4816,dark,main,20220103,0,0.9900066495476959,327,12,52,391
4816,dark,main,20220103,1,0.9869695165681198,289,12,31,332
4816,dark,main,20220103,2,0.9946088057633033,346,11,39,396
4816,dark,main,20220103,3,0.9893678790255137,310,13,49,372
4816,dark,main,20220103,4,0.9864560904970111,268,14,70,352
4816,dark,main,20220103,5,0.9872107143653611,279,11,82,372
4816,dark,main,20220103,6,0.993157114091171,272,13,93,378
4816,dark,main,20220103,7,0.9895500179477588,266,12,62,340
4816,dark,main,20220103,8,0.9895515014765206,296,11,64,371
4816,dark,main,20220103,9,0.9932138491824697,289,16,81,386
10641,dark,main,20220103,0,0.9918692646249674,286,16,82,384
10641,dark,main,20220103,1,0.9917480637044167,270,11,77,358
10641,dark,main,20220103,2,0.990034099776053,329,14,45,388
10641,dark,main,20220103,3,0.9888063805973162,267,16,54,337
10641,dark,main,20220103,4,0.9913222679199111,280,16,58,354
10641,dark,main,20220103,5,0.9915876423405147,249,18,87,354
10641,dark,main,20220103,6,0.989918832544506,271,15,100,386
10641,dark,main,20220103,7,0.9911733317444598,247,18,74,339
10641,dark,main,20220103,8,0.9864825661478499,266,13,92,371
10641,dark,main,20220103,9,0.9935385817399006,259,16,100,375
8778,dark,main,20220103,0,0.9895479585084608,296,18,67,381
8778,dark,main,20220103,1,0.9848198977459477,286,13,43,342
8778,dark,main,20220103,2,0.9963536219029416,313,14,41,368
8778,dark,main,20220103,3,0.9923330789701158,273,13,48,334
8778,dark,main,20220103,4,0.9910687011919046,278,13,53,344
8778,dark,main,20220103,5,0.9949369473333552,312,12,48,372
8778,dark,main,20220103,6,0.9945554372798544,274,17,93,384
8778,dark,main,20220103,7,0.9922890408226054,233,21,79,333
8778,dark,main,20220103,8,0.9933488035035579,276,15,89,380
8778,dark,main,20220103,9,0.9871349817472995,281,17,90,388
5965,dark,main,20220103,0,0.9955044177529319,268,18,105,391
5965,dark,main,20220103,1,0.9944953414798712,255,15,68,338
5965,dark,main,20220103,2,0.9921002782710568,302,15,78,395
5965,dark,main,20220103,3,0.9961809228596243,269,17,75,361
5965,dark,main,20220103,4,0.9900812738241058,286,14,54,354
5965,dark,main,20220103,5,0.9946175138530323,307,12,63,382
5965,dark,main,20220103,6,0.9954483209371796,285,14,72,371
5965,dark,main,20220103,7,0.9892190692312384,239,16,89,344
5965,dark,main,20220103,8,0.9889283437966901,261,17,93,371
5965,dark,main,20220103,9,0.9889394464697591,280,15,89,384
82634,m31,special,20220103,0,0.9968938298954811,60,365,16,441
82634,m31,special,20220103,1,0.9907630105857836,50,346,9,405
82634,m31,special,20220103,2,0.9904797849939773,75,355,9,439
82634,m31,special,20220103,3,0.9878327136540953,30,362,7,399
82634,m31,special,20220103,4,0.9883854859286769,34,360,6,400
82634,m31,special,20220103,5,0.993722898439094,22,393,7,422
82634,m31,special,20220103,6,0.9940392922113435,59,368,10,437
82634,m31,special,20220103,7,0.9891458748456127,37,328,9,374
82634,m31,special,20220103,8,0.9926778866500591,32,380,12,424
82634,m31,special,20220103,9,0.991888138909284,35,392,10,437
3229,dark,main,20220103,0,0.9910075020306773,287,16,89,392
3229,dark,main,20220103,1,0.9898383264556778,249,12,86,347
3229,dark,main,20220103,2,0.9877871196252462,301,13,64,378
3229,dark,main,20220103,3,0.9931251509126855,288,12,73,373
3229,dark,main,20220103,4,0.9900140798064601,287,10,53,350
3229,dark,main,20220103,5,0.9895574484491677,280,16,65,361
3229,dark,main,20220103,6,0.991988698466912,286,14,70,370
3229,dark,main,20220103,7,0.9929526002150718,226,13,91,330
3229,dark,main,20220103,8,0.9882836187886623,283,17,76,376
3229,dark,main,20220103,9,0.9957574553522349,283,11,81,375
7743,dark,main,20220103,0,0.9922812864843112,282,17,90,389
7743,dark,main,20220103,1,0.9886142850711805,269,11,64,344
7743,dark,main,20220103,2,0.9916740909277857,326,12,57,395
7743,dark,main,20220103,3,0.9874561304101301,251,17,71,339
7743,dark,main,20220103,4,0.9924475796731873,254,17,87,358
7743,dark,main,20220103,5,0.9917262509032994,264,17,95,376
7743,dark,main,20220103,6,0.9892352660904575,273,16,95,384
7743,dark,main,20220103,7,0.9913108749036703,231,19,85,335
7743,dark,main,20220103,8,0.9930189827174253,274,14,92,380
7743,dark,main,20220103,9,0.9917055809931975,269,14,97,380
8278,dark,main,20220103,0,0.9965355415674254,314,15,76,405
8278,dark,main,20220103,1,0.9888956737322987,276,14,58,348
8278,dark,main,20220103,2,0.991690298915991,315,14,76,405
8278,dark,main,20220103,3,0.9925118232818261,262,15,79,356
8278,dark,main,20220103,4,0.9956049100669773,274,12,64,350
8278,dark,main,20220103,5,0.984895641024241,303,16,41,360
8278,dark,main,20220103,6,0.9901212850526933,313,11,59,383
8278,dark,main,20220103,7,0.9938872856327299,267,10,47,324
8278,dark,main,20220103,8,0.9901889107555104,320,10,43,373
8278,dark,main,20220103,9,0.9917173124857803,298,15,85,398
2531,dark,main,20220103,0,0.9908374842875817,330,23,35,388
2531,dark,main,20220103,1,0.990175310190921,282,14,44,340
2531,dark,main,20220103,2,0.9896784788648365,303,18,47,368
2531,dark,main,20220103,3,0.9882306378523674,282,19,43,344
2531,dark,main,20220103,4,0.9857441010468626,290,16,48,354
2531,dark,main,20220103,5,0.9918987360322336,306,20,44,370
2531,dark,main,20220103,6,0.9944427973567987,324,13,42,379
2531,dark,main,20220103,7,0.9944615399235176,276,14,44,334
2531,dark,main,20220103,8,0.9951881160269214,291,22,70,383
2531,dark,main,20220103,9,0.9932181804640575,323,15,52,390
2487,dark,main,20220103,0,0.9961645835961928,343,17,46,406
2487,dark,main,20220103,1,0.9922913445210421,281,14,37,332
2487,dark,main,20220103,2,0.9895987500526766,318,16,43,377
2487,dark,main,20220103,3,0.9917820078295919,285,11,56,352
2487,dark,main,20220103,4,0.9899821141736938,286,10,54,350
2487,dark,main,20220103,5,0.99194481627504,294,13,59,366
2487,dark,main,20220103,6,0.9904227386581176,324,10,53,387
2487,dark,main,20220103,7,0.9919913936630756,276,11,50,337
2487,dark,main,20220103,8,0.9865022631000989,328,13,45,386
2487,dark,main,20220103,9,0.9890860291919525,337,16,39,392
8785,dark,main,20220103,0,0.996215664476453,309,17,55,381
8785,dark,main,20220103,1,0.996534945962178,269,16,51,336
8785,dark,main,20220103,2,0.9885916232923956,299,15,61,375
8785,dark,main,20220103,3,0.9944633548779529,245,17,98,360
8785,dark,main,20220103,4,0.9897876991438793,299,13,45,357
8785,dark,main,20220103,5,0.9941632537102072,310,10,52,372
8785,dark,main,20220103,6,0.9920906886676452,305,14,60,379
8785,dark,main,20220103,7,0.9929946697869787,253,17,40,310
8785,dark,main,20220103,8,0.9914272519447402,289,14,38,341
8785,dark,main,20220103,9,0.9860763368130958,308,13,57,378
8786,dark,main,20220103,0,0.9945052193630859,312,12,48,372
8786,dark,main,20220103,1,0.9950636465927679,282,17,42,341
8786,dark,main,20220103,2,0.9924095839929307,320,15,55,390
8786,dark,main,20220103,3,0.9880354061128137,296,11,48,355
8786,dark,main,20220103,4,0.9923948591967946,282,15,52,349
8786,dark,main,20220103,5,0.9945605261497069,298,12,54,364
8786,dark,main,20220103,6,0.9960076980175759,311,11,59,381
8786,dark,main,20220103,7,0.9927924005394341,254,14,48,316
8786,dark,main,20220103,8,0.9935635339068853,292,14,66,372
8786,dark,main,20220103,9,0.9910362417950754,307,15,46,368
9514,dark,main,20220103,0,0.9901183972946953,320,14,45,379
9514,dark,main,20220103,1,0.9776230049606744,260,28,45,333
9514,dark,main,20220103,2,0.9927285562153166,304,14,43,361
9514,dark,main,20220103,3,0.9894190185756556,286,14,38,338
9514,dark,main,20220103,4,0.9847390051679275,302,12,34,348
9514,dark,main,20220103,5,0.9938065856904784,297,18,45,360
9514,dark,main,20220103,6,0.9901455541219789,320,10,51,381
9514,dark,main,20220103,7,0.9869822470439352,266,13,46,325
9514,dark,main,20220103,8,0.9947696325569052,295,15,51,361
9514,dark,main,20220103,9,0.9851420842272173,308,15,48,371
10355,dark,main,20220103,0,0.988709688753978,336,11,50,397
10355,dark,main,20220103,1,0.984400769379559,269,13,61,343
10355,dark,main,20220103,2,0.9913630611703853,284,21,77,382
10355,dark,main,20220103,3,0.9944502487521064,290,11,57,358
10355,dark,main,20220103,4,0.9913693434036153,276,18,59,353
10355,dark,main,20220103,5,0.9927582684745864,298,12,63,373
10355,dark,main,20220103,6,0.9936151253016696,312,19,43,374
10355,dark,main,20220103,7,0.9951922430117564,281,17,28,326
10355,dark,main,20220103,8,0.9911525494460639,319,24,30,373
10355,dark,main,20220103,9,0.9899828290511469,301,16,41,358
11082,dark,main,20220103,0,0.9939058461263922,299,14,60,373
11082,dark,main,20220103,1,0.9830315009532216,241,12,87,340
11082,dark,main,20220103,2,0.9880429861381811,265,21,91,377
11082,dark,main,20220103,3,0.9892284875976547,265,15,75,355
11082,dark,main,20220103,4,0.9946918858263698,282,9,54,345
11082,dark,main,20220103,5,0.9920080274616253,296,13,54,363
11082,dark,main,20220103,6,0.9887452749270068,304,14,55,373
11082,dark,main,20220103,7,0.9841781402119125,257,14,52,323
11082,dark,main,20220103,8,0.9870039951420504,292,13,54,359
11082,dark,main,20220103,9,0.9884657317962475,311,18,60,389
2362,dark,main,20220103,0,0.9897962053248907,323,13,39,375
2362,dark,main,20220103,1,0.9922911139785172,282,9,55,346
2362,dark,main,20220103,2,0.9950758348726769,323,14,58,395
2362,dark,main,20220103,3,0.9865847395289951,297,13,33,343
2362,dark,main,20220103,4,0.9919165065541888,281,12,45,338
2362,dark,main,20220103,5,0.9874306104385498,295,14,45,354
2362,dark,main,20220103,6,0.9915668380769068,303,14,46,363
2362,dark,main,20220103,7,0.9882121519790698,273,17,30,320
2362,dark,main,20220103,8,0.994885479981738,289,17,58,364
2362,dark,main,20220103,9,0.9890801716476657,299,16,50,365
2529,dark,main,20220103,0,0.9890506812856928,318,14,57,389
2529,dark,main,20220103,1,0.9931125740353252,287,21,59,367
2529,dark,main,20220103,2,0.9924283237893884,327,13,48,388
2529,dark,main,20220103,3,0.9854183205821145,282,13,53,348
2529,dark,main,20220103,4,0.9918162811184881,294,15,36,345
2529,dark,main,20220103,5,0.9911907434505085,313,18,35,366
2529,dark,main,20220103,6,0.9885841204679607,301,25,53,379
2529,dark,main,20220103,7,0.9889177892637426,265,15,41,321
2529,dark,main,20220103,8,0.9937758265136118,308,17,47,372
2529,dark,main,20220103,9,0.9965541966291821,314,15,49,378
21062,bright,main,20220103,0,0.9894119328694665,363,59,2,424
21062,bright,main,20220103,1,0.9920669416934758,314,64,5,383
21062,bright,main,20220103,2,0.9951619612877314,333,80,10,423
21062,bright,main,20220103,3,0.9938709886386071,261,112,5,378
21062,bright,main,20220103,4,0.9913930789171533,248,125,1,374
21062,bright,main,20220103,5,0.9908164443656968,302,84,4,390
21062,bright,main,20220103,6,0.9933030215532658,292,117,3,412
21062,bright,main,20220103,7,0.9962715235860896,263,80,5,348
21062,bright,main,20220103,8,0.9952836478364233,339,66,4,409
21062,bright,main,20220103,9,0.9925836946348569,363,53,6,422
5281,dark,main,20220103,0,0.9912831882822316,298,14,58,370
5281,dark,main,20220103,1,0.9903926569193815,270,24,50,344
5281,dark,main,20220103,2,0.9942153325660522,319,20,36,375
5281,dark,main,20220103,3,0.98901244333135,274,18,40,332
5281,dark,main,20220103,4,0.9904070515877512,273,31,26,330
5281,dark,main,20220103,5,0.9922079269390338,302,15,38,355
5281,dark,main,20220103,6,0.99289414352374,316,13,45,374
5281,dark,main,20220103,7,0.9886504777607508,257,17,50,324
5281,dark,main,20220103,8,0.9876637549136282,286,22,42,350
5281,dark,main,20220103,9,0.9914358289431651,286,19,52,357
10190,dark,main,20220103,0,0.9895525155842463,300,12,48,360
10190,dark,main,20220103,1,0.9919450537688542,277,18,29,324
10190,dark,main,20220103,2,0.9889064603226182,317,16,47,380
10190,dark,main,20220103,3,0.9919220985840015,287,21,42,350
10190,dark,main,20220103,4,0.9913218158796246,278,14,48,340
10190,dark,main,20220103,5,0.9924029735224665,287,12,43,342
10190,dark,main,20220103,6,0.9895173622953983,330,15,36,381
10190,dark,main,20220103,7,0.9893397602009616,247,20,51,318
10190,dark,main,20220103,8,0.9907838418356495,282,23,71,376
10190,dark,main,20220103,9,0.9938190036251806,299,17,67,383
3244,dark,main,20220103,0,0.9888751499362253,315,13,53,381
3244,dark,main,20220103,1,0.9942417547575251,271,14,55,340
3244,dark,main,20220103,2,0.992832541275877,332,14,39,385
3244,dark,main,20220103,3,0.9886806523907681,280,11,57,348
3244,dark,main,20220103,4,0.9896352857047181,285,12,44,341
3244,dark,main,20220103,5,0.9916223026852815,296,9,58,363
3244,dark,main,20220103,6,0.9889923142901939,270,17,89,376
3244,dark,main,20220103,7,0.9899476623496443,259,15,44,318
3244,dark,main,20220103,8,0.988112247189192,303,15,57,375
3244,dark,main,20220103,9,0.9954006915777877,308,12,53,373
21052,bright,main,20220103,0,0.9957891191913992,302,114,4,420
21052,bright,main,20220103,1,0.9949489938166428,248,132,6,386
21052,bright,main,20220103,2,0.9906081650300173,291,128,3,422
21052,bright,main,20220103,3,0.9907027859200711,259,112,6,377
21052,bright,main,20220103,4,0.9899552106807783,302,79,5,386
21052,bright,main,20220103,5,0.9937681311076029,304,80,6,390
21052,bright,main,20220103,6,0.9906640263413679,344,61,8,413
21052,bright,main,20220103,7,0.9875961041160312,300,61,4,365
21052,bright,main,20220103,8,0.9948698698740237,338,67,3,408
21052,bright,main,20220103,9,0.9964165818921975,318,86,0,404
1715,dark,main,20220104,0,0.9932098994664046,325,11,49,385
1715,dark,main,20220104,1,0.9928520215155826,285,13,37,335
1715,dark,main,20220104,2,0.9944367854780145,329,9,32,370
1715,dark,main,20220104,3,0.9885537235121605,310,11,34,355
1715,dark,main,20220104,4,0.9866446911955127,287,12,43,342
1715,dark,main,20220104,5,0.9913707770107407,297,10,46,353
1715,dark,main,20220104,6,0.9925441416426765,314,13,55,382
1715,dark,main,20220104,7,0.9925441416426765,314,13,55,382
1715,dark,main,20220104,8,0.9839124780800265,280,14,68,362
1715,dark,main,20220104,9,0.9959660077170838,325,13,37,375
8779,dark,main,20220104,0,0.9920048722144281,323,14,50,387
8779,dark,main,20220104,1,0.9868235838921592,274,15,48,337
8779,dark,main,20220104,2,0.9854598502934226,271,16,91,378
8779,dark,main,20220104,3,0.9930395354137076,267,18,76,361
8779,dark,main,20220104,4,0.992909269060759,242,16,89,347
8779,dark,main,20220104,5,0.9878674144132062,251,16,93,360
8779,dark,main,20220104,6,0.9932760271430119,288,21,81,390
8779,dark,main,20220104,7,0.9932760271430119,288,21,81,390
8779,dark,main,20220104,8,0.9914919597071435,312,13,51,376
8779,dark,main,20220104,9,0.9962218541239691,323,10,44,377
8777,dark,main,20220104,0,0.9919502621807863,308,15,72,395
8777,dark,main,20220104,1,0.9849050809628979,264,17,60,341
8777,dark,main,20220104,2,0.9936226790669666,304,12,44,360
8777,dark,main,20220104,3,0.9866165305279538,307,11,37,355
8777,dark,main,20220104,4,0.993252999943092,272,13,54,339
8777,dark,main,20220104,5,0.9859201674411358,285,16,67,368
8777,dark,main,20220104,6,0.9919515849603467,293,14,77,384
8777,dark,main,20220104,7,0.9919515849603467,293,14,77,384
8777,dark,main,20220104,8,0.9930124311469856,311,14,45,370
8777,dark,main,20220104,9,0.9954595996574528,311,15,37,363
1577,dark,main,20220104,0,0.9916704219095667,255,18,86,359
1577,dark,main,20220104,1,0.9905504678903606,238,15,84,337
1577,dark,main,20220104,2,0.9887844638057058,256,19,106,381
1577,dark,main,20220104,3,0.9871269270124465,266,11,79,356
1577,dark,main,20220104,4,0.9926761301064784,232,16,83,331
1577,dark,main,20220104,5,0.9926257440673808,239,24,97,360
1577,dark,main,20220104,6,0.9903085936972955,260,20,89,369
1577,dark,main,20220104,7,0.9903085936972955,260,20,89,369
1577,dark,main,20220104,8,0.9904107815544301,252,18,87,357
1577,dark,main,20220104,9,0.9897762184674187,280,16,74,370
11068,dark,main,20220104,0,0.9871518250854872,281,17,75,373
11068,dark,main,20220104,1,0.988922899342699,263,22,57,342
11068,dark,main,20220104,2,0.9963611072411399,321,18,46,385
11068,dark,main,20220104,3,0.9892250081372093,284,10,38,332
11068,dark,main,20220104,4,0.9929222619289358,286,14,41,341
11068,dark,main,20220104,5,0.993144669927328,285,11,53,349
11068,dark,main,20220104,6,0.9926261807256039,256,20,83,359
11068,dark,main,20220104,7,0.9926261807256039,256,20,83,359
11068,dark,main,20220104,8,0.9830549167671763,257,16,83,356
11068,dark,main,20220104,9,0.9879787384183925,222,31,51,304
3284,dark,main,20220104,0,0.9956742208070466,320,11,56,387
3284,dark,main,20220104,1,0.9913723186478873,276,12,52,340
3284,dark,main,20220104,2,0.9892939951013923,302,12,63,377
3284,dark,main,20220104,3,0.9923780753684146,277,14,66,357
3284,dark,main,20220104,4,0.9973542028496385,272,13,57,342
3284,dark,main,20220104,5,0.9933994182772624,289,12,62,363
3284,dark,main,20220104,6,0.988877018996148,285,13,81,379
3284,dark,main,20220104,7,0.988877018996148,285,13,81,379
3284,dark,main,20220104,8,0.9937549369980692,308,12,56,376
3284,dark,main,20220104,9,0.9945064224448459,276,17,85,378
5500,dark,main,20220104,0,0.9921607163091881,322,20,49,391
5500,dark,main,20220104,1,0.993917588986964,287,16,48,351
5500,dark,main,20220104,2,0.9919955383978717,296,23,84,403
5500,dark,main,20220104,3,0.9899720912926226,276,20,83,379
5500,dark,main,20220104,4,0.9962116942977941,259,17,76,352
5500,dark,main,20220104,5,0.9897500999120352,267,15,85,367
5500,dark,main,20220104,6,0.9878003173909886,290,17,81,388
5500,dark,main,20220104,7,0.9878003173909886,290,17,81,388
5500,dark,main,20220104,8,0.9933918580697545,271,21,93,385
5500,dark,main,20220104,9,0.9934387137137853,326,13,49,388
10187,dark,main,20220104,0,0.996172253812964,304,15,78,397
10187,dark,main,20220104,1,0.992828804129384,263,19,53,335
10187,dark,main,20220104,2,0.9902811406966254,287,18,78,383
10187,dark,main,20220104,3,0.9969102514643741,251,19,72,342
10187,dark,main,20220104,4,0.9944052352837478,270,18,62,350
10187,dark,main,20220104,5,0.9907178147152063,267,17,76,360
10187,dark,main,20220104,6,0.9892146536064301,286,19,73,378
10187,dark,main,20220104,7,0.9892146536064301,286,19,73,378
10187,dark,main,20220104,8,0.9927264414877269,286,20,66,372
10187,dark,main,20220104,9,0.9939043181658752,323,15,45,383
3263,dark,main,20220104,0,0.9963040706002633,314,17,48,379
3263,dark,main,20220104,1,0.9883460162894927,290,14,40,344
3263,dark,main,20220104,2,0.9806377072490127,302,13,60,375
3263,dark,main,20220104,3,0.9911145667957213,282,17,59,358
3263,dark,main,20220104,4,0.9922990917623835,275,16,76,367
3263,dark,main,20220104,5,0.9934902679022993,292,14,60,366
3263,dark,main,20220104,6,0.9906959143290087,290,12,79,381
3263,dark,main,20220104,7,0.9906959143290087,290,12,79,381
3263,dark,main,20220104,8,0.9924738636744557,309,14,33,356
3263,dark,main,20220104,9,0.9920683508709612,332,14,35,381
2544,dark,main,20220104,0,0.9916953282581242,315,14,61,390
2544,dark,main,20220104,1,0.9944866585379499,283,20,39,342
2544,dark,main,20220104,2,0.9856511883894558,292,27,41,360
2544,dark,main,20220104,3,0.9925496620755339,287,17,55,359
2544,dark,main,20220104,4,0.9917811216894952,266,16,51,333
2544,dark,main,20220104,5,0.9955084455456045,270,14,77,361
2544,dark,main,20220104,6,0.9922084289997073,268,18,87,373
2544,dark,main,20220104,7,0.9922084289997073,268,18,87,373
2544,dark,main,20220104,8,0.9878079557466163,267,23,82,372
2544,dark,main,20220104,9,0.9940268092893251,289,17,81,387
5972,dark,main,20220104,0,0.9950954780631306,281,19,89,389
5972,dark,main,20220104,1,0.9934769708279542,275,12,60,347
5972,dark,main,20220104,2,0.989842078109383,330,10,55,395
5972,dark,main,20220104,3,0.9877199440800524,268,20,56,344
5972,dark,main,20220104,4,0.9908957938761052,274,11,55,340
5972,dark,main,20220104,5,0.9917743630533711,268,14,89,371
5972,dark,main,20220104,6,0.9974700299881789,273,21,85,379
5972,dark,main,20220104,7,0.9974700299881789,273,21,85,379
5972,dark,main,20220104,8,0.9923870844743804,271,17,87,375
5972,dark,main,20220104,9,0.9904349766793602,281,19,86,386
7838,dark,main,20220104,0,0.9904474776686516,299,21,68,388
7838,dark,main,20220104,1,0.98718974737243,283,15,42,340
7838,dark,main,20220104,2,0.983570851736514,298,26,49,373
7838,dark,main,20220104,3,0.9883583900549302,263,32,50,345
7838,dark,main,20220104,4,0.9894470036091844,257,29,49,335
7838,dark,main,20220104,5,0.9945235676872567,289,18,61,368
7838,dark,main,20220104,6,0.9927077945422164,279,26,79,384
7838,dark,main,20220104,7,0.9927077945422164,279,26,79,384
7838,dark,main,20220104,8,0.9906339573136013,297,19,61,377
7838,dark,main,20220104,9,0.9896258565697575,315,16,46,377
23712,bright,main,20220104,0,0.9922053981178334,331,91,3,425
23712,bright,main,20220104,1,0.99091838911446,294,87,6,387
23712,bright,main,20220104,2,0.9961869246108024,282,128,6,416
23712,bright,main,20220104,3,0.9931485180858335,276,111,4,391
23712,bright,main,20220104,4,0.9888621061979675,289,86,7,382
23712,bright,main,20220104,5,0.9939993679663158,332,67,2,401
23712,bright,main,20220104,6,0.9938054811734832,323,88,4,415
23712,bright,main,20220104,7,0.9878405208738367,272,98,2,372
23712,bright,main,20220104,8,0.9842208376879108,292,109,8,409
23712,bright,main,20220104,9,0.9925909715165524,296,112,5,413
3148,dark,main,20220104,0,0.9896470087106823,222,18,82,322
3148,dark,main,20220104,1,0.9918567609497501,246,14,77,337
3148,dark,main,20220104,2,0.9954738140678465,277,16,88,381
3148,dark,main,20220104,3,0.9905068503118573,244,20,85,349
3148,dark,main,20220104,4,0.9958633982723697,251,15,82,348
3148,dark,main,20220104,5,0.9859990611506159,250,21,89,360
3148,dark,main,20220104,6,0.9923377148998918,270,19,96,385
3148,dark,main,20220104,7,0.994900554906602,237,18,72,327
3148,dark,main,20220104,8,0.9948265090507781,259,18,88,365
3148,dark,main,20220104,9,0.9877178940348387,244,20,85,349
10836,dark,main,20220104,0,0.9948598564152173,254,19,115,388
10836,dark,main,20220104,1,0.9883675631655526,243,20,91,354
10836,dark,main,20220104,2,0.9905376916638721,290,14,86,390
10836,dark,main,20220104,3,0.9926441981453288,257,14,87,358
10836,dark,main,20220104,4,0.9912975374564803,256,18,82,356
10836,dark,main,20220104,5,0.9871493062181842,288,16,68,372
10836,dark,main,20220104,6,0.9923300647542863,288,16,76,380
10836,dark,main,20220104,7,0.9923300647542863,288,16,76,380
10836,dark,main,20220104,8,0.993403623008749,271,14,88,373
10836,dark,main,20220104,9,0.9894616017364396,267,15,104,386
8776,dark,main,20220104,0,0.9902716497565205,314,15,55,384
8776,dark,main,20220104,1,0.9872251775791823,286,12,40,338
8776,dark,main,20220104,2,0.9880230047671678,294,15,49,358
8776,dark,main,20220104,3,0.9949543097377143,298,15,39,352
8776,dark,main,20220104,4,0.9830722244414994,278,11,48,337
8776,dark,main,20220104,5,0.9932144936685418,282,15,53,350
8776,dark,main,20220104,6,0.9907959833241378,278,20,81,379
8776,dark,main,20220104,7,0.9907959833241378,278,20,81,379
8776,dark,main,20220104,8,0.9915450151473055,265,19,93,377
8776,dark,main,20220104,9,0.9965709069105211,287,14,73,374
2385,dark,main,20220104,0,0.9886793884111148,308,21,55,384
2385,dark,main,20220104,1,0.990969612677364,262,15,64,341
2385,dark,main,20220104,2,0.988720707845436,274,22,90,386
2385,dark,main,20220104,3,0.9927223425300618,273,20,61,354
2385,dark,main,20220104,4,0.9956765104644061,263,13,66,342
2385,dark,main,20220104,5,0.9870459486358806,290,23,57,370
2385,dark,main,20220104,6,0.9942048214099727,297,24,45,366
2385,dark,main,20220104,7,0.9942048214099727,297,24,45,366
2385,dark,main,20220104,8,0.9888368420998923,305,18,41,364
2385,dark,main,20220104,9,0.9893264151897333,307,16,41,364
2482,dark,main,20220104,0,0.9914542314371547,301,18,79,398
2482,dark,main,20220104,1,0.9892653546826825,281,15,58,354
2482,dark,main,20220104,2,0.9907698840838799,343,11,43,397
2482,dark,main,20220104,3,0.9908263838300558,308,11,42,361
2482,dark,main,20220104,4,0.9918132636332946,296,13,40,349
2482,dark,main,20220104,5,0.9890274448839467,314,11,38,363
2482,dark,main,20220104,6,0.9938555995018401,322,16,46,384
2482,dark,main,20220104,7,0.9938555995018401,322,16,46,384
2482,dark,main,20220104,8,0.992854180507321,328,10,36,374
2482,dark,main,20220104,9,0.9916674965617073,320,16,64,400
8800,dark,main,20220104,0,0.9899843052766168,317,13,58,388
8800,dark,main,20220104,1,0.9898854141368775,282,11,37,330
8800,dark,main,20220104,2,0.9944283226916425,320,15,42,377
8800,dark,main,20220104,3,0.9889544891508445,303,13,45,361
8800,dark,main,20220104,4,0.9910708201726881,286,12,40,338
8800,dark,main,20220104,5,0.9907074285384625,294,15,35,344
8800,dark,main,20220104,6,0.9929006813634844,331,15,39,385
8800,dark,main,20220104,7,0.9929006813634844,331,15,39,385
8800,dark,main,20220104,8,0.993326875513754,301,12,48,361
8800,dark,main,20220104,9,0.9901912579833825,310,17,58,385
4620,dark,main,20220104,0,0.9895028979311351,267,15,103,385
4620,dark,main,20220104,1,0.9924454782193858,234,16,90,340
4620,dark,main,20220104,2,0.9936606397877368,270,16,92,378
4620,dark,main,20220104,3,0.9958002562515502,236,18,108,362
4620,dark,main,20220104,4,0.9932521342121258,235,24,89,348
4620,dark,main,20220104,5,0.9896279620247616,260,16,89,365
4620,dark,main,20220104,6,0.9922858273406431,262,18,96,376
4620,dark,main,20220104,7,0.9922858273406431,262,18,96,376
4620,dark,main,20220104,8,0.9914702387008455,291,16,71,378
4620,dark,main,20220104,9,0.9881016156165239,303,15,80,398
2485,dark,main,20220104,0,0.9961749702901402,323,13,60,396
2485,dark,main,20220104,1,0.9886175770357463,277,14,53,344
2485,dark,main,20220104,2,0.9961488739172929,312,13,51,376
2485,dark,main,20220104,3,0.9878033673820185,299,11,44,354
2485,dark,main,20220104,4,0.9942940557297146,293,10,42,345
2485,dark,main,20220104,5,0.9957223112169835,315,17,43,375
2485,dark,main,20220104,6,0.988662382785883,326,12,34,372
2485,dark,main,20220104,7,0.988662382785883,326,12,34,372
2485,dark,main,20220104,8,0.9855667931243419,296,11,55,362
2485,dark,main,20220104,9,0.9957672131540756,316,11,49,376
10823,dark,main,20220104,0,0.9899239259676443,291,16,87,394
10823,dark,main,20220104,1,0.990434446514437,255,18,75,348
10823,dark,main,20220104,2,0.9933169035288507,251,18,124,393
10823,dark,main,20220104,3,0.9943110851967509,198,18,90,306
10823,dark,main,20220104,4,0.9830707552852371,256,15,84,355
10823,dark,main,20220104,5,0.992276727712889,263,15,95,373
10823,dark,main,20220104,6,0.9930955591127723,274,18,96,388
10823,dark,main,20220104,7,0.9930955591127723,274,18,96,388
10823,dark,main,20220104,8,0.9901552074216169,266,17,87,370
10823,dark,main,20220104,9,0.9952330315254025,242,19,111,372
3232,dark,main,20220104,0,0.9939170395268058,274,18,84,376
3232,dark,main,20220104,1,0.9892990819205595,269,17,76,362
3232,dark,main,20220104,2,0.9865397450021217,321,12,58,391
3232,dark,main,20220104,3,0.990688925312567,248,16,91,355
3232,dark,main,20220104,4,0.9899945936909407,250,17,89,356
3232,dark,main,20220104,5,0.993443938711497,274,22,78,374
3232,dark,main,20220104,6,0.98533413878033,253,19,103,375
3232,dark,main,20220104,7,0.98533413878033,253,19,103,375
3232,dark,main,20220104,8,0.9917004883699162,259,24,84,367
3232,dark,main,20220104,9,0.9889488261210184,296,19,64,379
11867,dark,main,20220104,0,0.9931626853843779,320,14,70,404
11867,dark,main,20220104,1,0.9928384542853651,275,9,59,343
11867,dark,main,20220104,2,0.9955692650637883,312,13,57,382
11867,dark,main,20220104,3,0.9881632975259512,288,13,62,363
11867,dark,main,20220104,4,0.9905230984707112,279,9,60,348
11867,dark,main,20220104,5,0.9912163283747044,277,13,87,377
11867,dark,main,20220104,6,0.9885484977629057,290,12,88,390
11867,dark,main,20220104,7,0.9885484977629057,290,12,88,390
11867,dark,main,20220104,8,0.9935379138978208,261,15,86,362
11867,dark,main,20220104,9,0.9944880312664407,296,12,63,371
9290,dark,main,20220104,0,0.9888727431378471,313,13,58,384
9290,dark,main,20220104,1,0.9946025497950168,271,12,54,337
9290,dark,main,20220104,2,0.9921397852323062,269,16,116,401
9290,dark,main,20220104,3,0.9896720643905462,252,14,85,351
9290,dark,main,20220104,4,0.9893128325084034,240,11,90,341
9290,dark,main,20220104,5,0.9917324360577925,271,18,76,365
9290,dark,main,20220104,6,0.9844834970193839,287,14,85,386
9290,dark,main,20220104,7,0.9844834970193839,287,14,85,386
9290,dark,main,20220104,8,0.9908101443595391,307,13,46,366
9290,dark,main,20220104,9,0.983437521009874,310,12,62,384
24162,bright,main,20220104,0,0.9924418947530883,330,91,4,425
24162,bright,main,20220104,1,0.990026452727802,253,76,2,331
24162,bright,main,20220104,2,0.9951046230152629,320,97,5,422
24162,bright,main,20220104,3,0.9930783803258995,314,60,9,383
24162,bright,main,20220104,4,0.9937997278740035,305,76,4,385
24162,bright,main,20220104,5,0.9904295085505448,271,112,5,388
24162,bright,main,20220104,6,0.9896844944056632,318,91,7,416
24162,bright,main,20220104,7,0.9896844944056632,318,91,7,416
24162,bright,main,20220104,8,0.9965379253229597,290,111,6,407
24162,bright,main,20220104,9,0.9949333034130349,328,85,5,418
11505,dark,main,20220104,0,0.9920577940897881,272,25,91,388
11505,dark,main,20220104,1,0.9954084417159607,260,20,66,346
11505,dark,main,20220104,2,0.9918807018960727,277,23,89,389
11505,dark,main,20220104,3,0.993231816703649,252,16,94,362
11505,dark,main,20220104,4,0.9909505720396165,250,15,84,349
11505,dark,main,20220104,5,0.9953547790242561,244,16,100,360
11505,dark,main,20220104,6,0.9877495442586983,280,17,85,382
11505,dark,main,20220104,7,0.9877495442586983,280,17,85,382
11505,dark,main,20220104,8,0.9917508285124653,275,16,91,382
11505,dark,main,20220104,9,0.9932940133328345,248,17,109,374
4040,dark,main,20220105,0,0.9867204981359987,326,13,52,391
4040,dark,main,20220105,1,0.9862620957905586,297,12,40,349
4040,dark,main,20220105,2,0.9916421280451655,324,13,52,389
4040,dark,main,20220105,3,0.9898587075375048,328,12,23,363
4040,dark,main,20220105,4,0.9926973011287044,311,9,37,357
4040,dark,main,20220105,5,0.9904165987842004,326,10,49,385
4040,dark,main,20220105,6,0.9923632727646851,334,11,43,388
4040,dark,main,20220105,7,0.9867256132305572,264,13,54,331
4040,dark,main,20220105,8,0.9927522168250033,296,13,73,382
4040,dark,main,20220105,9,0.9902187171486935,297,12,86,395
2480,dark,main,20220105,0,0.9888566392879442,333,17,56,406
2480,dark,main,20220105,1,0.9929140557633577,293,13,53,359
2480,dark,main,20220105,2,0.9923314516668086,342,10,56,408
2480,dark,main,20220105,3,0.9854435604993486,292,13,58,363
2480,dark,main,20220105,4,0.9962133854604271,306,15,39,360
2480,dark,main,20220105,5,0.9884125707967533,312,8,41,361
2480,dark,main,20220105,6,0.9874552372010555,313,9,45,367
2480,dark,main,20220105,7,0.9941593911491761,272,14,38,324
2480,dark,main,20220105,8,0.9911651848073367,317,11,45,373
2480,dark,main,20220105,9,0.9929375994987863,322,9,55,386
3932,dark,main,20220105,0,0.9936672178326348,307,19,65,391
3932,dark,main,20220105,1,0.9928534178615276,262,16,71,349
3932,dark,main,20220105,2,0.9957877255511473,284,22,65,371
3932,dark,main,20220105,3,0.9927958721399329,276,17,62,355
3932,dark,main,20220105,4,0.9928508114442272,259,11,61,331
3932,dark,main,20220105,5,0.993174204356905,307,13,45,365
3932,dark,main,20220105,6,0.9947967864683435,301,10,50,361
3932,dark,main,20220105,7,0.9900707776366708,277,15,28,320
3932,dark,main,20220105,8,0.994731387055389,310,15,51,376
3932,dark,main,20220105,9,0.9923677339489756,312,12,51,375
10818,dark,main,20220105,0,0.9963942512512908,278,14,95,387
10818,dark,main,20220105,1,0.9958128205628385,254,14,87,355
10818,dark,main,20220105,2,0.9941968949318529,274,14,91,379
10818,dark,main,20220105,3,0.9923533414199652,248,13,92,353
10818,dark,main,20220105,4,0.9892148146669881,262,11,71,344
10818,dark,main,20220105,5,0.9805126969222753,234,17,96,347
10818,dark,main,20220105,6,0.994635472236777,265,14,92,371
10818,dark,main,20220105,7,0.987998374863076,217,13,97,327
10818,dark,main,20220105,8,0.9949168847403291,266,16,85,367
10818,dark,main,20220105,9,0.9962411109492277,263,26,100,389
11355,dark,main,20220105,0,0.9896789690353953,318,21,63,402
11355,dark,main,20220105,1,0.9920760296345507,284,12,41,337
11355,dark,main,20220105,2,0.9885871308521539,316,12,47,375
11355,dark,main,20220105,3,0.9911947616186518,278,12,53,343
11355,dark,main,20220105,4,0.9917069835176501,283,9,41,333
11355,dark,main,20220105,5,0.9909883709138715,288,21,47,356
11355,dark,main,20220105,6,0.989448176011127,297,21,46,364
11355,dark,main,20220105,7,0.9900422984754833,251,11,61,323
11355,dark,main,20220105,8,0.9942991964231382,310,21,43,374
11355,dark,main,20220105,9,0.9878977255502024,293,15,47,355
5666,dark,main,20220105,0,0.9929321106916458,298,12,81,391
5666,dark,main,20220105,1,0.9827109330852606,306,14,42,362
5666,dark,main,20220105,2,0.9928509072351812,313,13,77,403
5666,dark,main,20220105,3,0.9961853789723659,236,17,106,359
5666,dark,main,20220105,4,0.9877469074119166,283,12,65,360
5666,dark,main,20220105,5,0.9874757439748074,258,20,92,370
5666,dark,main,20220105,6,0.9919545115392623,275,17,97,389
5666,dark,main,20220105,7,0.9902768614315994,242,13,79,334
5666,dark,main,20220105,8,0.9914424223950558,283,22,77,382
5666,dark,main,20220105,9,0.995040713373605,260,18,106,384
8771,dark,main,20220105,0,0.9941123619464027,306,12,47,365
8771,dark,main,20220105,1,0.9804833206154169,275,13,57,345
8771,dark,main,20220105,2,0.9928765058431767,326,11,58,395
8771,dark,main,20220105,3,0.9874935902676955,286,10,46,342
8771,dark,main,20220105,4,0.9946906295014137,289,15,49,353
8771,dark,main,20220105,5,0.9894650668195818,292,13,61,366
8771,dark,main,20220105,6,0.9906143508953065,327,13,62,402
8771,dark,main,20220105,7,0.9943146071960035,240,18,77,335
8771,dark,main,20220105,8,0.9943613059006906,270,17,93,380
8771,dark,main,20220105,9,0.994880429743792,303,12,69,384
7135,dark,main,20220105,0,0.9934429290891543,319,12,48,379
7135,dark,main,20220105,1,0.990463037502438,307,12,48,367
7135,dark,main,20220105,2,0.994535866282976,332,12,55,399
7135,dark,main,20220105,3,0.9897761249996136,287,13,63,363
7135,dark,main,20220105,4,0.9901631479125332,301,11,38,350
7135,dark,main,20220105,5,0.9930227844142369,305,13,39,357
7135,dark,main,20220105,6,0.9940539469771795,303,12,56,371
7135,dark,main,20220105,7,0.9936308163224321,260,12,59,331
7135,dark,main,20220105,8,0.9913372549634766,319,14,67,400
7135,dark,main,20220105,9,0.9901621655009482,314,15,53,382
10873,dark,main,20220105,0,0.9914444968908962,309,12,57,378
10873,dark,main,20220105,1,0.9924759280177067,278,13,52,343
10873,dark,main,20220105,2,0.9960942577003847,309,13,60,382
10873,dark,main,20220105,3,0.9951057929701299,297,15,51,363
10873,dark,main,20220105,4,0.9932900344799787,256,13,75,344
10873,dark,main,20220105,5,0.9896339722439957,282,17,69,368
10873,dark,main,20220105,6,0.9937350458875787,302,13,82,397
10873,dark,main,20220105,7,0.9853561799317481,233,13,82,328
10873,dark,main,20220105,8,0.9899827100960754,276,17,84,377
10873,dark,main,20220105,9,0.9917881514925441,295,17,60,372
4598,dark,main,20220105,0,0.9853076355991683,291,11,79,381
4598,dark,main,20220105,1,0.9890614122637262,250,15,83,348
4598,dark,main,20220105,2,0.9916367453844707,286,17,82,385
4598,dark,main,20220105,3,0.9896439658708243,266,13,78,357
4598,dark,main,20220105,4,0.9948123141785069,252,19,67,338
4598,dark,main,20220105,5,0.9943934016466541,267,15,81,363
4598,dark,main,20220105,6,0.9934097850882581,277,20,79,376
4598,dark,main,20220105,7,0.9954352991555891,223,18,81,322
4598,dark,main,20220105,8,0.9912038278184057,272,16,81,369
4598,dark,main,20220105,9,0.9863601865915983,267,20,94,381
9299,dark,main,20220105,0,0.9953411217615896,279,14,93,386
9299,dark,main,20220105,1,0.9932417334448979,243,17,89,349
9299,dark,main,20220105,2,0.9888524572431039,297,15,77,389
9299,dark,main,20220105,3,0.9925618417732311,262,15,80,357
9299,dark,main,20220105,4,0.9805828650528148,239,10,87,336
9299,dark,main,20220105,5,0.9928642657661703,283,13,78,374
9299,dark,main,20220105,6,0.9888882980233166,275,16,93,384
9299,dark,main,20220105,7,0.9879228905277311,246,18,75,339
9299,dark,main,20220105,8,0.9926998177725351,267,15,87,369
9299,dark,main,20220105,9,0.9947022160339082,245,16,111,372
7062,dark,main,20220105,0,0.9795146324896586,312,31,33,376
7062,dark,main,20220105,1,0.9911865737267627,302,14,27,343
7062,dark,main,20220105,2,0.9940050212999904,295,16,47,358
7062,dark,main,20220105,3,0.9838842990915931,263,17,68,348
7062,dark,main,20220105,4,0.9927309130528118,265,15,59,339
7062,dark,main,20220105,5,0.9943813999362471,290,21,41,352
7062,dark,main,20220105,6,0.9904256029401594,297,19,63,379
7062,dark,main,20220105,7,0.9917563088687358,247,15,61,323
7062,dark,main,20220105,8,0.9866789490031134,289,16,69,374
7062,dark,main,20220105,9,0.9931203544665336,291,21,73,385
23820,bright,main,20220105,0,0.9862984678357836,350,68,7,425
23820,bright,main,20220105,1,0.9895448279905008,294,70,2,366
23820,bright,main,20220105,2,0.9936013836372485,364,55,5,424
23820,bright,main,20220105,3,0.9914884699901972,309,65,7,381
23820,bright,main,20220105,4,0.9922282746181506,325,54,4,383
23820,bright,main,20220105,5,0.9891572780123166,309,65,4,378
23820,bright,main,20220105,6,0.9928939532172847,319,72,6,397
23820,bright,main,20220105,7,0.9926109008941173,273,68,0,341
23820,bright,main,20220105,8,0.9920125819510194,313,87,1,401
23820,bright,main,20220105,9,0.9898489999351389,294,90,7,391
11769,dark,main,20220105,0,0.9953694003825073,322,13,55,390
11769,dark,main,20220105,1,0.9824862086008535,274,19,53,346
11769,dark,main,20220105,2,0.9969645262545453,305,12,57,374
11769,dark,main,20220105,3,0.9911192649469737,289,14,50,353
11769,dark,main,20220105,4,0.9941446782364259,261,16,48,325
11769,dark,main,20220105,5,0.9929085778997191,270,17,79,366
11769,dark,main,20220105,6,0.983770639290471,287,15,80,382
11769,dark,main,20220105,7,0.9872922569162518,236,14,75,325
11769,dark,main,20220105,8,0.9950387197574185,279,11,87,377
11769,dark,main,20220105,9,0.9933900339595545,304,12,54,370
11808,dark,main,20220105,0,0.991197137721241,273,13,98,384
11808,dark,main,20220105,1,0.9942637241469543,286,13,68,367
11808,dark,main,20220105,2,0.9887475518226976,299,14,55,368
11808,dark,main,20220105,3,0.9953256829551574,268,10,62,340
11808,dark,main,20220105,4,0.9887392720239102,268,9,50,327
11808,dark,main,20220105,5,0.9915978010712861,281,13,76,370
11808,dark,main,20220105,6,0.9889227560520227,283,15,78,376
11808,dark,main,20220105,7,0.992970605399657,234,19,80,333
11808,dark,main,20220105,8,0.9955549238133383,265,15,99,379
11808,dark,main,20220105,9,0.9934896266257718,288,15,89,392
2355,dark,main,20220105,0,0.9970836309987384,272,15,96,383
2355,dark,main,20220105,1,0.9917431908473194,256,15,81,352
2355,dark,main,20220105,2,0.9834409281977312,295,19,70,384
2355,dark,main,20220105,3,0.9905471889442667,242,20,79,341
2355,dark,main,20220105,4,0.9880885305846185,274,13,53,340
2355,dark,main,20220105,5,0.9961006129973692,283,17,47,347
2355,dark,main,20220105,6,0.9884393731857151,285,15,81,381
2355,dark,main,20220105,7,0.9938173900526105,235,18,79,332
2355,dark,main,20220105,8,0.9877450027411271,253,13,95,361
2355,dark,main,20220105,9,0.9968647506943626,278,21,95,394
9289,dark,main,20220105,0,0.9849585197694011,314,16,63,393
9289,dark,main,20220105,1,0.9905950662242039,278,12,61,351
9289,dark,main,20220105,2,0.9945130256252761,299,11,72,382
9289,dark,main,20220105,3,0.9921716714440368,270,18,59,347
9289,dark,main,20220105,4,0.989648548939799,274,11,57,342
9289,dark,main,20220105,5,0.9917851263135667,274,14,77,365
9289,dark,main,20220105,6,0.9890332733699603,278,21,88,387
9289,dark,main,20220105,7,0.9934645281480072,249,10,69,328
9289,dark,main,20220105,8,0.9936318127432628,267,13,86,366
9289,dark,main,20220105,9,0.9909272256768316,272,14,70,356
2380,dark,main,20220105,0,0.993569495230495,286,13,73,372
2380,dark,main,20220105,1,0.988846954087408,270,12,53,335
2380,dark,main,20220105,2,0.9916628854387725,309,17,58,384
2380,dark,main,20220105,3,0.992083539105142,274,15,60,349
2380,dark,main,20220105,4,0.9887494546538377,279,16,43,338
2380,dark,main,20220105,5,0.9921480089516554,296,12,49,357
2380,dark,main,20220105,6,0.9937849868024045,272,13,79,364
2380,dark,main,20220105,7,0.9906625538994496,246,16,63,325
2380,dark,main,20220105,8,0.9945415431172033,271,16,77,364
2380,dark,main,20220105,9,0.9854980007971302,296,18,76,390
7704,dark,main,20220105,0,0.9923903048275872,263,19,102,384
7704,dark,main,20220105,1,0.9930810813860009,238,15,94,347
7704,dark,main,20220105,2,0.9922181325230073,269,18,90,377
7704,dark,main,20220105,3,0.9861289075027729,241,16,92,349
7704,dark,main,20220105,4,0.992754013056712,244,16,89,349
7704,dark,main,20220105,5,0.9882759966288021,259,16,91,366
7704,dark,main,20220105,6,0.9918045301727031,280,13,104,397
7704,dark,main,20220105,7,0.9822749601068173,241,15,72,328
7704,dark,main,20220105,8,0.9872325373564956,263,19,94,376
7704,dark,main,20220105,9,0.9921437271752146,269,16,96,381
2354,dark,main,20220105,0,0.9897665167299902,295,26,69,390
2354,dark,main,20220105,1,0.9962540909396302,252,18,71,341
2354,dark,main,20220105,2,0.9917567969833092,260,28,105,393
2354,dark,main,20220105,3,0.9894823793331796,245,24,75,344
2354,dark,main,20220105,4,0.9894323489289895,270,14,54,338
2354,dark,main,20220105,5,0.9946741152144307,280,18,54,352
2354,dark,main,20220105,6,0.9852178261211041,270,20,64,354
2354,dark,main,20220105,7,0.9952149575043819,224,23,77,324
2354,dark,main,20220105,8,0.9887869209541302,256,32,85,373
2354,dark,main,20220105,9,0.9902851568187891,265,20,105,390
11932,dark,main,20220105,0,0.991424407599877,285,12,87,384
11932,dark,main,20220105,1,0.9847798173586712,263,17,69,349
11932,dark,main,20220105,2,0.9901824473799423,283,17,85,385
11932,dark,main,20220105,3,0.9917481171093269,295,12,58,365
11932,dark,main,20220105,4,0.9817892869035744,290,11,47,348
11932,dark,main,20220105,5,0.994378402357347,289,12,48,349
11932,dark,main,20220105,6,0.9952553922023817,302,12,58,372
11932,dark,main,20220105,7,0.9902779119118943,242,18,58,318
11932,dark,main,20220105,8,0.991765287256279,286,12,75,373
11932,dark,main,20220105,9,0.9927520393391109,290,14,76,380
6152,dark,main,20220105,0,0.9949039519613827,270,22,102,394
6152,dark,main,20220105,1,0.9936712858826278,260,14,81,355
6152,dark,main,20220105,2,0.993413838823047,268,19,95,382
6152,dark,main,20220105,3,0.9813649319328254,249,21,86,356
6152,dark,main,20220105,4,0.98952651372658,249,12,95,356
6152,dark,main,20220105,5,0.9956515955543822,268,21,66,355
6152,dark,main,20220105,6,0.983193798426859,261,16,99,376
6152,dark,main,20220105,7,0.9914954167511475,212,17,99,328
6152,dark,main,20220105,8,0.9818076958598395,239,19,108,366
6152,dark,main,20220105,9,0.9832221623112523,284,16,89,389
7239,dark,main,20220105,0,0.9932726439104137,325,14,49,388
7239,dark,main,20220105,1,0.9913356916913959,278,15,63,356
7239,dark,main,20220105,2,0.988278336577252,318,10,50,378
7239,dark,main,20220105,3,0.9942234182163959,285,12,54,351
7239,dark,main,20220105,4,0.9946871938137972,265,11,50,326
7239,dark,main,20220105,5,0.9919808751206908,289,10,60,359
7239,dark,main,20220105,6,0.9924386931615371,298,12,59,369
7239,dark,main,20220105,7,0.9924611300564037,256,12,48,316
7239,dark,main,20220105,8,0.9953070034237643,291,12,51,354
7239,dark,main,20220105,9,0.9955243131702267,312,11,50,373
8633,dark,main,20220105,0,0.9889458126219585,290,12,85,387
8633,dark,main,20220105,1,0.9952029915270846,268,17,75,360
8633,dark,main,20220105,2,0.9919552192848684,305,19,63,387
8633,dark,main,20220105,3,0.9961059623094096,283,15,56,354
8633,dark,main,20220105,4,0.9923567338661207,276,21,49,346
8633,dark,main,20220105,5,0.9911502438382515,287,26,53,366
8633,dark,main,20220105,6,0.9822624438008632,295,22,54,371
8633,dark,main,20220105,7,0.9948004729249734,284,11,37,332
8633,dark,main,20220105,8,0.9939704135725422,283,14,69,366
8633,dark,main,20220105,9,0.9941525540672813,258,19,107,384
7105,dark,main,20220106,0,0.9925559950148668,280,12,106,398
7105,dark,main,20220106,1,0.9872144044927932,242,13,92,347
7105,dark,main,20220106,2,0.990589247829452,281,15,99,395
7105,dark,main,20220106,3,0.9941878382393047,246,17,88,351
7105,dark,main,20220106,4,0.9942823501979237,247,14,79,340
7105,dark,main,20220106,5,0.9873512184287438,285,17,59,361
7105,dark,main,20220106,6,0.9912659436968667,291,11,64,366
7105,dark,main,20220106,7,0.980117379365127,251,11,65,327
7105,dark,main,20220106,8,0.9883028135700244,286,17,79,382
7105,dark,main,20220106,9,0.9912262749730574,284,14,96,394
7132,dark,main,20220106,0,0.9912828396344675,290,12,93,395
7132,dark,main,20220106,1,0.9969887262061313,303,13,55,371
7132,dark,main,20220106,2,0.9935232563816014,331,12,53,396
7132,dark,main,20220106,3,0.9846828709992539,320,13,37,370
7132,dark,main,20220106,4,0.992925810180849,302,10,40,352
7132,dark,main,20220106,5,0.99490204959327,308,11,44,363
7132,dark,main,20220106,6,0.9881039327531983,310,12,55,377
7132,dark,main,20220106,7,0.9903334701231914,301,12,32,345
7132,dark,main,20220106,8,0.9951806735720078,320,10,53,383
7132,dark,main,20220106,9,0.9905321266099106,326,10,61,397
5670,dark,main,20220106,0,0.9950042678358625,278,15,94,387
5670,dark,main,20220106,1,0.9942657432367668,269,12,82,363
5670,dark,main,20220106,2,0.993208444512714,301,13,70,384
5670,dark,main,20220106,3,0.9902690832003751,280,14,62,356
5670,dark,main,20220106,4,0.9932904716166283,288,11,60,359
5670,dark,main,20220106,5,0.99570396075601,310,14,45,369
5670,dark,main,20220106,6,0.993997982629784,264,21,98,383
5670,dark,main,20220106,7,0.9914588742605625,236,15,92,343
5670,dark,main,20220106,8,0.9918375962996037,272,14,99,385
5670,dark,main,20220106,9,0.9950969899848903,254,19,105,378
9517,dark,main,20220106,0,0.9904423208776784,325,11,39,375
9517,dark,main,20220106,1,0.9862071590552027,286,13,56,355
9517,dark,main,20220106,2,0.9855723262479935,331,16,31,378
9517,dark,main,20220106,3,0.9941134636085087,287,14,35,336
9517,dark,main,20220106,4,0.981843609717346,292,10,39,341
9517,dark,main,20220106,5,0.9900659916039809,294,14,58,366
9517,dark,main,20220106,6,0.9899016202513706,301,13,62,376
9517,dark,main,20220106,7,0.9877408638938339,255,12,61,328
9517,dark,main,20220106,8,0.9935232942048878,322,12,43,377
9517,dark,main,20220106,9,0.9938507480477156,324,11,52,387
10257,dark,main,20220106,0,0.994731183609901,344,11,53,408
10257,dark,main,20220106,1,0.9877833030422126,306,12,48,366
10257,dark,main,20220106,2,0.9944445233638384,328,15,54,397
10257,dark,main,20220106,3,0.9954311940427516,297,11,68,376
10257,dark,main,20220106,4,0.9920928649256315,286,12,59,357
10257,dark,main,20220106,5,0.9938795355955521,283,11,68,362
10257,dark,main,20220106,6,0.9939157898745845,308,12,54,374
10257,dark,main,20220106,7,0.9895737823634372,287,12,33,332
10257,dark,main,20220106,8,0.9918257342114248,297,11,55,363
10257,dark,main,20220106,9,0.9958747068760535,340,11,44,395
4417,dark,main,20220106,0,0.9922186651312431,254,20,102,376
4417,dark,main,20220106,1,0.9921960430440653,248,15,87,350
4417,dark,main,20220106,2,0.985220518628007,271,18,85,374
4417,dark,main,20220106,3,0.9904161489416713,251,18,90,359
4417,dark,main,20220106,4,0.9870779350676218,239,17,88,344
4417,dark,main,20220106,5,0.9936320192706593,257,16,98,371
4417,dark,main,20220106,6,0.992109706453023,266,18,98,382
4417,dark,main,20220106,7,0.9859492627023552,247,21,68,336
4417,dark,main,20220106,8,0.9949555498751913,255,19,100,374
4417,dark,main,20220106,9,0.9865349576053358,279,21,89,389
3257,dark,main,20220106,0,0.990812507800997,342,10,51,403
3257,dark,main,20220106,1,0.9934315350165835,297,13,46,356
3257,dark,main,20220106,2,0.9913197646124945,338,11,44,393
3257,dark,main,20220106,3,0.9787505427183469,304,13,33,350
3257,dark,main,20220106,4,0.9897259618245338,286,10,47,343
3257,dark,main,20220106,5,0.9878350694975818,317,10,47,374
3257,dark,main,20220106,6,0.9901721230974498,305,12,55,372
3257,dark,main,20220106,7,0.9864941595547896,260,11,49,320
3257,dark,main,20220106,8,0.9913865737938563,310,9,51,370
3257,dark,main,20220106,9,0.9917762430113053,311,12,69,392
2357,dark,main,20220106,0,0.9936543190785135,303,15,55,373
2357,dark,main,20220106,1,0.9896472711385064,288,18,59,365
2357,dark,main,20220106,2,0.9905030886832922,293,24,56,373
2357,dark,main,20220106,3,0.9938449622357675,274,13,70,357
2357,dark,main,20220106,4,0.9946245406860074,252,11,75,338
2357,dark,main,20220106,5,0.9926712915789013,284,20,55,359
2357,dark,main,20220106,6,0.9907929905353222,290,19,63,372
2357,dark,main,20220106,7,0.9941001821455286,227,16,84,327
2357,dark,main,20220106,8,0.9922560892316242,281,19,76,376
2357,dark,main,20220106,9,0.9909086551365968,308,14,47,369
8053,dark,main,20220106,0,0.9949817558507357,276,16,106,398
8053,dark,main,20220106,1,0.9940433669891288,254,16,98,368
8053,dark,main,20220106,2,0.9907140018181518,283,14,92,389
8053,dark,main,20220106,3,0.9903355928045356,241,17,93,351
8053,dark,main,20220106,4,0.9894560139072445,240,23,94,357
8053,dark,main,20220106,5,0.9844902862754248,268,15,89,372
8053,dark,main,20220106,6,0.9861982711436285,279,14,94,387
8053,dark,main,20220106,7,0.9909850091013638,226,13,92,331
8053,dark,main,20220106,8,0.984237659036221,259,19,94,372
8053,dark,main,20220106,9,0.9927029489999579,273,19,91,383
10313,dark,main,20220106,0,0.9904678482238312,302,11,68,381
10313,dark,main,20220106,1,0.9880031992260868,304,16,48,368
10313,dark,main,20220106,2,0.9904505589070864,333,11,62,406
10313,dark,main,20220106,3,0.9917041991634874,303,13,52,368
10313,dark,main,20220106,4,0.9822745177203991,296,10,50,356
10313,dark,main,20220106,5,0.9869957227767907,314,14,45,373
10313,dark,main,20220106,6,0.9906951553641979,304,14,49,367
10313,dark,main,20220106,7,0.9943774673504472,261,13,65,339
10313,dark,main,20220106,8,0.9911399096124872,295,16,69,380
10313,dark,main,20220106,9,0.9800804901065004,308,14,72,394
3944,dark,main,20220106,0,0.9959567012060576,290,23,83,396
3944,dark,main,20220106,1,0.9929789945092027,266,20,57,343
3944,dark,main,20220106,2,0.9837173270595403,313,15,51,379
3944,dark,main,20220106,3,0.9880156687472554,277,19,50,346
3944,dark,main,20220106,4,0.9876683007542425,294,13,40,347
3944,dark,main,20220106,5,0.9882455639764373,287,14,52,353
3944,dark,main,20220106,6,0.9856321040311109,304,13,62,379
3944,dark,main,20220106,7,0.9855349016853169,263,13,47,323
3944,dark,main,20220106,8,0.9928374850831211,295,11,74,380
3944,dark,main,20220106,9,0.9923520562143785,289,15,92,396
7222,dark,main,20220106,0,0.992225714213034,307,11,62,380
7222,dark,main,20220106,1,0.9868659228735921,298,14,45,357
7222,dark,main,20220106,2,0.9920087935095353,290,47,43,380
7222,dark,main,20220106,3,0.9914555068588508,302,15,54,371
7222,dark,main,20220106,4,0.9910313880488829,269,23,67,359
7222,dark,main,20220106,5,0.9879006756241717,264,19,81,364
7222,dark,main,20220106,6,0.9902851244039712,287,13,93,393
7222,dark,main,20220106,7,0.9927101389282216,244,12,76,332
7222,dark,main,20220106,8,0.9892411388201575,269,13,77,359
7222,dark,main,20220106,9,0.9940357262900725,300,17,60,377
2522,dark,main,20220106,0,0.9949637672378149,241,26,116,383
2522,dark,main,20220106,1,0.9862348450292602,276,15,82,373
2522,dark,main,20220106,2,0.992875486267172,310,15,51,376
2522,dark,main,20220106,3,0.9938986962900425,271,12,69,352
2522,dark,main,20220106,4,0.9905950396272931,277,14,53,344
2522,dark,main,20220106,5,0.991045699058403,290,12,67,369
2522,dark,main,20220106,6,0.9925212142021431,287,16,84,387
2522,dark,main,20220106,7,0.9796379818846939,223,17,80,320
2522,dark,main,20220106,8,0.993729171357781,265,11,91,367
2522,dark,main,20220106,9,0.9914328537933548,262,17,111,390
9274,dark,main,20220106,0,0.9900882068543321,274,16,94,384
9274,dark,main,20220106,1,0.9953136400137895,252,16,91,359
9274,dark,main,20220106,2,0.9951576490171979,272,19,98,389
9274,dark,main,20220106,3,0.9952288109394583,244,18,98,360
9274,dark,main,20220106,4,0.9915194940145013,229,9,92,330
9274,dark,main,20220106,5,0.9920478822171974,262,15,86,363
9274,dark,main,20220106,6,0.9855771140167997,255,20,106,381
9274,dark,main,20220106,7,0.9912013182730278,219,13,89,321
9274,dark,main,20220106,8,0.9890887713056459,265,12,89,366
9274,dark,main,20220106,9,0.9838303106940719,262,15,107,384
11933,dark,main,20220106,0,0.9953913260383438,316,11,58,385
11933,dark,main,20220106,1,0.9828450032661119,300,18,37,355
11933,dark,main,20220106,2,0.9891813447695876,305,12,61,378
11933,dark,main,20220106,3,0.9917576978473858,294,11,50,355
11933,dark,main,20220106,4,0.9914061955927939,261,15,72,348
11933,dark,main,20220106,5,0.9940427127019262,285,15,82,382
11933,dark,main,20220106,6,0.9946355764742004,272,15,86,373
11933,dark,main,20220106,7,0.9854401695475462,234,13,77,324
11933,dark,main,20220106,8,0.9941661952248877,290,14,67,371
11933,dark,main,20220106,9,0.9928363317212502,306,13,52,371
9248,dark,main,20220106,0,0.9834326491641179,282,13,88,383
9248,dark,main,20220106,1,0.9888402351614025,255,18,82,355
9248,dark,main,20220106,2,0.9873385950407182,268,25,89,382
9248,dark,main,20220106,3,0.9924755783399603,252,17,93,362
9248,dark,main,20220106,4,0.9925215045512901,247,18,74,339
9248,dark,main,20220106,5,0.9932354277961052,240,20,96,356
9248,dark,main,20220106,6,0.990070023866676,251,22,91,364
9248,dark,main,20220106,7,0.997418933353747,216,18,84,318
9248,dark,main,20220106,8,0.9955430376045502,229,24,90,343
9248,dark,main,20220106,9,0.9888132689302898,260,16,88,364
1807,dark,main,20220106,0,0.9964605607600768,313,12,51,376
1807,dark,main,20220106,1,0.9858224725633472,297,18,43,358
1807,dark,main,20220106,2,0.9865554720649937,277,14,69,360
1807,dark,main,20220106,3,0.9950488718343029,295,12,47,354
1807,dark,main,20220106,4,0.9900199602683367,282,15,62,359
1807,dark,main,20220106,5,0.9952130142061418,262,18,79,359
1807,dark,main,20220106,6,0.9916236577769572,279,19,94,392
1807,dark,main,20220106,7,0.9889331666602156,254,12,64,330
1807,dark,main,20220106,8,0.9936241737306719,308,19,52,379
1807,dark,main,20220106,9,0.9881083110233566,289,10,75,374
7960,dark,main,20220106,0,0.9912738265822619,314,10,58,382
7960,dark,main,20220106,1,0.9878861690924489,296,11,48,355
7960,dark,main,20220106,2,0.9956604977635853,325,14,45,384
7960,dark,main,20220106,3,0.9944000714514577,291,14,36,341
7960,dark,main,20220106,4,0.9910307566379207,268,12,59,339
7960,dark,main,20220106,5,0.9939495803417446,287,14,66,367
7960,dark,main,20220106,6,0.995421362802339,301,14,56,371
7960,dark,main,20220106,7,0.9889770512834357,223,13,78,314
7960,dark,main,20220106,8,0.986898304021914,203,17,53,273
7960,dark,main,20220106,9,0.992869013671809,200,14,37,251
6680,dark,main,20220106,0,0.994221998320327,299,17,74,390
6680,dark,main,20220106,1,0.9914790639238359,276,17,61,354
6680,dark,main,20220106,2,0.9907497865599932,314,12,61,387
6680,dark,main,20220106,3,0.9927407393172,307,12,34,353
6680,dark,main,20220106,4,0.9854085553434299,295,9,37,341
6680,dark,main,20220106,5,0.9924986742268033,313,13,44,370
6680,dark,main,20220106,6,0.9937732926865462,269,14,73,356
6680,dark,main,20220106,7,0.9893921162236843,238,18,81,337
6680,dark,main,20220106,8,0.9886180578215862,269,20,87,376
6680,dark,main,20220106,9,0.9914621452639815,272,15,94,381
8280,dark,main,20220106,0,0.9908565652961928,278,19,94,391
8280,dark,main,20220106,1,0.9870341765384258,244,18,82,344
8280,dark,main,20220106,2,0.9897172980353782,288,18,80,386
8280,dark,main,20220106,3,0.9929611913070964,259,18,88,365
8280,dark,main,20220106,4,0.9923311973715189,259,11,91,361
8280,dark,main,20220106,5,0.9920800083388834,264,17,89,370
8280,dark,main,20220106,6,0.9973774680884002,269,21,93,383
8280,dark,main,20220106,7,0.9864080384713091,237,12,79,328
8280,dark,main,20220106,8,0.9934890060649202,263,16,94,373
8280,dark,main,20220106,9,0.9877212416489833,289,15,73,377
3519,dark,main,20220106,0,0.9943033508490176,314,15,50,379
3519,dark,main,20220106,1,0.9896797584869337,298,11,38,347
3519,dark,main,20220106,2,0.9915061423675746,344,11,43,398
3519,dark,main,20220106,3,0.9916566144123136,288,15,62,365
3519,dark,main,20220106,4,0.9901489269556221,265,11,68,344
3519,dark,main,20220106,5,0.9924004909169623,292,17,66,375
3519,dark,main,20220106,6,0.9913587075996534,314,19,47,380
3519,dark,main,20220106,7,0.9927421363797843,270,15,56,341
3519,dark,main,20220106,8,0.992450718848076,298,16,54,368
3519,dark,main,20220106,9,0.981391539877957,293,15,70,378
3151,dark,main,20220106,0,0.9934693494536986,257,23,99,379
3151,dark,main,20220106,1,0.9891196092124727,245,19,83,347
3151,dark,main,20220106,2,0.9943128868957869,286,21,88,395
3151,dark,main,20220106,3,0.9812162442604749,251,20,77,348
3151,dark,main,20220106,4,0.9909991594902455,246,17,71,334
3151,dark,main,20220106,5,0.9840543607919012,291,15,60,366
3151,dark,main,20220106,6,0.9950769459671138,316,15,48,379
3151,dark,main,20220106,7,0.9880045900761162,271,14,49,334
3151,dark,main,20220106,8,0.9825667422038246,300,19,71,390
3151,dark,main,20220106,9,0.9886127430961357,262,12,83,357
3004,dark,main,20220106,0,0.994138671904537,273,17,97,387
3004,dark,main,20220106,1,0.99485250376287,252,17,80,349
3004,dark,main,20220106,2,0.9935358073756569,278,13,94,385
3004,dark,main,20220106,3,0.9899401695670594,246,13,95,354
3004,dark,main,20220106,4,0.9914986717845051,243,19,78,340
3004,dark,main,20220106,5,0.9869163747527474,237,14,118,369
3004,dark,main,20220106,6,0.9910837626848832,258,22,84,364
3004,dark,main,20220106,7,0.9882210059451966,223,15,83,321
3004,dark,main,20220106,8,0.9929446144801577,262,20,73,355
3004,dark,main,20220106,9,0.9886545302555126,282,18,92,392
8048,dark,main,20220106,0,0.991763245600875,297,16,63,376
8048,dark,main,20220106,1,0.9829799510509629,271,14,77,362
8048,dark,main,20220106,2,0.9903566687372354,293,12,81,386
8048,dark,main,20220106,3,0.989623446228749,258,17,78,353
8048,dark,main,20220106,4,0.9958025605414603,237,19,82,338
8048,dark,main,20220106,5,0.9854558899514771,225,21,78,324
8048,dark,main,20220106,6,0.9910186115121263,280,23,83,386
8048,dark,main,20220106,7,0.988501926121513,239,16,70,325
8048,dark,main,20220106,8,0.9929169820275393,290,21,66,377
8048,dark,main,20220106,9,0.9896328771137887,300,26,53,379
10184,dark,main,20220106,0,0.99038670826785,300,15,50,365
10184,dark,main,20220106,1,0.9928960646298196,270,13,64,347
10184,dark,main,20220106,2,0.9910398189849622,287,10,68,365
10184,dark,main,20220106,3,0.9941828864625551,291,12,52,355
10184,dark,main,20220106,4,0.9895498982958015,266,14,75,355
10184,dark,main,20220106,5,0.9772751057506662,309,11,48,368
10184,dark,main,20220106,6,0.9883931076921597,325,13,44,382
10184,dark,main,20220106,7,0.9893601576104183,287,10,33,330
10184,dark,main,20220106,8,0.9942385842388078,305,13,52,370
10184,dark,main,20220106,9,0.9944009685124396,308,17,47,372
7211,dark,main,20220106,0,0.9912125268335933,276,16,100,392
7211,dark,main,20220106,1,0.9934550465230132,243,14,90,347
7211,dark,main,20220106,2,0.9864827572547734,262,15,111,388
7211,dark,main,20220106,3,0.9837214523145501,267,10,77,354
7211,dark,main,20220106,4,0.9956975132993798,285,11,56,352
7211,dark,main,20220106,5,0.9852104011657153,288,14,60,362
7211,dark,main,20220106,6,0.9959315728015037,297,16,77,390
7211,dark,main,20220106,7,0.9925598056502049,240,12,82,334
7211,dark,main,20220106,8,0.99556598458079,291,11,79,381
7211,dark,main,20220106,9,0.9898815575951734,265,18,100,383
3055,dark,main,20220106,0,0.991202995705346,280,15,108,403
3055,dark,main,20220106,1,0.9858450593787564,260,16,81,357
3055,dark,main,20220106,2,0.9935584804967236,285,23,82,390
3055,dark,main,20220106,3,0.9869322829172118,230,17,99,346
3055,dark,main,20220106,4,0.9921404794484269,238,14,79,331
3055,dark,main,20220106,5,0.9915463519553493,254,15,96,365
3055,dark,main,20220106,6,0.9875162607350297,260,19,87,366
3055,dark,main,20220106,7,0.9919284896238556,222,16,80,318
3055,dark,main,20220106,8,0.992158241225984,246,17,106,369
3055,dark,main,20220106,9,0.9947706415459491,293,16,83,392
9275,dark,main,20220106,0,0.9955122612270554,291,17,90,398
9275,dark,main,20220106,1,0.9920522710421364,245,14,99,358
9275,dark,main,20220106,2,0.990329782532242,264,17,111,392
9275,dark,main,20220106,3,0.9919841971488015,255,17,74,346
9275,dark,main,20220106,4,0.9875685277830287,240,22,79,341
9275,dark,main,20220106,5,0.9934225650067361,275,14,92,381
9275,dark,main,20220106,6,0.9942827547260336,253,16,85,354
9275,dark,main,20220106,7,0.9880091029071741,229,15,73,317
9275,dark,main,20220106,8,0.9890928806258042,254,16,97,367
9275,dark,main,20220106,9,0.9949782386786674,267,13,86,366
22355,bright,main,20220106,0,0.990950939077366,320,117,2,439
22355,bright,main,20220106,1,0.9928273956623419,304,87,7,398
22355,bright,main,20220106,2,0.9966657083253522,250,176,6,432
22355,bright,main,20220106,3,0.9935317738876949,248,147,5,400
22355,bright,main,20220106,4,0.9916628362334676,291,90,7,388
22355,bright,main,20220106,5,0.988231980698518,301,106,4,411
22355,bright,main,20220106,6,0.9926493967091167,319,107,5,431
22355,bright,main,20220106,7,0.9902076743990267,262,106,3,371
22355,bright,main,20220106,8,0.9935888969133223,217,191,2,410
22355,bright,main,20220106,9,0.9956019072425271,273,149,2,424
3984,dark,main,20220106,0,0.988458897089316,289,14,96,399
3984,dark,main,20220106,1,0.9964902766926642,266,14,72,352
3984,dark,main,20220106,2,0.9911589623725695,274,13,102,389
3984,dark,main,20220106,3,0.9874398116980955,252,17,73,342
3984,dark,main,20220106,4,0.9873274403883316,246,15,73,334
3984,dark,main,20220106,5,0.9885469093571813,249,14,98,361
3984,dark,main,20220106,6,0.9916662922593222,283,15,88,386
3984,dark,main,20220106,7,0.9896635841332032,260,14,57,331
3984,dark,main,20220106,8,0.9887830999309556,279,24,71,374
3984,dark,main,20220106,9,0.988697322836497,281,16,94,391
3046,dark,main,20220106,0,0.9919546604490987,292,15,88,395
3046,dark,main,20220106,1,0.995883369386053,272,14,73,359
3046,dark,main,20220106,2,0.995521736376793,258,23,110,391
3046,dark,main,20220106,3,0.9836707689413546,252,21,90,363
3046,dark,main,20220106,4,0.9853777513217014,237,14,100,351
3046,dark,main,20220106,5,0.9953847682132957,274,16,80,370
3046,dark,main,20220106,6,0.9885860949388298,293,21,75,389
3046,dark,main,20220106,7,0.987025179769557,232,19,76,327
3046,dark,main,20220106,8,0.9946491275445375,266,18,86,370
3046,dark,main,20220106,9,0.9913890018960979,269,13,107,389
2381,dark,main,20220106,0,0.9966620000530254,297,15,92,404
2381,dark,main,20220106,1,0.991004159420239,270,15,70,355
2381,dark,main,20220106,2,0.9842402712090831,294,26,60,380
2381,dark,main,20220106,3,0.9939604257710081,298,15,60,373
2381,dark,main,20220106,4,0.9934694849531508,260,20,61,341
2381,dark,main,20220106,5,0.988835846109876,288,11,66,365
2381,dark,main,20220106,6,0.9888441596980606,290,15,73,378
2381,dark,main,20220106,7,0.9935368394360612,226,17,80,323
2381,dark,main,20220106,8,0.9884680990869995,283,13,85,381
2381,dark,main,20220106,9,0.9935680753523639,277,16,91,384
6165,dark,main,20220106,0,0.9939390202609453,282,16,91,389
6165,dark,main,20220106,1,0.9934469619733721,241,18,92,351
6165,dark,main,20220106,2,0.9909502217987731,294,16,91,401
6165,dark,main,20220106,3,0.9920595060587283,247,16,90,353
6165,dark,main,20220106,4,0.9865629371974174,234,15,77,326
6165,dark,main,20220106,5,0.9920430534536124,241,21,104,366
6165,dark,main,20220106,6,0.9882061905884958,252,15,95,362
6165,dark,main,20220106,7,0.9910055522985947,243,16,73,332
6165,dark,main,20220106,8,0.9935398401431759,255,15,90,360
6165,dark,main,20220106,9,0.9947855155033574,284,18,83,385
23722,bright,main,20220106,0,0.9902215082289246,232,124,8,364
23722,bright,main,20220106,1,0.992448538218579,244,95,9,348
23722,bright,main,20220106,2,0.9926788439223518,256,125,9,390
23722,bright,main,20220106,3,0.9901218613990692,259,87,7,353
23722,bright,main,20220106,4,0.9923758892299865,271,69,4,344
23722,bright,main,20220106,5,0.9885518425614606,253,108,6,367
23722,bright,main,20220106,6,0.9927159081737389,206,153,6,365
23722,bright,main,20220106,7,0.9927159081737389,206,153,6,365
23722,bright,main,20220106,8,0.9930550928797452,252,59,12,323
23722,bright,main,20220106,9,0.9909660235412112,231,132,7,370
22367,bright,main,20220106,0,0.9945101394427277,377,62,3,442
22367,bright,main,20220106,1,0.9942136003064816,330,64,5,399
22367,bright,main,20220106,2,0.993250064000609,341,87,7,435
22367,bright,main,20220106,3,0.9919949239379064,337,59,2,398
22367,bright,main,20220106,4,0.9927414144946225,314,76,4,394
22367,bright,main,20220106,5,0.996327193173415,307,102,3,412
22367,bright,main,20220106,6,0.993103510810856,301,117,5,423
22367,bright,main,20220106,7,0.9930804296687957,277,90,5,372
22367,bright,main,20220106,8,0.9957560664291253,278,129,3,410
22367,bright,main,20220106,9,0.9947514639570701,338,88,5,431
6143,dark,main,20220106,0,0.9880076881619964,261,19,101,381
6143,dark,main,20220106,1,0.9950109754930461,260,16,81,357
6143,dark,main,20220106,2,0.9920055557986999,299,11,75,385
6143,dark,main,20220106,3,0.9866769493548327,245,18,91,354
6143,dark,main,20220106,4,0.9949854886446293,233,14,96,343
6143,dark,main,20220106,5,0.990391629158551,250,18,85,353
6143,dark,main,20220106,6,0.9945729700557558,249,16,102,367
6143,dark,main,20220106,7,0.9918889638386097,241,15,79,335
6143,dark,main,20220106,8,0.9924833448265307,248,21,107,376
6143,dark,main,20220106,9,0.9967920574440561,252,17,107,376
7102,dark,main,20220106,0,0.9940305892053491,306,18,64,388
7102,dark,main,20220106,1,0.9837577249109342,280,20,51,351
7102,dark,main,20220106,2,0.990632903740531,300,11,67,378
7102,dark,main,20220106,3,0.9899426287027024,289,14,47,350
7102,dark,main,20220106,4,0.9922754509965249,273,14,59,346
7102,dark,main,20220106,5,0.9805816853897074,258,9,92,359
7102,dark,main,20220106,6,0.992082463623125,273,14,86,373
7102,dark,main,20220106,7,0.9901221317040687,222,16,98,336
7102,dark,main,20220106,8,0.9876748513463111,258,13,100,371
7102,dark,main,20220106,9,0.9903158724667479,284,12,85,381
1583,dark,main,20220106,0,0.9923170088837149,287,14,86,387
1583,dark,main,20220106,1,0.9951094488044716,242,19,92,353
1583,dark,main,20220106,2,0.9915307877973921,270,16,95,381
1583,dark,main,20220106,3,0.9897506803294789,236,24,84,344
1583,dark,main,20220106,4,0.9883829077929948,236,19,84,339
1583,dark,main,20220106,5,0.9894121632920734,250,23,78,351
1583,dark,main,20220106,6,0.9934957024781637,252,20,94,366
1583,dark,main,20220106,7,0.9814220146215633,234,20,77,331
1583,dark,main,20220106,8,0.9883679783771327,260,17,92,369
1583,dark,main,20220106,9,0.9856843273780632,253,16,109,378
1991,dark,main,20220106,0,0.9879109649986729,319,24,44,387
1991,dark,main,20220106,1,0.9935595700957489,270,22,71,363
1991,dark,main,20220106,2,0.9928548725553477,281,31,76,388
1991,dark,main,20220106,3,0.9937172843114156,259,22,80,361
1991,dark,main,20220106,4,0.9879879630162507,264,31,58,353
1991,dark,main,20220106,5,0.990458420740741,276,28,64,368
1991,dark,main,20220106,6,0.9946075546497979,299,30,52,381
1991,dark,main,20220106,7,0.9876981376381715,259,23,43,325
1991,dark,main,20220106,8,0.9865117824718677,294,38,59,391
1991,dark,main,20220106,9,0.9907957234655754,302,19,48,369
4850,dark,main,20220106,0,0.9950056196773175,290,15,99,404
4850,dark,main,20220106,1,0.9824896177994276,288,12,52,352
4850,dark,main,20220106,2,0.9862471351332585,332,13,45,390
4850,dark,main,20220106,3,0.9861541645932587,286,10,49,345
4850,dark,main,20220106,4,0.9888444724633012,292,12,46,350
4850,dark,main,20220106,5,0.991377177667451,294,13,52,359
4850,dark,main,20220106,6,0.9947213625750295,270,13,86,369
4850,dark,main,20220106,7,0.9898941728841414,248,11,60,319
4850,dark,main,20220106,8,0.9961412615617528,272,13,83,368
4850,dark,main,20220106,9,0.9914653502893713,262,16,87,365
8718,dark,main,20220106,0,0.9914043695647652,301,15,69,385
8718,dark,main,20220106,1,0.9940972274644545,296,11,55,362
8718,dark,main,20220106,2,0.9924265944540612,288,12,91,391
8718,dark,main,20220106,3,0.992213933273858,303,12,37,352
8718,dark,main,20220106,4,0.9882145160359905,299,12,36,347
8718,dark,main,20220106,5,0.9877434093210352,300,14,48,362
8718,dark,main,20220106,6,0.9942389103389961,276,15,80,371
8718,dark,main,20220106,7,0.9919902706125205,198,15,65,278
8718,dark,main,20220106,8,0.9884998391027301,214,13,72,299
8718,dark,main,20220106,9,0.9958350970126828,293,11,101,405
25870,bright,main,20220107,0,0.9887900675654562,323,91,6,420
25870,bright,main,20220107,1,0.9954432699256927,296,80,4,380
25870,bright,main,20220107,2,0.995305788664981,342,64,3,409
25870,bright,main,20220107,3,0.9932831751088518,301,74,5,380
25870,bright,main,20220107,4,0.9938517371630582,284,93,3,380
25870,bright,main,20220107,5,0.9867252009243987,283,104,4,391
25870,bright,main,20220107,6,0.9947414392927677,332,75,8,415
25870,bright,main,20220107,7,0.9917468560908698,295,54,2,351
25870,bright,main,20220107,8,0.9902909545560422,308,98,1,407
25870,bright,main,20220107,9,0.9949203366715643,315,88,7,410
42418,backup,main,20220107,0,0.994786537047293,64,382,0,446
42418,backup,main,20220107,1,0.9928033866861625,64,343,0,407
42418,backup,main,20220107,2,0.9920430163789657,89,356,0,445
42418,backup,main,20220107,3,0.9923121256595455,49,356,0,405
42418,backup,main,20220107,4,0.9941737687051068,38,365,0,403
42418,backup,main,20220107,5,0.9930097781003321,46,377,0,423
42418,backup,main,20220107,6,0.9970394446961786,42,393,0,435
42418,backup,main,20220107,7,0.9955754234354018,27,348,0,375
42418,backup,main,20220107,8,0.9894619497490569,22,406,0,428
42418,backup,main,20220107,9,0.9920424556738543,40,401,0,441
11003,dark,main,20220107,0,0.9915001603436973,289,12,82,383
11003,dark,main,20220107,1,0.9892946277443634,258,15,78,351
11003,dark,main,20220107,2,0.993157233701998,292,13,81,386
11003,dark,main,20220107,3,0.9854463003832551,270,13,82,365
11003,dark,main,20220107,4,0.988590222666701,249,15,85,349
11003,dark,main,20220107,5,0.9913223345415773,252,11,90,353
11003,dark,main,20220107,6,0.9933791197776312,272,14,95,381
11003,dark,main,20220107,7,0.9924751590543587,245,11,71,327
11003,dark,main,20220107,8,0.9911275098797715,272,13,94,379
11003,dark,main,20220107,9,0.9869923945119361,283,18,84,385
21320,bright,main,20220107,0,0.9914731167077423,301,141,2,444
21320,bright,main,20220107,1,0.9951095004173016,285,116,3,404
21320,bright,main,20220107,2,0.9874516972762669,315,120,2,437
21320,bright,main,20220107,3,0.9940317344640661,230,167,2,399
21320,bright,main,20220107,4,0.9945013861502999,251,143,6,400
21320,bright,main,20220107,5,0.9946742819867106,205,206,2,413
21320,bright,main,20220107,6,0.9934599851578035,257,172,6,435
21320,bright,main,20220107,7,0.9942759456989007,242,126,4,372
21320,bright,main,20220107,8,0.9928808745005326,281,136,6,423
21320,bright,main,20220107,9,0.9929912167467753,298,132,3,433
2940,dark,main,20220107,0,0.9897713317916668,291,13,93,397
2940,dark,main,20220107,1,0.9909413254535541,250,12,84,346
2940,dark,main,20220107,2,0.9957022076493479,285,11,100,396
2940,dark,main,20220107,3,0.993804277476096,254,13,81,348
2940,dark,main,20220107,4,0.9916329818656237,252,11,84,347
2940,dark,main,20220107,5,0.9917918858077425,241,12,108,361
2940,dark,main,20220107,6,0.992982965941974,273,14,94,381
2940,dark,main,20220107,7,0.9930033884408934,242,13,88,343
2940,dark,main,20220107,8,0.9950535231330832,292,13,75,380
2940,dark,main,20220107,9,0.9924074737874558,286,12,88,386
3190,dark,main,20220107,0,0.9893814255849729,291,15,80,386
3190,dark,main,20220107,1,0.9891370955849366,262,12,85,359
3190,dark,main,20220107,2,0.9951270228027358,263,13,101,377
3190,dark,main,20220107,3,0.9935371300932507,239,11,100,350
3190,dark,main,20220107,4,0.9873744843338458,278,10,67,355
3190,dark,main,20220107,5,0.9871776188835882,282,11,75,368
3190,dark,main,20220107,6,0.9904686838144946,318,11,47,376
3190,dark,main,20220107,7,0.9978333986853682,273,17,46,336
3190,dark,main,20220107,8,0.9902327767344863,299,11,74,384
3190,dark,main,20220107,9,0.9956982196692801,294,13,75,382
6037,dark,main,20220107,0,0.9929104689028784,300,15,64,379
6037,dark,main,20220107,1,0.9896090323132238,294,11,54,359
6037,dark,main,20220107,2,0.9972037495754095,323,11,63,397
6037,dark,main,20220107,3,0.9907708510062492,274,14,70,358
6037,dark,main,20220107,4,0.9842593501058655,274,11,72,357
6037,dark,main,20220107,5,0.9895839588991548,260,12,93,365
6037,dark,main,20220107,6,0.9919990127121738,276,13,90,379
6037,dark,main,20220107,7,0.9943002999302158,238,14,79,331
6037,dark,main,20220107,8,0.9935355624374792,274,17,93,384
6037,dark,main,20220107,9,0.9934475716234156,282,15,74,371
42413,backup,main,20220107,0,0.9919107524231978,25,424,0,449
42413,backup,main,20220107,1,0.9934795927924401,25,383,0,408
42413,backup,main,20220107,2,0.9943719389522415,25,420,0,445
42413,backup,main,20220107,3,0.989668593691775,31,376,0,407
42413,backup,main,20220107,4,0.9875411817681659,7,395,0,402
42413,backup,main,20220107,5,0.986526566756656,13,407,0,420
42413,backup,main,20220107,6,0.9909668932169919,7,429,0,436
42413,backup,main,20220107,7,0.9940542141348462,4,372,0,376
42413,backup,main,20220107,8,0.994205294323364,9,420,0,429
42413,backup,main,20220107,9,0.9918821685664753,20,420,0,440
6052,dark,main,20220107,0,0.9965658630907193,270,14,106,390
6052,dark,main,20220107,1,0.9908527323180752,257,14,87,358
6052,dark,main,20220107,2,0.9908843413855879,275,13,90,378
6052,dark,main,20220107,3,0.9919380777466317,246,12,92,350
6052,dark,main,20220107,4,0.9882161198524196,270,10,71,351
6052,dark,main,20220107,5,0.9939762852438842,258,12,103,373
6052,dark,main,20220107,6,0.9963922074091309,277,11,76,364
6052,dark,main,20220107,7,0.9891642888408466,238,13,75,326
6052,dark,main,20220107,8,0.9933121750993571,258,13,78,349
6052,dark,main,20220107,9,0.9956187210928777,263,17,99,379
26009,bright,main,20220107,0,0.9894515608082444,265,181,1,447
26009,bright,main,20220107,1,0.9946978946119786,231,148,3,382
26009,bright,main,20220107,2,0.9856364569317456,171,156,3,330
26009,bright,main,20220107,3,0.9939956080784794,233,162,2,397
26009,bright,main,20220107,4,0.9925645154925092,242,155,1,398
26009,bright,main,20220107,5,0.9947511369087391,264,151,2,417
26009,bright,main,20220107,6,0.9936757467310892,248,182,4,434
26009,bright,main,20220107,7,0.9918575449140551,185,110,5,300
26009,bright,main,20220107,8,0.9877448979148967,212,205,5,422
26009,bright,main,20220107,9,0.9931362367208852,228,204,2,434
22539,bright,main,20220107,0,0.9960168146787846,358,74,4,436
22539,bright,main,20220107,1,0.9886852785246374,319,75,3,397
22539,bright,main,20220107,2,0.9918542508398381,321,91,3,415
22539,bright,main,20220107,3,0.9898278252635154,267,110,3,380
22539,bright,main,20220107,4,0.9893170736366024,227,146,4,377
22539,bright,main,20220107,5,0.9925451997739682,233,156,6,395
22539,bright,main,20220107,6,0.9928185743443244,293,116,5,414
22539,bright,main,20220107,7,0.9931648167660524,251,98,2,351
22539,bright,main,20220107,8,0.9951055302203844,313,94,6,413
22539,bright,main,20220107,9,0.9909953261380632,347,70,4,421
7880,dark,main,20220107,0,0.9909035097724177,324,11,51,386
7880,dark,main,20220107,1,0.9912180016766308,266,11,79,356
7880,dark,main,20220107,2,0.9952611547368727,285,16,73,374
7880,dark,main,20220107,3,0.9880685869613018,259,11,89,359
7880,dark,main,20220107,4,0.9887873339788188,238,11,88,337
7880,dark,main,20220107,5,0.9945765131147236,269,14,83,366
7880,dark,main,20220107,6,0.9777440789363967,266,16,88,370
7880,dark,main,20220107,7,0.9926626623750412,263,11,44,318
7880,dark,main,20220107,8,0.9925132891122218,306,14,60,380
7880,dark,main,20220107,9,0.9950768412806302,299,11,64,374
24112,bright,main,20220107,0,0.9927251514855147,335,92,6,433
24112,bright,main,20220107,1,0.990655461794138,256,141,6,403
24112,bright,main,20220107,2,0.9900020429197094,318,114,2,434
24112,bright,main,20220107,3,0.99506752572114,264,135,3,402
24112,bright,main,20220107,4,0.9960495664269404,265,131,3,399
24112,bright,main,20220107,5,0.9871827497849047,301,112,6,419
24112,bright,main,20220107,6,0.9882693033810047,298,125,1,424
24112,bright,main,20220107,7,0.9944034990086651,243,127,5,375
24112,bright,main,20220107,8,0.9929038623663137,306,110,4,420
24112,bright,main,20220107,9,0.9937767648367647,308,112,8,428
4496,dark,main,20220107,0,0.9904484050733073,297,12,81,390
4496,dark,main,20220107,1,0.9868701217853999,248,16,83,347
4496,dark,main,20220107,2,0.9866903291838296,296,12,87,395
4496,dark,main,20220107,3,0.9892650449154037,268,12,72,352
4496,dark,main,20220107,4,0.9931767156123742,258,11,96,365
4496,dark,main,20220107,5,0.9906009495313811,284,12,82,378
4496,dark,main,20220107,6,0.9947688950547183,289,15,83,387
4496,dark,main,20220107,7,0.9933813377873653,242,13,78,333
4496,dark,main,20220107,8,0.9913635948293936,271,10,93,374
4496,dark,main,20220107,9,0.987893106686343,278,15,90,383
25085,bright,main,20220107,0,0.9900504719262878,378,36,9,423
25085,bright,main,20220107,1,0.9881894466790111,311,66,5,382
25085,bright,main,20220107,2,0.9967531138370279,341,66,10,417
25085,bright,main,20220107,3,0.99462621549044,323,56,5,384
25085,bright,main,20220107,4,0.9925959965598167,298,66,4,368
25085,bright,main,20220107,5,0.9910696479539017,318,63,2,383
25085,bright,main,20220107,6,0.9871625207608064,355,51,3,409
25085,bright,main,20220107,7,0.9956423267469054,319,39,1,359
25085,bright,main,20220107,8,0.9955897902847338,338,59,4,401
25085,bright,main,20220107,9,0.9866943817444567,345,67,3,415
10002,dark,main,20220107,0,0.9963414959021155,289,15,87,391
10002,dark,main,20220107,1,0.9895623335317222,253,12,81,346
10002,dark,main,20220107,2,0.9960060137439762,266,13,115,394
10002,dark,main,20220107,3,0.9912154423253986,270,14,76,360
10002,dark,main,20220107,4,0.9912233725226681,250,13,82,345
10002,dark,main,20220107,5,0.9941857505080112,261,13,89,363
10002,dark,main,20220107,6,0.9932386313605635,272,13,90,375
10002,dark,main,20220107,7,0.9915080883408904,244,11,88,343
10002,dark,main,20220107,8,0.9886349055114738,295,15,73,383
10002,dark,main,20220107,9,0.9938678365973509,284,13,87,384
20361,bright,main,20220107,0,0.9900051930453765,299,101,5,405
20361,bright,main,20220107,1,0.9905536422060286,268,84,6,358
20361,bright,main,20220107,2,0.9914080037358006,282,111,9,402
20361,bright,main,20220107,3,0.9824191723431404,276,104,6,386
20361,bright,main,20220107,4,0.9907169292607927,290,77,4,371
20361,bright,main,20220107,5,0.9806885889641126,318,72,5,395
20361,bright,main,20220107,6,0.9935581711776346,327,70,5,402
20361,bright,main,20220107,7,0.9944348230634159,258,78,1,337
20361,bright,main,20220107,8,0.9920796429443899,343,52,4,399
20361,bright,main,20220107,9,0.9926287402233076,328,68,4,400
42414,backup,main,20220107,0,0.9940802973662933,59,390,0,449
42414,backup,main,20220107,1,0.989100669589395,50,358,0,408
42414,backup,main,20220107,2,0.995354420143901,51,394,0,445
42414,backup,main,20220107,3,0.9932764710988127,54,352,0,406
42414,backup,main,20220107,4,0.9861967217568101,27,376,0,403
42414,backup,main,20220107,5,0.9953618781706239,26,396,0,422
42414,backup,main,20220107,6,0.9936038861958073,11,425,0,436
42414,backup,main,20220107,7,0.995349613851714,22,355,0,377
42414,backup,main,20220107,8,0.9965674368116605,17,412,0,429
42414,backup,main,20220107,9,0.9931795390710064,29,411,0,440
6091,dark,main,20220107,0,0.9960038928452148,287,15,99,401
6091,dark,main,20220107,1,0.9896150820275308,248,16,97,361
6091,dark,main,20220107,2,0.9921594312010009,276,14,87,377
6091,dark,main,20220107,3,0.9901186738014386,254,17,83,354
6091,dark,main,20220107,4,0.9879462009877144,238,14,80,332
6091,dark,main,20220107,5,0.9833926696265832,256,17,89,362
6091,dark,main,20220107,6,0.989237853483848,261,12,98,371
6091,dark,main,20220107,7,0.9949902777966424,246,12,79,337
6091,dark,main,20220107,8,0.990289246796389,272,11,92,375
6091,dark,main,20220107,9,0.9895711279261626,274,12,104,390
6050,dark,main,20220107,0,0.9930958997349648,292,12,98,402
6050,dark,main,20220107,1,0.9878013127180941,252,12,87,351
6050,dark,main,20220107,2,0.9904075531140881,278,12,93,383
6050,dark,main,20220107,3,0.9940738419392235,257,11,87,355
6050,dark,main,20220107,4,0.9786239080811852,260,11,73,344
6050,dark,main,20220107,5,0.9942200760784095,273,11,86,370
6050,dark,main,20220107,6,0.9863083074399567,296,12,72,380
6050,dark,main,20220107,7,0.9955588885026199,248,11,78,337
6050,dark,main,20220107,8,0.9903847040830915,264,13,94,371
6050,dark,main,20220107,9,0.9907595037583221,265,15,102,382
2948,dark,main,20220107,0,0.991059583680622,307,12,68,387
2948,dark,main,20220107,1,0.9904516996090937,258,15,80,353
2948,dark,main,20220107,2,0.9923455284654338,261,13,108,382
2948,dark,main,20220107,3,0.992148551112584,250,15,88,353
2948,dark,main,20220107,4,0.9842532114168024,230,13,89,332
2948,dark,main,20220107,5,0.9922848894452895,274,12,79,365
2948,dark,main,20220107,6,0.9931792671937834,297,17,71,385
2948,dark,main,20220107,7,0.9931075205488687,272,12,40,324
2948,dark,main,20220107,8,0.9904003252834547,319,13,50,382
2948,dark,main,20220107,9,0.9908456996006414,309,11,50,370
23046,bright,main,20220107,0,0.989741387253264,364,73,3,440
23046,bright,main,20220107,1,0.9927566640437768,340,50,5,395
23046,bright,main,20220107,2,0.9963440069942348,378,55,7,440
23046,bright,main,20220107,3,0.9913272735921071,299,95,4,398
23046,bright,main,20220107,4,0.9825608837820687,275,113,5,393
23046,bright,main,20220107,5,0.9911263593925959,329,80,3,412
23046,bright,main,20220107,6,0.9932714441916065,359,63,6,428
23046,bright,main,20220107,7,0.9866047479607171,291,71,4,366
23046,bright,main,20220107,8,0.9904994910426397,319,95,3,417
23046,bright,main,20220107,9,0.9838966872714838,334,91,6,431
26031,bright,main,20220108,0,0.995214044873097,245,97,7,349
26031,bright,main,20220108,1,0.9881556060346138,223,88,8,319
26031,bright,main,20220108,2,0.9918931960132704,255,91,12,358
26031,bright,main,20220108,3,0.9894816869613389,266,69,10,345
26031,bright,main,20220108,4,0.980028612601537,233,90,5,328
26031,bright,main,20220108,5,0.9862610760034917,219,121,6,346
26031,bright,main,20220108,6,0.988597736583378,261,93,8,362
26031,bright,main,20220108,7,0.9943403722389665,213,83,8,304
26031,bright,main,20220108,8,0.9925569456024865,247,87,6,340
26031,bright,main,20220108,9,0.9951971141542504,239,94,5,338
21487,bright,main,20220108,0,0.9941125561075447,231,203,4,438
21487,bright,main,20220108,1,0.9880941979735703,197,187,2,386
21487,bright,main,20220108,2,0.9861513526752473,224,200,5,429
21487,bright,main,20220108,3,0.9882323744285088,247,143,2,392
21487,bright,main,20220108,4,0.9871666127136448,280,112,1,393
21487,bright,main,20220108,5,0.9875159002527775,292,107,2,401
21487,bright,main,20220108,6,0.9921879286284091,317,101,5,423
21487,bright,main,20220108,7,0.992654336585015,278,84,4,366
21487,bright,main,20220108,8,0.990025007812539,313,86,5,404
21487,bright,main,20220108,9,0.9922497311842856,287,127,6,420
7040,dark,main,20220108,0,0.9955030664534141,267,44,87,398
7040,dark,main,20220108,1,0.9915692549385482,260,24,67,351
7040,dark,main,20220108,2,0.9905895068292305,261,39,75,375
7040,dark,main,20220108,3,0.9909257414547447,237,38,78,353
7040,dark,main,20220108,4,0.9928412716825614,258,23,64,345
7040,dark,main,20220108,5,0.9925488944553392,285,22,67,374
7040,dark,main,20220108,6,0.9867480598331475,271,23,81,375
7040,dark,main,20220108,7,0.9914066153323727,226,28,83,337
7040,dark,main,20220108,8,0.9874964155726084,249,31,93,373
7040,dark,main,20220108,9,0.9952185925692962,263,32,92,387
6695,dark,main,20220108,0,0.9957892794513237,319,13,53,385
6695,dark,main,20220108,1,0.9911100312624596,284,18,48,350
6695,dark,main,20220108,2,0.9953813319619268,313,19,55,387
6695,dark,main,20220108,3,0.9942410924376853,260,32,74,366
6695,dark,main,20220108,4,0.9935831145835179,263,34,62,359
6695,dark,main,20220108,5,0.9939969020731955,288,25,60,373
6695,dark,main,20220108,6,0.9969714363580924,306,29,53,388
6695,dark,main,20220108,7,0.9939505290600356,268,14,43,325
6695,dark,main,20220108,8,0.9948523476458444,290,18,63,371
6695,dark,main,20220108,9,0.9920500004061492,316,17,45,378
7047,dark,main,20220108,0,0.9924350721135523,334,14,33,381
7047,dark,main,20220108,1,0.9902456517785091,315,10,35,360
7047,dark,main,20220108,2,0.9969443062292732,324,10,48,382
7047,dark,main,20220108,3,0.9907173101939591,285,14,53,352
7047,dark,main,20220108,4,0.9926799501294387,292,11,43,346
7047,dark,main,20220108,5,0.9945937876674206,300,16,50,366
7047,dark,main,20220108,6,0.9934956243946312,285,14,73,372
7047,dark,main,20220108,7,0.9906816804535137,258,14,53,325
7047,dark,main,20220108,8,0.9937819480112015,284,15,62,361
7047,dark,main,20220108,9,0.9918017598201726,308,16,43,367
25029,bright,main,20220108,0,0.9959040690698768,284,147,3,434
25029,bright,main,20220108,1,0.9934207171004298,286,111,3,400
25029,bright,main,20220108,2,0.9907816053107381,316,98,5,419
25029,bright,main,20220108,3,0.9958221926029864,281,106,10,397
25029,bright,main,20220108,4,0.9913469306060791,310,79,2,391
25029,bright,main,20220108,5,0.9940285563058191,334,70,4,408
25029,bright,main,20220108,6,0.9920969063512312,314,107,6,427
25029,bright,main,20220108,7,0.9957079306495012,242,126,2,370
25029,bright,main,20220108,8,0.9944156782376257,284,127,3,414
25029,bright,main,20220108,9,0.9963868725207646,298,128,3,429
9760,dark,main,20220108,0,0.9944461704224142,340,12,44,396
9760,dark,main,20220108,1,0.9867455988772688,291,14,47,352
9760,dark,main,20220108,2,0.9949580088030361,311,12,64,387
9760,dark,main,20220108,3,0.9952429062927669,276,15,62,353
9760,dark,main,20220108,4,0.9912161397801251,257,9,66,332
9760,dark,main,20220108,5,0.9874791181883119,303,12,49,364
9760,dark,main,20220108,6,0.9951186011541219,297,12,52,361
9760,dark,main,20220108,7,0.9902438567239359,258,13,55,326
9760,dark,main,20220108,8,0.9945960958018067,307,14,46,367
9760,dark,main,20220108,9,0.9927204396323593,322,10,40,372
26177,bright,main,20220108,0,0.99202149122843,356,81,4,441
26177,bright,main,20220108,1,0.9904600711315755,291,102,4,397
26177,bright,main,20220108,2,0.9901273663096704,325,106,6,437
26177,bright,main,20220108,3,0.9936779312398435,260,134,6,400
26177,bright,main,20220108,4,0.9907888583622398,301,93,1,395
26177,bright,main,20220108,5,0.9942102651097172,309,102,4,415
26177,bright,main,20220108,6,0.9882795437657105,334,94,0,428
26177,bright,main,20220108,7,0.9941143060574764,292,79,2,373
26177,bright,main,20220108,8,0.9886556550577885,345,71,1,417
26177,bright,main,20220108,9,0.989514937715026,344,80,6,430
11804,dark,main,20220109,0,0.9921982628073114,313,13,62,388
11804,dark,main,20220109,1,0.9909403468983253,287,13,53,353
11804,dark,main,20220109,2,0.9901078959906056,289,14,77,380
11804,dark,main,20220109,3,0.98977676987908,289,13,48,350
11804,dark,main,20220109,4,0.9930863440836971,282,14,58,354
11804,dark,main,20220109,5,0.9855257121931669,263,14,78,355
11804,dark,main,20220109,6,0.986269729202322,276,16,89,381
11804,dark,main,20220109,7,0.9951835074156935,243,19,63,325
11804,dark,main,20220109,8,0.989615027870167,259,13,86,358
11804,dark,main,20220109,9,0.9941776203246184,299,13,68,380
20990,bright,main,20220109,0,0.992797771720977,330,110,4,444
20990,bright,main,20220109,1,0.9910605809946315,266,137,6,409
20990,bright,main,20220109,2,0.9972694781040115,242,197,1,440
20990,bright,main,20220109,3,0.9924313540212791,240,161,3,404
20990,bright,main,20220109,4,0.989558594937387,252,146,2,400
20990,bright,main,20220109,5,0.9902253341209376,249,167,2,418
20990,bright,main,20220109,6,0.9911938019570559,209,220,4,433
20990,bright,main,20220109,7,0.9856300781501034,205,174,0,379
20990,bright,main,20220109,8,0.9947188360929439,301,125,3,429
20990,bright,main,20220109,9,0.9974560236509,340,90,6,436
3061,dark,main,20220109,0,0.9916107894867628,270,19,84,373
3061,dark,main,20220109,1,0.9915963927885911,243,13,98,354
3061,dark,main,20220109,2,0.9970193437968708,271,17,94,382
3061,dark,main,20220109,3,0.9912466104071228,247,20,92,359
3061,dark,main,20220109,4,0.9886897485568382,225,16,107,348
3061,dark,main,20220109,5,0.9845150693895831,268,13,88,369
3061,dark,main,20220109,6,0.9915771456372064,255,10,111,376
3061,dark,main,20220109,7,0.9870671521430264,247,13,74,334
3061,dark,main,20220109,8,0.9903674113391996,263,23,81,367
3061,dark,main,20220109,9,0.9923327789710834,265,19,89,373
42453,backup,main,20220109,0,0.9875111391156535,92,354,0,446
42453,backup,main,20220109,1,0.9934586397390258,66,343,0,409
42453,backup,main,20220109,2,0.9915873698059883,102,343,0,445
42453,backup,main,20220109,3,0.992344357100139,56,350,0,406
42453,backup,main,20220109,4,0.994254880572611,68,335,0,403
42453,backup,main,20220109,5,0.9906060206709666,72,350,0,422
42453,backup,main,20220109,6,0.9952872710386612,35,402,0,437
42453,backup,main,20220109,7,0.9932403055217454,10,367,0,377
42453,backup,main,20220109,8,0.9940338749949167,18,411,0,429
42453,backup,main,20220109,9,0.9947259331357908,51,387,0,438
24652,bright,main,20220109,0,0.9940241966836898,359,79,2,440
24652,bright,main,20220109,1,0.9928154165204146,330,70,4,404
24652,bright,main,20220109,2,0.9913456408039037,332,106,2,440
24652,bright,main,20220109,3,0.9905425059043513,283,118,3,404
24652,bright,main,20220109,4,0.990846065244137,279,115,4,398
24652,bright,main,20220109,5,0.9915874669392354,256,155,4,415
24652,bright,main,20220109,6,0.992898019573795,258,171,3,432
24652,bright,main,20220109,7,0.9930531199199539,223,148,2,373
24652,bright,main,20220109,8,0.9938545623791619,300,121,2,423
24652,bright,main,20220109,9,0.9905920507630168,327,104,3,434
6072,dark,main,20220109,0,0.9925196902652065,305,12,56,373
6072,dark,main,20220109,1,0.9923553722745461,278,11,62,351
6072,dark,main,20220109,2,0.9956496301447436,260,13,89,362
6072,dark,main,20220109,3,0.99548688938904,269,11,74,354
6072,dark,main,20220109,4,0.9896921689310244,234,9,87,330
6072,dark,main,20220109,5,0.9915982049049716,251,13,87,351
6072,dark,main,20220109,6,0.9871490726417557,262,10,85,357
6072,dark,main,20220109,7,0.992926560467359,236,13,72,321
6072,dark,main,20220109,8,0.9910732196338772,268,13,81,362
6072,dark,main,20220109,9,0.988847859180137,287,11,70,368
23093,bright,main,20220109,0,0.9943047019684274,297,145,3,445
23093,bright,main,20220109,1,0.9912937729207498,261,143,2,406
23093,bright,main,20220109,2,0.9932555544975198,291,139,0,430
23093,bright,main,20220109,3,0.9932555544975198,291,139,0,430
23093,bright,main,20220109,4,0.9851687562191602,295,99,3,397
23093,bright,main,20220109,5,0.9919913279175441,325,93,1,419
23093,bright,main,20220109,6,0.9921398449753404,347,80,3,430
23093,bright,main,20220109,7,0.9941680419445729,294,80,4,378
23093,bright,main,20220109,8,0.9902250904810506,234,188,3,425
23093,bright,main,20220109,9,0.9955214775558704,260,177,1,438
23713,bright,main,20220109,0,0.9921477040404971,281,151,6,438
23713,bright,main,20220109,1,0.9868566678270485,303,95,2,400
23713,bright,main,20220109,2,0.9907747927439341,267,156,8,431
23713,bright,main,20220109,3,0.9945837536894598,273,122,2,397
23713,bright,main,20220109,4,0.99575775176418,251,132,2,385
23713,bright,main,20220109,5,0.995790523783226,256,137,8,401
23713,bright,main,20220109,6,0.9915306946987626,268,148,5,421
23713,bright,main,20220109,7,0.9884788059754865,219,147,6,372
23713,bright,main,20220109,8,0.9937459863493103,228,179,5,412
23713,bright,main,20220109,9,0.9902150686320988,297,130,2,429
21347,bright,main,20220109,0,0.9934580318331045,223,220,2,445
21347,bright,main,20220109,1,0.9949804567219598,157,147,2,306
21347,bright,main,20220109,2,0.9943302897390569,107,225,2,334
21347,bright,main,20220109,3,0.9909903020713478,235,164,1,400
21347,bright,main,20220109,4,0.9931169394252088,277,118,3,398
21347,bright,main,20220109,5,0.9934272332393049,280,136,5,421
21347,bright,main,20220109,6,0.9858413429904272,280,147,6,433
21347,bright,main,20220109,7,0.991017120578077,218,158,4,380
21347,bright,main,20220109,8,0.9925715342998064,219,198,5,422
21347,bright,main,20220109,9,0.9914757100056593,237,192,6,435
9271,dark,main,20220109,0,0.9949689454546958,274,21,100,395
9271,dark,main,20220109,1,0.9894534031845391,248,16,81,345
9271,dark,main,20220109,2,0.9908151260280597,286,20,91,397
9271,dark,main,20220109,3,0.9938586430649153,249,25,81,355
9271,dark,main,20220109,4,0.987613924373362,241,13,93,347
9271,dark,main,20220109,5,0.9861132104743965,251,19,85,355
9271,dark,main,20220109,6,0.9918521214245914,266,23,110,399
9271,dark,main,20220109,7,0.9884452317553938,229,17,89,335
9271,dark,main,20220109,8,0.9934029468450322,283,21,72,376
9271,dark,main,20220109,9,0.9884876214550775,267,26,98,391
4516,dark,main,20220109,0,0.9880917041234641,288,18,90,396
4516,dark,main,20220109,1,0.9962337934502579,281,11,67,359
4516,dark,main,20220109,2,0.9902378443448253,283,12,89,384
4516,dark,main,20220109,3,0.9935513615753538,239,17,92,348
4516,dark,main,20220109,4,0.9935923678948649,266,9,73,348
4516,dark,main,20220109,5,0.9908846561149588,296,12,62,370
4516,dark,main,20220109,6,0.9874841705758698,281,14,97,392
4516,dark,main,20220109,7,0.988168868910238,252,14,64,330
4516,dark,main,20220109,8,0.9876709067545731,267,31,63,361
4516,dark,main,20220109,9,0.9901719202754728,275,13,95,383
9311,dark,main,20220109,0,0.9892119184471703,264,18,102,384
9311,dark,main,20220109,1,0.9929052040147607,238,24,92,354
9311,dark,main,20220109,2,0.9926069066106162,266,17,95,378
9311,dark,main,20220109,3,0.9966371141904058,243,16,81,340
9311,dark,main,20220109,4,0.9895426762099008,245,18,83,346
9311,dark,main,20220109,5,0.9892487197729919,256,16,98,370
9311,dark,main,20220109,6,0.9944695137185601,275,13,92,380
9311,dark,main,20220109,7,0.9912160495437327,245,17,75,337
9311,dark,main,20220109,8,0.9935843373112819,262,18,78,358
9311,dark,main,20220109,9,0.9891524014310908,254,22,88,364
4578,dark,main,20220109,0,0.990032394823999,276,22,71,369
4578,dark,main,20220109,1,0.9784845836535652,250,18,83,351
4578,dark,main,20220109,2,0.9898093673254695,281,21,95,397
4578,dark,main,20220109,3,0.9919597657829278,244,17,93,354
4578,dark,main,20220109,4,0.9937979578625873,254,16,85,355
4578,dark,main,20220109,5,0.9919267828812052,256,17,79,352
4578,dark,main,20220109,6,0.9864959629398742,266,21,100,387
4578,dark,main,20220109,7,0.9848246098142476,233,15,83,331
4578,dark,main,20220109,8,0.9894144527494769,258,23,93,374
4578,dark,main,20220109,9,0.9937405862201999,275,23,81,379
10767,dark,main,20220109,0,0.9949726210326456,305,11,64,380
10767,dark,main,20220109,1,0.9867051798464582,287,11,61,359
10767,dark,main,20220109,2,0.9942848853948043,294,15,84,393
10767,dark,main,20220109,3,0.991045854525186,257,14,79,350
10767,dark,main,20220109,4,0.9828675494204256,272,13,59,344
10767,dark,main,20220109,5,0.9925514605355411,293,14,62,369
10767,dark,main,20220109,6,0.990126286632058,294,11,65,370
10767,dark,main,20220109,7,0.9927378855797061,254,14,58,326
10767,dark,main,20220109,8,0.9925102112870735,295,14,67,376
10767,dark,main,20220109,9,0.9920894199475039,299,18,54,371
9279,dark,main,20220109,0,0.9953557278782351,273,23,82,378
9279,dark,main,20220109,1,0.9890656760371455,252,17,81,350
9279,dark,main,20220109,2,0.9913324417678012,264,17,94,375
9279,dark,main,20220109,3,0.9871305556615632,250,18,74,342
9279,dark,main,20220109,4,0.9941427872061691,237,15,94,346
9279,dark,main,20220109,5,0.9931784984707605,240,14,112,366
9279,dark,main,20220109,6,0.9917329326478221,249,18,102,369
9279,dark,main,20220109,7,0.9951251770082962,228,22,70,320
9279,dark,main,20220109,8,0.985973698530138,263,22,90,375
9279,dark,main,20220109,9,0.9868538364061957,242,18,102,362
26040,bright,main,20220109,0,0.9907688110033204,309,117,2,428
26040,bright,main,20220109,1,0.9894979126976499,266,132,5,403
26040,bright,main,20220109,2,0.9893018772042272,320,96,3,419
26040,bright,main,20220109,3,0.9924940101478952,282,112,5,399
26040,bright,main,20220109,4,0.9917076839369666,287,104,9,400
26040,bright,main,20220109,5,0.9938983686816036,313,96,7,416
26040,bright,main,20220109,6,0.9782272089310409,115,32,0,147
26040,bright,main,20220109,7,0.992892601530646,294,78,3,375
26040,bright,main,20220109,8,0.9950559849815962,311,109,6,426
26040,bright,main,20220109,9,0.9933204846569285,321,116,0,437
21416,bright,main,20220109,0,0.9965697913610804,372,59,4,435
21416,bright,main,20220109,1,0.9955638183500048,294,89,5,388
21416,bright,main,20220109,2,0.9863822875062352,349,73,4,426
21416,bright,main,20220109,3,0.9936350157192858,293,88,2,383
21416,bright,main,20220109,4,0.9879007110369796,319,64,10,393
21416,bright,main,20220109,5,0.9959262170234312,317,79,3,399
21416,bright,main,20220109,6,0.9968056074399296,330,81,5,416
21416,bright,main,20220109,7,0.9903203932677251,303,64,2,369
21416,bright,main,20220109,8,0.9941455778583056,304,96,5,405
21416,bright,main,20220109,9,0.9921181203337426,352,72,4,428
9406,dark,main,20220109,0,0.9936027060057347,289,16,82,387
9406,dark,main,20220109,1,0.9907405693680393,258,16,77,351
9406,dark,main,20220109,2,0.9965547107245668,285,17,90,392
9406,dark,main,20220109,3,0.9868746743629209,262,15,90,367
9406,dark,main,20220109,4,0.9946786042584365,245,18,91,354
9406,dark,main,20220109,5,0.9916853943150135,273,26,71,370
9406,dark,main,20220109,6,0.9901399011067086,262,18,100,380
9406,dark,main,20220109,7,0.9900367911463216,231,19,87,337
9406,dark,main,20220109,8,0.9923191023110917,286,19,66,371
9406,dark,main,20220109,9,0.988201963623877,298,14,63,375
4586,dark,main,20220109,0,0.9874621535956274,267,15,102,384
4586,dark,main,20220109,1,0.9937823040112563,239,20,87,346
4586,dark,main,20220109,2,0.9951490674320363,254,26,99,379
4586,dark,main,20220109,3,0.9847440437991176,254,14,86,354
4586,dark,main,20220109,4,0.9900604517800577,246,19,88,353
4586,dark,main,20220109,5,0.9901057458887845,263,16,101,380
4586,dark,main,20220109,6,0.9891537475809962,290,15,82,387
4586,dark,main,20220109,7,0.9898525132481237,242,23,74,339
4586,dark,main,20220109,8,0.9923449424412388,261,23,88,372
4586,dark,main,20220109,9,0.9942369469174924,264,19,92,375
2347,dark,main,20220109,0,0.9890595613190525,302,23,64,389
2347,dark,main,20220109,1,0.986140833080777,183,22,49,254
2347,dark,main,20220109,2,0.9889942856075268,144,25,46,215
2347,dark,main,20220109,3,0.9898696722627326,233,27,72,332
2347,dark,main,20220109,4,0.9926499861272056,239,25,73,337
2347,dark,main,20220109,5,0.991538747804628,285,17,62,364
2347,dark,main,20220109,6,0.99123228353177,277,22,73,372
2347,dark,main,20220109,7,0.9904418711072592,233,22,78,333
2347,dark,main,20220109,8,0.991194995245299,264,21,75,360
2347,dark,main,20220109,9,0.9881041934015306,269,23,81,373
3060,dark,main,20220109,0,0.9886635314378108,273,15,90,378
3060,dark,main,20220109,1,0.9936588447129379,244,21,73,338
3060,dark,main,20220109,2,0.9934973973832231,275,19,93,387
3060,dark,main,20220109,3,0.985309132464814,259,17,75,351
3060,dark,main,20220109,4,0.995044278756297,233,16,90,339
3060,dark,main,20220109,5,0.993606435232542,263,17,95,375
3060,dark,main,20220109,6,0.9903340249796967,271,18,79,368
3060,dark,main,20220109,7,0.9952273063916962,241,19,68,328
3060,dark,main,20220109,8,0.9920952059232688,256,16,105,377
3060,dark,main,20220109,9,0.9960036845803246,281,18,82,381
6292,dark,main,20220109,0,0.9947601589366905,266,15,111,392
6292,dark,main,20220109,1,0.9884944719776451,263,14,82,359
6292,dark,main,20220109,2,0.9954593679091729,275,15,93,383
6292,dark,main,20220109,3,0.990729903723422,242,18,79,339
6292,dark,main,20220109,4,0.9910559779509296,262,18,86,366
6292,dark,main,20220109,5,0.9899784137395858,260,17,98,375
6292,dark,main,20220109,6,0.995476535115313,275,15,69,359
6292,dark,main,20220109,7,0.9834080530321255,238,16,81,335
6292,dark,main,20220109,8,0.9891197469660391,258,15,97,370
6292,dark,main,20220109,9,0.9923832990402188,274,17,99,390
11794,dark,main,20220109,0,0.9923595849293273,305,17,61,383
11794,dark,main,20220109,1,0.9895716915753289,292,16,57,365
11794,dark,main,20220109,2,0.9915987804179409,312,13,63,388
11794,dark,main,20220109,3,0.9939548556799342,280,11,67,358
11794,dark,main,20220109,4,0.9919423813923823,246,18,85,349
11794,dark,main,20220109,5,0.9929224911849505,252,13,102,367
11794,dark,main,20220109,6,0.9922200014648765,290,19,84,393
11794,dark,main,20220109,7,0.988303030360489,243,13,70,326
11794,dark,main,20220109,8,0.995289883481685,270,13,98,381
11794,dark,main,20220109,9,0.9951204078224477,266,17,94,377
3058,dark,main,20220109,0,0.9934989058161428,269,15,92,376
3058,dark,main,20220109,1,0.9929846028075148,262,17,75,354
3058,dark,main,20220109,2,0.9884627954912358,268,18,86,372
3058,dark,main,20220109,3,0.9938408745842016,240,15,81,336
3058,dark,main,20220109,4,0.995058470713614,226,15,99,340
3058,dark,main,20220109,5,0.9922691370475396,263,15,90,368
3058,dark,main,20220109,6,0.990695067057528,271,12,92,375
3058,dark,main,20220109,7,0.9847216345503821,216,13,103,332
3058,dark,main,20220109,8,0.9947245571182028,249,17,102,368
3058,dark,main,20220109,9,0.9925815289941626,267,12,100,379
23708,bright,main,20220109,0,0.9953228616151245,345,89,2,436
23708,bright,main,20220109,1,0.9913854349837171,290,115,2,407
23708,bright,main,20220109,2,0.9934439767088868,319,114,2,435
23708,bright,main,20220109,3,0.992371285697196,282,120,3,405
23708,bright,main,20220109,4,0.9941963623516124,341,56,1,398
23708,bright,main,20220109,5,0.995268927857206,371,40,4,415
23708,bright,main,20220109,6,0.9935375496157315,347,81,3,431
23708,bright,main,20220109,7,0.9914222785066886,290,85,3,378
23708,bright,main,20220109,8,0.9953331304728014,336,87,4,427
23708,bright,main,20220109,9,0.9954944617144512,363,66,3,432
41773,backup,main,20220111,0,0.9927646724996103,0,449,0,449
41773,backup,main,20220111,1,0.9864411227440781,0,408,1,409
41773,backup,main,20220111,2,0.9907378219682331,1,443,0,444
41773,backup,main,20220111,3,0.9953521170036258,4,403,0,407
41773,backup,main,20220111,4,0.9942268663755841,1,402,0,403
41773,backup,main,20220111,5,0.9931039600171637,3,420,0,423
41773,backup,main,20220111,6,0.9938669949283829,1,435,0,436
41773,backup,main,20220111,7,0.9929555844256706,5,375,0,380
41773,backup,main,20220111,8,0.99289603375276,0,431,0,431
41773,backup,main,20220111,9,0.9902701820940903,0,439,0,439
41757,backup,main,20220111,0,0.9903823553966272,4,445,0,449
41757,backup,main,20220111,1,0.993651871533033,3,405,0,408
41757,backup,main,20220111,2,0.9944763549366519,0,444,0,444
41757,backup,main,20220111,3,0.9907454535967632,6,401,0,407
41757,backup,main,20220111,4,0.9922049420620921,3,400,0,403
41757,backup,main,20220111,5,0.9874536129628229,5,417,0,422
41757,backup,main,20220111,6,0.9953757832669656,2,435,0,437
41757,backup,main,20220111,7,0.9938128512119105,4,376,0,380
41757,backup,main,20220111,8,0.9938490345676032,2,426,0,428
41757,backup,main,20220111,9,0.9946927443712983,1,440,0,441
41540,backup,main,20220111,0,0.9923027383832498,3,407,0,410
41540,backup,main,20220111,1,0.9878051881809031,2,371,0,373
41540,backup,main,20220111,2,0.9916492993195726,4,402,0,406
41540,backup,main,20220111,3,0.9915786511602855,6,364,1,371
41540,backup,main,20220111,4,0.9947277888088689,1,359,3,363
41540,backup,main,20220111,5,0.9909436568858239,2,373,0,375
41540,backup,main,20220111,6,0.9910826642925972,0,391,2,393
41540,backup,main,20220111,7,0.9857433684847627,4,336,2,342
41540,backup,main,20220111,8,0.9949002800928379,7,390,1,398
41540,backup,main,20220111,9,0.9926873341024218,1,397,1,399
40590,backup,main,20220111,0,0.992569151547717,6,418,2,426
40590,backup,main,20220111,1,0.9936664738401939,5,372,0,377
40590,backup,main,20220111,2,0.9967098336555759,5,403,0,408
40590,backup,main,20220111,3,0.9879265975604868,8,355,3,366
40590,backup,main,20220111,4,0.9931639886495569,7,354,2,363
40590,backup,main,20220111,5,0.991855306485405,2,393,0,395
40590,backup,main,20220111,6,0.9928546936916829,5,394,3,402
40590,backup,main,20220111,7,0.9824951729426081,5,336,0,341
40590,backup,main,20220111,8,0.9919596890585997,3,381,0,384
40590,backup,main,20220111,9,0.9928963649335598,7,393,1,401
23718,bright,main,20220111,0,0.9928897240444082,343,90,5,438
23718,bright,main,20220111,1,0.9898823387233662,297,100,2,399
23718,bright,main,20220111,2,0.9957422483222449,303,128,4,435
23718,bright,main,20220111,3,0.988004250209172,266,127,4,397
23718,bright,main,20220111,4,0.9903987412129802,281,100,4,385
23718,bright,main,20220111,5,0.9877683624468261,286,115,5,406
23718,bright,main,20220111,6,0.992394552529581,320,100,3,423
23718,bright,main,20220111,7,0.9926402154294997,281,84,3,368
23718,bright,main,20220111,8,0.9895645012513763,317,95,5,417
23718,bright,main,20220111,9,0.9820487859991923,310,118,5,433
41747,backup,main,20220111,0,0.9902888752137144,1,447,0,448
41747,backup,main,20220111,1,0.9912887435150981,2,406,0,408
41747,backup,main,20220111,2,0.9951608781591322,3,442,0,445
41747,backup,main,20220111,3,0.9913781831737178,10,397,0,407
41747,backup,main,20220111,4,0.9923207208588762,10,391,0,401
41747,backup,main,20220111,5,0.9955006154122772,2,422,0,424
41747,backup,main,20220111,6,0.9960566470743537,6,431,0,437
41747,backup,main,20220111,7,0.9959685526433915,4,376,0,380
41747,backup,main,20220111,8,0.9948982570249824,4,426,0,430
41747,backup,main,20220111,9,0.9932116008256179,3,438,0,441
41253,backup,main,20220111,0,0.9912193981791632,7,441,0,448
41253,backup,main,20220111,1,0.9906902904267927,3,405,0,408
41253,backup,main,20220111,2,0.9909256340363144,2,442,0,444
41253,backup,main,20220111,3,0.9938318896016153,6,401,0,407
41253,backup,main,20220111,4,0.9925167487408662,5,398,0,403
41253,backup,main,20220111,5,0.9846288763118269,2,420,0,422
41253,backup,main,20220111,6,0.9929538912727002,2,434,0,436
41253,backup,main,20220111,7,0.9920173116338314,3,378,0,381
41253,backup,main,20220111,8,0.9846526669161542,2,428,0,430
41253,backup,main,20220111,9,0.9919610367043178,1,440,0,441
40565,backup,main,20220111,0,0.9887692346340057,5,405,0,410
40565,backup,main,20220111,1,0.9911209308298894,5,352,0,357
40565,backup,main,20220111,2,0.9918064662472422,4,391,1,396
40565,backup,main,20220111,3,0.991340847162388,6,355,2,363
40565,backup,main,20220111,4,0.9805912005813966,3,357,1,361
40565,backup,main,20220111,5,0.9855687122024147,12,362,2,376
40565,backup,main,20220111,6,0.9936785546599931,5,382,0,387
40565,backup,main,20220111,7,0.9925319231240518,33,304,0,337
40565,backup,main,20220111,8,0.989489715657154,5,365,0,370
40565,backup,main,20220111,9,0.9946027892220659,7,390,0,397
7850,dark,main,20220112,0,0.9837519075717656,177,17,65,259
7850,dark,main,20220112,1,0.991768707161805,160,20,61,241
7850,dark,main,20220112,2,0.9843558739212983,168,18,63,249
7850,dark,main,20220112,3,0.9868399462096672,164,16,64,244
7850,dark,main,20220112,4,0.9757857049879012,161,11,45,217
7850,dark,main,20220112,5,0.9890337057569633,160,12,67,239
7850,dark,main,20220112,6,0.9857143653673603,173,11,50,234
7850,dark,main,20220112,7,0.9862752155902423,170,13,52,235
7850,dark,main,20220112,8,0.9843815451420354,187,13,53,253
7850,dark,main,20220112,9,0.9880437519748031,180,17,71,268
4592,dark,main,20220112,0,0.9940996713096217,298,17,65,380
4592,dark,main,20220112,1,0.9927425555426197,265,16,80,361
4592,dark,main,20220112,2,0.9923093817341894,264,16,99,379
4592,dark,main,20220112,3,0.9849519897745342,244,15,85,344
4592,dark,main,20220112,4,0.9936040188901297,251,15,73,339
4592,dark,main,20220112,5,0.9884938039402045,257,12,104,373
4592,dark,main,20220112,6,0.993456273810007,262,13,97,372
4592,dark,main,20220112,7,0.9949009705675532,227,14,82,323
4592,dark,main,20220112,8,0.9926765627713092,266,21,81,368
4592,dark,main,20220112,9,0.9910308808106512,260,20,102,382
24688,bright,main,20220112,0,0.994215705063878,313,109,8,430
24688,bright,main,20220112,1,0.9926475409893278,298,101,2,401
24688,bright,main,20220112,2,0.9877632693483178,347,80,5,432
24688,bright,main,20220112,3,0.9905262942514232,318,71,3,392
24688,bright,main,20220112,4,0.9948327755808128,327,61,2,390
24688,bright,main,20220112,5,0.9853075619149793,343,60,3,406
24688,bright,main,20220112,6,0.990668365162933,356,65,4,425
24688,bright,main,20220112,7,0.992517409289696,285,80,0,365
24688,bright,main,20220112,8,0.9938631733186748,247,147,7,401
24688,bright,main,20220112,9,0.9913475183059152,284,136,4,424
25867,bright,main,20220112,0,0.9932983754697006,334,67,12,413
25867,bright,main,20220112,1,0.9861803115172372,291,79,6,376
25867,bright,main,20220112,2,0.9926065305177046,352,55,5,412
25867,bright,main,20220112,3,0.9923491901208633,329,52,1,382
25867,bright,main,20220112,4,0.9952254592644258,319,52,1,372
25867,bright,main,20220112,5,0.9902508494385358,312,60,2,374
25867,bright,main,20220112,6,0.992658544893847,329,56,9,394
25867,bright,main,20220112,7,0.9918224871723182,279,54,2,335
25867,bright,main,20220112,8,0.9897711308900246,312,74,2,388
25867,bright,main,20220112,9,0.9955577251977676,317,75,6,398
23106,bright,main,20220112,0,0.99474639882277,312,125,5,442
23106,bright,main,20220112,1,0.9912889409159568,260,128,8,396
23106,bright,main,20220112,2,0.9948651845730858,312,122,4,438
23106,bright,main,20220112,3,0.9879106535725602,246,145,7,398
23106,bright,main,20220112,4,0.9849896961268555,294,95,2,391
23106,bright,main,20220112,5,0.9900834275056614,304,106,3,413
23106,bright,main,20220112,6,0.9944248096285634,353,72,3,428
23106,bright,main,20220112,7,0.9906078776480987,303,66,4,373
23106,bright,main,20220112,8,0.9918732431438434,333,82,8,423
23106,bright,main,20220112,9,0.9937686980140953,352,74,3,429
1449,dark,main,20220112,0,0.9867792109290309,271,24,101,396
1449,dark,main,20220112,1,0.9939972208396772,251,15,82,348
1449,dark,main,20220112,2,0.993112673975652,283,13,87,383
1449,dark,main,20220112,3,0.995860693636611,231,17,102,350
1449,dark,main,20220112,4,0.9926151112373167,267,14,66,347
1449,dark,main,20220112,5,0.9898889000531816,260,14,98,372
1449,dark,main,20220112,6,0.9920586607787777,255,19,80,354
1449,dark,main,20220112,7,0.9840993166721203,223,14,90,327
1449,dark,main,20220112,8,0.9930906585186395,264,17,87,368
1449,dark,main,20220112,9,0.9906752170141347,256,19,98,373
9264,dark,main,20220112,0,0.9937721762775202,266,19,97,382
9264,dark,main,20220112,1,0.9893276793078534,235,18,101,354
9264,dark,main,20220112,2,0.9839025511731034,276,16,96,388
9264,dark,main,20220112,3,0.9916876542340438,241,17,99,357
9264,dark,main,20220112,4,0.9931775946010053,249,14,87,350
9264,dark,main,20220112,5,0.992546541568416,263,13,85,361
9264,dark,main,20220112,6,0.9929908586421199,262,18,103,383
9264,dark,main,20220112,7,0.9930979912635943,234,13,85,332
9264,dark,main,20220112,8,0.9899928498261644,262,16,87,365
9264,dark,main,20220112,9,0.9959619727767606,272,12,98,382
43005,backup,main,20220112,0,0.9941556519309628,69,374,0,443
43005,backup,main,20220112,1,0.991295779280468,116,281,5,402
43005,backup,main,20220112,2,0.9928558771668201,108,324,7,439
43005,backup,main,20220112,3,0.9880679229474323,62,343,0,405
43005,backup,main,20220112,4,0.9934688117523546,33,365,0,398
43005,backup,main,20220112,5,0.9945531761574269,18,404,0,422
43005,backup,main,20220112,6,0.9900563181625123,19,416,0,435
43005,backup,main,20220112,7,0.9910890881920519,6,373,0,379
43005,backup,main,20220112,8,0.9931371465530364,20,409,0,429
43005,backup,main,20220112,9,0.9951890768311623,40,399,1,440
23125,bright,main,20220112,0,0.996502290053235,355,80,3,438
23125,bright,main,20220112,1,0.990629153616578,318,83,2,403
23125,bright,main,20220112,2,0.9910610995052602,313,116,7,436
23125,bright,main,20220112,3,0.9938795978725473,232,166,3,401
23125,bright,main,20220112,4,0.9910713468900382,271,127,1,399
23125,bright,main,20220112,5,0.9948251740343818,333,83,4,420
23125,bright,main,20220112,6,0.9928522970411192,340,82,5,427
23125,bright,main,20220112,7,0.99282101750951,282,91,4,377
23125,bright,main,20220112,8,0.9906352202430414,345,66,7,418
23125,bright,main,20220112,9,0.9900986403008393,349,79,6,434
42980,backup,main,20220112,0,0.9934073055279595,20,426,0,446
42980,backup,main,20220112,1,0.9912417278251381,26,382,0,408
42980,backup,main,20220112,2,0.996552926271801,26,419,0,445
42980,backup,main,20220112,3,0.9905328416727613,12,393,0,405
42980,backup,main,20220112,4,0.9924063300538829,6,396,0,402
42980,backup,main,20220112,5,0.9890448697921604,11,412,0,423
42980,backup,main,20220112,6,0.9909117030818033,3,434,0,437
42980,backup,main,20220112,7,0.9954001823782791,7,371,0,378
42980,backup,main,20220112,8,0.9924564494095501,5,422,1,428
42980,backup,main,20220112,9,0.9963093851740962,24,416,0,440
23081,bright,main,20220112,0,0.9959274320327045,232,191,1,424
23081,bright,main,20220112,1,0.9928239217146578,275,109,1,385
23081,bright,main,20220112,2,0.9970243134039363,287,136,5,428
23081,bright,main,20220112,3,0.9953597574792711,259,123,2,384
23081,bright,main,20220112,4,0.9935281628851926,260,123,4,387
23081,bright,main,20220112,5,0.9962521365412031,258,148,5,411
23081,bright,main,20220112,6,0.989442461559112,250,160,6,416
23081,bright,main,20220112,7,0.9941462269152366,190,168,1,359
23081,bright,main,20220112,8,0.9930794393103455,216,189,8,413
23081,bright,main,20220112,9,0.9961343986814698,275,149,4,428
42994,backup,main,20220112,0,0.9924140408387807,9,439,0,448
42994,backup,main,20220112,1,0.9935187772548751,18,383,0,401
42994,backup,main,20220112,2,0.9948657919995507,14,428,0,442
42994,backup,main,20220112,3,0.9908880913930975,21,383,0,404
42994,backup,main,20220112,4,0.9926071595308977,13,387,0,400
42994,backup,main,20220112,5,0.984333582771751,23,395,0,418
42994,backup,main,20220112,6,0.9967150710567918,13,418,0,431
42994,backup,main,20220112,7,0.9915135088436272,14,359,0,373
42994,backup,main,20220112,8,0.9937223643804177,12,411,1,424
42994,backup,main,20220112,9,0.9946810801132709,12,426,0,438
26212,bright,main,20220112,0,0.9936624500408523,216,210,13,439
26212,bright,main,20220112,1,0.993596780564098,232,166,4,402
26212,bright,main,20220112,2,0.9903910556677675,278,143,9,430
26212,bright,main,20220112,3,0.9942185066780321,276,115,6,397
26212,bright,main,20220112,4,0.985800297967221,268,110,6,384
26212,bright,main,20220112,5,0.9816772809618164,285,117,4,406
26212,bright,main,20220112,6,0.9881842635750433,291,130,5,426
26212,bright,main,20220112,7,0.9894403115728808,240,123,4,367
26212,bright,main,20220112,8,0.990031783944958,301,104,4,409
26212,bright,main,20220112,9,0.991617733458638,272,143,11,426
11795,dark,main,20220112,0,0.9894833420483078,329,11,59,399
11795,dark,main,20220112,1,0.9919985012399293,283,12,63,358
11795,dark,main,20220112,2,0.9938165661148316,304,13,72,389
11795,dark,main,20220112,3,0.9913227378225834,287,13,50,350
11795,dark,main,20220112,4,0.9846480633639128,284,11,64,359
11795,dark,main,20220112,5,0.9911244429554229,285,13,67,365
11795,dark,main,20220112,6,0.9924376257582592,261,17,88,366
11795,dark,main,20220112,7,0.9919299814799372,246,13,79,338
11795,dark,main,20220112,8,0.9895371165775305,278,17,83,378
11795,dark,main,20220112,9,0.9898202526240455,298,11,67,376
26111,bright,main,20220112,0,0.9956583860656348,309,128,1,438
26111,bright,main,20220112,1,0.9922617617596867,296,106,4,406
26111,bright,main,20220112,2,0.9929891291611274,318,118,2,438
26111,bright,main,20220112,3,0.99096678599587,268,127,5,400
26111,bright,main,20220112,4,0.9859054052874753,310,82,4,396
26111,bright,main,20220112,5,0.9965944460692358,349,63,4,416
26111,bright,main,20220112,6,0.9929646729290815,353,67,7,427
26111,bright,main,20220112,7,0.9906660093749567,301,70,2,373
26111,bright,main,20220112,8,0.9921776964643506,321,96,5,422
26111,bright,main,20220112,9,0.9947240262269531,293,135,8,436
23116,bright,main,20220112,0,0.994833574779449,330,103,2,435
23116,bright,main,20220112,1,0.9933327652713635,321,77,5,403
23116,bright,main,20220112,2,0.9957732192618144,297,122,5,424
23116,bright,main,20220112,3,0.9908956537260138,327,64,4,395
23116,bright,main,20220112,4,0.9859291728842077,259,129,6,394
23116,bright,main,20220112,5,0.9895554221255841,258,143,9,410
23116,bright,main,20220112,6,0.9852703534471728,285,132,7,424
23116,bright,main,20220112,7,0.9885852904133053,225,135,4,364
23116,bright,main,20220112,8,0.9951082588858737,297,114,3,414
23116,bright,main,20220112,9,0.9931039928397692,341,79,6,426
23131,bright,main,20220112,0,0.9956645874265547,280,164,0,444
23131,bright,main,20220112,1,0.9898651195376178,266,135,3,404
23131,bright,main,20220112,2,0.9954270249583472,307,126,6,439
23131,bright,main,20220112,3,0.9963823147032308,301,96,2,399
23131,bright,main,20220112,4,0.991716531022317,322,75,2,399
23131,bright,main,20220112,5,0.9885321063008049,327,92,3,422
23131,bright,main,20220112,6,0.9967299843937816,307,114,5,426
23131,bright,main,20220112,7,0.9863813562426377,260,110,4,374
23131,bright,main,20220112,8,0.9909634037005229,282,136,5,423
23131,bright,main,20220112,9,0.9922793586780011,255,174,6,435
42979,backup,main,20220112,0,0.9948829790152539,17,429,0,446
42979,backup,main,20220112,1,0.9911760843392508,29,378,0,407
42979,backup,main,20220112,2,0.9900661670804426,10,429,0,439
42979,backup,main,20220112,3,0.9944304554810836,12,388,0,400
42979,backup,main,20220112,4,0.9931203009985174,14,382,0,396
42979,backup,main,20220112,5,0.9910090711112746,15,401,0,416
42979,backup,main,20220112,6,0.9919485925179635,11,421,0,432
42979,backup,main,20220112,7,0.9925896693422757,19,354,1,374
42979,backup,main,20220112,8,0.9963813891438518,9,414,1,424
42979,backup,main,20220112,9,0.993666312904634,21,417,0,438
4594,dark,main,20220112,0,0.9959938775047438,292,17,80,389
4594,dark,main,20220112,1,0.9882372059464415,242,15,86,343
4594,dark,main,20220112,2,0.9952452520301608,290,14,93,397
4594,dark,main,20220112,3,0.9932759738103936,274,12,73,359
4594,dark,main,20220112,4,0.9928071540978507,238,13,99,350
4594,dark,main,20220112,5,0.9936955777477445,253,14,100,367
4594,dark,main,20220112,6,0.9954448961132244,276,14,96,386
4594,dark,main,20220112,7,0.9947926754608528,232,13,90,335
4594,dark,main,20220112,8,0.9925785642476654,238,14,109,361
4594,dark,main,20220112,9,0.9947243904648202,282,13,99,394
21732,bright,main,20220112,0,0.9951143359205405,324,88,5,417
21732,bright,main,20220112,1,0.992161838609689,310,59,5,374
21732,bright,main,20220112,2,0.9915118877893961,325,72,9,406
21732,bright,main,20220112,3,0.9959242111276702,284,85,3,372
21732,bright,main,20220112,4,0.989740934088988,289,79,4,372
21732,bright,main,20220112,5,0.9951656426625243,279,105,2,386
21732,bright,main,20220112,6,0.992784221773975,285,105,8,398
21732,bright,main,20220112,7,0.9872051048170108,262,77,6,345
21732,bright,main,20220112,8,0.9803066317773357,287,89,6,382
21732,bright,main,20220112,9,0.9923767728858076,320,86,2,408
8380,dark,main,20220112,0,0.9883124126235376,265,13,97,375
8380,dark,main,20220112,1,0.9888505635016083,247,16,73,336
8380,dark,main,20220112,2,0.9879831593900118,256,20,98,374
8380,dark,main,20220112,3,0.9896423197893276,247,18,83,348
8380,dark,main,20220112,4,0.9870208559588945,223,23,86,332
8380,dark,main,20220112,5,0.9886285525002888,236,20,107,363
8380,dark,main,20220112,6,0.9951200606489832,258,14,101,373
8380,dark,main,20220112,7,0.9888323612899574,244,17,68,329
8380,dark,main,20220112,8,0.9931170630830015,256,17,87,360
8380,dark,main,20220112,9,0.983024465096721,251,16,98,365
10831,dark,main,20220112,0,0.9887717982198886,286,17,85,388
10831,dark,main,20220112,1,0.985100623944263,250,13,91,354
10831,dark,main,20220112,2,0.994030113364021,275,16,95,386
10831,dark,main,20220112,3,0.9877310710368935,256,14,93,363
10831,dark,main,20220112,4,0.9929360332123124,253,16,77,346
10831,dark,main,20220112,5,0.9904543029000209,253,17,95,365
10831,dark,main,20220112,6,0.9940314792790715,274,16,81,371
10831,dark,main,20220112,7,0.9906222270528701,220,17,102,339
10831,dark,main,20220112,8,0.9893311808717761,247,19,95,361
10831,dark,main,20220112,9,0.9916595958574962,250,14,103,367
3687,dark,main,20220112,0,0.9873513858658947,297,18,69,384
3687,dark,main,20220112,1,0.991617819869571,258,16,77,351
3687,dark,main,20220112,2,0.9952521310962793,272,23,78,373
3687,dark,main,20220112,3,0.9947253567959423,240,18,96,354
3687,dark,main,20220112,4,0.9883222457908303,231,25,84,340
3687,dark,main,20220112,5,0.9869281662997371,214,14,107,335
3687,dark,main,20220112,6,0.9892835467346203,262,20,81,363
3687,dark,main,20220112,7,0.9868781418221556,228,20,75,323
3687,dark,main,20220112,8,0.9921698050352381,243,18,103,364
3687,dark,main,20220112,9,0.9874266219832126,242,22,106,370
21559,bright,main,20220112,0,0.9857344572991706,339,94,2,435
21559,bright,main,20220112,1,0.9904255404020836,260,118,3,381
21559,bright,main,20220112,2,0.9950136226614704,237,176,8,421
21559,bright,main,20220112,3,0.9950725637181558,309,86,3,398
21559,bright,main,20220112,4,0.9937951657571052,260,129,2,391
21559,bright,main,20220112,5,0.9912552753826028,334,73,2,409
21559,bright,main,20220112,6,0.9931038492126143,323,95,3,421
21559,bright,main,20220112,7,0.9939047922871055,280,78,3,361
21559,bright,main,20220112,8,0.991694643855058,328,85,1,414
21559,bright,main,20220112,9,0.9928801719516883,356,70,2,428
24679,bright,main,20220112,0,0.9927521305084324,373,62,6,441
24679,bright,main,20220112,1,0.9942252770854602,316,79,4,399
24679,bright,main,20220112,2,0.9935716904546068,337,82,6,425
24679,bright,main,20220112,3,0.995471830146922,251,140,3,394
24679,bright,main,20220112,4,0.9915646507226058,223,152,9,384
24679,bright,main,20220112,5,0.9952536224245505,280,115,6,401
24679,bright,main,20220112,6,0.9919693332580376,301,117,5,423
24679,bright,main,20220112,7,0.9902715687565012,253,102,3,358
24679,bright,main,20220112,8,0.9931385575462376,267,137,4,408
24679,bright,main,20220112,9,0.9907646708790451,318,105,3,426
10738,dark,main,20220112,0,0.9917280749521008,297,13,80,390
10738,dark,main,20220112,1,0.9851244459282882,255,17,77,349
10738,dark,main,20220112,2,0.9927243705407317,292,15,79,386
10738,dark,main,20220112,3,0.9870613611187586,253,16,80,349
10738,dark,main,20220112,4,0.9853152198413699,253,13,87,353
10738,dark,main,20220112,5,0.9910747925426747,250,9,100,359
10738,dark,main,20220112,6,0.9931303411822763,286,16,89,391
10738,dark,main,20220112,7,0.9930793126264592,234,18,77,329
10738,dark,main,20220112,8,0.9913472299234916,263,20,83,366
10738,dark,main,20220112,9,0.9942947595597701,256,16,102,374
23090,bright,main,20220112,0,0.993761503376051,307,131,4,442
23090,bright,main,20220112,1,0.9889885447236606,304,93,4,401
23090,bright,main,20220112,2,0.9875531978120711,319,111,3,433
23090,bright,main,20220112,3,0.9924329383979061,329,69,4,402
23090,bright,main,20220112,4,0.9944107125324776,321,64,5,390
23090,bright,main,20220112,5,0.9946330340407387,357,53,2,412
23090,bright,main,20220112,6,0.9930406556087741,359,62,1,422
23090,bright,main,20220112,7,0.9940510528333577,282,79,10,371
23090,bright,main,20220112,8,0.9908464286797459,321,95,6,422
23090,bright,main,20220112,9,0.9923526440367462,340,83,7,430
42964,backup,main,20220112,0,0.9915160174480642,58,391,0,449
42964,backup,main,20220112,1,0.9873825142321289,60,347,0,407
42964,backup,main,20220112,2,0.9946971570086008,62,375,6,443
42964,backup,main,20220112,3,0.9959017247118853,61,341,1,403
42964,backup,main,20220112,4,0.9896747498143819,51,346,2,399
42964,backup,main,20220112,5,0.989795338776711,34,390,0,424
42964,backup,main,20220112,6,0.9874379816360795,32,401,1,434
42964,backup,main,20220112,7,0.9920038342113942,43,332,2,377
42964,backup,main,20220112,8,0.9966532926669205,36,388,1,425
42964,backup,main,20220112,9,0.9962944029442037,45,395,0,440
21576,bright,main,20220113,0,0.9949623136270785,299,104,5,408
21576,bright,main,20220113,1,0.9929625355838366,280,98,10,388
21576,bright,main,20220113,2,0.987877639001778,233,169,9,411
21576,bright,main,20220113,3,0.9967004023457829,263,120,4,387
21576,bright,main,20220113,4,0.989923563345405,233,136,6,375
21576,bright,main,20220113,5,0.9877805546752659,254,128,3,385
21576,bright,main,20220113,6,0.9769492386838128,314,81,6,401
21576,bright,main,20220113,7,0.992421704182142,287,67,3,357
21576,bright,main,20220113,8,0.9963768988878996,290,97,5,392
21576,bright,main,20220113,9,0.9927677523999581,292,114,4,410
22622,bright,main,20220113,0,0.991426999575207,253,148,4,405
22622,bright,main,20220113,1,0.9911911965393055,257,117,1,375
22622,bright,main,20220113,2,0.9959241871326137,276,132,8,416
22622,bright,main,20220113,3,0.9937862800922327,238,134,4,376
22622,bright,main,20220113,4,0.9924947631592578,277,96,6,379
22622,bright,main,20220113,5,0.9959875659747011,272,118,5,395
22622,bright,main,20220113,6,0.9933668051150943,282,113,4,399
22622,bright,main,20220113,7,0.9915467836760421,276,72,8,356
22622,bright,main,20220113,8,0.9907786229703666,285,107,7,399
22622,bright,main,20220113,9,0.9917502461208948,238,157,6,401
4403,dark,main,20220113,0,0.9963326792314523,275,14,101,390
4403,dark,main,20220113,1,0.993236137123939,247,11,94,352
4403,dark,main,20220113,2,0.9908445984667521,258,15,104,377
4403,dark,main,20220113,3,0.9905103597855488,289,12,56,357
4403,dark,main,20220113,4,0.9921075740240507,290,11,56,357
4403,dark,main,20220113,5,0.9930454183728621,286,13,62,361
4403,dark,main,20220113,6,0.9909599679483257,310,10,58,378
4403,dark,main,20220113,7,0.9900342384091876,268,11,50,329
4403,dark,main,20220113,8,0.9926933509512448,299,11,69,379
4403,dark,main,20220113,9,0.993027083135846,294,15,71,380
21749,bright,main,20220113,0,0.9924759043907149,255,143,11,409
21749,bright,main,20220113,1,0.997940539821533,201,171,5,377
21749,bright,main,20220113,2,0.9943466942023638,201,177,13,391
21749,bright,main,20220113,3,0.9908577900724208,242,128,10,380
21749,bright,main,20220113,4,0.9895280571552573,247,120,7,374
21749,bright,main,20220113,5,0.9954821626802163,233,154,9,396
21749,bright,main,20220113,6,0.9954347012582275,223,172,6,401
21749,bright,main,20220113,7,0.9928258153594651,230,110,11,351
21749,bright,main,20220113,8,0.9927848908463207,267,111,10,388
21749,bright,main,20220113,9,0.9879158639786016,279,108,5,392
21306,bright,main,20220113,0,0.9964379902662787,292,138,5,435
21306,bright,main,20220113,1,0.9856699782644325,295,100,4,399
21306,bright,main,20220113,2,0.9900301377910972,212,218,2,432
21306,bright,main,20220113,3,0.9939110332369087,163,231,4,398
21306,bright,main,20220113,4,0.9890896392850245,194,201,2,397
21306,bright,main,20220113,5,0.9930685442654816,200,213,1,414
21306,bright,main,20220113,6,0.992822737050764,234,187,6,427
21306,bright,main,20220113,7,0.9955553807143664,245,125,5,375
21306,bright,main,20220113,8,0.9938545545204517,263,154,5,422
21306,bright,main,20220113,9,0.9937189193868913,316,114,6,436
24233,bright,main,20220113,0,0.9898142551705806,294,138,2,434
24233,bright,main,20220113,1,0.9960660886143563,276,107,9,392
24233,bright,main,20220113,2,0.9937384270444899,267,152,8,427
24233,bright,main,20220113,3,0.9954092413764835,243,134,5,382
24233,bright,main,20220113,4,0.9911874643830206,273,101,2,376
24233,bright,main,20220113,5,0.9902870799222053,301,98,11,410
24233,bright,main,20220113,6,0.996422397277276,318,97,3,418
24233,bright,main,20220113,7,0.9885616357289192,229,121,6,356
24233,bright,main,20220113,8,0.9878174357319303,250,143,9,402
24233,bright,main,20220113,9,0.9902365261283083,323,103,4,430
23411,bright,main,20220113,0,0.9898460660891444,313,122,4,439
23411,bright,main,20220113,1,0.9951294684630267,310,86,4,400
23411,bright,main,20220113,2,0.991273065418661,343,87,3,433
23411,bright,main,20220113,3,0.9922004270657924,231,162,4,397
23411,bright,main,20220113,4,0.9932399558841407,257,133,3,393
23411,bright,main,20220113,5,0.996247654079202,309,105,4,418
23411,bright,main,20220113,6,0.982783541161016,311,103,5,419
23411,bright,main,20220113,7,0.9900776767288817,263,97,6,366
23411,bright,main,20220113,8,0.993511785939021,267,141,3,411
23411,bright,main,20220113,9,0.9934758640216814,283,144,6,433
40533,backup,main,20220113,0,0.9911993040576417,7,424,0,431
40533,backup,main,20220113,1,0.9940422176992958,3,390,0,393
40533,backup,main,20220113,2,0.9891092554672983,4,422,0,426
40533,backup,main,20220113,3,0.9889570866063391,3,381,2,386
40533,backup,main,20220113,4,0.9853745673023385,2,382,0,384
40533,backup,main,20220113,5,0.9900479131101796,0,397,1,398
40533,backup,main,20220113,6,0.9881204523359509,7,400,0,407
40533,backup,main,20220113,7,0.9898348990231229,5,351,0,356
40533,backup,main,20220113,8,0.9949624810919895,7,402,2,411
40533,backup,main,20220113,9,0.9904664365738358,4,413,0,417
10192,dark,main,20220113,0,0.9922112279230965,297,22,60,379
10192,dark,main,20220113,1,0.9953065348970669,298,15,38,351
10192,dark,main,20220113,2,0.9932054007503426,305,18,50,373
10192,dark,main,20220113,3,0.9921526376124824,291,23,46,360
10192,dark,main,20220113,4,0.9937080345656478,285,15,47,347
10192,dark,main,20220113,5,0.9955765826979535,305,10,48,363
10192,dark,main,20220113,6,0.9933782357339191,298,16,46,360
10192,dark,main,20220113,7,0.9940359669855034,263,14,42,319
10192,dark,main,20220113,8,0.9824984338487419,292,17,48,357
10192,dark,main,20220113,9,0.993453183247123,308,23,43,374
23410,bright,main,20220113,0,0.996100419954132,230,199,6,435
23410,bright,main,20220113,1,0.9951594679150118,277,107,9,393
23410,bright,main,20220113,2,0.9898921464975857,351,71,3,425
23410,bright,main,20220113,3,0.9952212309634262,309,79,4,392
23410,bright,main,20220113,4,0.9932104501750612,282,99,4,385
23410,bright,main,20220113,5,0.9916980967519711,277,130,4,411
23410,bright,main,20220113,6,0.9907094653372849,328,92,5,425
23410,bright,main,20220113,7,0.9851370363088942,285,77,2,364
23410,bright,main,20220113,8,0.9895686918988024,248,147,6,401
23410,bright,main,20220113,9,0.9800367720792428,177,233,6,416
41378,backup,main,20220113,0,0.9953428048105135,4,442,0,446
41378,backup,main,20220113,1,0.992411614308775,4,401,0,405
41378,backup,main,20220113,2,0.9929287809602557,5,435,0,440
41378,backup,main,20220113,3,0.9879346194492883,7,399,0,406
41378,backup,main,20220113,4,0.9926089122295588,9,392,0,401
41378,backup,main,20220113,5,0.9913676556738721,4,416,2,422
41378,backup,main,20220113,6,0.9905374367762885,4,431,0,435
41378,backup,main,20220113,7,0.9926128173890253,2,378,0,380
41378,backup,main,20220113,8,0.9971727365413612,2,426,0,428
41378,backup,main,20220113,9,0.978246829266527,7,430,1,438
22871,bright,main,20220113,0,0.9911546246710814,369,64,6,439
22871,bright,main,20220113,1,0.9901965742313668,348,51,2,401
22871,bright,main,20220113,2,0.9942236680086242,324,106,5,435
22871,bright,main,20220113,3,0.9937430451323387,255,141,1,397
22871,bright,main,20220113,4,0.9955792720426291,276,108,9,393
22871,bright,main,20220113,5,0.9931781349311956,322,85,3,410
22871,bright,main,20220113,6,0.9946909176237279,370,50,3,423
22871,bright,main,20220113,7,0.9810177967178316,301,67,4,372
22871,bright,main,20220113,8,0.9939841720917668,346,71,3,420
22871,bright,main,20220113,9,0.9964655948065677,343,76,5,424
42652,backup,main,20220113,0,0.996723476779561,6,436,0,442
42652,backup,main,20220113,1,0.9949785974229548,7,393,1,401
42652,backup,main,20220113,2,0.9913810413997346,9,429,0,438
42652,backup,main,20220113,3,0.9907737878528632,15,377,0,392
42652,backup,main,20220113,4,0.9950147231535956,5,389,0,394
42652,backup,main,20220113,5,0.9800374936887304,5,412,0,417
42652,backup,main,20220113,6,0.9949158150326878,12,419,0,431
42652,backup,main,20220113,7,0.9922442869932163,9,363,0,372
42652,backup,main,20220113,8,0.9859737981182253,8,407,1,416
42652,backup,main,20220113,9,0.9922867617013189,11,420,0,431
24436,bright,main,20220113,0,0.9877424251991476,184,249,1,434
24436,bright,main,20220113,1,0.9928382459052293,198,202,3,403
24436,bright,main,20220113,2,0.9935393510148333,258,175,6,439
24436,bright,main,20220113,3,0.9923353370862226,244,155,2,401
24436,bright,main,20220113,4,0.9870304549079015,269,128,5,402
24436,bright,main,20220113,5,0.996337943856653,252,158,4,414
24436,bright,main,20220113,6,0.9910217928619184,244,175,5,424
24436,bright,main,20220113,7,0.9899500767292441,217,141,6,364
24436,bright,main,20220113,8,0.9926272500384417,204,213,5,422
24436,bright,main,20220113,9,0.9940621150739435,181,245,8,434
40535,backup,main,20220113,0,0.9922348027686687,2,432,0,434
40535,backup,main,20220113,1,0.9869509345698848,1,393,1,395
40535,backup,main,20220113,2,0.9939417123378358,1,423,0,424
40535,backup,main,20220113,3,0.9925967269400303,4,389,2,395
40535,backup,main,20220113,4,0.9888695349586963,0,381,0,381
40535,backup,main,20220113,5,0.9901310950823061,2,400,1,403
40535,backup,main,20220113,6,0.9920285378854385,1,408,0,409
40535,backup,main,20220113,7,0.9859935995404223,2,347,1,350
40535,backup,main,20220113,8,0.9913361941950345,1,411,0,412
40535,backup,main,20220113,9,0.9942181221686006,1,421,0,422
24420,bright,main,20220114,0,0.988354308120029,294,143,3,440
24420,bright,main,20220114,1,0.9945143552721787,268,126,4,398
24420,bright,main,20220114,2,0.9940828397574168,306,127,4,437
24420,bright,main,20220114,3,0.9887767892884934,289,103,2,394
24420,bright,main,20220114,4,0.9901312944791248,310,95,4,409
24420,bright,main,20220114,5,0.9950957024696393,313,94,6,413
24420,bright,main,20220114,6,0.9945434766722056,286,138,4,428
24420,bright,main,20220114,7,0.9939123191233985,266,103,4,373
24420,bright,main,20220114,8,0.9926266240931492,344,77,5,426
24420,bright,main,20220114,9,0.9961680905526051,334,92,3,429
42653,backup,main,20220114,0,0.9932546574272709,7,433,0,440
42653,backup,main,20220114,1,0.9926609787686922,9,384,0,393
42653,backup,main,20220114,2,0.9927109320559694,8,430,0,438
42653,backup,main,20220114,3,0.9952895080318549,12,387,0,399
42653,backup,main,20220114,4,0.9904984628029861,6,385,0,391
42653,backup,main,20220114,5,0.9906721222853909,9,397,1,407
42653,backup,main,20220114,6,0.9920772714958579,7,414,1,422
42653,backup,main,20220114,7,0.9940995370401634,3,362,0,365
42653,backup,main,20220114,8,0.9921406080409192,5,411,0,416
42653,backup,main,20220114,9,0.9945523367196168,16,399,0,415
21321,bright,main,20220114,0,0.9877204562662721,275,154,5,434
21321,bright,main,20220114,1,0.9935881346252524,212,167,11,390
21321,bright,main,20220114,2,0.9973142436555701,219,206,6,431
21321,bright,main,20220114,3,0.9889607244605778,251,126,4,381
21321,bright,main,20220114,4,0.993965625410852,294,84,5,383
21321,bright,main,20220114,5,0.9918848719958806,291,90,10,391
21321,bright,main,20220114,6,0.993758257334591,289,109,12,410
21321,bright,main,20220114,7,0.9962266140252316,187,163,6,356
21321,bright,main,20220114,8,0.993121217248921,210,172,19,401
21321,bright,main,20220114,9,0.9936858637429555,246,171,7,424
21522,bright,main,20220114,0,0.9928807849815063,334,95,5,434
21522,bright,main,20220114,1,0.9904194179265645,321,68,8,397
21522,bright,main,20220114,2,0.9945678240571488,356,61,6,423
21522,bright,main,20220114,3,0.9927982236195525,334,57,6,397
21522,bright,main,20220114,4,0.9914392413461665,322,64,9,395
21522,bright,main,20220114,5,0.9920498335763996,342,58,4,404
21522,bright,main,20220114,6,0.9922034511318581,341,82,3,426
21522,bright,main,20220114,7,0.9940559225779445,288,74,3,365
21522,bright,main,20220114,8,0.9848309566371274,315,100,3,418
21522,bright,main,20220114,9,0.9928943359095899,310,99,6,415
23724,bright,main,20220114,0,0.9920238795998509,243,182,8,433
23724,bright,main,20220114,1,0.9930324988693231,244,148,7,399
23724,bright,main,20220114,2,0.9896888965129612,241,193,2,436
23724,bright,main,20220114,3,0.9961937159866694,239,152,2,393
23724,bright,main,20220114,4,0.9888889149025787,310,78,4,392
23724,bright,main,20220114,5,0.9885453917187791,307,101,3,411
23724,bright,main,20220114,6,0.9886128092814691,308,111,4,423
23724,bright,main,20220114,7,0.9837199408980646,242,122,3,367
23724,bright,main,20220114,8,0.990844120079662,234,175,1,410
23724,bright,main,20220114,9,0.9945073523005289,235,183,5,423
24656,bright,main,20220114,0,0.9928377499968932,353,67,4,424
24656,bright,main,20220114,1,0.9960202531215061,320,64,3,387
24656,bright,main,20220114,2,0.9908126001987072,347,67,3,417
24656,bright,main,20220114,3,0.9898471521208292,278,93,5,376
24656,bright,main,20220114,4,0.9837206495162565,323,48,4,375
24656,bright,main,20220114,5,0.9958442828195041,322,66,4,392
24656,bright,main,20220114,6,0.9875508308887615,362,50,4,416
24656,bright,main,20220114,7,0.9932731147996146,304,50,8,362
24656,bright,main,20220114,8,0.9924355481371244,328,72,3,403
24656,bright,main,20220114,9,0.9939912923114811,351,64,4,419
23716,bright,main,20220114,0,0.9942614461987397,334,96,7,437
23716,bright,main,20220114,1,0.9945874943482468,328,62,6,396
23716,bright,main,20220114,2,0.9903937772126744,297,126,5,428
23716,bright,main,20220114,3,0.9943924409256034,291,98,2,391
23716,bright,main,20220114,4,0.9930117198345951,273,114,4,391
23716,bright,main,20220114,5,0.9962556915603115,320,84,2,406
23716,bright,main,20220114,6,0.9918685549730472,315,102,3,420
23716,bright,main,20220114,7,0.9932155756194134,269,94,5,368
23716,bright,main,20220114,8,0.9925151540196314,297,118,9,424
23716,bright,main,20220114,9,0.9917120538141531,294,120,3,417
23120,bright,main,20220114,0,0.9926799116725882,379,56,1,436
23120,bright,main,20220114,1,0.9930283063447705,290,101,5,396
23120,bright,main,20220114,2,0.9937831240872775,295,125,4,424
23120,bright,main,20220114,3,0.9918281279981962,275,113,7,395
23120,bright,main,20220114,4,0.9930798643969961,224,160,3,387
23120,bright,main,20220114,5,0.9891863645723025,237,152,5,394
23120,bright,main,20220114,6,0.9918043453589245,268,144,5,417
23120,bright,main,20220114,7,0.9936349610790867,227,128,5,360
23120,bright,main,20220114,8,0.9925318454529487,266,131,5,402
23120,bright,main,20220114,9,0.9938275627513057,326,89,1,416
43009,backup,main,20220114,0,0.9960951132703503,4,443,0,447
43009,backup,main,20220114,1,0.9931080642655298,3,402,0,405
43009,backup,main,20220114,2,0.9916740296340207,5,437,0,442
43009,backup,main,20220114,3,0.9835250778618324,6,398,0,404
43009,backup,main,20220114,4,0.992565214854871,0,401,0,401
43009,backup,main,20220114,5,0.9895341045104006,3,413,0,416
43009,backup,main,20220114,6,0.992206483712437,1,432,0,433
43009,backup,main,20220114,7,0.9886126268673985,2,372,0,374
43009,backup,main,20220114,8,0.9899464318421207,4,421,0,425
43009,backup,main,20220114,9,0.9931627968244795,8,429,0,437
42621,backup,main,20220114,0,0.9931440740072287,8,429,0,437
42621,backup,main,20220114,1,0.9951499113620249,4,384,0,388
42621,backup,main,20220114,2,0.9906261132081843,6,431,0,437
42621,backup,main,20220114,3,0.9843148102895498,9,383,0,392
42621,backup,main,20220114,4,0.9921220152681965,5,390,0,395
42621,backup,main,20220114,5,0.9907134940449364,7,397,1,405
42621,backup,main,20220114,6,0.9861957219997043,7,420,0,427
42621,backup,main,20220114,7,0.9921651512136948,6,360,0,366
42621,backup,main,20220114,8,0.994405070240676,6,410,1,417
42621,backup,main,20220114,9,0.9928684141786474,13,399,0,412
21540,bright,main,20220114,0,0.9936755533820198,253,180,5,438
21540,bright,main,20220114,1,0.9947409479626271,252,152,1,405
21540,bright,main,20220114,2,0.9916104538455872,265,170,3,438
21540,bright,main,20220114,3,0.990589847466821,257,141,2,400
21540,bright,main,20220114,4,0.9928374800700288,302,92,3,397
21540,bright,main,20220114,5,0.9961680678663914,298,111,7,416
21540,bright,main,20220114,6,0.9914640509017096,260,167,5,432
21540,bright,main,20220114,7,0.991213391757505,257,113,2,372
21540,bright,main,20220114,8,0.9924166062113146,302,119,5,426
21540,bright,main,20220114,9,0.9873597622429315,277,154,5,436
24643,bright,main,20220114,0,0.9933156508547314,338,87,4,429
24643,bright,main,20220114,1,0.9937463356437045,299,82,2,383
24643,bright,main,20220114,2,0.9926236592956639,351,80,1,432
24643,bright,main,20220114,3,0.9929481353693194,302,77,4,383
24643,bright,main,20220114,4,0.9936881064816349,321,61,5,387
24643,bright,main,20220114,5,0.9906636447576193,350,56,3,409
24643,bright,main,20220114,6,0.994235455155497,348,68,6,422
24643,bright,main,20220114,7,0.9944693075113413,292,65,3,360
24643,bright,main,20220114,8,0.9930759454962187,337,65,7,409
24643,bright,main,20220114,9,0.9955788437910215,312,99,3,414
21703,bright,main,20220114,0,0.9896478668358285,303,105,5,413
21703,bright,main,20220114,1,0.9867387385625567,267,102,4,373
21703,bright,main,20220114,2,0.9939138532130746,264,150,4,418
21703,bright,main,20220114,3,0.9899919689010193,280,97,6,383
21703,bright,main,20220114,4,0.9968673446183417,263,109,4,376
21703,bright,main,20220114,5,0.9946617632589432,304,88,5,397
21703,bright,main,20220114,6,0.9929719715396976,248,140,5,393
21703,bright,main,20220114,7,0.9901182104876847,210,137,5,352
21703,bright,main,20220114,8,0.9926106063326434,278,110,6,394
21703,bright,main,20220114,9,0.9925447042820448,352,58,5,415
26203,bright,main,20220114,0,0.9945932570701215,320,111,6,437
26203,bright,main,20220114,1,0.9897700440608865,286,110,4,400
26203,bright,main,20220114,2,0.9941206196591724,362,71,2,435
26203,bright,main,20220114,3,0.9951335774755155,326,62,7,395
26203,bright,main,20220114,4,0.9922517965153632,311,68,5,384
26203,bright,main,20220114,5,0.9942640646454209,284,121,8,413
26203,bright,main,20220114,6,0.9961734469041109,291,127,5,423
26203,bright,main,20220114,7,0.9877106724056595,278,87,3,368
26203,bright,main,20220114,8,0.9941359670695213,338,72,4,414
26203,bright,main,20220114,9,0.9895422103371972,338,89,5,432
42651,backup,main,20220114,0,0.9886842468339493,4,437,0,441
42651,backup,main,20220114,1,0.996542215122517,4,395,1,400
42651,backup,main,20220114,2,0.9936240956823427,5,433,0,438
42651,backup,main,20220114,3,0.9943721383829858,5,394,0,399
42651,backup,main,20220114,4,0.990950002270924,2,394,0,396
42651,backup,main,20220114,5,0.9945876460470072,2,416,0,418
42651,backup,main,20220114,6,0.9968745878625492,2,434,0,436
42651,backup,main,20220114,7,0.9902055424995094,1,369,0,370
42651,backup,main,20220114,8,0.9909829556195444,3,416,0,419
42651,backup,main,20220114,9,0.9931807131672321,2,430,0,432
23418,bright,main,20220114,0,0.9904211914502693,383,48,6,437
23418,bright,main,20220114,1,0.9895200513864276,323,61,4,388
23418,bright,main,20220114,2,0.9935508910438303,321,99,6,426
23418,bright,main,20220114,3,0.9951838701703822,274,103,3,380
23418,bright,main,20220114,4,0.9898407285882646,296,83,9,388
23418,bright,main,20220114,5,0.9973896179382041,330,70,6,406
23418,bright,main,20220114,6,0.9935307403839881,333,69,6,408
23418,bright,main,20220114,7,0.9915891443304219,310,47,1,358
23418,bright,main,20220114,8,0.9950038623726246,329,77,5,411
23418,bright,main,20220114,9,0.9930555700374981,342,69,4,415
23717,bright,main,20220114,0,0.9927039098804653,361,71,5,437
23717,bright,main,20220114,1,0.995438891910408,336,56,2,394
23717,bright,main,20220114,2,0.9922500205127379,345,77,4,426
23717,bright,main,20220114,3,0.9926211615523064,326,66,1,393
23717,bright,main,20220114,4,0.987789594688013,299,79,4,382
23717,bright,main,20220114,5,0.9880066968346347,305,102,4,411
23717,bright,main,20220114,6,0.991830255959529,333,87,6,426
23717,bright,main,20220114,7,0.9937926253444173,292,71,5,368
23717,bright,main,20220114,8,0.989927788393591,344,69,5,418
23717,bright,main,20220114,9,0.9925869811128818,346,78,2,426
43007,backup,main,20220114,0,0.9910479661584426,8,438,0,446
43007,backup,main,20220114,1,0.9927956333595551,10,393,0,403
43007,backup,main,20220114,2,0.9869041612314448,12,432,0,444
43007,backup,main,20220114,3,0.9892166633894501,23,382,0,405
43007,backup,main,20220114,4,0.9970836208310954,11,391,0,402
43007,backup,main,20220114,5,0.9896209989790181,6,415,0,421
43007,backup,main,20220114,6,0.9947192168905292,6,428,0,434
43007,backup,main,20220114,7,0.9922577554555904,9,367,0,376
43007,backup,main,20220114,8,0.9936053485743975,2,422,0,424
43007,backup,main,20220114,9,0.9958604686811604,13,426,0,439
40553,backup,main,20220114,0,0.9919423913465073,5,406,0,411
40553,backup,main,20220114,1,0.9914673585092931,6,363,3,372
40553,backup,main,20220114,2,0.9924043912838271,1,409,0,410
40553,backup,main,20220114,3,0.984512800474419,11,354,1,366
40553,backup,main,20220114,4,0.9924695676983809,1,361,0,362
40553,backup,main,20220114,5,0.9940849276897087,2,383,0,385
40553,backup,main,20220114,6,0.9926928428131038,5,397,1,403
40553,backup,main,20220114,7,0.9862574525445725,4,330,0,334
40553,backup,main,20220114,8,0.9872824964478538,6,387,0,393
40553,backup,main,20220114,9,0.99065594295765,9,397,1,407
23715,bright,main,20220114,0,0.9869180773140815,338,87,1,426
23715,bright,main,20220114,1,0.9920802734449509,277,111,5,393
23715,bright,main,20220114,2,0.9906694460002998,338,95,3,436
23715,bright,main,20220114,3,0.9942975133066299,345,50,1,396
23715,bright,main,20220114,4,0.9930195219535518,310,70,5,385
23715,bright,main,20220114,5,0.9893143448091669,347,49,5,401
23715,bright,main,20220114,6,0.9889909121905247,350,74,3,427
23715,bright,main,20220114,7,0.9950154336737793,247,111,7,365
23715,bright,main,20220114,8,0.9940488884505372,289,119,4,412
23715,bright,main,20220114,9,0.9894415785380515,312,109,9,430
24479,bright,main,20220119,0,0.9936995271580986,312,104,1,417
24479,bright,main,20220119,1,0.9939718650261614,291,83,5,379
24479,bright,main,20220119,2,0.9905131396673339,316,94,7,417
24479,bright,main,20220119,3,0.9967167320798188,305,69,7,381
24479,bright,main,20220119,4,0.9919897547095313,249,69,6,324
24479,bright,main,20220119,5,0.9920114459611186,272,110,8,390
24479,bright,main,20220119,6,0.9908892236154212,300,108,2,410
24479,bright,main,20220119,7,0.9922320232783813,250,96,4,350
24479,bright,main,20220119,8,0.9892681554206612,338,66,4,408
24479,bright,main,20220119,9,0.9885113884873717,325,83,2,410
23779,bright,main,20220119,0,0.9909268519022333,312,89,7,408
23779,bright,main,20220119,1,0.982900605002102,312,69,3,384
23779,bright,main,20220119,2,0.9953542524818694,338,71,10,419
23779,bright,main,20220119,3,0.9942286834189678,315,71,2,388
23779,bright,main,20220119,4,0.9926523734451104,272,57,3,332
23779,bright,main,20220119,5,0.9899286339863109,340,54,3,397
23779,bright,main,20220119,6,0.9958176006703755,338,65,5,408
23779,bright,main,20220119,7,0.9866875211007231,280,65,5,350
23779,bright,main,20220119,8,0.9895157903405938,310,78,6,394
23779,bright,main,20220119,9,0.994420046483603,306,91,5,402
20637,bright,main,20220119,0,0.9937287706978977,341,70,6,417
20637,bright,main,20220119,1,0.9916429697305321,312,62,9,383
20637,bright,main,20220119,2,0.9846815365284357,357,48,7,412
20637,bright,main,20220119,3,0.9956988560814485,300,66,6,372
20637,bright,main,20220119,4,0.990284136487393,261,56,4,321
20637,bright,main,20220119,5,0.993748291131116,314,74,2,390
20637,bright,main,20220119,6,0.9953039056816012,316,79,6,401
20637,bright,main,20220119,7,0.9879671071464187,318,42,0,360
20637,bright,main,20220119,8,0.9956326079327894,318,68,5,391
20637,bright,main,20220119,9,0.9933946564372531,323,69,5,397
23783,bright,main,20220119,0,0.9944908118607234,346,78,2,426
23783,bright,main,20220119,1,0.9886021665553917,319,63,2,384
23783,bright,main,20220119,2,0.9952763077942565,353,61,7,421
23783,bright,main,20220119,3,0.9920329580850435,296,73,6,375
23783,bright,main,20220119,4,0.9884768415875471,250,74,6,330
23783,bright,main,20220119,5,0.9933447729830385,276,118,3,397
23783,bright,main,20220119,6,0.9887665811162208,321,83,5,409
23783,bright,main,20220119,7,0.9921246056480181,286,58,9,353
23783,bright,main,20220119,8,0.9953754853975485,299,87,2,388
23783,bright,main,20220119,9,0.9950355625001622,326,75,1,402
23774,bright,main,20220119,0,0.9883115279544056,358,55,9,422
23774,bright,main,20220119,1,0.9926452183136956,307,69,8,384
23774,bright,main,20220119,2,0.9926363019940196,339,64,5,408
23774,bright,main,20220119,3,0.9898708515169121,303,68,5,376
23774,bright,main,20220119,4,0.9938786009186081,270,58,4,332
23774,bright,main,20220119,5,0.9907382690745786,314,81,6,401
23774,bright,main,20220119,6,0.9921865292961493,331,68,5,404
23774,bright,main,20220119,7,0.9937109069305721,289,65,2,356
23774,bright,main,20220119,8,0.9916341259793879,309,79,6,394
23774,bright,main,20220119,9,0.9951126577266732,334,78,3,415
21323,bright,main,20220120,0,0.9954398630502667,340,81,9,430
21323,bright,main,20220120,1,0.9881531781277528,300,87,8,395
21323,bright,main,20220120,2,0.9932402791954258,317,106,3,426
21323,bright,main,20220120,3,0.995719692726983,287,104,5,396
21323,bright,main,20220120,4,0.9915173088255419,253,125,4,382
21323,bright,main,20220120,5,0.9901889417165721,299,102,5,406
21323,bright,main,20220120,6,0.9951905514952406,318,92,7,417
21323,bright,main,20220120,7,0.9939518890829666,274,91,2,367
21323,bright,main,20220120,8,0.9941632552912855,318,87,4,409
21323,bright,main,20220120,9,0.9947806646405682,310,114,2,426
26038,bright,main,20220120,0,0.9952562931465729,369,62,4,435
26038,bright,main,20220120,1,0.9871179375898567,322,64,2,388
26038,bright,main,20220120,2,0.9860605341404822,348,77,7,432
26038,bright,main,20220120,3,0.9921724720064465,309,69,11,389
26038,bright,main,20220120,4,0.996379599442631,310,66,1,377
26038,bright,main,20220120,5,0.9893318329148935,343,60,4,407
26038,bright,main,20220120,6,0.9947575584920016,347,64,7,418
26038,bright,main,20220120,7,0.9866057258610758,291,64,5,360
26038,bright,main,20220120,8,0.9865656830648293,308,90,6,404
26038,bright,main,20220120,9,0.9943891522752405,310,97,6,413
4005,dark,main,20220120,0,0.984378927857017,300,13,75,388
4005,dark,main,20220120,1,0.9947650155166953,263,13,84,360
4005,dark,main,20220120,2,0.9873612997795151,310,12,64,386
4005,dark,main,20220120,3,0.9873612997795151,310,12,64,386
4005,dark,main,20220120,4,0.9881285282045377,283,12,58,353
4005,dark,main,20220120,5,0.9895976134565817,285,15,62,362
4005,dark,main,20220120,6,0.9927055682200719,335,14,53,402
4005,dark,main,20220120,7,0.9876067219781338,290,12,41,343
4005,dark,main,20220120,8,0.9953323624601472,299,11,77,387
4005,dark,main,20220120,9,0.9856648571850664,309,14,73,396
10260,dark,main,20220120,0,0.9913244922770327,326,11,62,399
10260,dark,main,20220120,1,0.9887333889847104,293,11,56,360
10260,dark,main,20220120,2,0.9924823223559377,315,11,58,384
10260,dark,main,20220120,3,0.9917370611466659,300,14,41,355
10260,dark,main,20220120,4,0.9865354124507602,283,11,55,349
10260,dark,main,20220120,5,0.9919820323092003,295,11,54,360
10260,dark,main,20220120,6,0.994380274510248,326,15,44,385
10260,dark,main,20220120,7,0.9911783943063835,289,9,52,350
10260,dark,main,20220120,8,0.9902713480355091,297,10,69,376
10260,dark,main,20220120,9,0.994639844045571,304,15,67,386
20932,bright,main,20220120,0,0.9965498850059262,344,85,2,431
20932,bright,main,20220120,1,0.9910863058631968,337,58,4,399
20932,bright,main,20220120,2,0.9940750814402889,358,70,3,431
20932,bright,main,20220120,3,0.9917522960332437,313,82,2,397
20932,bright,main,20220120,4,0.9922601750121668,280,109,4,393
20932,bright,main,20220120,5,0.9953367548914154,246,159,3,408
20932,bright,main,20220120,6,0.9939625845056967,286,131,9,426
20932,bright,main,20220120,7,0.9927238846841681,238,127,2,367
20932,bright,main,20220120,8,0.9922302232530463,287,119,7,413
20932,bright,main,20220120,9,0.9851269839135391,328,102,5,435
20976,bright,main,20220120,0,0.9935171437630407,286,154,1,441
20976,bright,main,20220120,1,0.9929721439631599,239,160,5,404
20976,bright,main,20220120,2,0.9918239299606564,242,192,2,436
20976,bright,main,20220120,3,0.9926648215603411,206,185,3,394
20976,bright,main,20220120,4,0.9913321562596548,248,142,7,397
20976,bright,main,20220120,5,0.9826832218875189,249,166,3,418
20976,bright,main,20220120,6,0.9931879743523263,286,135,2,423
20976,bright,main,20220120,7,0.988738078828724,255,119,4,378
20976,bright,main,20220120,8,0.9920318648167277,306,113,5,424
20976,bright,main,20220120,9,0.9916020161029557,282,149,2,433
24465,bright,main,20220120,0,0.9941367844309502,348,76,6,430
24465,bright,main,20220120,1,0.9871214027954656,292,92,4,388
24465,bright,main,20220120,2,0.993275541134648,345,76,3,424
24465,bright,main,20220120,3,0.9882224472075881,301,84,4,389
24465,bright,main,20220120,4,0.9944349576995194,313,68,3,384
24465,bright,main,20220120,5,0.9911852039757872,329,81,0,410
24465,bright,main,20220120,6,0.988890675242527,323,93,3,419
24465,bright,main,20220120,7,0.9915595919060197,273,82,2,357
24465,bright,main,20220120,8,0.9950405404379816,308,95,4,407
24465,bright,main,20220120,9,0.9940127279320259,331,73,7,411
22741,bright,main,20220120,0,0.9901471112502966,256,139,5,400
22741,bright,main,20220120,1,0.9954956460396839,242,118,11,371
22741,bright,main,20220120,2,0.9892468718222831,341,75,7,423
22741,bright,main,20220120,3,0.9930434481148178,315,64,1,380
22741,bright,main,20220120,4,0.9913952414405107,328,44,7,379
22741,bright,main,20220120,5,0.9888020319009618,336,55,3,394
22741,bright,main,20220120,6,0.9976951124227679,320,97,5,422
22741,bright,main,20220120,7,0.9912141129491622,256,91,4,351
22741,bright,main,20220120,8,0.9834503322174595,301,96,3,400
22741,bright,main,20220120,9,0.9927014615889328,263,141,1,405
23780,bright,main,20220120,0,0.9868152381295123,332,80,4,416
23780,bright,main,20220120,1,0.9946656980428147,296,70,6,372
23780,bright,main,20220120,2,0.9945029910319965,345,77,4,426
23780,bright,main,20220120,3,0.9938169187691441,302,78,6,386
23780,bright,main,20220120,4,0.9915412770155798,311,66,2,379
23780,bright,main,20220120,5,0.9930295383814237,326,62,3,391
23780,bright,main,20220120,6,0.9930916991318851,382,39,3,424
23780,bright,main,20220120,7,0.9860492557471119,313,54,2,369
23780,bright,main,20220120,8,0.987514923513067,351,55,3,409
23780,bright,main,20220120,9,0.9966823011202722,320,86,5,411
23133,bright,main,20220120,0,0.9907943856217257,333,83,9,425
23133,bright,main,20220120,1,0.994856590955772,320,66,3,389
23133,bright,main,20220120,2,0.9901357503517836,265,147,10,422
23133,bright,main,20220120,3,0.9932103743315579,268,113,6,387
23133,bright,main,20220120,4,0.9927517731958482,260,114,2,376
23133,bright,main,20220120,5,0.9925803559504481,298,97,5,400
23133,bright,main,20220120,6,0.9926819156646969,309,101,4,414
23133,bright,main,20220120,7,0.9935981784558203,297,55,2,354
23133,bright,main,20220120,8,0.9955052573832498,337,63,5,405
23133,bright,main,20220120,9,0.9947223520048611,344,64,7,415
21329,bright,main,20220120,0,0.9923626136694091,330,89,8,427
21329,bright,main,20220120,1,0.9951440326681804,299,84,9,392
21329,bright,main,20220120,2,0.9934075531974305,336,82,6,424
21329,bright,main,20220120,3,0.9947828306760166,246,115,4,365
21329,bright,main,20220120,4,0.9880851631413756,306,73,4,383
21329,bright,main,20220120,5,0.9920752863932784,314,84,5,403
21329,bright,main,20220120,6,0.9898985241206896,353,63,4,420
21329,bright,main,20220120,7,0.995434996813235,322,42,5,369
21329,bright,main,20220120,8,0.9934474936888606,346,61,0,407
21329,bright,main,20220120,9,0.991222417352215,336,81,7,424
21332,bright,main,20220120,0,0.9870515951431772,311,99,7,417
21332,bright,main,20220120,1,0.9945171276566819,258,114,6,378
21332,bright,main,20220120,2,0.991459989376057,217,177,5,399
21332,bright,main,20220120,3,0.9929653447485943,240,137,5,382
21332,bright,main,20220120,4,0.9963701760176942,286,88,6,380
21332,bright,main,20220120,5,0.9871702863829948,306,86,5,397
21332,bright,main,20220120,6,0.9875174169932825,327,79,5,411
21332,bright,main,20220120,7,0.9915541778841971,270,65,9,344
21332,bright,main,20220120,8,0.9911421848058557,305,84,8,397
21332,bright,main,20220120,9,0.9866775492521289,331,80,8,419
21333,bright,main,20220120,0,0.9912034845287762,368,65,5,438
21333,bright,main,20220120,1,0.9903803734604432,330,64,1,395
21333,bright,main,20220120,2,0.9890027765872847,373,49,7,429
21333,bright,main,20220120,3,0.99380368322415,346,41,3,390
21333,bright,main,20220120,4,0.9894826569556324,301,83,2,386
21333,bright,main,20220120,5,0.9867968889837853,363,49,1,413
21333,bright,main,20220120,6,0.9895177409677895,381,44,3,428
21333,bright,main,20220120,7,0.9950545284586813,334,36,3,373
21333,bright,main,20220120,8,0.9939345038706477,330,70,9,409
21333,bright,main,20220120,9,0.9907919556477478,352,63,2,417
21325,bright,main,20220120,0,0.9946441119876764,330,95,5,430
21325,bright,main,20220120,1,0.9905113708557173,240,142,2,384
21325,bright,main,20220120,2,0.9941165017125816,266,147,3,416
21325,bright,main,20220120,3,0.9936873971524234,266,109,5,380
21325,bright,main,20220120,4,0.9907901097706562,310,74,5,389
21325,bright,main,20220120,5,0.9962891176366939,327,67,4,398
21325,bright,main,20220120,6,0.9849345828439556,345,67,5,417
21325,bright,main,20220120,7,0.9832889892526603,297,64,3,364
21325,bright,main,20220120,8,0.9936160861417516,302,105,2,409
21325,bright,main,20220120,9,0.9951351714235496,306,120,3,429
20645,bright,main,20220120,0,0.9896515505341824,359,56,1,416
20645,bright,main,20220120,1,0.99043422297603,333,56,8,397
20645,bright,main,20220120,2,0.9926963329165555,319,89,5,413
20645,bright,main,20220120,3,0.9909160695737104,304,60,4,368
20645,bright,main,20220120,4,0.9928701336767236,318,59,6,383
20645,bright,main,20220120,5,0.985025005212094,352,46,5,403
20645,bright,main,20220120,6,0.9939843905927563,345,64,4,413
20645,bright,main,20220120,7,0.9952276064599703,324,40,3,367
20645,bright,main,20220120,8,0.9900463551991551,345,57,4,406
20645,bright,main,20220120,9,0.9914471530533274,347,67,7,421
20633,bright,main,20220120,0,0.9906308292185928,285,89,3,377
20633,bright,main,20220120,1,0.9922071393393345,305,74,3,382
20633,bright,main,20220120,2,0.9917452339390989,320,83,5,408
20633,bright,main,20220120,3,0.9923184496051227,294,75,6,375
20633,bright,main,20220120,4,0.9934941799004414,272,100,4,376
20633,bright,main,20220120,5,0.991143653360772,299,85,8,392
20633,bright,main,20220120,6,0.9910683675767941,300,98,5,403
20633,bright,main,20220120,7,0.9922740636354541,285,70,0,355
20633,bright,main,20220120,8,0.9908565745848393,305,95,4,404
20633,bright,main,20220120,9,0.992667976404486,311,79,11,401
21335,bright,main,20220120,0,0.9884524505638796,343,80,4,427
21335,bright,main,20220120,1,0.9936099798204184,300,77,8,385
21335,bright,main,20220120,2,0.9896010668037272,339,72,5,416
21335,bright,main,20220120,3,0.9951661346886377,292,95,3,390
21335,bright,main,20220120,4,0.9924785099719067,251,128,3,382
21335,bright,main,20220120,5,0.9937105938957977,242,139,12,393
21335,bright,main,20220120,6,0.9953335632119946,260,133,7,400
21335,bright,main,20220120,7,0.9861852576632665,168,169,9,346
21335,bright,main,20220120,8,0.9932160366496859,245,148,5,398
21335,bright,main,20220120,9,0.9927632175608287,342,79,3,424
25643,bright,main,20220120,0,0.99092241819027,322,115,7,444
25643,bright,main,20220120,1,0.9917198021831267,306,93,1,400
25643,bright,main,20220120,2,0.9937006182478237,331,101,7,439
25643,bright,main,20220120,3,0.9919452617993006,291,105,6,402
25643,bright,main,20220120,4,0.990711183627678,306,103,2,411
25643,bright,main,20220120,5,0.987412888589068,312,105,3,420
25643,bright,main,20220120,6,0.9916356540292154,313,101,5,419
25643,bright,main,20220120,7,0.9873177505902725,288,84,3,375
25643,bright,main,20220120,8,0.9930287214151822,315,101,2,418
25643,bright,main,20220120,9,0.998364416966877,264,160,4,428
23782,bright,main,20220120,0,0.992764012496084,319,110,5,434
23782,bright,main,20220120,1,0.9941591498688458,284,99,3,386
23782,bright,main,20220120,2,0.9837391757754064,345,63,4,412
23782,bright,main,20220120,3,0.9915286166787618,308,67,7,382
23782,bright,main,20220120,4,0.9931849872845631,304,69,6,379
23782,bright,main,20220120,5,0.9903908899835192,316,78,6,400
23782,bright,main,20220120,6,0.9920715039830282,331,84,4,419
23782,bright,main,20220120,7,0.9850981291049928,282,68,6,356
23782,bright,main,20220120,8,0.9963403949519197,296,96,5,397
23782,bright,main,20220120,9,0.9911964315674083,296,111,9,416
24118,bright,main,20220120,0,0.9948221697352854,266,167,1,434
24118,bright,main,20220120,1,0.990067688916562,274,124,2,400
24118,bright,main,20220120,2,0.9892383745254116,294,137,5,436
24118,bright,main,20220120,3,0.9888507201915726,297,101,1,399
24118,bright,main,20220120,4,0.9925765447777743,287,106,2,395
24118,bright,main,20220120,5,0.9926073661943723,262,149,3,414
24118,bright,main,20220120,6,0.9914526645192365,259,164,6,429
24118,bright,main,20220120,7,0.9906637563881354,261,109,3,373
24118,bright,main,20220120,8,0.9912835772815779,237,176,2,415
24118,bright,main,20220120,9,0.9923409218694165,249,181,3,433
24284,bright,main,20220120,0,0.9926196732584691,316,107,7,430
24284,bright,main,20220120,1,0.9887094883641843,274,97,8,379
24284,bright,main,20220120,2,0.9924295099122066,291,121,6,418
24284,bright,main,20220120,3,0.9931646031899957,261,106,3,370
24284,bright,main,20220120,4,0.9938815826943121,276,92,4,372
24284,bright,main,20220120,5,0.9924099684725736,306,83,6,395
24284,bright,main,20220120,6,0.9947887075859241,339,75,3,417
24284,bright,main,20220120,7,0.9920066321600409,274,81,4,359
24284,bright,main,20220120,8,0.9915008748488551,268,124,7,399
24284,bright,main,20220120,9,0.9933865484225113,295,110,2,407
10135,dark,main,20220120,0,0.9964144510645684,299,13,83,395
10135,dark,main,20220120,1,0.9892464748560059,264,16,66,346
10135,dark,main,20220120,2,0.9935124326373949,293,11,79,383
10135,dark,main,20220120,3,0.988349784105161,285,11,75,371
10135,dark,main,20220120,4,0.9890134902371993,256,13,76,345
10135,dark,main,20220120,5,0.9950554224304334,277,13,88,378
10135,dark,main,20220120,6,0.9880706771645603,281,14,88,383
10135,dark,main,20220120,7,0.9899644505614908,243,9,78,330
10135,dark,main,20220120,8,0.9928034514696417,286,16,75,377
10135,dark,main,20220120,9,0.9894004667833123,300,11,73,384
23773,bright,main,20220120,0,0.9892930824799444,366,56,2,424
23773,bright,main,20220120,1,0.9899077481010635,321,51,5,377
23773,bright,main,20220120,2,0.9975080257609646,360,62,1,423
23773,bright,main,20220120,3,0.9922672512914295,311,70,5,386
23773,bright,main,20220120,4,0.9935604794824261,269,95,6,370
23773,bright,main,20220120,5,0.9860161964863562,265,122,6,393
23773,bright,main,20220120,6,0.9970882000999672,289,119,1,409
23773,bright,main,20220120,7,0.9912885487746417,275,84,2,361
23773,bright,main,20220120,8,0.9920048367173424,360,42,2,404
23773,bright,main,20220120,9,0.9957887903132715,337,63,3,403
26016,bright,main,20220120,0,0.9937487942738733,263,154,3,420
26016,bright,main,20220120,1,0.992399876813181,279,103,7,389
26016,bright,main,20220120,2,0.9894404071973197,282,144,2,428
26016,bright,main,20220120,3,0.9879797524692919,200,181,1,382
26016,bright,main,20220120,4,0.9922000218658789,236,146,2,384
26016,bright,main,20220120,5,0.9894046237320446,255,146,3,404
26016,bright,main,20220120,6,0.9920743533016383,250,155,10,415
26016,bright,main,20220120,7,0.9938267412332755,179,175,4,358
26016,bright,main,20220120,8,0.9943617223200044,261,137,7,405
26016,bright,main,20220120,9,0.9887879970204655,256,156,5,417
23778,bright,main,20220120,0,0.9893285659910709,324,94,6,424
23778,bright,main,20220120,1,0.9876026223187889,297,81,4,382
23778,bright,main,20220120,2,0.9953574604548998,347,66,9,422
23778,bright,main,20220120,3,0.9911916355755762,333,46,4,383
23778,bright,main,20220120,4,0.9947968266415127,298,74,5,377
23778,bright,main,20220120,5,0.9888458620326759,313,76,3,392
23778,bright,main,20220120,6,0.9816452322305428,347,58,3,408
23778,bright,main,20220120,7,0.9929721241900215,286,59,2,347
23778,bright,main,20220120,8,0.995019275945322,345,63,2,410
23778,bright,main,20220120,9,0.9903524419287764,370,51,3,424
24272,bright,main,20220120,0,0.9949382256340673,322,112,5,439
24272,bright,main,20220120,1,0.9925354777153267,330,70,3,403
24272,bright,main,20220120,2,0.9891036842679377,290,134,5,429
24272,bright,main,20220120,3,0.9876685993222863,248,150,4,402
24272,bright,main,20220120,4,0.9883125766315523,231,176,7,414
24272,bright,main,20220120,5,0.9889703374442211,280,146,2,428
24272,bright,main,20220120,6,0.9908603628653123,294,131,2,427
24272,bright,main,20220120,7,0.9883184186802834,265,113,5,383
24272,bright,main,20220120,8,0.9956580856345895,278,148,1,427
24272,bright,main,20220120,9,0.9937043658513619,262,176,1,439
21331,bright,main,20220120,0,0.9876588648317298,334,89,7,430
21331,bright,main,20220120,1,0.9917065297414568,242,135,7,384
21331,bright,main,20220120,2,0.9937032423116908,290,127,4,421
21331,bright,main,20220120,3,0.9904161891107464,244,131,5,380
21331,bright,main,20220120,4,0.9823324461605774,292,81,5,378
21331,bright,main,20220120,5,0.9915043679746343,316,75,4,395
21331,bright,main,20220120,6,0.9929814051416032,363,52,5,420
21331,bright,main,20220120,7,0.9901176713732436,300,57,4,361
21331,bright,main,20220120,8,0.9943220137381548,341,64,4,409
21331,bright,main,20220120,9,0.9915352639550485,346,66,5,417
20936,bright,main,20220120,0,0.9935082932327375,297,136,2,435
20936,bright,main,20220120,1,0.9915253486128126,295,98,6,399
20936,bright,main,20220120,2,0.9884963027990293,289,134,5,428
20936,bright,main,20220120,3,0.9956846982563489,301,94,1,396
20936,bright,main,20220120,4,0.9918595750669823,330,59,2,391
20936,bright,main,20220120,5,0.9928906905852437,332,75,2,409
20936,bright,main,20220120,6,0.9909779941237509,353,69,4,426
20936,bright,main,20220120,7,0.9905424671348205,296,68,4,368
20936,bright,main,20220120,8,0.9937141144355367,305,109,5,419
20936,bright,main,20220120,9,0.9948941430335285,322,103,5,430
25889,bright,main,20220120,0,0.9889915958834504,319,101,5,425
25889,bright,main,20220120,1,0.9951367829734794,345,45,1,391
25889,bright,main,20220120,2,0.9927028734347211,354,54,5,413
25889,bright,main,20220120,3,0.9939936664509431,307,70,8,385
25889,bright,main,20220120,4,0.9930880151017806,217,144,2,363
25889,bright,main,20220120,5,0.9864967782261493,290,102,2,394
25889,bright,main,20220120,6,0.9953836711685955,311,90,3,404
25889,bright,main,20220120,7,0.988393794454403,262,82,2,346
25889,bright,main,20220120,8,0.9920577266557467,275,118,5,398
25889,bright,main,20220120,9,0.9924561408303721,297,114,3,414
24078,bright,main,20220120,0,0.995408148787861,309,129,6,444
24078,bright,main,20220120,1,0.9919427987605807,308,90,4,402
24078,bright,main,20220120,2,0.9890963208132222,307,126,1,434
24078,bright,main,20220120,3,0.9896284220811877,303,85,9,397
24078,bright,main,20220120,4,0.9907338849421551,277,113,5,395
24078,bright,main,20220120,5,0.9930804316982181,293,118,3,414
24078,bright,main,20220120,6,0.9929933212904691,305,115,6,426
24078,bright,main,20220120,7,0.9885421432888,286,86,1,373
24078,bright,main,20220120,8,0.9942113541930396,306,111,2,419
24078,bright,main,20220120,9,0.9947140176743099,327,100,7,434
25888,bright,main,20220120,0,0.9958979816347472,359,60,7,426
25888,bright,main,20220120,1,0.9961427245273783,296,81,3,380
25888,bright,main,20220120,2,0.9940423364455032,328,83,9,420
25888,bright,main,20220120,3,0.9935662894080115,297,74,7,378
25888,bright,main,20220120,4,0.9899304808919202,306,62,6,374
25888,bright,main,20220120,5,0.9928402003055997,308,81,4,393
25888,bright,main,20220120,6,0.9909974370062017,325,59,5,389
25888,bright,main,20220120,7,0.9939110019415449,282,69,6,357
25888,bright,main,20220120,8,0.9937873439317272,320,72,2,394
25888,bright,main,20220120,9,0.9934011581987334,336,72,5,413
23798,bright,main,20220120,0,0.9843489992828035,334,75,4,413
23798,bright,main,20220120,1,0.994716855152556,311,66,5,382
23798,bright,main,20220120,2,0.9903886768061048,346,68,6,420
23798,bright,main,20220120,3,0.9917202690735771,311,68,2,381
23798,bright,main,20220120,4,0.9897766983270633,291,87,3,381
23798,bright,main,20220120,5,0.9879965592304166,295,90,4,389
23798,bright,main,20220120,6,0.9915989377563601,334,68,3,405
23798,bright,main,20220120,7,0.9881080610833802,283,75,3,361
23798,bright,main,20220120,8,0.9955706137156899,343,64,5,412
23798,bright,main,20220120,9,0.9901224250896715,344,75,3,422
25666,bright,main,20220120,0,0.986643382588772,320,95,8,423
25666,bright,main,20220120,1,0.9850523611788011,311,82,4,397
25666,bright,main,20220120,2,0.9936112122248268,332,95,5,432
25666,bright,main,20220120,3,0.9936112122248268,332,95,5,432
25666,bright,main,20220120,4,0.9943352892758563,271,115,0,386
25666,bright,main,20220120,5,0.9939982116762374,303,98,4,405
25666,bright,main,20220120,6,0.9887737412499108,324,94,8,426
25666,bright,main,20220120,7,0.995469682116022,290,69,9,368
25666,bright,main,20220120,8,0.9917658636302319,306,100,4,410
25666,bright,main,20220120,9,0.9857659719493348,303,104,6,413
25370,bright,main,20220120,0,0.9907101203736898,278,140,5,423
25370,bright,main,20220120,1,0.9927663789076827,279,105,4,388
25370,bright,main,20220120,2,0.9886507502545964,295,111,6,412
25370,bright,main,20220120,3,0.9891983471272126,275,100,4,379
25370,bright,main,20220120,4,0.9927328733438264,259,111,6,376
25370,bright,main,20220120,5,0.9942328871582358,262,134,10,406
25370,bright,main,20220120,6,0.9911864846975225,270,134,7,411
25370,bright,main,20220120,7,0.9910501599460023,196,156,8,360
25370,bright,main,20220120,8,0.9944009795277751,201,188,5,394
25370,bright,main,20220120,9,0.9931620727250882,249,155,7,411
23201,bright,main,20220121,0,0.9958596457277407,322,89,6,417
23201,bright,main,20220121,1,0.9915310692079904,307,83,5,395
23201,bright,main,20220121,2,0.9894714184403116,343,77,3,423
23201,bright,main,20220121,3,0.9903641426365569,285,87,5,377
23201,bright,main,20220121,4,0.9920211299993718,285,86,7,378
23201,bright,main,20220121,5,0.9913443726471082,318,83,2,403
23201,bright,main,20220121,6,0.9926103204789811,347,57,2,406
23201,bright,main,20220121,7,0.9929579287868562,297,60,3,360
23201,bright,main,20220121,8,0.9876525550127772,319,80,4,403
23201,bright,main,20220121,9,0.9957696489569325,319,81,2,402
20958,bright,main,20220121,0,0.9902709987103607,267,147,9,423
20958,bright,main,20220121,1,0.9903061950739974,242,133,3,378
20958,bright,main,20220121,2,0.9941207769768754,304,111,5,420
20958,bright,main,20220121,3,0.9918649680893008,296,86,4,386
20958,bright,main,20220121,4,0.9911192030900532,314,65,4,383
20958,bright,main,20220121,5,0.9916929578664061,324,72,3,399
20958,bright,main,20220121,6,0.9927676528088442,334,76,1,411
20958,bright,main,20220121,7,0.9819188666227572,271,80,2,353
20958,bright,main,20220121,8,0.9960464659521829,325,79,9,413
20958,bright,main,20220121,9,0.995263923775888,335,82,6,423
41650,backup,main,20220121,0,0.9909159021495401,3,350,0,353
41650,backup,main,20220121,1,0.9878762781333847,3,302,1,306
41650,backup,main,20220121,2,0.9863702324031046,6,339,1,346
41650,backup,main,20220121,3,0.9933975476970636,5,316,0,321
41650,backup,main,20220121,4,0.9913399252588861,1,311,1,313
41650,backup,main,20220121,5,0.9904289035849696,1,324,1,326
41650,backup,main,20220121,6,0.9931372480421657,3,340,1,344
41650,backup,main,20220121,7,0.9920536340516307,8,295,2,305
41650,backup,main,20220121,8,0.9887074174150591,1,336,1,338
41650,backup,main,20220121,9,0.9878199156690557,3,335,1,339
23698,bright,main,20220121,0,0.9975021816181596,248,188,1,437
23698,bright,main,20220121,1,0.9903336064282028,256,146,1,403
23698,bright,main,20220121,2,0.9951715432504809,251,179,7,437
23698,bright,main,20220121,3,0.9902146856526601,242,159,2,403
23698,bright,main,20220121,4,0.9948377211436911,253,145,3,401
23698,bright,main,20220121,5,0.9901727417468709,230,186,3,419
23698,bright,main,20220121,6,0.9940091297015325,237,191,4,432
23698,bright,main,20220121,7,0.9851541750397454,222,151,5,378
23698,bright,main,20220121,8,0.9931360353042877,210,219,0,429
23698,bright,main,20220121,9,0.9907951623051486,240,190,3,433
26042,bright,main,20220121,0,0.9939155211276073,353,69,6,428
26042,bright,main,20220121,1,0.9905216918056209,327,63,5,395
26042,bright,main,20220121,2,0.9945588879588493,339,73,5,417
26042,bright,main,20220121,3,0.9908573293329339,323,64,3,390
26042,bright,main,20220121,4,0.995660666115586,308,75,5,388
26042,bright,main,20220121,5,0.9923389350687252,287,105,2,394
26042,bright,main,20220121,6,0.9856824708938796,340,65,5,410
26042,bright,main,20220121,7,0.9921430730303866,279,71,7,357
26042,bright,main,20220121,8,0.9942739095826058,295,93,5,393
26042,bright,main,20220121,9,0.9880250155965832,351,55,3,409
23710,bright,main,20220121,0,0.9921553809361764,315,116,4,435
23710,bright,main,20220121,1,0.994650433300741,308,96,3,407
23710,bright,main,20220121,2,0.9939395974705738,362,71,2,435
23710,bright,main,20220121,3,0.992553009467901,303,98,1,402
23710,bright,main,20220121,4,0.9944344304947187,210,186,2,398
23710,bright,main,20220121,5,0.9905299907243584,200,214,3,417
23710,bright,main,20220121,6,0.9908832016693518,160,267,2,429
23710,bright,main,20220121,7,0.9931968420043134,129,247,3,379
23710,bright,main,20220121,8,0.9922504286661638,225,195,3,423
23710,bright,main,20220121,9,0.9907794479842666,260,166,6,432
9497,dark,main,20220121,0,0.9881060900148844,301,14,66,381
9497,dark,main,20220121,1,0.9880601004259899,261,15,79,355
9497,dark,main,20220121,2,0.9959427527422801,268,17,94,379
9497,dark,main,20220121,3,0.9899275524853669,285,15,56,356
9497,dark,main,20220121,4,0.9939478252175068,291,10,52,353
9497,dark,main,20220121,5,0.9919483040718721,313,16,40,369
9497,dark,main,20220121,6,0.9910686523590946,314,12,54,380
9497,dark,main,20220121,7,0.9834658388585791,256,14,61,331
9497,dark,main,20220121,8,0.9861234051911021,146,4,37,187
9497,dark,main,20220121,9,0.9905314489942549,286,15,77,378
41645,backup,main,20220121,0,0.9867144797247527,8,348,0,356
41645,backup,main,20220121,1,0.9875392229778049,1,313,1,315
41645,backup,main,20220121,2,0.9912204686447051,4,346,0,350
41645,backup,main,20220121,3,0.9897454827187419,4,336,0,340
41645,backup,main,20220121,4,0.9973413314157819,1,323,1,325
41645,backup,main,20220121,5,0.986639102242155,8,313,1,322
41645,backup,main,20220121,6,0.9904005778439762,6,332,2,340
41645,backup,main,20220121,7,0.9874732862596013,8,288,2,298
41645,backup,main,20220121,8,0.9861220068081772,10,325,2,337
41645,backup,main,20220121,9,0.991406244747854,6,330,0,336
9489,dark,main,20220121,0,0.9930585143831041,313,12,57,382
9489,dark,main,20220121,1,0.9882338392609472,300,11,40,351
9489,dark,main,20220121,2,0.9898147271651102,317,15,50,382
9489,dark,main,20220121,3,0.9954651794900561,285,15,66,366
9489,dark,main,20220121,4,0.9870159719555656,238,22,51,311
9489,dark,main,20220121,5,0.9926324905045908,303,14,62,379
9489,dark,main,20220121,6,0.9956750322088608,291,16,62,369
9489,dark,main,20220121,7,0.9937170858611184,271,15,56,342
9489,dark,main,20220121,8,0.9931375373564337,294,13,76,383
9489,dark,main,20220121,9,0.9899007735962966,284,15,77,376
21382,bright,main,20220121,0,0.9956462435781057,264,164,6,434
21382,bright,main,20220121,1,0.9929345898246329,250,151,3,404
21382,bright,main,20220121,2,0.9890555202502317,280,154,3,437
21382,bright,main,20220121,3,0.9912878914473257,236,166,3,405
21382,bright,main,20220121,4,0.9923203387166584,273,121,4,398
21382,bright,main,20220121,5,0.9921281291039067,303,108,7,418
21382,bright,main,20220121,6,0.9960864364259966,320,106,4,430
21382,bright,main,20220121,7,0.9927357188204415,292,83,2,377
21382,bright,main,20220121,8,0.9882593940525181,326,97,2,425
21382,bright,main,20220121,9,0.9942002288535253,265,166,3,434
24060,bright,main,20220121,0,0.9927210323903862,339,92,4,435
24060,bright,main,20220121,1,0.9936137077539072,279,114,5,398
24060,bright,main,20220121,2,0.991187374085267,237,181,6,424
24060,bright,main,20220121,3,0.9957718176494937,240,148,3,391
24060,bright,main,20220121,4,0.9956296849932603,175,202,5,382
24060,bright,main,20220121,5,0.9977598334797565,185,209,7,401
24060,bright,main,20220121,6,0.9933468640017193,235,183,2,420
24060,bright,main,20220121,7,0.987599142691264,193,170,3,366
24060,bright,main,20220121,8,0.992207785909654,296,119,2,417
24060,bright,main,20220121,9,0.9938959124195681,304,111,3,418
41611,backup,main,20220121,0,0.9938236351288461,4,347,2,353
41611,backup,main,20220121,1,0.9890062127199675,6,312,2,320
41611,backup,main,20220121,2,0.9944125147461156,7,338,0,345
41611,backup,main,20220121,3,0.9955339386250001,7,301,2,310
41611,backup,main,20220121,4,0.9897482460054856,3,309,0,312
41611,backup,main,20220121,5,0.9912422068099184,7,317,1,325
41611,backup,main,20220121,6,0.9927121233505716,6,330,1,337
41611,backup,main,20220121,7,0.9940488364366901,7,288,1,296
41611,backup,main,20220121,8,0.9904125902575838,2,321,2,325
41611,backup,main,20220121,9,0.9912212643656148,11,329,2,342
22187,bright,main,20220121,0,0.9879745153035877,338,81,4,423
22187,bright,main,20220121,1,0.9945254849940761,289,77,5,371
22187,bright,main,20220121,2,0.9938637507717284,324,87,5,416
22187,bright,main,20220121,3,0.9930800090652093,302,68,4,374
22187,bright,main,20220121,4,0.9852299166135188,282,76,6,364
22187,bright,main,20220121,5,0.990782182797248,312,72,10,394
22187,bright,main,20220121,6,0.9919517688161058,326,75,5,406
22187,bright,main,20220121,7,0.9901093945157399,312,43,3,358
22187,bright,main,20220121,8,0.9885822541631049,330,61,9,400
22187,bright,main,20220121,9,0.9941852471672905,314,86,8,408
25265,bright,main,20220121,0,0.9922903331909136,336,100,2,438
25265,bright,main,20220121,1,0.989657419428922,248,151,6,405
25265,bright,main,20220121,2,0.9881113795104758,303,127,5,435
25265,bright,main,20220121,3,0.9903117191479807,272,131,1,404
25265,bright,main,20220121,4,0.9907371676244578,220,175,4,399
25265,bright,main,20220121,5,0.9921489122054368,247,172,0,419
25265,bright,main,20220121,6,0.983415959187474,198,231,4,433
25265,bright,main,20220121,7,0.9894568726935311,187,186,5,378
25265,bright,main,20220121,8,0.9928067102736985,298,121,3,422
25265,bright,main,20220121,9,0.9965657848786164,262,174,2,438
26041,bright,main,20220121,0,0.9950059794308763,336,85,4,425
26041,bright,main,20220121,1,0.9893914421134893,333,57,1,391
26041,bright,main,20220121,2,0.9966968859491676,369,53,4,426
26041,bright,main,20220121,3,0.9941684104125064,297,80,5,382
26041,bright,main,20220121,4,0.9935029079068776,306,75,3,384
26041,bright,main,20220121,5,0.9950758389075676,328,67,4,399
26041,bright,main,20220121,6,0.9893739408390285,373,43,6,422
26041,bright,main,20220121,7,0.9933052586192166,286,70,3,359
26041,bright,main,20220121,8,0.9934658768131126,311,80,9,400
26041,bright,main,20220121,9,0.9918506085639766,331,82,3,416
22904,bright,main,20220121,0,0.9956110248736705,355,61,8,424
22904,bright,main,20220121,1,0.9948534620576878,314,73,4,391
22904,bright,main,20220121,2,0.996290454996544,351,64,4,419
22904,bright,main,20220121,3,0.989195363962647,335,51,6,392
22904,bright,main,20220121,4,0.9929227015585428,321,54,5,380
22904,bright,main,20220121,5,0.9894298265569246,333,70,6,409
22904,bright,main,20220121,6,0.9955865749861212,335,75,5,415
22904,bright,main,20220121,7,0.9888089190306428,284,63,4,351
22904,bright,main,20220121,8,0.9914666226291626,312,78,8,398
22904,bright,main,20220121,9,0.993622627223673,330,81,4,415
25653,bright,main,20220121,0,0.9951832252610976,306,97,10,413
25653,bright,main,20220121,1,0.9944572694474463,289,89,3,381
25653,bright,main,20220121,2,0.993529668875671,343,77,7,427
25653,bright,main,20220121,3,0.9921771784276897,297,84,4,385
25653,bright,main,20220121,4,0.9894491032510634,331,59,3,393
25653,bright,main,20220121,5,0.9919041778849054,328,67,8,403
25653,bright,main,20220121,6,0.9945097225611654,340,73,8,421
25653,bright,main,20220121,7,0.9884158172797693,285,67,10,362
25653,bright,main,20220121,8,0.9931645600776514,352,58,4,414
25653,bright,main,20220121,9,0.987508163066058,312,95,5,412
25639,bright,main,20220121,0,0.9891597410346165,351,75,1,427
25639,bright,main,20220121,1,0.9949414360950967,300,81,4,385
25639,bright,main,20220121,2,0.9918594767809357,312,100,3,415
25639,bright,main,20220121,3,0.9930746603609968,288,91,3,382
25639,bright,main,20220121,4,0.9933415406128656,280,99,1,380
25639,bright,main,20220121,5,0.9901243942461769,312,81,2,395
25639,bright,main,20220121,6,0.9888413279638846,343,69,4,416
25639,bright,main,20220121,7,0.9896040850385585,270,82,2,354
25639,bright,main,20220121,8,0.9923764914976594,315,78,4,397
25639,bright,main,20220121,9,0.9940097756061964,342,70,5,417
23700,bright,main,20220121,0,0.9901365179743117,288,153,1,442
23700,bright,main,20220121,1,0.9877772737632464,244,162,1,407
23700,bright,main,20220121,2,0.9952796374518289,238,193,4,435
23700,bright,main,20220121,3,0.9953984715629494,276,123,4,403
23700,bright,main,20220121,4,0.9864435669539358,325,69,4,398
23700,bright,main,20220121,5,0.9960606590337928,310,102,2,414
23700,bright,main,20220121,6,0.9900504767115611,345,86,5,436
23700,bright,main,20220121,7,0.9878565220985084,297,78,2,377
23700,bright,main,20220121,8,0.9882828441631735,299,119,3,421
23700,bright,main,20220121,9,0.9952956169675327,311,120,3,434
23741,bright,main,20220121,0,0.9927433705863113,348,70,7,425
23741,bright,main,20220121,1,0.9895727444059352,298,63,7,368
23741,bright,main,20220121,2,0.9860965215629718,355,59,2,416
23741,bright,main,20220121,3,0.9896079526433064,338,40,3,381
23741,bright,main,20220121,4,0.9946286860899078,320,61,2,383
23741,bright,main,20220121,5,0.9917281797881198,324,60,8,392
23741,bright,main,20220121,6,0.988453966141553,344,53,11,408
23741,bright,main,20220121,7,0.9918537035820544,279,66,3,348
23741,bright,main,20220121,8,0.9957949839273352,329,73,1,403
23741,bright,main,20220121,9,0.9942796626997118,321,88,6,415
23735,bright,main,20220121,0,0.9921821153650068,371,46,2,419
23735,bright,main,20220121,1,0.9926127537685817,336,47,5,388
23735,bright,main,20220121,2,0.9921347026054884,369,54,3,426
23735,bright,main,20220121,3,0.9962613589397203,337,47,6,390
23735,bright,main,20220121,4,0.9950012950513312,338,44,3,385
23735,bright,main,20220121,5,0.9951055186834231,342,45,6,393
23735,bright,main,20220121,6,0.990657498437094,349,56,8,413
23735,bright,main,20220121,7,0.9873632166959952,311,37,7,355
23735,bright,main,20220121,8,0.9892721116789066,349,53,4,406
23735,bright,main,20220121,9,0.9969972116064671,376,44,6,426
24103,bright,main,20220121,0,0.9924838879071365,280,157,5,442
24103,bright,main,20220121,1,0.9944436146878136,322,75,1,398
24103,bright,main,20220121,2,0.9922451259324158,339,89,8,436
24103,bright,main,20220121,3,0.9878962948980321,314,79,7,400
24103,bright,main,20220121,4,0.9937277500942955,321,69,3,393
24103,bright,main,20220121,5,0.9907213016338495,344,60,2,406
24103,bright,main,20220121,6,0.9953400466556135,334,79,4,417
24103,bright,main,20220121,7,0.989329084066929,287,78,5,370
24103,bright,main,20220121,8,0.9865707135132032,345,69,5,419
24103,bright,main,20220121,9,0.9899314633368876,289,134,2,425
22174,bright,main,20220121,0,0.9918691330965484,301,96,8,405
22174,bright,main,20220121,1,0.9882377257148843,303,69,8,380
22174,bright,main,20220121,2,0.9904099897161841,334,86,4,424
22174,bright,main,20220121,3,0.9875933451766143,291,78,6,375
22174,bright,main,20220121,4,0.9959386324700358,314,60,5,379
22174,bright,main,20220121,5,0.9953940038658768,319,72,6,397
22174,bright,main,20220121,6,0.9950089426807074,317,78,8,403
22174,bright,main,20220121,7,0.994559288584124,272,80,0,352
22174,bright,main,20220121,8,0.9954366276858952,341,63,4,408
22174,bright,main,20220121,9,0.9880203346454006,332,75,7,414
25371,bright,main,20220121,0,0.9951481934373145,356,68,4,428
25371,bright,main,20220121,1,0.9920449781742819,315,72,6,393
25371,bright,main,20220121,2,0.9824744169027074,360,55,4,419
25371,bright,main,20220121,3,0.9907020271129473,286,90,3,379
25371,bright,main,20220121,4,0.9940826669066486,271,105,3,379
25371,bright,main,20220121,5,0.9892600816200664,231,163,7,401
25371,bright,main,20220121,6,0.9915486880472424,310,96,4,410
25371,bright,main,20220121,7,0.9935991037491302,320,43,4,367
25371,bright,main,20220121,8,0.9917699511098861,341,41,5,387
25371,bright,main,20220121,9,0.9929909596804686,351,61,7,419
22225,bright,main,20220121,0,0.9957137812883343,311,90,8,409
22225,bright,main,20220121,1,0.986302500028015,293,77,4,374
22225,bright,main,20220121,2,0.9979303518495798,321,87,1,409
22225,bright,main,20220121,3,0.9963298989948396,284,75,8,367
22225,bright,main,20220121,4,0.9938009825403915,319,53,4,376
22225,bright,main,20220121,5,0.9939524200181276,322,71,5,398
22225,bright,main,20220121,6,0.9867822870972757,333,72,4,409
22225,bright,main,20220121,7,0.9940884858520377,273,70,4,347
22225,bright,main,20220121,8,0.9968324262352585,303,81,5,389
22225,bright,main,20220121,9,0.9928134346339924,344,65,5,414
23740,bright,main,20220121,0,0.990169274977488,344,73,8,425
23740,bright,main,20220121,1,0.9902671340579967,315,59,8,382
23740,bright,main,20220121,2,0.9901190367708614,358,61,2,421
23740,bright,main,20220121,3,0.9932079127360802,335,39,6,380
23740,bright,main,20220121,4,0.9883941229669829,316,58,2,376
23740,bright,main,20220121,5,0.9852168613826258,336,46,9,391
23740,bright,main,20220121,6,0.9965465598519196,353,55,3,411
23740,bright,main,20220121,7,0.9917224743732772,296,60,2,358
23740,bright,main,20220121,8,0.9889832595166537,342,61,2,405
23740,bright,main,20220121,9,0.9928707809771937,347,64,5,416
20632,bright,main,20220121,0,0.9891809672211612,351,67,6,424
20632,bright,main,20220121,1,0.9946728182344998,314,67,5,386
20632,bright,main,20220121,2,0.9915982882188022,342,66,2,410
20632,bright,main,20220121,3,0.990514286165967,306,64,7,377
20632,bright,main,20220121,4,0.9904549089577612,310,69,4,383
20632,bright,main,20220121,5,0.9926492617749562,298,85,5,388
20632,bright,main,20220121,6,0.9964833112533719,330,69,5,404
20632,bright,main,20220121,7,0.9920169367286428,293,59,2,354
20632,bright,main,20220121,8,0.9939959139688963,347,54,7,408
20632,bright,main,20220121,9,0.9941101666175198,349,64,3,416
25692,bright,main,20220121,0,0.9912884042514325,330,80,6,416
25692,bright,main,20220121,1,0.993795897786972,306,78,3,387
25692,bright,main,20220121,2,0.9917196151175439,324,87,5,416
25692,bright,main,20220121,3,0.9890889510574495,305,63,10,378
25692,bright,main,20220121,4,0.9944827642794932,309,64,5,378
25692,bright,main,20220121,5,0.9876245097483687,299,83,7,389
25692,bright,main,20220121,6,0.9965797306724612,306,105,2,413
25692,bright,main,20220121,7,0.9892940746685168,248,95,3,346
25692,bright,main,20220121,8,0.9948604824746394,335,63,7,405
25692,bright,main,20220121,9,0.9896224471653842,290,98,5,393
25304,bright,main,20220121,0,0.9928568419865998,345,74,3,422
25304,bright,main,20220121,1,0.9902501513464448,295,86,6,387
25304,bright,main,20220121,2,0.9928654715615957,288,118,3,409
25304,bright,main,20220121,3,0.9866994992298493,297,81,4,382
25304,bright,main,20220121,4,0.9913716049505962,320,57,1,378
25304,bright,main,20220121,5,0.9877673643270639,331,63,6,400
25304,bright,main,20220121,6,0.996017267552884,336,71,1,408
25304,bright,main,20220121,7,0.9932959280975256,279,60,5,344
25304,bright,main,20220121,8,0.9924062037480236,332,70,7,409
25304,bright,main,20220121,9,0.9924617808992066,358,49,5,412
41648,backup,main,20220121,0,0.986761401149877,2,341,2,345
41648,backup,main,20220121,1,0.9832967776112592,3,310,2,315
41648,backup,main,20220121,2,0.9824330637692289,9,318,3,330
41648,backup,main,20220121,3,0.9878737222962164,5,324,0,329
41648,backup,main,20220121,4,0.9917861634458986,8,292,1,301
41648,backup,main,20220121,5,0.9812362017763895,4,326,1,331
41648,backup,main,20220121,6,0.9930582274713483,7,348,1,356
41648,backup,main,20220121,7,0.9820695269902325,5,293,2,300
41648,backup,main,20220121,8,0.9900355719829952,6,322,3,331
41648,backup,main,20220121,9,0.9861176290057994,4,331,2,337
41250,backup,main,20220122,0,0.9951524034191757,6,443,0,449
41250,backup,main,20220122,1,0.9933627681649243,19,388,0,407
41250,backup,main,20220122,2,0.9901622586229298,9,436,0,445
41250,backup,main,20220122,3,0.9913225468022892,6,401,0,407
41250,backup,main,20220122,4,0.9893244626395583,15,388,0,403
41250,backup,main,20220122,5,0.9912427200318027,6,418,0,424
41250,backup,main,20220122,6,0.9912988931219028,0,436,0,436
41250,backup,main,20220122,7,0.9923649569218892,4,375,0,379
41250,backup,main,20220122,8,0.9915031255617132,7,423,0,430
41250,backup,main,20220122,9,0.9925620764127101,6,435,0,441
21366,bright,main,20220122,0,0.9942332025609645,347,89,4,440
21366,bright,main,20220122,1,0.9950663154438708,302,101,5,408
21366,bright,main,20220122,2,0.9887708224993037,340,98,5,443
21366,bright,main,20220122,3,0.9924491561385207,338,62,1,401
21366,bright,main,20220122,4,0.9961436225205069,288,110,1,399
21366,bright,main,20220122,5,0.991381007555973,271,148,1,420
21366,bright,main,20220122,6,0.9923053556954972,303,128,0,431
21366,bright,main,20220122,7,0.9917832204160207,259,115,3,377
21366,bright,main,20220122,8,0.9936056595892974,301,119,4,424
21366,bright,main,20220122,9,0.9934216366642783,338,96,3,437
4091,dark,main,20220123,0,0.9929753926927788,302,15,50,367
4091,dark,main,20220123,1,0.9942653469256292,276,16,41,333
4091,dark,main,20220123,2,0.988550464611537,288,19,63,370
4091,dark,main,20220123,3,0.9904312906036981,281,22,46,349
4091,dark,main,20220123,4,0.9819797861585794,285,17,39,341
4091,dark,main,20220123,5,0.980778629072732,310,12,49,371
4091,dark,main,20220123,6,0.9915182135304133,316,12,49,377
4091,dark,main,20220123,7,0.9951651827906892,274,14,46,334
4091,dark,main,20220123,8,0.9880171086772916,295,16,54,365
4091,dark,main,20220123,9,0.9944386919416373,285,23,63,371
9427,dark,main,20220123,0,0.9905577633815862,288,10,104,402
9427,dark,main,20220123,1,0.9894388935003497,248,10,93,351
9427,dark,main,20220123,2,0.9895596625328601,298,12,88,398
9427,dark,main,20220123,3,0.9909532940869947,266,12,85,363
9427,dark,main,20220123,4,0.9937318795463173,257,13,77,347
9427,dark,main,20220123,5,0.9955054610494187,277,12,88,377
9427,dark,main,20220123,6,0.9889722357164149,276,14,92,382
9427,dark,main,20220123,7,0.9851486002945985,230,14,86,330
9427,dark,main,20220123,8,0.9953053672459129,282,15,90,387
9427,dark,main,20220123,9,0.9890428918429116,281,18,95,394
24293,bright,main,20220123,0,0.9897205442079154,337,87,4,428
24293,bright,main,20220123,1,0.994577594714081,320,63,2,385
24293,bright,main,20220123,2,0.9930798333094413,358,62,4,424
24293,bright,main,20220123,3,0.9915828867806271,336,47,3,386
24293,bright,main,20220123,4,0.9933869123610263,329,46,6,381
24293,bright,main,20220123,5,0.9889078539072242,335,56,6,397
24293,bright,main,20220123,6,0.9925201525045106,340,68,4,412
24293,bright,main,20220123,7,0.9913435117806894,277,80,2,359
24293,bright,main,20220123,8,0.9947774894417837,326,72,3,401
24293,bright,main,20220123,9,0.9948297462907415,348,62,9,419
4749,dark,main,20220123,0,0.9922472580007377,287,13,104,404
4749,dark,main,20220123,1,0.9948388221633689,260,11,90,361
4749,dark,main,20220123,2,0.9913719394662827,292,10,101,403
4749,dark,main,20220123,3,0.9884779025574052,274,11,72,357
4749,dark,main,20220123,4,0.9848413105604189,258,10,83,351
4749,dark,main,20220123,5,0.9961426762639529,276,13,79,368
4749,dark,main,20220123,6,0.9932850372102917,289,12,94,395
4749,dark,main,20220123,7,0.983030242889425,252,12,75,339
4749,dark,main,20220123,8,0.9955955841946655,247,12,116,375
4749,dark,main,20220123,9,0.9920735306671036,297,13,81,391
4750,dark,main,20220123,0,0.9931986598163954,271,14,103,388
4750,dark,main,20220123,1,0.9929613323382394,267,17,80,364
4750,dark,main,20220123,2,0.9908358507567988,284,16,87,387
4750,dark,main,20220123,3,0.9927493808924367,260,14,86,360
4750,dark,main,20220123,4,0.9955913774800919,266,13,85,364
4750,dark,main,20220123,5,0.9937345410870563,262,14,91,367
4750,dark,main,20220123,6,0.9918582024391492,277,11,105,393
4750,dark,main,20220123,7,0.9961711835965025,252,13,70,335
4750,dark,main,20220123,8,0.9919673062685315,266,14,90,370
4750,dark,main,20220123,9,0.9924121656619863,296,12,82,390
5653,dark,main,20220123,0,0.9950109814962976,305,15,71,391
5653,dark,main,20220123,1,0.9882674744078187,284,16,48,348
5653,dark,main,20220123,2,0.9870984252881331,294,20,56,370
5653,dark,main,20220123,3,0.994107491983353,297,16,39,352
5653,dark,main,20220123,4,0.9944660815942976,288,21,36,345
5653,dark,main,20220123,5,0.9922622141963356,301,19,58,378
5653,dark,main,20220123,6,0.9875135534137012,324,13,39,376
5653,dark,main,20220123,7,0.991287710151137,271,16,35,322
5653,dark,main,20220123,8,0.9913007736533339,319,12,50,381
5653,dark,main,20220123,9,0.9885936938759217,319,14,61,394
6887,dark,main,20220123,0,0.9887836619853044,269,15,106,390
6887,dark,main,20220123,1,0.9945261913227758,260,17,77,354
6887,dark,main,20220123,2,0.9894976334058755,274,14,90,378
6887,dark,main,20220123,3,0.9887873229256356,251,16,84,351
6887,dark,main,20220123,4,0.9911165126144965,261,12,82,355
6887,dark,main,20220123,5,0.992811264309616,270,16,88,374
6887,dark,main,20220123,6,0.99311825898207,275,13,94,382
6887,dark,main,20220123,7,0.9889224763851617,236,18,72,326
6887,dark,main,20220123,8,0.9850736927691846,280,15,79,374
6887,dark,main,20220123,9,0.9943328592044504,282,12,99,393
21374,bright,main,20220123,0,0.9975979619983815,246,192,5,443
21374,bright,main,20220123,1,0.9928646451052414,275,127,6,408
21374,bright,main,20220123,2,0.9955587462645653,293,135,5,433
21374,bright,main,20220123,3,0.9944743584472059,245,157,2,404
21374,bright,main,20220123,4,0.9925600025982821,236,163,1,400
21374,bright,main,20220123,5,0.9860357088644756,201,217,2,420
21374,bright,main,20220123,6,0.9942781922582502,322,111,2,435
21374,bright,main,20220123,7,0.9925811891940082,201,171,4,376
21374,bright,main,20220123,8,0.9938956168189564,235,181,7,423
21374,bright,main,20220123,9,0.9946149172741927,244,185,7,436
26194,bright,main,20220123,0,0.9895711414766023,287,135,3,425
26194,bright,main,20220123,1,0.9942196215615993,281,110,2,393
26194,bright,main,20220123,2,0.9924227079012946,340,88,2,430
26194,bright,main,20220123,3,0.9876137918775585,273,113,7,393
26194,bright,main,20220123,4,0.9906398376804174,240,147,6,393
26194,bright,main,20220123,5,0.9935899558938758,252,153,6,411
26194,bright,main,20220123,6,0.9929818079556054,277,143,8,428
26194,bright,main,20220123,7,0.9910001160184214,215,149,5,369
26194,bright,main,20220123,8,0.9947204931034798,296,123,3,422
26194,bright,main,20220123,9,0.9928431031022343,296,132,2,430
4131,dark,main,20220123,0,0.9930672963166595,315,14,51,380
4131,dark,main,20220123,1,0.9895278238852898,273,20,50,343
4131,dark,main,20220123,2,0.9870312160184873,308,24,52,384
4131,dark,main,20220123,3,0.9939503762344436,295,23,35,353
4131,dark,main,20220123,4,0.9896967136641044,300,16,33,349
4131,dark,main,20220123,5,0.9915040052205139,304,15,56,375
4131,dark,main,20220123,6,0.9932323038210098,294,29,72,395
4131,dark,main,20220123,7,0.9851193425272347,272,21,36,329
4131,dark,main,20220123,8,0.9911047621278739,298,12,50,360
4131,dark,main,20220123,9,0.9916982499316921,319,20,42,381
6856,dark,main,20220123,0,0.9950433081764737,264,15,111,390
6856,dark,main,20220123,1,0.984621908614962,277,11,79,367
6856,dark,main,20220123,2,0.9900465551659335,294,15,79,388
6856,dark,main,20220123,3,0.9890987012811603,268,12,84,364
6856,dark,main,20220123,4,0.9922593380175435,251,19,75,345
6856,dark,main,20220123,5,0.9958088665540867,287,16,76,379
6856,dark,main,20220123,6,0.9938095810122209,285,11,92,388
6856,dark,main,20220123,7,0.9927573827380022,245,10,81,336
6856,dark,main,20220123,8,0.9940952560587734,284,13,87,384
6856,dark,main,20220123,9,0.9922707827187193,285,14,79,378
4760,dark,main,20220123,0,0.986521858586609,274,13,98,385
4760,dark,main,20220123,1,0.9937244237966202,277,14,81,372
4760,dark,main,20220123,2,0.9873284841245804,300,17,68,385
4760,dark,main,20220123,3,0.9892604313603729,251,17,100,368
4760,dark,main,20220123,4,0.9895218255760444,271,10,89,370
4760,dark,main,20220123,5,0.9931810283680426,274,13,80,367
4760,dark,main,20220123,6,0.9941187424391815,294,14,74,382
4760,dark,main,20220123,7,0.9938857227377373,251,14,75,340
4760,dark,main,20220123,8,0.992883096327984,259,14,97,370
4760,dark,main,20220123,9,0.9919209305307758,295,11,73,379
24281,bright,main,20220123,0,0.9902512385342761,278,158,6,442
24281,bright,main,20220123,1,0.9940927830138208,163,244,1,408
24281,bright,main,20220123,2,0.9934357524836662,126,316,1,443
24281,bright,main,20220123,3,0.9910421830988212,137,266,1,404
24281,bright,main,20220123,4,0.9888378117271883,183,212,4,399
24281,bright,main,20220123,5,0.9914219357245021,233,180,5,418
24281,bright,main,20220123,6,0.988006408414779,355,75,2,432
24281,bright,main,20220123,7,0.9890005517833402,271,101,4,376
24281,bright,main,20220123,8,0.9902589436488187,277,145,3,425
24281,bright,main,20220123,9,0.9899154112505179,305,130,1,436
25047,bright,main,20220123,0,0.9916004305603092,358,57,6,421
25047,bright,main,20220123,1,0.9883974687999371,308,64,7,379
25047,bright,main,20220123,2,0.9929224888486146,354,55,7,416
25047,bright,main,20220123,3,0.9969146022825321,312,61,7,380
25047,bright,main,20220123,4,0.9927530388690764,291,71,7,369
25047,bright,main,20220123,5,0.9870468549756002,320,62,6,388
25047,bright,main,20220123,6,0.9932803486992148,335,61,4,400
25047,bright,main,20220123,7,0.9893246611529155,306,48,6,360
25047,bright,main,20220123,8,0.9955011425518292,322,66,9,397
25047,bright,main,20220123,9,0.9873163925862879,359,50,2,411
22239,bright,main,20220123,0,0.990971294391534,373,57,1,431
22239,bright,main,20220123,1,0.9942747378505117,308,65,1,374
22239,bright,main,20220123,2,0.9958791999587389,348,64,4,416
22239,bright,main,20220123,3,0.9932955053265883,317,64,3,384
22239,bright,main,20220123,4,0.9937114912343541,300,83,3,386
22239,bright,main,20220123,5,0.9902122928499303,330,65,2,397
22239,bright,main,20220123,6,0.9881061701024759,355,67,1,423
22239,bright,main,20220123,7,0.9908317276638862,320,48,2,370
22239,bright,main,20220123,8,0.9948154818743574,308,88,3,399
22239,bright,main,20220123,9,0.9953763157169278,340,66,8,414
11935,dark,main,20220123,0,0.9857550832332524,159,16,54,229
11935,dark,main,20220123,1,0.9832682018546138,218,19,33,270
11935,dark,main,20220123,2,0.9915824620186605,286,24,59,369
11935,dark,main,20220123,3,0.9902672982020108,270,16,42,328
11935,dark,main,20220123,4,0.9866028136020328,296,11,28,335
11935,dark,main,20220123,5,0.9886576767484075,260,15,58,333
11935,dark,main,20220123,6,0.9826663546196464,271,16,65,352
11935,dark,main,20220123,7,0.9884999005195348,259,11,32,302
11935,dark,main,20220123,8,0.9913794665696682,259,16,75,350
11935,dark,main,20220123,9,0.9951829318710828,222,13,78,313
4076,dark,main,20220123,0,0.9893106465309047,322,14,67,403
4076,dark,main,20220123,1,0.9863848053058956,307,16,31,354
4076,dark,main,20220123,2,0.9926299020903248,316,10,39,365
4076,dark,main,20220123,3,0.9877989924501669,290,13,41,344
4076,dark,main,20220123,4,0.9882872781165992,257,14,59,330
4076,dark,main,20220123,5,0.9884053893377781,296,13,55,364
4076,dark,main,20220123,6,0.9888681209338114,305,14,63,382
4076,dark,main,20220123,7,0.9959262868408492,282,13,47,342
4076,dark,main,20220123,8,0.9940713783171933,280,15,84,379
4076,dark,main,20220123,9,0.994874505539763,301,20,65,386
42785,backup,main,20220123,0,0.9922794481646471,19,343,0,362
42785,backup,main,20220123,1,0.9905511140865357,13,325,1,339
42785,backup,main,20220123,2,0.9924802469334478,19,344,1,364
42785,backup,main,20220123,3,0.9901836013500501,25,316,2,343
42785,backup,main,20220123,4,0.9894418814702013,18,309,3,330
42785,backup,main,20220123,5,0.9944990107554273,11,342,4,357
42785,backup,main,20220123,6,0.993768069007749,25,335,2,362
42785,backup,main,20220123,7,0.9930300699850493,22,302,0,324
42785,backup,main,20220123,8,0.9976248823679988,18,353,3,374
42785,backup,main,20220123,9,0.994017692887698,21,341,0,362
9156,dark,main,20220123,0,0.993726762491034,265,21,91,377
9156,dark,main,20220123,1,0.985321804552065,263,14,78,355
9156,dark,main,20220123,2,0.9935299475987206,281,11,88,380
9156,dark,main,20220123,3,0.9882070835433521,263,16,72,351
9156,dark,main,20220123,4,0.9844393452132433,255,16,83,354
9156,dark,main,20220123,5,0.9798735418651234,273,14,80,367
9156,dark,main,20220123,6,0.98548063137299,274,19,89,382
9156,dark,main,20220123,7,0.9904433936991417,244,15,80,339
9156,dark,main,20220123,8,0.9901901207611706,258,14,91,363
9156,dark,main,20220123,9,0.99423520231177,283,14,97,394
25050,bright,main,20220123,0,0.9929313645858644,327,83,2,412
25050,bright,main,20220123,1,0.9911141068808121,293,77,4,374
25050,bright,main,20220123,2,0.9885347314580731,335,67,4,406
25050,bright,main,20220123,3,0.9927665357967813,310,62,3,375
25050,bright,main,20220123,4,0.9904079897912584,313,55,7,375
25050,bright,main,20220123,5,0.9943385457553892,333,45,3,381
25050,bright,main,20220123,6,0.9927853351740826,347,56,7,410
25050,bright,main,20220123,7,0.9892260745346748,307,56,1,364
25050,bright,main,20220123,8,0.9896807677809979,294,98,2,394
25050,bright,main,20220123,9,0.9921949452311403,339,68,5,412
42767,backup,main,20220123,0,0.9874571629218379,32,317,0,349
42767,backup,main,20220123,1,0.9846037968321726,23,282,3,308
42767,backup,main,20220123,2,0.987612555629508,25,327,0,352
42767,backup,main,20220123,3,0.9891047057223096,28,293,2,323
42767,backup,main,20220123,4,0.9916865146126728,20,286,2,308
42767,backup,main,20220123,5,0.9863500209105661,18,323,1,342
42767,backup,main,20220123,6,0.9914337611030596,24,322,1,347
42767,backup,main,20220123,7,0.9915741713464089,21,281,1,303
42767,backup,main,20220123,8,0.9874681388605001,20,327,0,347
42767,backup,main,20220123,9,0.9878772796294922,21,326,4,351
21533,bright,main,20220123,0,0.9937328265965285,202,232,1,435
21533,bright,main,20220123,1,0.9924673636056839,195,203,2,400
21533,bright,main,20220123,2,0.9971879876030454,229,201,2,432
21533,bright,main,20220123,3,0.992925604252161,281,117,3,401
21533,bright,main,20220123,4,0.9892312784273299,311,85,2,398
21533,bright,main,20220123,5,0.9935667784941967,309,102,2,413
21533,bright,main,20220123,6,0.9921909270323654,317,107,6,430
21533,bright,main,20220123,7,0.996281667048951,215,158,2,375
21533,bright,main,20220123,8,0.9923334886262585,228,189,2,419
21533,bright,main,20220123,9,0.9929259340535483,176,253,2,431
9443,dark,main,20220123,0,0.9822112333194339,313,11,65,389
9443,dark,main,20220123,1,0.9927396188549311,289,13,53,355
9443,dark,main,20220123,2,0.993193009040108,321,12,62,395
9443,dark,main,20220123,3,0.9930946703801992,273,16,70,359
9443,dark,main,20220123,4,0.9941836995211626,270,11,77,358
9443,dark,main,20220123,5,0.9925061975290042,262,14,98,374
9443,dark,main,20220123,6,0.9951284584853449,261,13,105,379
9443,dark,main,20220123,7,0.9905744723206049,250,15,79,344
9443,dark,main,20220123,8,0.9852140725914229,295,16,80,391
9443,dark,main,20220123,9,0.9969418126060441,306,15,62,383
25364,bright,main,20220123,0,0.9967809413567802,342,81,2,425
25364,bright,main,20220123,1,0.9935843343289509,290,96,1,387
25364,bright,main,20220123,2,0.9874529801016917,342,73,3,418
25364,bright,main,20220123,3,0.9964840255397918,331,49,4,384
25364,bright,main,20220123,4,0.9922067917181748,299,85,3,387
25364,bright,main,20220123,5,0.9907798285799811,295,105,5,405
25364,bright,main,20220123,6,0.9895318129761516,341,76,7,424
25364,bright,main,20220123,7,0.9900469205456217,254,101,5,360
25364,bright,main,20220123,8,0.9925372594050275,308,101,3,412
25364,bright,main,20220123,9,0.992166293240544,304,107,6,417
22240,bright,main,20220124,0,0.9919097494668498,350,71,5,426
22240,bright,main,20220124,1,0.9794377088371407,316,65,5,386
22240,bright,main,20220124,2,0.9933590097977492,323,91,5,419
22240,bright,main,20220124,3,0.9892665198865617,266,105,5,376
22240,bright,main,20220124,4,0.9925791502901458,282,99,4,385
22240,bright,main,20220124,5,0.9914811261126278,276,107,4,387
22240,bright,main,20220124,6,0.9946507413183174,256,144,7,407
22240,bright,main,20220124,7,0.9833777378756531,150,59,2,211
22240,bright,main,20220124,8,0.9899177843863786,324,72,10,406
22240,bright,main,20220124,9,0.989891683147535,359,51,7,417
6873,dark,main,20220124,0,0.9946763225405706,327,11,50,388
6873,dark,main,20220124,1,0.9916305427679287,296,17,45,358
6873,dark,main,20220124,2,0.9918376232905582,318,17,61,396
6873,dark,main,20220124,3,0.9810537987682694,291,11,55,357
6873,dark,main,20220124,4,0.9913026250492353,278,12,61,351
6873,dark,main,20220124,5,0.9902370915420283,314,10,45,369
6873,dark,main,20220124,6,0.9966677962336624,307,14,56,377
6873,dark,main,20220124,7,0.9858136407309346,234,8,33,275
6873,dark,main,20220124,8,0.9874799630105923,303,17,57,377
6873,dark,main,20220124,9,0.9950229571926836,317,12,57,386
9498,dark,main,20220124,0,0.983534844087247,313,13,64,390
9498,dark,main,20220124,1,0.9838022696134766,296,16,37,349
9498,dark,main,20220124,2,0.9912612927870883,316,11,50,377
9498,dark,main,20220124,3,0.9864282978616455,292,12,42,346
9498,dark,main,20220124,4,0.9885242813929103,292,14,46,352
9498,dark,main,20220124,5,0.9788961613344597,300,15,52,367
9498,dark,main,20220124,6,0.9895079358536724,278,12,91,381
9498,dark,main,20220124,7,0.9897513304465795,172,7,32,211
9498,dark,main,20220124,8,0.9919034590862428,303,15,60,378
9498,dark,main,20220124,9,0.992669235745595,322,11,58,391
20688,bright,main,20220124,0,0.9937262992051433,325,102,5,432
20688,bright,main,20220124,1,0.9925009794465842,263,121,3,387
20688,bright,main,20220124,2,0.9909199705432548,331,89,2,422
20688,bright,main,20220124,3,0.9930816525596271,323,63,4,390
20688,bright,main,20220124,4,0.9893758976589642,325,52,3,380
20688,bright,main,20220124,5,0.9959180490182549,322,69,2,393
20688,bright,main,20220124,6,0.9922200147859541,339,61,5,405
20688,bright,main,20220124,7,0.9945540136384784,243,60,0,303
20688,bright,main,20220124,8,0.9924074025426058,304,101,4,409
20688,bright,main,20220124,9,0.9953145965585595,325,93,2,420
5608,dark,main,20220124,0,0.9935448235843277,316,15,60,391
5608,dark,main,20220124,1,0.9957391828816194,280,14,55,349
5608,dark,main,20220124,2,0.9927189778739333,320,10,68,398
5608,dark,main,20220124,3,0.9923680106414903,280,18,64,362
5608,dark,main,20220124,4,0.9915531448849804,297,13,43,353
5608,dark,main,20220124,5,0.9954829087547201,297,12,51,360
5608,dark,main,20220124,6,0.9887670721942079,318,15,53,386
5608,dark,main,20220124,7,0.9913531781938358,242,16,31,289
5608,dark,main,20220124,8,0.9942344438450949,311,15,55,381
5608,dark,main,20220124,9,0.9956259558831836,326,18,56,400
8799,dark,main,20220124,0,0.9884766382868787,316,13,50,379
8799,dark,main,20220124,1,0.9880335506625237,295,12,50,357
8799,dark,main,20220124,2,0.9922744660946748,329,21,33,383
8799,dark,main,20220124,3,0.9927868855575063,281,17,40,338
8799,dark,main,20220124,4,0.9960903450557015,286,15,32,333
8799,dark,main,20220124,5,0.9867049600787471,293,12,53,358
8799,dark,main,20220124,6,0.9942173504647238,295,23,62,380
8799,dark,main,20220124,7,0.9870717451910289,220,11,41,272
8799,dark,main,20220124,8,0.9888467945641268,300,14,42,356
8799,dark,main,20220124,9,0.9808220673027077,308,15,40,363
8447,dark,main,20220124,0,0.9872274423641633,268,19,96,383
8447,dark,main,20220124,1,0.9897278411035242,290,15,56,361
8447,dark,main,20220124,2,0.9951214011455236,318,13,61,392
8447,dark,main,20220124,3,0.9932084551876974,262,12,65,339
8447,dark,main,20220124,4,0.993155665133803,290,14,43,347
8447,dark,main,20220124,5,0.9898670629721533,274,15,86,375
8447,dark,main,20220124,6,0.9847642022089692,261,12,93,366
8447,dark,main,20220124,7,0.9807432863157433,195,13,71,279
8447,dark,main,20220124,8,0.9925562408734142,265,13,89,367
8447,dark,main,20220124,9,0.9931505018919076,281,14,88,383
11914,dark,main,20220124,0,0.993767163651188,283,16,65,364
11914,dark,main,20220124,1,0.9921488414188177,288,16,54,358
11914,dark,main,20220124,2,0.9920457476053344,317,15,44,376
11914,dark,main,20220124,3,0.9903330468485145,294,17,51,362
11914,dark,main,20220124,4,0.989370557524413,279,10,52,341
11914,dark,main,20220124,5,0.992975527348752,309,10,41,360
11914,dark,main,20220124,6,0.9936854366303718,302,20,52,374
11914,dark,main,20220124,7,0.9851857208172518,240,9,31,280
11914,dark,main,20220124,8,0.9890864808834189,309,11,50,370
11914,dark,main,20220124,9,0.9914692662834076,324,12,45,381
25861,bright,main,20220124,0,0.9959815722675638,302,117,5,424
25861,bright,main,20220124,1,0.9910942868535029,297,85,3,385
25861,bright,main,20220124,2,0.9904404754391817,353,65,7,425
25861,bright,main,20220124,3,0.9921746035725507,250,121,6,377
25861,bright,main,20220124,4,0.9870097786431701,281,90,10,381
25861,bright,main,20220124,5,0.9902091763847851,311,83,6,400
25861,bright,main,20220124,6,0.9925291144362542,275,123,9,407
25861,bright,main,20220124,7,0.9854255798304667,212,81,4,297
25861,bright,main,20220124,8,0.9914719701185432,248,137,4,389
25861,bright,main,20220124,9,0.9964821868448245,284,128,3,415
7760,dark,main,20220124,0,0.9874344273141401,309,14,75,398
7760,dark,main,20220124,1,0.9850718939016452,266,14,92,372
7760,dark,main,20220124,2,0.9878667820322412,286,13,104,403
7760,dark,main,20220124,3,0.9965206406937948,266,20,80,366
7760,dark,main,20220124,4,0.9944887658037207,255,11,91,357
7760,dark,main,20220124,5,0.996901337862738,262,15,95,372
7760,dark,main,20220124,6,0.9914947284913537,292,13,90,395
7760,dark,main,20220124,7,0.9890901180938539,231,13,37,281
7760,dark,main,20220124,8,0.9905487195167961,311,10,50,371
7760,dark,main,20220124,9,0.9923888191545723,321,16,53,390
7227,dark,main,20220124,0,0.9939531546624477,298,18,47,363
7227,dark,main,20220124,1,0.993143137842061,272,19,42,333
7227,dark,main,20220124,2,0.9933763174726312,310,21,46,377
7227,dark,main,20220124,3,0.9863297942369581,289,15,30,334
7227,dark,main,20220124,4,0.9905565485274109,272,19,61,352
7227,dark,main,20220124,5,0.9929467245757314,304,16,43,363
7227,dark,main,20220124,6,0.9937442486083132,311,17,51,379
7227,dark,main,20220124,7,0.9913889955746946,186,11,65,262
7227,dark,main,20220124,8,0.9884463983042309,302,17,56,375
7227,dark,main,20220124,9,0.9945362845923925,317,19,45,381
6869,dark,main,20220124,0,0.9872918456478814,297,18,89,404
6869,dark,main,20220124,1,0.9813723199067985,267,14,80,361
6869,dark,main,20220124,2,0.990459094611719,287,16,102,405
6869,dark,main,20220124,3,0.9923084524242604,257,13,85,355
6869,dark,main,20220124,4,0.9903466266894284,250,11,90,351
6869,dark,main,20220124,5,0.9930182028790535,264,10,93,367
6869,dark,main,20220124,6,0.9887833728091839,297,13,92,402
6869,dark,main,20220124,7,0.9883586596711411,203,12,58,273
6869,dark,main,20220124,8,0.9931544307304365,254,16,107,377
6869,dark,main,20220124,9,0.9917492204277025,287,12,91,390
6871,dark,main,20220124,0,0.9915996032903116,322,12,49,383
6871,dark,main,20220124,1,0.99264582959352,291,12,51,354
6871,dark,main,20220124,2,0.9894457725344279,299,14,73,386
6871,dark,main,20220124,3,0.9870323428168102,254,18,80,352
6871,dark,main,20220124,4,0.9929684399804604,266,13,75,354
6871,dark,main,20220124,5,0.9892819165014725,264,9,94,367
6871,dark,main,20220124,6,0.9909877254358068,282,11,100,393
6871,dark,main,20220124,7,0.9891211859175345,222,13,51,286
6871,dark,main,20220124,8,0.9917847257810921,275,12,96,383
6871,dark,main,20220124,9,0.9922090676248446,317,15,53,385
20722,bright,main,20220124,0,0.9945036791002093,213,201,7,421
20722,bright,main,20220124,1,0.9917816321339301,200,181,6,387
20722,bright,main,20220124,2,0.9951915765332581,281,133,4,418
20722,bright,main,20220124,3,0.989761898715348,235,132,6,373
20722,bright,main,20220124,4,0.9877645708978963,290,72,5,367
20722,bright,main,20220124,5,0.9911124149128979,269,112,7,388
20722,bright,main,20220124,6,0.9930067640146543,291,118,3,412
20722,bright,main,20220124,7,0.9786987216890152,79,33,4,116
20722,bright,main,20220124,8,0.9879060580939192,275,123,4,402
20722,bright,main,20220124,9,0.9944183534659817,241,160,8,409
4106,dark,main,20220124,0,0.9934215092983162,333,18,40,391
4106,dark,main,20220124,1,0.9876249166664822,301,13,49,363
4106,dark,main,20220124,2,0.991490259144721,303,19,50,372
4106,dark,main,20220124,3,0.992014335964754,301,12,45,358
4106,dark,main,20220124,4,0.9907060102981554,287,11,42,340
4106,dark,main,20220124,5,0.9925985050903329,313,12,43,368
4106,dark,main,20220124,6,0.9951553809194382,308,18,64,390
4106,dark,main,20220124,7,0.9869960572833945,241,8,33,282
4106,dark,main,20220124,8,0.9961985710887175,311,11,45,367
4106,dark,main,20220124,9,0.9895573103077793,320,15,54,389
7111,dark,main,20220124,0,0.9902907153956095,301,14,53,368
7111,dark,main,20220124,1,0.9936041646067608,284,15,42,341
7111,dark,main,20220124,2,0.9796555208766959,305,13,47,365
7111,dark,main,20220124,3,0.987252302549331,253,17,49,319
7111,dark,main,20220124,4,0.982034266691276,283,18,41,342
7111,dark,main,20220124,5,0.9940246954684693,300,13,40,353
7111,dark,main,20220124,6,0.990660776199126,301,31,39,371
7111,dark,main,20220124,7,0.9889460860814407,224,18,35,277
7111,dark,main,20220124,8,0.9929841152814257,296,14,53,363
7111,dark,main,20220124,9,0.9915484391305842,301,15,44,360
5610,dark,main,20220124,0,0.9946746584888445,339,17,37,393
5610,dark,main,20220124,1,0.9938720457394766,291,12,35,338
5610,dark,main,20220124,2,0.9880591423561916,321,12,45,378
5610,dark,main,20220124,3,0.991291183662987,308,15,56,379
5610,dark,main,20220124,4,0.98771614841566,265,16,87,368
5610,dark,main,20220124,5,0.9918945348992632,309,11,52,372
5610,dark,main,20220124,6,0.993235201985475,308,13,54,375
5610,dark,main,20220124,7,0.9916491252677289,239,8,36,283
5610,dark,main,20220124,8,0.9909877712014902,311,13,52,376
5610,dark,main,20220124,9,0.9910507514948985,322,11,50,383
3222,dark,main,20220124,0,0.9899519470609999,264,14,111,389
3222,dark,main,20220124,1,0.9935979472029174,272,14,81,367
3222,dark,main,20220124,2,0.9913162908544356,282,13,103,398
3222,dark,main,20220124,3,0.9932348966481626,261,13,88,362
3222,dark,main,20220124,4,0.9896222369454033,258,17,66,341
3222,dark,main,20220124,5,0.991517589333323,294,13,61,368
3222,dark,main,20220124,6,0.989449914537945,303,11,62,376
3222,dark,main,20220124,7,0.9946812050155965,219,10,53,282
3222,dark,main,20220124,8,0.996218222817369,312,11,53,376
3222,dark,main,20220124,9,0.9934660848091951,302,15,75,392
5542,dark,main,20220124,0,0.9949678967110466,330,17,47,394
5542,dark,main,20220124,1,0.9890673896243307,298,16,44,358
5542,dark,main,20220124,2,0.995246885318922,324,24,55,403
5542,dark,main,20220124,3,0.9867877649566353,304,14,38,356
5542,dark,main,20220124,4,0.9910206996534114,269,21,50,340
5542,dark,main,20220124,5,0.9929218748300713,283,21,51,355
5542,dark,main,20220124,6,0.9945273324779939,309,17,63,389
5542,dark,main,20220124,7,0.9902763523071327,233,25,31,289
5542,dark,main,20220124,8,0.9907046775846106,324,18,35,377
5542,dark,main,20220124,9,0.9921502907159743,311,23,39,373
4704,dark,main,20220124,0,0.9859106059020588,297,18,49,364
4704,dark,main,20220124,1,0.991945394829317,287,16,41,344
4704,dark,main,20220124,2,0.9932323079348061,290,24,51,365
4704,dark,main,20220124,3,0.99180330694288,292,16,34,342
4704,dark,main,20220124,4,0.9851684718670343,288,18,37,343
4704,dark,main,20220124,5,0.9910298200570318,292,23,49,364
4704,dark,main,20220124,6,0.9888455489499474,278,29,51,358
4704,dark,main,20220124,7,0.9876137947062902,211,18,50,279
4704,dark,main,20220124,8,0.9921131704369507,304,12,35,351
4704,dark,main,20220124,9,0.991309807997389,308,22,47,377
10768,dark,main,20220124,0,0.9901142896344285,308,12,65,385
10768,dark,main,20220124,1,0.9934946811310642,284,12,50,346
10768,dark,main,20220124,2,0.9921314898451872,323,15,46,384
10768,dark,main,20220124,3,0.9935891572788969,297,12,50,359
10768,dark,main,20220124,4,0.9917045943079799,274,13,50,337
10768,dark,main,20220124,5,0.9840445030803373,287,15,68,370
10768,dark,main,20220124,6,0.9912718300076222,308,14,75,397
10768,dark,main,20220124,7,0.9790325140092577,210,12,53,275
10768,dark,main,20220124,8,0.9815653619594172,281,16,75,372
10768,dark,main,20220124,9,0.9916493110442961,298,15,63,376
4114,dark,main,20220124,0,0.9938488228128389,325,15,41,381
4114,dark,main,20220124,1,0.9894488356841976,287,15,57,359
4114,dark,main,20220124,2,0.9922284938195796,303,15,66,384
4114,dark,main,20220124,3,0.9903308424387196,287,16,63,366
4114,dark,main,20220124,4,0.9934453534573027,279,14,51,344
4114,dark,main,20220124,5,0.9895238330988325,293,17,48,358
4114,dark,main,20220124,6,0.9935287851027458,292,14,69,375
4114,dark,main,20220124,7,0.984370962303217,223,7,51,281
4114,dark,main,20220124,8,0.9925674377256475,322,13,38,373
4114,dark,main,20220124,9,0.9846004425219727,332,16,26,374
4082,dark,main,20220124,0,0.9904622051064383,314,14,64,392
4082,dark,main,20220124,1,0.9909420201626372,317,12,35,364
4082,dark,main,20220124,2,0.9928383406259327,322,16,52,390
4082,dark,main,20220124,3,0.9915960375183488,304,13,44,361
4082,dark,main,20220124,4,0.9937379193264543,303,14,48,365
4082,dark,main,20220124,5,0.9922226386648076,281,16,61,358
4082,dark,main,20220124,6,0.9930444970825905,324,15,57,396
4082,dark,main,20220124,7,0.9909404094863342,229,16,42,287
4082,dark,main,20220124,8,0.9852132081326447,276,22,81,379
4082,dark,main,20220124,9,0.9946167938374487,300,17,66,383
4602,dark,main,20220124,0,0.9937148268349217,313,17,70,400
4602,dark,main,20220124,1,0.9872455889204336,277,13,57,347
4602,dark,main,20220124,2,0.9932598399154622,304,14,73,391
4602,dark,main,20220124,3,0.9887153188567237,249,17,87,353
4602,dark,main,20220124,4,0.9914328007445887,241,20,86,347
4602,dark,main,20220124,5,0.9912164322689866,261,15,74,350
4602,dark,main,20220124,6,0.9936155849231064,255,19,90,364
4602,dark,main,20220124,7,0.9845147170064885,168,17,91,276
4602,dark,main,20220124,8,0.994107100396386,271,16,87,374
4602,dark,main,20220124,9,0.994699344982977,312,17,62,391
4708,dark,main,20220124,0,0.9890380399556924,321,19,38,378
4708,dark,main,20220124,1,0.9888713145920568,278,22,48,348
4708,dark,main,20220124,2,0.9946602604611239,310,24,50,384
4708,dark,main,20220124,3,0.9917173779903923,277,17,54,348
4708,dark,main,20220124,4,0.9922525979989496,297,16,33,346
4708,dark,main,20220124,5,0.9862707343108464,306,18,36,360
4708,dark,main,20220124,6,0.9906653869059711,301,20,41,362
4708,dark,main,20220124,7,0.9835305434131847,211,12,38,261
4708,dark,main,20220124,8,0.9922805585711622,295,13,42,350
4708,dark,main,20220124,9,0.9922389200281014,312,20,44,376
6888,dark,main,20220124,0,0.994140124536433,289,12,87,388
6888,dark,main,20220124,1,0.993632722707984,237,18,90,345
6888,dark,main,20220124,2,0.9885238377445844,286,14,89,389
6888,dark,main,20220124,3,0.9929820500463762,261,16,83,360
6888,dark,main,20220124,4,0.9888195190953241,271,10,76,357
6888,dark,main,20220124,5,0.9929058987628824,262,13,82,357
6888,dark,main,20220124,6,0.9887076110386573,255,17,65,337
6888,dark,main,20220124,7,0.9929211380604902,238,15,69,322
6888,dark,main,20220124,8,0.9919641419933565,271,18,76,365
6888,dark,main,20220124,9,0.9909689794147347,272,12,99,383
23814,bright,main,20220124,0,0.9917240982052022,326,94,6,426
23814,bright,main,20220124,1,0.9937956411641145,285,89,7,381
23814,bright,main,20220124,2,0.9895420824801592,297,106,5,408
23814,bright,main,20220124,3,0.991086249813217,258,121,6,385
23814,bright,main,20220124,4,0.9959812475462966,268,114,4,386
23814,bright,main,20220124,5,0.9925820588033957,284,113,4,401
23814,bright,main,20220124,6,0.9946318750565775,302,109,10,421
23814,bright,main,20220124,7,0.9962386738707719,249,54,2,305
23814,bright,main,20220124,8,0.9897262750831426,326,76,2,404
23814,bright,main,20220124,9,0.9855265880880737,332,78,4,414
5612,dark,main,20220124,0,0.9934296241517261,285,16,41,342
5612,dark,main,20220124,1,0.9936682200049614,275,11,33,319
5612,dark,main,20220124,2,0.9946125245318084,314,12,42,368
5612,dark,main,20220124,3,0.9875806468749615,276,13,35,324
5612,dark,main,20220124,4,0.9858873413384434,264,9,39,312
5612,dark,main,20220124,5,0.9894378463012636,271,14,41,326
5612,dark,main,20220124,6,0.9936160400436463,290,13,42,345
5612,dark,main,20220124,7,0.9802119385339895,231,13,55,299
5612,dark,main,20220124,8,0.9931011559269133,269,13,46,328
5612,dark,main,20220124,9,0.9938566567850107,278,15,47,340
24980,bright,main,20220125,0,0.9827567161274,328,81,6,415
24980,bright,main,20220125,1,0.9912530797200143,275,104,5,384
24980,bright,main,20220125,2,0.9787762537934205,218,184,8,410
24980,bright,main,20220125,3,0.9902253615338331,214,166,4,384
24980,bright,main,20220125,4,0.9960191788552276,217,156,5,378
24980,bright,main,20220125,5,0.9939586781645299,308,83,11,402
24980,bright,main,20220125,6,0.992439409733688,341,72,6,419
24980,bright,main,20220125,7,0.9910645947183294,278,70,1,349
24980,bright,main,20220125,8,0.988914371508852,334,73,1,408
24980,bright,main,20220125,9,0.9927048288203035,368,55,6,429
4703,dark,main,20220125,0,0.9943862520582861,304,27,45,376
4703,dark,main,20220125,1,0.9941874980714537,297,16,43,356
4703,dark,main,20220125,2,0.9940522664257928,291,21,87,399
4703,dark,main,20220125,3,0.9923122313017674,255,23,84,362
4703,dark,main,20220125,4,0.9945091708041709,250,21,78,349
4703,dark,main,20220125,5,0.9876844291591783,280,19,67,366
4703,dark,main,20220125,6,0.9937226570306215,295,19,61,375
4703,dark,main,20220125,7,0.9949591879433733,248,20,58,326
4703,dark,main,20220125,8,0.9896878065001059,306,23,43,372
4703,dark,main,20220125,9,0.993605878597848,318,20,39,377
25909,bright,main,20220125,0,0.9916169747684287,365,54,4,423
25909,bright,main,20220125,1,0.9945537757734788,322,64,3,389
25909,bright,main,20220125,2,0.9924998746869352,318,81,5,404
25909,bright,main,20220125,3,0.9957829959500942,302,73,7,382
25909,bright,main,20220125,4,0.9857266465577251,320,41,5,366
25909,bright,main,20220125,5,0.986363498057598,289,81,8,378
25909,bright,main,20220125,6,0.9958025444650119,330,68,4,402
25909,bright,main,20220125,7,0.9818865323600318,281,64,2,347
25909,bright,main,20220125,8,0.993366238310714,344,60,3,407
25909,bright,main,20220125,9,0.9928526248813733,361,43,3,407
25167,bright,main,20220125,0,0.9914486887767372,337,90,2,429
25167,bright,main,20220125,1,0.9892783088242559,327,50,5,382
25167,bright,main,20220125,2,0.9893470026582988,349,68,5,422
25167,bright,main,20220125,3,0.9961171416992208,320,60,3,383
25167,bright,main,20220125,4,0.9915415948981156,312,71,2,385
25167,bright,main,20220125,5,0.9944773456963383,323,66,4,393
25167,bright,main,20220125,6,0.9905011699657574,322,84,6,412
25167,bright,main,20220125,7,0.9893099921405291,286,67,4,357
25167,bright,main,20220125,8,0.9867521919275327,337,69,5,411
25167,bright,main,20220125,9,0.9941461012821874,367,53,5,425
24976,bright,main,20220125,0,0.9886182278706532,244,170,7,421
24976,bright,main,20220125,1,0.9911051164878727,319,81,2,402
24976,bright,main,20220125,2,0.9916093716663751,312,120,5,437
24976,bright,main,20220125,3,0.9921188633600524,293,90,6,389
24976,bright,main,20220125,4,0.9864940111769286,307,79,3,389
24976,bright,main,20220125,5,0.9920783514859087,322,64,9,395
24976,bright,main,20220125,6,0.9836813252151966,344,71,4,419
24976,bright,main,20220125,7,0.9968595095218973,294,62,4,360
24976,bright,main,20220125,8,0.9919827026049094,335,73,7,415
24976,bright,main,20220125,9,0.990201054848917,269,146,3,418
22777,bright,main,20220125,0,0.9932762376720665,322,87,6,415
22777,bright,main,20220125,1,0.9855551579644646,314,66,4,384
22777,bright,main,20220125,2,0.9961581343268159,335,62,6,403
22777,bright,main,20220125,3,0.9906362264000574,336,41,4,381
22777,bright,main,20220125,4,0.9902713732087532,319,58,4,381
22777,bright,main,20220125,5,0.9929990375012806,328,62,4,394
22777,bright,main,20220125,6,0.9910906221153326,353,54,4,411
22777,bright,main,20220125,7,0.9911095627800683,274,69,2,345
22777,bright,main,20220125,8,0.9940483123853301,290,92,2,384
22777,bright,main,20220125,9,0.9947203834421318,328,80,4,412
20666,bright,main,20220125,0,0.9945638605256645,256,152,8,416
20666,bright,main,20220125,1,0.9894510320888471,264,126,2,392
20666,bright,main,20220125,2,0.9941350570594663,302,108,7,417
20666,bright,main,20220125,3,0.9949390816345635,267,114,5,386
20666,bright,main,20220125,4,0.991010575201712,254,120,6,380
20666,bright,main,20220125,5,0.9912106482033287,293,97,5,395
20666,bright,main,20220125,6,0.9957208391947155,302,107,6,415
20666,bright,main,20220125,7,0.9939242379332588,258,99,1,358
20666,bright,main,20220125,8,0.9954659042775361,293,105,4,402
20666,bright,main,20220125,9,0.9894118818045359,277,133,4,414
24651,bright,main,20220125,0,0.9934611364507192,326,111,1,438
24651,bright,main,20220125,1,0.986256216113172,257,145,3,405
24651,bright,main,20220125,2,0.9953559778851528,291,147,1,439
24651,bright,main,20220125,3,0.9878439400533632,310,85,2,397
24651,bright,main,20220125,4,0.9963579818157094,272,124,3,399
24651,bright,main,20220125,5,0.9967958253713545,281,132,2,415
24651,bright,main,20220125,6,0.9949566578558561,260,165,5,430
24651,bright,main,20220125,7,0.9938752840314332,237,122,1,360
24651,bright,main,20220125,8,0.9919768038758605,241,178,3,422
24651,bright,main,20220125,9,0.994363062933963,274,150,8,432
26205,bright,main,20220125,0,0.9904651498231006,205,223,1,429
26205,bright,main,20220125,1,0.9942099193496455,215,182,2,399
26205,bright,main,20220125,2,0.99326170795037,344,87,8,439
26205,bright,main,20220125,3,0.9908510321352686,274,118,5,397
26205,bright,main,20220125,4,0.9865977484991306,247,141,4,392
26205,bright,main,20220125,5,0.9890620153903441,220,182,4,406
26205,bright,main,20220125,6,0.9874906259401554,251,164,5,420
26205,bright,main,20220125,7,0.987980745303491,260,104,3,367
26205,bright,main,20220125,8,0.9943767616420882,250,157,4,411
26205,bright,main,20220125,9,0.9879693791655222,267,156,6,429
26134,bright,main,20220125,0,0.9957195712890604,277,145,5,427
26134,bright,main,20220125,1,0.9942615489996925,316,81,5,402
26134,bright,main,20220125,2,0.9963222811406849,344,88,4,436
26134,bright,main,20220125,3,0.9958798359145205,318,72,2,392
26134,bright,main,20220125,4,0.9920017373097477,279,107,1,387
26134,bright,main,20220125,5,0.9952776015810465,215,178,9,402
26134,bright,main,20220125,6,0.9889626335147389,242,177,4,423
26134,bright,main,20220125,7,0.9875167707512289,223,136,5,364
26134,bright,main,20220125,8,0.9935239546962132,202,203,4,409
26134,bright,main,20220125,9,0.9865057711016397,214,204,6,424
26256,bright,main,20220125,0,0.985806831942618,315,105,4,424
26256,bright,main,20220125,1,0.989275947355107,280,113,1,394
26256,bright,main,20220125,2,0.9960125500775234,268,160,6,434
26256,bright,main,20220125,3,0.993929997528168,196,186,1,383
26256,bright,main,20220125,4,0.9949062753969756,202,181,2,385
26256,bright,main,20220125,5,0.993909062564575,219,177,2,398
26256,bright,main,20220125,6,0.989633511821047,316,100,5,421
26256,bright,main,20220125,7,0.9901338867673183,282,67,2,351
26256,bright,main,20220125,8,0.9878184606139306,316,90,1,407
26256,bright,main,20220125,9,0.9907427141277656,344,79,3,426
24975,bright,main,20220125,0,0.9931954543091335,293,131,3,427
24975,bright,main,20220125,1,0.993221123103601,279,99,5,383
24975,bright,main,20220125,2,0.9969341759549953,314,107,5,426
24975,bright,main,20220125,3,0.9927406209895855,314,77,1,392
24975,bright,main,20220125,4,0.9836296952095057,340,42,7,389
24975,bright,main,20220125,5,0.9845180645710037,339,65,4,408
24975,bright,main,20220125,6,0.9931639620133498,358,65,5,428
24975,bright,main,20220125,7,0.9900349334979889,282,73,3,358
24975,bright,main,20220125,8,0.992062900498996,349,64,1,414
24975,bright,main,20220125,9,0.9943868138145375,333,85,2,420
25860,bright,main,20220125,0,0.9917049507638341,269,102,12,383
25860,bright,main,20220125,1,0.9930497734376345,247,96,4,347
25860,bright,main,20220125,2,0.9937729555921807,295,84,5,384
25860,bright,main,20220125,3,0.9918736485390168,241,104,5,350
25860,bright,main,20220125,4,0.9899440647265384,255,86,3,344
25860,bright,main,20220125,5,0.9930732256171423,255,117,6,378
25860,bright,main,20220125,6,0.9920748436897686,269,115,6,390
25860,bright,main,20220125,7,0.9872170099744311,266,63,8,337
25860,bright,main,20220125,8,0.9929749524254233,262,102,9,373
25860,bright,main,20220125,9,0.9858012561540136,275,98,8,381
25363,bright,main,20220125,0,0.992332269324267,268,90,4,362
25363,bright,main,20220125,1,0.9938806754617141,308,71,3,382
25363,bright,main,20220125,2,0.9920986198997201,296,113,6,415
25363,bright,main,20220125,3,0.9885889129768588,281,92,4,377
25363,bright,main,20220125,4,0.9901921313896047,301,72,7,380
25363,bright,main,20220125,5,0.9937362280031042,308,87,3,398
25363,bright,main,20220125,6,0.9966576636813056,342,66,5,413
25363,bright,main,20220125,7,0.9834121163618207,312,43,4,359
25363,bright,main,20220125,8,0.9963946046453357,339,55,9,403
25363,bright,main,20220125,9,0.9934735527825546,335,75,3,413
24350,bright,main,20220125,0,0.9910320439589522,349,63,6,418
24350,bright,main,20220125,1,0.9911810874257354,331,53,2,386
24350,bright,main,20220125,2,0.9955254368271026,261,166,4,431
24350,bright,main,20220125,3,0.9942808720860217,313,63,7,383
24350,bright,main,20220125,4,0.9933788572062593,322,62,4,388
24350,bright,main,20220125,5,0.9879732001248072,328,70,7,405
24350,bright,main,20220125,6,0.9913318148348943,337,63,2,402
24350,bright,main,20220125,7,0.993353998108454,326,29,5,360
24350,bright,main,20220125,8,0.9927854461970544,345,51,5,401
24350,bright,main,20220125,9,0.995626995430805,366,58,3,427
21104,bright,main,20220125,0,0.9891462695483091,340,80,2,422
21104,bright,main,20220125,1,0.9847878732686618,301,69,3,373
21104,bright,main,20220125,2,0.9919501827050048,351,56,6,413
21104,bright,main,20220125,3,0.9894549976638709,303,73,3,379
21104,bright,main,20220125,4,0.9948283399162473,301,70,3,374
21104,bright,main,20220125,5,0.9967387261161148,340,60,3,403
21104,bright,main,20220125,6,0.994769895062234,358,48,7,413
21104,bright,main,20220125,7,0.9931679430919748,311,42,3,356
21104,bright,main,20220125,8,0.9915024843990121,345,61,3,409
21104,bright,main,20220125,9,0.9961464233245428,363,56,1,420
23069,bright,main,20220125,0,0.9946419145178541,215,203,5,423
23069,bright,main,20220125,1,0.99524536032166,190,203,2,395
23069,bright,main,20220125,2,0.9962557500641358,297,120,4,421
23069,bright,main,20220125,3,0.9900654295624605,301,84,6,391
23069,bright,main,20220125,4,0.9791505351146174,330,60,3,393
23069,bright,main,20220125,5,0.986224166990467,312,90,7,409
23069,bright,main,20220125,6,0.9948454920848615,321,96,6,423
23069,bright,main,20220125,7,0.9916110166477704,258,108,0,366
23069,bright,main,20220125,8,0.9903126047022189,189,218,5,412
23069,bright,main,20220125,9,0.990748800145911,222,200,6,428
22236,bright,main,20220125,0,0.994750363345236,185,216,3,404
22236,bright,main,20220125,1,0.988001038839801,283,96,6,385
22236,bright,main,20220125,2,0.9916045143514282,290,126,6,422
22236,bright,main,20220125,3,0.995806689644937,292,95,2,389
22236,bright,main,20220125,4,0.9915225810326259,280,95,2,377
22236,bright,main,20220125,5,0.9904259013307601,286,105,7,398
22236,bright,main,20220125,6,0.9811942063089786,332,77,3,412
22236,bright,main,20220125,7,0.9903385798165381,263,80,9,352
22236,bright,main,20220125,8,0.9940948934434107,266,129,3,398
22236,bright,main,20220125,9,0.9921131927604171,243,153,11,407
20663,bright,main,20220125,0,0.9890087839572627,329,86,3,418
20663,bright,main,20220125,1,0.9935246954162644,313,77,0,390
20663,bright,main,20220125,2,0.9921179128552743,307,105,4,416
20663,bright,main,20220125,3,0.9944871626878248,230,147,5,382
20663,bright,main,20220125,4,0.9921874892754683,197,174,7,378
20663,bright,main,20220125,5,0.9922047230114402,209,184,9,402
20663,bright,main,20220125,6,0.9924122647791291,276,134,5,415
20663,bright,main,20220125,7,0.9913868166963649,277,81,3,361
20663,bright,main,20220125,8,0.9924356141861038,340,67,1,408
20663,bright,main,20220125,9,0.9923131693256882,306,79,4,389
25864,bright,main,20220125,0,0.9879777214294995,287,127,3,417
25864,bright,main,20220125,1,0.9904629429971215,250,111,6,367
25864,bright,main,20220125,2,0.9903712178654281,283,115,9,407
25864,bright,main,20220125,3,0.9909046495449925,243,125,5,373
25864,bright,main,20220125,4,0.9909724607835305,260,120,4,384
25864,bright,main,20220125,5,0.9827686348908854,317,80,3,400
25864,bright,main,20220125,6,0.990485958224377,301,110,2,413
25864,bright,main,20220125,7,0.9956899283150822,270,86,1,357
25864,bright,main,20220125,8,0.9949717825176926,280,118,5,403
25864,bright,main,20220125,9,0.9950114543889491,243,151,3,397
23834,bright,main,20220125,0,0.9943392841841573,247,151,6,404
23834,bright,main,20220125,1,0.9904585966541207,261,120,8,389
23834,bright,main,20220125,2,0.9905927175592718,245,167,10,422
23834,bright,main,20220125,3,0.9961347149084371,212,160,7,379
23834,bright,main,20220125,4,0.9925485253975451,167,209,9,385
23834,bright,main,20220125,5,0.9910349336709883,188,202,5,395
23834,bright,main,20220125,6,0.9909343384688987,177,224,11,412
23834,bright,main,20220125,7,0.9950128474003037,239,118,2,359
23834,bright,main,20220125,8,0.9949376070972495,230,180,3,413
23834,bright,main,20220125,9,0.9946997067571466,240,177,4,421
21526,bright,main,20220125,0,0.9860438429614968,375,61,1,437
21526,bright,main,20220125,1,0.9939110448304473,328,64,6,398
21526,bright,main,20220125,2,0.9924209333112294,354,77,5,436
21526,bright,main,20220125,3,0.9905510504868333,338,57,6,401
21526,bright,main,20220125,4,0.9952239028100491,282,107,4,393
21526,bright,main,20220125,5,0.9903716598729795,329,76,5,410
21526,bright,main,20220125,6,0.9932467135811961,305,118,5,428
21526,bright,main,20220125,7,0.9925612157169275,232,129,4,365
21526,bright,main,20220125,8,0.9969354929304863,259,158,4,421
21526,bright,main,20220125,9,0.9922801357759286,339,93,3,435
24653,bright,main,20220125,0,0.9947759374809655,265,165,6,436
24653,bright,main,20220125,1,0.9879463812672523,234,170,1,405
24653,bright,main,20220125,2,0.9924868561217987,328,108,2,438
24653,bright,main,20220125,3,0.9922777569146379,259,137,3,399
24653,bright,main,20220125,4,0.9960657586775153,248,150,1,399
24653,bright,main,20220125,5,0.9938983541434863,271,143,3,417
24653,bright,main,20220125,6,0.9899137790666515,330,102,1,433
24653,bright,main,20220125,7,0.9862062920014091,253,115,3,371
24653,bright,main,20220125,8,0.9926075124351466,287,133,4,424
24653,bright,main,20220125,9,0.988521188872335,255,176,2,433
23052,bright,main,20220125,0,0.9909159145324739,296,135,5,436
23052,bright,main,20220125,1,0.9927835485394858,223,166,3,392
23052,bright,main,20220125,2,0.9911968190989949,217,207,6,430
23052,bright,main,20220125,3,0.9896634344317374,212,180,4,396
23052,bright,main,20220125,4,0.9958650121700281,212,175,6,393
23052,bright,main,20220125,5,0.995005017333499,233,173,3,409
23052,bright,main,20220125,6,0.9956923260280176,299,125,5,429
23052,bright,main,20220125,7,0.9907004750055651,277,91,2,370
23052,bright,main,20220125,8,0.9954629566661766,243,169,3,415
23052,bright,main,20220125,9,0.9889204350849775,286,143,6,435
26250,bright,main,20220125,0,0.9857982695560892,295,133,2,430
26250,bright,main,20220125,1,0.9872186789200798,297,95,8,400
26250,bright,main,20220125,2,0.9917688484294936,235,196,5,436
26250,bright,main,20220125,3,0.9899441568200807,138,250,4,392
26250,bright,main,20220125,4,0.9908612879663627,166,215,8,389
26250,bright,main,20220125,5,0.9835460203162102,165,236,4,405
26250,bright,main,20220125,6,0.9957995267790187,247,175,4,426
26250,bright,main,20220125,7,0.9961898535886758,261,100,3,364
26250,bright,main,20220125,8,0.9882766478419132,308,99,5,412
26250,bright,main,20220125,9,0.9944444278914367,266,156,8,430
25735,bright,main,20220125,0,0.9915073915019468,251,50,3,304
25735,bright,main,20220125,1,0.9885653364213925,202,65,7,274
25735,bright,main,20220125,2,0.9817410882914424,207,107,5,319
25735,bright,main,20220125,3,0.993932507470216,167,139,4,310
25735,bright,main,20220125,4,0.9845368204019488,172,103,1,276
25735,bright,main,20220125,5,0.9831013748244138,162,117,8,287
25735,bright,main,20220125,6,0.993330313700644,209,80,12,301
25735,bright,main,20220125,7,0.9922154503657119,203,55,2,260
25735,bright,main,20220125,8,0.9874981732704744,225,56,3,284
25735,bright,main,20220125,9,0.9902434663660998,261,49,3,313
24641,bright,main,20220125,0,0.9927833773147409,354,78,3,435
24641,bright,main,20220125,1,0.9911352654736365,341,56,2,399
24641,bright,main,20220125,2,0.9887907631656165,343,73,7,423
24641,bright,main,20220125,3,0.9881158280639382,330,69,2,401
24641,bright,main,20220125,4,0.993366202752032,253,129,6,388
24641,bright,main,20220125,5,0.9926549161462537,262,141,9,412
24641,bright,main,20220125,6,0.99308045051582,324,101,3,428
24641,bright,main,20220125,7,0.9914705205156913,226,128,5,359
24641,bright,main,20220125,8,0.9909338864842456,276,127,5,408
24641,bright,main,20220125,9,0.9925150221167576,324,101,0,425
24542,bright,main,20220125,0,0.9956333429654931,283,155,2,440
24542,bright,main,20220125,1,0.9833957995685125,246,157,2,405
24542,bright,main,20220125,2,0.9918325525903225,293,140,4,437
24542,bright,main,20220125,3,0.9923992349129612,311,91,1,403
24542,bright,main,20220125,4,0.9922045501636897,299,100,3,402
24542,bright,main,20220125,5,0.9960837980344848,324,93,1,418
24542,bright,main,20220125,6,0.9904237729514387,245,185,3,433
24542,bright,main,20220125,7,0.9894136630775039,184,186,1,371
24542,bright,main,20220125,8,0.9931951171584661,217,204,3,424
24542,bright,main,20220125,9,0.9948188443199948,305,132,2,439
24211,bright,main,20220125,0,0.9906959094473063,302,91,8,401
24211,bright,main,20220125,1,0.9957647408460728,275,90,3,368
24211,bright,main,20220125,2,0.9890098138852735,305,94,7,406
24211,bright,main,20220125,3,0.9914427490101761,274,89,3,366
24211,bright,main,20220125,4,0.9931555978032475,279,83,5,367
24211,bright,main,20220125,5,0.9916930305960945,325,66,5,396
24211,bright,main,20220125,6,0.9923284501991174,307,91,7,405
24211,bright,main,20220125,7,0.9924202276227061,295,31,4,330
24211,bright,main,20220125,8,0.9954365994872136,282,97,5,384
24211,bright,main,20220125,9,0.9919193142424216,332,82,2,416
4083,dark,main,20220126,0,0.9905938182884514,320,14,62,396
4083,dark,main,20220126,1,0.9866855348556326,260,20,79,359
4083,dark,main,20220126,2,0.9921118011470246,314,14,61,389
4083,dark,main,20220126,3,0.9945870710014408,293,15,46,354
4083,dark,main,20220126,4,0.9876126234390575,261,18,67,346
4083,dark,main,20220126,5,0.99115978721142,288,16,68,372
4083,dark,main,20220126,6,0.9903395256355573,285,18,87,390
4083,dark,main,20220126,7,0.9902564226757318,240,11,87,338
4083,dark,main,20220126,8,0.9873037070729876,261,19,93,373
4083,dark,main,20220126,9,0.9912278783355108,289,16,64,369
11936,dark,main,20220126,0,0.9905318786113149,306,25,48,379
11936,dark,main,20220126,1,0.9909163312167341,286,11,45,342
11936,dark,main,20220126,2,0.9949933884735548,313,12,62,387
11936,dark,main,20220126,3,0.990172713528712,286,16,48,350
11936,dark,main,20220126,4,0.9929155471471605,297,18,50,365
11936,dark,main,20220126,5,0.9900030829530617,319,9,35,363
11936,dark,main,20220126,6,0.9877479285769454,308,11,50,369
11936,dark,main,20220126,7,0.9934617154898348,272,16,52,340
11936,dark,main,20220126,8,0.9920412146563502,307,14,48,369
11936,dark,main,20220126,9,0.9941150488457674,315,13,55,383
8322,dark,main,20220126,0,0.991401907877762,273,15,90,378
8322,dark,main,20220126,1,0.9904895418663332,246,20,87,353
8322,dark,main,20220126,2,0.9888897315518994,255,19,92,366
8322,dark,main,20220126,3,0.9914166083284185,228,18,89,335
8322,dark,main,20220126,4,0.9855171981636798,244,19,72,335
8322,dark,main,20220126,5,0.9917210070768468,246,18,102,366
8322,dark,main,20220126,6,0.9945014094777245,249,18,102,369
8322,dark,main,20220126,7,0.9902555990135194,230,19,81,330
8322,dark,main,20220126,8,0.988133397180439,259,17,90,366
8322,dark,main,20220126,9,0.9964772165944442,277,17,88,382
1267,dark,main,20220126,0,0.9927540050481213,329,13,56,398
1267,dark,main,20220126,1,0.9869265412056084,291,18,38,347
1267,dark,main,20220126,2,0.9941402883079423,312,12,74,398
1267,dark,main,20220126,3,0.9959201381959893,298,16,52,366
1267,dark,main,20220126,4,0.9917558102745877,243,17,93,353
1267,dark,main,20220126,5,0.9961000962966214,279,19,75,373
1267,dark,main,20220126,6,0.9979693921846446,287,13,89,389
1267,dark,main,20220126,7,0.9918216708391593,242,12,70,324
1267,dark,main,20220126,8,0.9849512048746029,266,17,88,371
1267,dark,main,20220126,9,0.985338398308237,284,17,82,383
2386,dark,main,20220126,0,0.9800701564564162,301,18,53,372
2386,dark,main,20220126,1,0.9964036885420362,290,13,41,344
2386,dark,main,20220126,2,0.9949280639018923,307,18,43,368
2386,dark,main,20220126,3,0.99465329800446,274,28,51,353
2386,dark,main,20220126,4,0.9879556501781946,265,32,41,338
2386,dark,main,20220126,5,0.9938805189617862,313,15,33,361
2386,dark,main,20220126,6,0.9891820573064022,280,27,55,362
2386,dark,main,20220126,7,0.9865746353069541,250,13,58,321
2386,dark,main,20220126,8,0.9904574084956608,291,16,45,352
2386,dark,main,20220126,9,0.9949902829592638,310,15,42,367
11938,dark,main,20220126,0,0.991035815076218,320,15,41,376
11938,dark,main,20220126,1,0.9931968605908328,299,13,38,350
11938,dark,main,20220126,2,0.988512755544495,321,12,36,369
11938,dark,main,20220126,3,0.9897686113443056,288,17,53,358
11938,dark,main,20220126,4,0.9883686607241393,270,14,58,342
11938,dark,main,20220126,5,0.9919025947729532,281,12,67,360
11938,dark,main,20220126,6,0.9952431808436593,289,12,81,382
11938,dark,main,20220126,7,0.9900372898771834,273,11,40,324
11938,dark,main,20220126,8,0.9948484862732241,298,16,43,357
11938,dark,main,20220126,9,0.9866332335529264,322,12,41,375
4093,dark,main,20220126,0,0.9943152035579007,302,13,65,380
4093,dark,main,20220126,1,0.9926260335584473,283,18,39,340
4093,dark,main,20220126,2,0.9913592539352385,286,16,60,362
4093,dark,main,20220126,3,0.9768761503409298,264,19,48,331
4093,dark,main,20220126,4,0.9916154673944773,288,14,41,343
4093,dark,main,20220126,5,0.9847102248791099,310,13,36,359
4093,dark,main,20220126,6,0.9956801333248965,325,17,37,379
4093,dark,main,20220126,7,0.9943265586889346,267,17,49,333
4093,dark,main,20220126,8,0.9934320822145504,297,16,58,371
4093,dark,main,20220126,9,0.9935035336663748,329,16,40,385
7719,dark,main,20220126,0,0.9867885778994647,317,14,67,398
7719,dark,main,20220126,1,0.9886166221025576,258,14,75,347
7719,dark,main,20220126,2,0.987885220805903,325,16,53,394
7719,dark,main,20220126,3,0.9929369507072618,296,13,51,360
7719,dark,main,20220126,4,0.9938487268618104,271,14,73,358
7719,dark,main,20220126,5,0.987772098403943,275,16,85,376
7719,dark,main,20220126,6,0.9880922929860988,268,19,94,381
7719,dark,main,20220126,7,0.9834809464882733,242,17,69,328
7719,dark,main,20220126,8,0.9922744847532919,271,18,87,376
7719,dark,main,20220126,9,0.9960156215431759,286,17,85,388
25273,bright,main,20220126,0,0.9910183157728776,236,191,5,432
25273,bright,main,20220126,1,0.9936960519635827,227,163,0,390
25273,bright,main,20220126,2,0.9944578249612258,272,149,1,422
25273,bright,main,20220126,3,0.9939377874224221,280,113,1,394
25273,bright,main,20220126,4,0.9933238915686713,313,69,7,389
25273,bright,main,20220126,5,0.989561551718395,313,92,3,408
25273,bright,main,20220126,6,0.9953203287829627,280,137,7,424
25273,bright,main,20220126,7,0.9920330433711059,268,99,3,370
25273,bright,main,20220126,8,0.9932406692151793,280,129,9,418
25273,bright,main,20220126,9,0.996997805391229,262,165,6,433
10232,dark,main,20220126,0,0.9885651820600754,313,19,40,372
10232,dark,main,20220126,1,0.9936970872446875,275,21,45,341
10232,dark,main,20220126,2,0.9895920964170382,290,20,52,362
10232,dark,main,20220126,3,0.9889153684003612,288,26,36,350
10232,dark,main,20220126,4,0.9935802606617194,272,23,31,326
10232,dark,main,20220126,5,0.9888886552338585,301,15,44,360
10232,dark,main,20220126,6,0.9902774000544549,305,24,36,365
10232,dark,main,20220126,7,0.9864753905999711,257,19,36,312
10232,dark,main,20220126,8,0.9928179490368038,293,16,45,354
10232,dark,main,20220126,9,0.993378675111391,300,17,45,362
8704,dark,main,20220126,0,0.9939622109177455,325,9,71,405
8704,dark,main,20220126,1,0.9913751821017619,274,11,81,366
8704,dark,main,20220126,2,0.9957143992201439,310,14,74,398
8704,dark,main,20220126,3,0.9931592187262634,277,14,61,352
8704,dark,main,20220126,4,0.9866907098705663,266,11,93,370
8704,dark,main,20220126,5,0.9934172237655058,277,14,91,382
8704,dark,main,20220126,6,0.992900925580068,295,12,77,384
8704,dark,main,20220126,7,0.9930265304906719,246,15,84,345
8704,dark,main,20220126,8,0.9946645945826269,305,18,61,384
8704,dark,main,20220126,9,0.9944308781657922,319,13,62,394
7079,dark,main,20220126,0,0.9911332814922846,296,32,55,383
7079,dark,main,20220126,1,0.9895030215503792,251,19,68,338
7079,dark,main,20220126,2,0.9901407519812935,300,18,58,376
7079,dark,main,20220126,3,0.9849938510264067,289,15,59,363
7079,dark,main,20220126,4,0.994931871485758,279,17,48,344
7079,dark,main,20220126,5,0.993003014120617,300,12,37,349
7079,dark,main,20220126,6,0.9903562946370668,300,14,52,366
7079,dark,main,20220126,7,0.9935468191297716,250,20,51,321
7079,dark,main,20220126,8,0.9942004880704264,274,17,69,360
7079,dark,main,20220126,9,0.9910585842877221,276,31,67,374
2562,dark,main,20220126,0,0.9904775803227271,320,14,41,375
2562,dark,main,20220126,1,0.9947862564284172,277,16,55,348
2562,dark,main,20220126,2,0.9928165517244637,290,15,79,384
2562,dark,main,20220126,3,0.9887151451985818,243,14,104,361
2562,dark,main,20220126,4,0.9951223080123093,260,18,91,369
2562,dark,main,20220126,5,0.9951307025601621,281,12,83,376
2562,dark,main,20220126,6,0.9913752781300748,253,14,104,371
2562,dark,main,20220126,7,0.991322114665785,239,15,67,321
2562,dark,main,20220126,8,0.9939703995721175,294,14,54,362
2562,dark,main,20220126,9,0.9894299251735588,320,13,39,372
42867,backup,main,20220126,0,0.9905997382953216,31,392,0,423
42867,backup,main,20220126,1,0.9840377311545404,26,339,0,365
42867,backup,main,20220126,2,0.9915182913868554,28,375,3,406
42867,backup,main,20220126,3,0.9915445082920107,27,322,1,350
42867,backup,main,20220126,4,0.9902197553335996,12,352,1,365
42867,backup,main,20220126,5,0.9868871843354506,27,356,0,383
42867,backup,main,20220126,6,0.9968398340473145,21,377,1,399
42867,backup,main,20220126,7,0.9908158197535131,18,334,0,352
42867,backup,main,20220126,8,0.9872773134091425,31,363,2,396
42867,backup,main,20220126,9,0.9941877466776774,35,351,1,387
5611,dark,main,20220126,0,0.9943774906339019,339,13,49,401
5611,dark,main,20220126,1,0.9808826727633441,315,15,41,371
5611,dark,main,20220126,2,0.9942883157154772,317,23,57,397
5611,dark,main,20220126,3,0.9901885075100901,308,14,47,369
5611,dark,main,20220126,4,0.9960709946264007,300,15,46,361
5611,dark,main,20220126,5,0.9896812321969857,305,11,50,366
5611,dark,main,20220126,6,0.9950639533632426,331,11,40,382
5611,dark,main,20220126,7,0.9909604512206109,271,16,28,315
5611,dark,main,20220126,8,0.9892427242876397,328,14,32,374
5611,dark,main,20220126,9,0.9953420378019793,346,12,40,398
10340,dark,main,20220126,0,0.9913180840932427,321,15,48,384
10340,dark,main,20220126,1,0.9944153880389981,282,12,43,337
10340,dark,main,20220126,2,0.9907039981047576,323,9,57,389
10340,dark,main,20220126,3,0.9923907825263352,283,14,47,344
10340,dark,main,20220126,4,0.9958604167212068,280,13,42,335
10340,dark,main,20220126,5,0.9947191257565159,324,13,47,384
10340,dark,main,20220126,6,0.9849211927713651,287,14,60,361
10340,dark,main,20220126,7,0.9936547688997022,283,14,28,325
10340,dark,main,20220126,8,0.9962442928780998,287,14,51,352
10340,dark,main,20220126,9,0.9923732325212845,316,14,48,378
10360,dark,main,20220126,0,0.9901333675827882,309,20,52,381
10360,dark,main,20220126,1,0.9914093737323998,282,20,42,344
10360,dark,main,20220126,2,0.9927278514668277,294,19,71,384
10360,dark,main,20220126,3,0.9919340344472836,287,21,39,347
10360,dark,main,20220126,4,0.9909150548163298,283,21,34,338
10360,dark,main,20220126,5,0.9895681249168953,301,21,48,370
10360,dark,main,20220126,6,0.99072174743135,309,22,50,381
10360,dark,main,20220126,7,0.9945028489565033,264,17,49,330
10360,dark,main,20220126,8,0.9846173461431318,291,23,52,366
10360,dark,main,20220126,9,0.9925972169164193,315,16,43,374
11937,dark,main,20220126,0,0.996505267062982,308,14,56,378
11937,dark,main,20220126,1,0.9897083871712843,286,16,45,347
11937,dark,main,20220126,2,0.9951609653130822,307,20,48,375
11937,dark,main,20220126,3,0.981969114722488,295,20,46,361
11937,dark,main,20220126,4,0.9890462044605233,289,13,49,351
11937,dark,main,20220126,5,0.9947992847703179,306,19,46,371
11937,dark,main,20220126,6,0.9918654899843653,317,14,54,385
11937,dark,main,20220126,7,0.9947053370973852,279,15,32,326
11937,dark,main,20220126,8,0.991226174893103,323,16,33,372
11937,dark,main,20220126,9,0.9936929247520565,304,15,51,370
21125,bright,main,20220126,0,0.9952265706390747,342,78,9,429
21125,bright,main,20220126,1,0.9856645170047954,318,63,6,387
21125,bright,main,20220126,2,0.9946702909353694,339,83,3,425
21125,bright,main,20220126,3,0.9897371418772047,320,71,4,395
21125,bright,main,20220126,4,0.9916175752690346,328,51,7,386
21125,bright,main,20220126,5,0.989394796209716,329,77,3,409
21125,bright,main,20220126,6,0.995759551374465,330,90,3,423
21125,bright,main,20220126,7,0.9926744907353979,285,66,6,357
21125,bright,main,20220126,8,0.9958745383476204,301,97,5,403
21125,bright,main,20220126,9,0.9929131503730987,294,113,5,412
25899,bright,main,20220126,0,0.9914021597097772,277,131,4,412
25899,bright,main,20220126,1,0.9953536781850226,238,131,4,373
25899,bright,main,20220126,2,0.9941092615242033,274,121,8,403
25899,bright,main,20220126,3,0.9904134664990566,236,127,7,370
25899,bright,main,20220126,4,0.9889680999487886,221,143,4,368
25899,bright,main,20220126,5,0.9956023629441972,258,125,5,388
25899,bright,main,20220126,6,0.9789026885242266,306,94,3,403
25899,bright,main,20220126,7,0.9947551559994338,259,79,6,344
25899,bright,main,20220126,8,0.989058109315908,270,120,8,398
25899,bright,main,20220126,9,0.9938960965106602,273,118,4,395
11479,dark,main,20220126,0,0.9946625426150485,301,14,76,391
11479,dark,main,20220126,1,0.9880313276150344,248,19,83,350
11479,dark,main,20220126,2,0.9937318415236194,268,18,92,378
11479,dark,main,20220126,3,0.9903284435439582,253,23,72,348
11479,dark,main,20220126,4,0.9835393183335222,266,13,76,355
11479,dark,main,20220126,5,0.9946814336071612,266,18,92,376
11479,dark,main,20220126,6,0.9903864278618639,260,27,81,368
11479,dark,main,20220126,7,0.9884649886017817,226,12,94,332
11479,dark,main,20220126,8,0.9914390055203441,269,20,91,380
11479,dark,main,20220126,9,0.9881803369319377,278,16,80,374
6261,dark,main,20220126,0,0.9924731252014337,326,14,46,386
6261,dark,main,20220126,1,0.9918894874681261,287,24,51,362
6261,dark,main,20220126,2,0.991829571276609,276,21,85,382
6261,dark,main,20220126,3,0.9904094386303148,275,26,63,364
6261,dark,main,20220126,4,0.9857003670323969,278,16,57,351
6261,dark,main,20220126,5,0.9815055132626507,310,15,46,371
6261,dark,main,20220126,6,0.9895383317412764,303,14,51,368
6261,dark,main,20220126,7,0.986387896101683,283,16,36,335
6261,dark,main,20220126,8,0.9939733316458512,308,12,41,361
6261,dark,main,20220126,9,0.9914641187213559,320,13,39,372
11944,dark,main,20220126,0,0.9904774508712011,304,25,70,399
11944,dark,main,20220126,1,0.993182922154783,288,13,48,349
11944,dark,main,20220126,2,0.9847064006494541,297,15,58,370
11944,dark,main,20220126,3,0.9933111356171059,269,12,83,364
11944,dark,main,20220126,4,0.9941209388358536,256,15,75,346
11944,dark,main,20220126,5,0.9850862716507122,268,16,93,377
11944,dark,main,20220126,6,0.9877564502347169,304,15,66,385
11944,dark,main,20220126,7,0.9904204912990564,251,14,61,326
11944,dark,main,20220126,8,0.995457187924527,301,16,54,371
11944,dark,main,20220126,9,0.9887903818823573,291,16,94,401
5613,dark,main,20220126,0,0.9939160405091011,327,12,48,387
5613,dark,main,20220126,1,0.990444664881495,308,11,32,351
5613,dark,main,20220126,2,0.9905297623476979,330,13,41,384
5613,dark,main,20220126,3,0.992702062962691,290,13,43,346
5613,dark,main,20220126,4,0.9885325826017042,294,13,42,349
5613,dark,main,20220126,5,0.9903873134901191,306,16,45,367
5613,dark,main,20220126,6,0.9937738456313023,321,11,33,365
5613,dark,main,20220126,7,0.993114911141998,291,15,27,333
5613,dark,main,20220126,8,0.9895578974255184,327,11,38,376
5613,dark,main,20220126,9,0.9936394814783893,349,11,36,396
25275,bright,main,20220126,0,0.9868198716319456,339,86,5,430
25275,bright,main,20220126,1,0.993484169712517,335,52,2,389
25275,bright,main,20220126,2,0.9918435557509725,331,88,5,424
25275,bright,main,20220126,3,0.9948203285068791,325,62,0,387
25275,bright,main,20220126,4,0.9872989413098341,290,80,4,374
25275,bright,main,20220126,5,0.986384869014819,305,88,5,398
25275,bright,main,20220126,6,0.9935969176435355,313,104,5,422
25275,bright,main,20220126,7,0.990119916625129,271,78,3,352
25275,bright,main,20220126,8,0.9834319321690433,176,34,1,211
25275,bright,main,20220126,9,0.9890083111754373,336,89,4,429
8413,dark,main,20220126,0,0.9913693866554415,306,12,85,403
8413,dark,main,20220126,1,0.9968841540472593,258,16,83,357
8413,dark,main,20220126,2,0.990293428929875,277,14,103,394
8413,dark,main,20220126,3,0.9856716073707228,268,11,81,360
8413,dark,main,20220126,4,0.9931158309149047,247,13,86,346
8413,dark,main,20220126,5,0.990913285056321,273,15,84,372
8413,dark,main,20220126,6,0.9875684854428933,295,15,72,382
8413,dark,main,20220126,7,0.9898228238754317,216,8,43,267
8413,dark,main,20220126,8,0.9919265092903436,288,11,67,366
8413,dark,main,20220126,9,0.9917160687245076,302,12,63,377
24346,bright,main,20220126,0,0.9948501029531395,391,43,5,439
24346,bright,main,20220126,1,0.9924481115608292,351,38,7,396
24346,bright,main,20220126,2,0.9924443309124751,385,44,1,430
24346,bright,main,20220126,3,0.9959124805029906,340,50,2,392
24346,bright,main,20220126,4,0.9911009515384079,336,42,7,385
24346,bright,main,20220126,5,0.9870013523312975,352,42,1,395
24346,bright,main,20220126,6,0.9930952989660446,345,66,5,416
24346,bright,main,20220126,7,0.9927506628167739,280,73,2,355
24346,bright,main,20220126,8,0.996147358101897,336,66,5,407
24346,bright,main,20220126,9,0.9923502656996653,339,74,4,417
22246,bright,main,20220126,0,0.9923961262732929,275,149,6,430
22246,bright,main,20220126,1,0.9941150372952444,295,93,7,395
22246,bright,main,20220126,2,0.9950451848798261,298,114,6,418
22246,bright,main,20220126,3,0.9947121962965753,216,151,0,367
22246,bright,main,20220126,4,0.9872904896790142,208,169,3,380
22246,bright,main,20220126,5,0.9914854449127172,219,163,4,386
22246,bright,main,20220126,6,0.9869935131625998,321,89,3,413
22246,bright,main,20220126,7,0.9915090341899715,259,80,7,346
22246,bright,main,20220126,8,0.9939344509485948,291,103,7,401
22246,bright,main,20220126,9,0.9938859140474763,260,134,5,399
22643,bright,main,20220126,0,0.9926763820238763,384,49,3,436
22643,bright,main,20220126,1,0.9922787442267151,336,46,6,388
22643,bright,main,20220126,2,0.9940893978250382,347,76,3,426
22643,bright,main,20220126,3,0.9904913033864886,305,68,8,381
22643,bright,main,20220126,4,0.9914211956824255,304,84,3,391
22643,bright,main,20220126,5,0.9933178222016753,303,102,2,407
22643,bright,main,20220126,6,0.9900716293785712,345,63,8,416
22643,bright,main,20220126,7,0.988975189879494,293,70,3,366
22643,bright,main,20220126,8,0.9936999569414328,334,65,8,407
22643,bright,main,20220126,9,0.9916609748027141,336,84,5,425
5980,dark,main,20220126,0,0.9929038398983436,319,16,59,394
5980,dark,main,20220126,1,0.9913765334878033,279,15,68,362
5980,dark,main,20220126,2,0.9905765990787311,293,20,75,388
5980,dark,main,20220126,3,0.9932001902548712,263,17,59,339
5980,dark,main,20220126,4,0.991866054421251,252,15,81,348
5980,dark,main,20220126,5,0.991068964272217,292,11,71,374
5980,dark,main,20220126,6,0.9957757073825073,294,16,66,376
5980,dark,main,20220126,7,0.9912542752791216,274,13,49,336
5980,dark,main,20220126,8,0.9946498695598766,313,12,57,382
5980,dark,main,20220126,9,0.9893645404524488,318,18,54,390
42844,backup,main,20220126,0,0.9914363422602825,5,410,0,415
42844,backup,main,20220126,1,0.9839181800991945,4,364,0,368
42844,backup,main,20220126,2,0.9903990811045545,7,408,1,416
42844,backup,main,20220126,3,0.9847760914694298,2,372,0,374
42844,backup,main,20220126,4,0.995006721919205,7,364,0,371
42844,backup,main,20220126,5,0.9956613795381005,4,393,0,397
42844,backup,main,20220126,6,0.9954821406751326,0,416,2,418
42844,backup,main,20220126,7,0.9936435545209185,2,355,0,357
42844,backup,main,20220126,8,0.9890221619032953,0,405,0,405
42844,backup,main,20220126,9,0.9894328966325223,12,382,0,394
41774,backup,main,20220127,0,0.9922229055699785,2,445,0,447
41774,backup,main,20220127,1,0.9912019994527609,0,408,0,408
41774,backup,main,20220127,2,0.9944631823624138,7,437,0,444
41774,backup,main,20220127,3,0.9944551421584498,6,399,0,405
41774,backup,main,20220127,4,0.9870997430080457,5,415,0,420
41774,backup,main,20220127,5,0.9829619620906472,0,434,0,434
41774,backup,main,20220127,6,0.9927360825175284,2,433,0,435
41774,backup,main,20220127,7,0.9914277154827916,5,379,0,384
41774,backup,main,20220127,8,0.9969398154026948,3,425,0,428
41774,backup,main,20220127,9,0.9923631165893411,3,435,2,440
21686,bright,main,20220127,0,0.9953964513432512,347,85,5,437
21686,bright,main,20220127,1,0.9940702415450479,326,72,2,400
21686,bright,main,20220127,2,0.9959124095611209,319,110,7,436
21686,bright,main,20220127,3,0.9959369669386196,330,64,6,400
21686,bright,main,20220127,4,0.9894482625146873,239,145,6,390
21686,bright,main,20220127,5,0.9926933641367746,261,142,1,404
21686,bright,main,20220127,6,0.994315345207879,294,127,3,424
21686,bright,main,20220127,7,0.9875143574792359,235,133,2,370
21686,bright,main,20220127,8,0.991093177721887,279,128,5,412
21686,bright,main,20220127,9,0.9899982475730332,371,58,3,432
23114,bright,main,20220127,0,0.9933965853163951,280,152,5,437
23114,bright,main,20220127,1,0.99288276103875,259,127,5,391
23114,bright,main,20220127,2,0.9893819826443977,309,115,7,431
23114,bright,main,20220127,3,0.9893056196566337,279,113,8,400
23114,bright,main,20220127,4,0.9944515991969972,263,117,2,382
23114,bright,main,20220127,5,0.994957251585392,253,147,3,403
23114,bright,main,20220127,6,0.991635595388854,248,171,5,424
23114,bright,main,20220127,7,0.9887965345274489,258,113,4,375
23114,bright,main,20220127,8,0.996078897192524,250,149,4,403
23114,bright,main,20220127,9,0.9917837764675086,260,156,4,420
82635,m31,special,20220127,0,0.9967252922215428,43,396,0,439
82635,m31,special,20220127,1,0.9948625121466468,176,216,1,393
82635,m31,special,20220127,2,0.9951902872131188,79,346,4,429
82635,m31,special,20220127,3,0.9902167923189543,29,373,1,403
82635,m31,special,20220127,4,0.9973936523196915,20,372,6,398
82635,m31,special,20220127,5,0.9901186121534226,36,378,5,419
82635,m31,special,20220127,6,0.9961772899438069,43,380,11,434
82635,m31,special,20220127,7,0.9862523197434092,28,344,3,375
82635,m31,special,20220127,8,0.9936201628333161,33,386,8,427
82635,m31,special,20220127,9,0.9979429517084561,29,389,11,429
41759,backup,main,20220127,0,0.9921011815164327,2,446,0,448
41759,backup,main,20220127,1,0.9928973213438097,0,407,0,407
41759,backup,main,20220127,2,0.995017979507145,3,440,0,443
41759,backup,main,20220127,3,0.9881492108291509,0,407,0,407
41759,backup,main,20220127,4,0.9901355444998736,2,400,0,402
41759,backup,main,20220127,5,0.9945895385224353,1,422,0,423
41759,backup,main,20220127,6,0.9894134633870137,3,434,0,437
41759,backup,main,20220127,7,0.9951979766772278,6,372,0,378
41759,backup,main,20220127,8,0.9837551999835208,3,425,0,428
41759,backup,main,20220127,9,0.9951864877173855,2,433,0,435
25289,bright,main,20220127,0,0.993646740366396,321,114,3,438
25289,bright,main,20220127,1,0.993811473704418,283,104,6,393
25289,bright,main,20220127,2,0.9909294533573227,354,82,1,437
25289,bright,main,20220127,3,0.9928114018746502,303,91,6,400
25289,bright,main,20220127,4,0.9953991990734959,260,122,1,383
25289,bright,main,20220127,5,0.993203388651014,256,149,1,406
25289,bright,main,20220127,6,0.9918299237252354,291,130,1,422
25289,bright,main,20220127,7,0.9947303321664102,288,84,1,373
25289,bright,main,20220127,8,0.9915289327353014,366,53,2,421
25289,bright,main,20220127,9,0.9931020595934473,329,97,1,427
23137,bright,main,20220127,0,0.9909769080280667,291,131,6,428
23137,bright,main,20220127,1,0.9913520456980313,265,118,6,389
23137,bright,main,20220127,2,0.9924822079356234,276,141,5,422
23137,bright,main,20220127,3,0.9895808062980681,272,110,3,385
23137,bright,main,20220127,4,0.9848196500483972,246,121,4,371
23137,bright,main,20220127,5,0.9867797417372324,286,108,2,396
23137,bright,main,20220127,6,0.9877097265712821,275,124,4,403
23137,bright,main,20220127,7,0.9929805039428842,264,97,3,364
23137,bright,main,20220127,8,0.990498796293315,313,95,2,410
23137,bright,main,20220127,9,0.9882983635710699,275,137,8,420
40067,backup,main,20220127,0,0.9958968226000297,3,443,0,446
40067,backup,main,20220127,1,0.9929821368378795,0,407,0,407
40067,backup,main,20220127,2,0.9950121091376051,3,438,0,441
40067,backup,main,20220127,3,0.9917884931404631,4,400,0,404
40067,backup,main,20220127,4,0.9881403521730169,3,399,0,402
40067,backup,main,20220127,5,0.9954956182715141,1,422,0,423
40067,backup,main,20220127,6,0.9879302692255918,1,435,0,436
40067,backup,main,20220127,7,0.9927980463274397,0,377,0,377
40067,backup,main,20220127,8,0.9916542663888123,2,425,0,427
40067,backup,main,20220127,9,0.9922872365879055,3,437,0,440
25744,bright,main,20220127,0,0.9959177561564544,154,117,6,277
25744,bright,main,20220127,1,0.9802535833829672,149,74,2,225
25744,bright,main,20220127,2,0.9847263881707654,178,77,3,258
25744,bright,main,20220127,3,0.9900822027694766,164,72,5,241
25744,bright,main,20220127,4,0.9861979821050236,126,100,3,229
25744,bright,main,20220127,5,0.9817862115668986,143,109,0,252
25744,bright,main,20220127,6,0.9893559143133627,156,110,5,271
25744,bright,main,20220127,7,0.9826956162521799,87,159,4,250
25744,bright,main,20220127,8,0.9857851371511157,100,174,8,282
25744,bright,main,20220127,9,0.9915446769022555,121,164,4,289
23118,bright,main,20220127,0,0.9894899960851136,318,111,6,435
23118,bright,main,20220127,1,0.9853789540954311,275,117,4,396
23118,bright,main,20220127,2,0.9971679437046393,322,110,2,434
23118,bright,main,20220127,3,0.9917207191826221,321,73,4,398
23118,bright,main,20220127,4,0.9946416274787738,304,77,6,387
23118,bright,main,20220127,5,0.9904770586029105,314,97,2,413
23118,bright,main,20220127,6,0.9877878932885109,354,69,2,425
23118,bright,main,20220127,7,0.9915996057152925,300,57,2,359
23118,bright,main,20220127,8,0.9948355371488706,315,95,2,412
23118,bright,main,20220127,9,0.9901465588294548,318,101,5,424
41562,backup,main,20220127,0,0.9941175411788706,4,380,3,387
41562,backup,main,20220127,1,0.9898162791229508,3,340,3,346
41562,backup,main,20220127,2,0.9909223050790481,4,369,0,373
41562,backup,main,20220127,3,0.9936830722970017,7,336,2,345
41562,backup,main,20220127,4,0.9857031181405891,3,328,1,332
41562,backup,main,20220127,5,0.9922603813746821,1,334,1,336
41562,backup,main,20220127,6,0.9887656144270496,5,344,1,350
41562,backup,main,20220127,7,0.9856480243077496,2,314,2,318
41562,backup,main,20220127,8,0.9923808054902847,4,358,0,362
41562,backup,main,20220127,9,0.9945198717741959,2,369,1,372
23115,bright,main,20220127,0,0.9939376793196874,342,93,2,437
23115,bright,main,20220127,1,0.9919644002294816,297,94,5,396
23115,bright,main,20220127,2,0.9900320184308371,333,96,5,434
23115,bright,main,20220127,3,0.9886442442052269,227,165,6,398
23115,bright,main,20220127,4,0.9867747192603811,210,175,5,390
23115,bright,main,20220127,5,0.9940977306507225,225,177,4,406
23115,bright,main,20220127,6,0.9922946418813555,229,183,5,417
23115,bright,main,20220127,7,0.9854948947178216,246,122,1,369
23115,bright,main,20220127,8,0.9970527140473433,285,121,3,409
23115,bright,main,20220127,9,0.9926854032147102,254,166,3,423
21681,bright,main,20220127,0,0.9928095800757368,313,119,3,435
21681,bright,main,20220127,1,0.9947744423642784,236,160,4,400
21681,bright,main,20220127,2,0.992357691920421,299,133,4,436
21681,bright,main,20220127,3,0.9835692333438046,273,114,3,390
21681,bright,main,20220127,4,0.9875525563139623,283,106,3,392
21681,bright,main,20220127,5,0.996094301674997,258,153,6,417
21681,bright,main,20220127,6,0.9902580406977272,322,97,5,424
21681,bright,main,20220127,7,0.987466783530104,262,102,3,367
21681,bright,main,20220127,8,0.9895272725487451,324,93,3,420
21681,bright,main,20220127,9,0.9873191533817763,336,95,3,434
21687,bright,main,20220127,0,0.9975702804466182,283,153,0,436
21687,bright,main,20220127,1,0.9828769617046701,228,158,9,395
21687,bright,main,20220127,2,0.9912756154177508,272,164,1,437
21687,bright,main,20220127,3,0.9868333408252505,310,79,3,392
21687,bright,main,20220127,4,0.9960302517150753,287,101,1,389
21687,bright,main,20220127,5,0.9936006055920413,271,132,5,408
21687,bright,main,20220127,6,0.9912619273797472,272,142,7,421
21687,bright,main,20220127,7,0.9908902530699494,206,163,3,372
21687,bright,main,20220127,8,0.9891911767314512,247,155,8,410
21687,bright,main,20220127,9,0.9889197167268712,278,145,2,425
22152,bright,main,20220127,0,0.9898254276946107,268,164,4,436
22152,bright,main,20220127,1,0.9917695772001676,233,158,3,394
22152,bright,main,20220127,2,0.9902547628491678,288,141,3,432
22152,bright,main,20220127,3,0.9953263475928624,277,116,6,399
22152,bright,main,20220127,4,0.9910012568882584,226,166,3,395
22152,bright,main,20220127,5,0.9882201560292105,217,192,3,412
22152,bright,main,20220127,6,0.9964156265761905,330,98,3,431
22152,bright,main,20220127,7,0.9903157134520266,266,105,3,374
22152,bright,main,20220127,8,0.9972469791938819,253,158,3,414
22152,bright,main,20220127,9,0.9949666977918934,301,132,1,434
24695,bright,main,20220127,0,0.9940171680132994,311,119,8,438
24695,bright,main,20220127,1,0.9931909231794007,256,137,2,395
24695,bright,main,20220127,2,0.9943502468923013,340,92,2,434
24695,bright,main,20220127,3,0.9880320634428637,294,102,4,400
24695,bright,main,20220127,4,0.9884726048974511,263,130,3,396
24695,bright,main,20220127,5,0.9928673748358569,256,145,5,406
24695,bright,main,20220127,6,0.9925498450408553,258,161,5,424
24695,bright,main,20220127,7,0.9899345844732701,214,154,4,372
24695,bright,main,20220127,8,0.994043114653259,216,187,4,407
24695,bright,main,20220127,9,0.9931798864043785,239,186,4,429
25283,bright,main,20220127,0,0.9957508697882902,321,116,4,441
25283,bright,main,20220127,1,0.9951050692958605,275,114,5,394
25283,bright,main,20220127,2,0.99295144262372,276,151,3,430
25283,bright,main,20220127,3,0.9859441694539919,270,112,3,385
25283,bright,main,20220127,4,0.9936195590688548,246,117,6,369
25283,bright,main,20220127,5,0.9919369199817251,304,99,2,405
25283,bright,main,20220127,6,0.9930712025218141,327,82,4,413
25283,bright,main,20220127,7,0.9922496733404779,286,78,3,367
25283,bright,main,20220127,8,0.995726014656045,311,90,5,406
25283,bright,main,20220127,9,0.9933475920912329,255,159,9,423
40580,backup,main,20220127,0,0.9923092854926098,1,416,1,418
40580,backup,main,20220127,1,0.9897442453500375,1,374,1,376
40580,backup,main,20220127,2,0.9884257548102696,6,402,1,409
40580,backup,main,20220127,3,0.9917772142008593,4,365,0,369
40580,backup,main,20220127,4,0.9894963514294776,3,352,2,357
40580,backup,main,20220127,5,0.9873371295126064,8,380,0,388
40580,backup,main,20220127,6,0.9882452203042085,3,394,0,397
40580,backup,main,20220127,7,0.9961846508668267,4,346,1,351
40580,backup,main,20220127,8,0.9952988363501843,3,394,0,397
40580,backup,main,20220127,9,0.9942692832119593,6,399,0,405
22232,bright,main,20220127,0,0.9946202649904018,350,64,4,418
22232,bright,main,20220127,1,0.9884685721468423,304,73,3,380
22232,bright,main,20220127,2,0.9937783200209482,266,145,4,415
22232,bright,main,20220127,3,0.9909019571764693,275,107,8,390
22232,bright,main,20220127,4,0.9898351971759666,235,142,8,385
22232,bright,main,20220127,5,0.9941343435160219,259,135,6,400
22232,bright,main,20220127,6,0.9941603130930773,314,93,3,410
22232,bright,main,20220127,7,0.9962749113601461,246,98,6,350
22232,bright,main,20220127,8,0.9911888716499702,282,112,4,398
22232,bright,main,20220127,9,0.9907059547297599,348,60,10,418
22938,bright,main,20220127,0,0.9944104789327189,331,108,1,440
22938,bright,main,20220127,1,0.9909689262781698,241,167,0,408
22938,bright,main,20220127,2,0.9908207158555201,333,102,4,439
22938,bright,main,20220127,3,0.9969500298730968,343,59,2,404
22938,bright,main,20220127,4,0.9947681787308125,323,71,5,399
22938,bright,main,20220127,5,0.9941150126857848,325,91,2,418
22938,bright,main,20220127,6,0.9927112843157004,347,79,5,431
22938,bright,main,20220127,7,0.9935301774159414,292,84,2,378
22938,bright,main,20220127,8,0.9963480640442288,325,96,1,422
22938,bright,main,20220127,9,0.9949642775655796,300,135,2,437
43068,backup,main,20220128,0,0.9900083406854491,0,400,1,401
43068,backup,main,20220128,1,0.9965631983035874,2,358,2,362
43068,backup,main,20220128,2,0.9929220756133051,6,391,0,397
43068,backup,main,20220128,3,0.9875049565957319,3,349,0,352
43068,backup,main,20220128,4,0.9895495896248055,0,349,0,349
43068,backup,main,20220128,5,0.9933792563908234,1,362,1,364
43068,backup,main,20220128,6,0.992365907368372,5,371,0,376
43068,backup,main,20220128,7,0.993323163628073,0,331,0,331
43068,backup,main,20220128,8,0.9935309328377931,2,376,1,379
43068,backup,main,20220128,9,0.9941547104699324,3,370,1,374
41571,backup,main,20220129,0,0.9969976231055905,2,408,2,412
41571,backup,main,20220129,1,0.996701780023142,2,374,2,378
41571,backup,main,20220129,2,0.994577913651671,1,408,0,409
41571,backup,main,20220129,3,0.9916371991487012,9,360,0,369
41571,backup,main,20220129,4,0.9904843240900522,4,357,1,362
41571,backup,main,20220129,5,0.9845554143257147,3,382,2,387
41571,backup,main,20220129,6,0.9922168087925749,4,399,1,404
41571,backup,main,20220129,7,0.9953505348610183,1,354,0,355
41571,backup,main,20220129,8,0.9925525292622226,4,391,1,396
41571,backup,main,20220129,9,0.9932731603282614,2,386,1,389
23811,bright,main,20220129,0,0.9939019318884724,324,95,9,428
23811,bright,main,20220129,1,0.9920051579634238,287,87,4,378
23811,bright,main,20220129,2,0.9895510511513698,318,86,3,407
23811,bright,main,20220129,3,0.9877759400562569,283,90,4,377
23811,bright,main,20220129,4,0.9864356457893678,279,96,4,379
23811,bright,main,20220129,5,0.9939688601497104,258,130,7,395
23811,bright,main,20220129,6,0.9935502834495943,304,103,4,411
23811,bright,main,20220129,7,0.9885106900898758,252,93,3,348
23811,bright,main,20220129,8,0.9921944896455451,262,127,6,395
23811,bright,main,20220129,9,0.9914436640659244,327,87,6,420
25406,bright,main,20220129,0,0.988686725063264,278,130,4,412
25406,bright,main,20220129,1,0.9947813552204149,244,142,5,391
25406,bright,main,20220129,2,0.9925002445172803,242,119,6,367
25406,bright,main,20220129,3,0.9911155896192073,290,103,2,395
25406,bright,main,20220129,4,0.9961662104220486,243,132,5,380
25406,bright,main,20220129,5,0.99150080148652,215,153,10,378
25406,bright,main,20220129,6,0.9876790470281789,253,155,7,415
25406,bright,main,20220129,7,0.9832836386280782,242,115,3,360
25406,bright,main,20220129,8,0.9931111068631749,262,137,4,403
25406,bright,main,20220129,9,0.9934552919498867,264,138,8,410
2527,dark,main,20220130,0,0.9907289083483681,310,19,39,368
2527,dark,main,20220130,1,0.987728718380952,291,21,37,349
2527,dark,main,20220130,2,0.9965749599504149,303,20,50,373
2527,dark,main,20220130,3,0.9945778493693913,286,23,33,342
2527,dark,main,20220130,4,0.9960643511446893,294,16,42,352
2527,dark,main,20220130,5,0.992966983320222,301,19,46,366
2527,dark,main,20220130,6,0.992778455717432,308,16,45,369
2527,dark,main,20220130,7,0.980708356882318,284,17,37,338
2527,dark,main,20220130,8,0.992957199997389,313,14,37,364
2527,dark,main,20220130,9,0.9918164792103958,316,15,46,377
11874,dark,main,20220130,0,0.9871143053443017,314,22,41,377
11874,dark,main,20220130,1,0.9893936078754709,308,15,38,361
11874,dark,main,20220130,2,0.9941008057315658,320,17,48,385
11874,dark,main,20220130,3,0.9955614455689442,291,12,53,356
11874,dark,main,20220130,4,0.9941938878861165,298,16,38,352
11874,dark,main,20220130,5,0.9945328821345145,310,15,50,375
11874,dark,main,20220130,6,0.9918334675269795,329,13,46,388
11874,dark,main,20220130,7,0.9891440382483074,269,13,46,328
11874,dark,main,20220130,8,0.9876762241070766,319,11,44,374
11874,dark,main,20220130,9,0.9867790600947911,313,12,50,375
10384,dark,main,20220130,0,0.990020040579202,297,25,41,363
10384,dark,main,20220130,1,0.9915589344474312,307,21,32,360
10384,dark,main,20220130,2,0.9892080117093845,325,23,40,388
10384,dark,main,20220130,3,0.9922365572019429,294,17,40,351
10384,dark,main,20220130,4,0.9943974041043574,283,26,23,332
10384,dark,main,20220130,5,0.9862096135585735,314,22,32,368
10384,dark,main,20220130,6,0.9949488459668014,295,24,49,368
10384,dark,main,20220130,7,0.9932805931926082,294,13,26,333
10384,dark,main,20220130,8,0.9951625141985534,311,16,37,364
10384,dark,main,20220130,9,0.9909585423171585,296,18,47,361
2533,dark,main,20220130,0,0.9956227255227209,310,21,50,381
2533,dark,main,20220130,1,0.9918132230195802,290,18,33,341
2533,dark,main,20220130,2,0.9886652759719096,310,21,37,368
2533,dark,main,20220130,3,0.9915627773669754,299,15,29,343
2533,dark,main,20220130,4,0.9890837127019674,300,15,31,346
2533,dark,main,20220130,5,0.9968384671357716,315,16,40,371
2533,dark,main,20220130,6,0.9905422669600906,296,19,58,373
2533,dark,main,20220130,7,0.9878425775767957,276,18,39,333
2533,dark,main,20220130,8,0.9939683337803841,300,17,38,355
2533,dark,main,20220130,9,0.9893437677795879,315,21,37,373
7832,dark,main,20220130,0,0.9917497220969801,306,16,38,360
7832,dark,main,20220130,1,0.9888818188840371,292,26,43,361
7832,dark,main,20220130,2,0.9930519867038708,324,18,38,380
7832,dark,main,20220130,3,0.989311168411816,279,18,45,342
7832,dark,main,20220130,4,0.9954332452698693,304,21,28,353
7832,dark,main,20220130,5,0.9910217658678705,279,34,33,346
7832,dark,main,20220130,6,0.9864108498619827,303,18,49,370
7832,dark,main,20220130,7,0.9923431908500107,259,16,61,336
7832,dark,main,20220130,8,0.9921939788535985,302,18,51,371
7832,dark,main,20220130,9,0.9886351710589364,304,18,51,373
4068,dark,main,20220130,0,0.9867549374000151,298,13,36,347
4068,dark,main,20220130,1,0.99490856914837,262,13,45,320
4068,dark,main,20220130,2,0.990724241479902,284,14,57,355
4068,dark,main,20220130,3,0.9953137231286003,299,13,32,344
4068,dark,main,20220130,4,0.9944419452021613,280,12,31,323
4068,dark,main,20220130,5,0.991851717738106,288,7,46,341
4068,dark,main,20220130,6,0.9892165663015365,284,15,40,339
4068,dark,main,20220130,7,0.994218683526882,263,14,47,324
4068,dark,main,20220130,8,0.9922869984342089,265,13,68,346
4068,dark,main,20220130,9,0.9923808053717906,291,13,54,358
10209,dark,main,20220130,0,0.9941782624565807,307,19,47,373
10209,dark,main,20220130,1,0.99101189948288,305,15,29,349
10209,dark,main,20220130,2,0.9889011124218761,317,16,45,378
10209,dark,main,20220130,3,0.9875092134069586,272,18,34,324
10209,dark,main,20220130,4,0.9904841790706546,264,23,45,332
10209,dark,main,20220130,5,0.9928127934901829,277,21,60,358
10209,dark,main,20220130,6,0.989891502744255,294,19,65,378
10209,dark,main,20220130,7,0.9853261360768484,262,20,42,324
10209,dark,main,20220130,8,0.9956792805178918,289,21,41,351
10209,dark,main,20220130,9,0.9848599243132363,308,31,44,383
8382,dark,main,20220130,0,0.992558684684589,285,16,82,383
8382,dark,main,20220130,1,0.9873438024616652,254,20,83,357
8382,dark,main,20220130,2,0.9931837481729221,267,20,89,376
8382,dark,main,20220130,3,0.9964279778582483,265,13,71,349
8382,dark,main,20220130,4,0.9877427028837398,284,13,50,347
8382,dark,main,20220130,5,0.988923406920541,283,14,74,371
8382,dark,main,20220130,6,0.9925788563666251,277,29,74,380
8382,dark,main,20220130,7,0.9889848860710477,222,12,94,328
8382,dark,main,20220130,8,0.9919225267515935,267,17,78,362
8382,dark,main,20220130,9,0.9914135464209765,281,16,89,386
24781,bright,main,20220130,0,0.9954717047841712,346,87,5,438
24781,bright,main,20220130,1,0.9933507280191073,272,130,0,402
24781,bright,main,20220130,2,0.9942008648076661,326,106,3,435
24781,bright,main,20220130,3,0.9889335961798514,265,133,2,400
24781,bright,main,20220130,4,0.9854900670572027,269,121,3,393
24781,bright,main,20220130,5,0.9943386739164579,309,101,3,413
24781,bright,main,20220130,6,0.9844306222131299,262,162,4,428
24781,bright,main,20220130,7,0.991351435471448,254,115,5,374
24781,bright,main,20220130,8,0.9914474265088319,250,169,1,420
24781,bright,main,20220130,9,0.9956277939435707,298,133,2,433
11828,dark,main,20220130,0,0.9903207243809872,331,14,51,396
11828,dark,main,20220130,1,0.9944458390396614,303,14,52,369
11828,dark,main,20220130,2,0.9851870607796438,327,15,63,405
11828,dark,main,20220130,3,0.9935063020215936,308,12,47,367
11828,dark,main,20220130,4,0.9933570142612623,329,13,35,377
11828,dark,main,20220130,5,0.9941883520132646,318,12,42,372
11828,dark,main,20220130,6,0.9884340137377352,304,12,55,371
11828,dark,main,20220130,7,0.9887873278720977,287,15,46,348
11828,dark,main,20220130,8,0.9956328865769658,335,13,47,395
11828,dark,main,20220130,9,0.9943638207017222,350,13,45,408
1460,dark,main,20220130,0,0.9913259068560886,325,16,38,379
1460,dark,main,20220130,1,0.981981825288978,269,14,56,339
1460,dark,main,20220130,2,0.9911004726184668,291,18,86,395
1460,dark,main,20220130,3,0.9941580674764261,256,16,79,351
1460,dark,main,20220130,4,0.9882331641745961,269,9,79,357
1460,dark,main,20220130,5,0.9852461902712205,264,18,90,372
1460,dark,main,20220130,6,0.9921783236295196,278,15,93,386
1460,dark,main,20220130,7,0.9840520951733349,232,13,82,327
1460,dark,main,20220130,8,0.9921552102194886,306,10,45,361
1460,dark,main,20220130,9,0.9896745200214793,303,13,47,363
5984,dark,main,20220130,0,0.9895331172499008,285,20,92,397
5984,dark,main,20220130,1,0.988220093244033,237,23,79,339
5984,dark,main,20220130,2,0.9901213336484718,270,15,88,373
5984,dark,main,20220130,3,0.9889266995946013,256,13,91,360
5984,dark,main,20220130,4,0.9901845138320153,273,16,69,358
5984,dark,main,20220130,5,0.9907521379281666,318,10,37,365
5984,dark,main,20220130,6,0.991236287541468,312,13,57,382
5984,dark,main,20220130,7,0.9916243095517672,285,11,37,333
5984,dark,main,20220130,8,0.9965857996554482,284,18,74,376
5984,dark,main,20220130,9,0.9916318097577596,265,16,99,380
21684,bright,main,20220130,0,0.9952164079442831,278,151,3,432
21684,bright,main,20220130,1,0.9931637607247988,237,152,6,395
21684,bright,main,20220130,2,0.9910231972712571,315,112,3,430
21684,bright,main,20220130,3,0.9923096348372962,301,88,3,392
21684,bright,main,20220130,4,0.988601727088889,263,115,8,386
21684,bright,main,20220130,5,0.9943500984198191,273,130,8,411
21684,bright,main,20220130,6,0.9923497547823193,300,118,3,421
21684,bright,main,20220130,7,0.9956679672085378,279,87,4,370
21684,bright,main,20220130,8,0.9916709134811362,308,102,9,419
21684,bright,main,20220130,9,0.9904950881913538,303,116,3,422
25400,bright,main,20220130,0,0.9904138791040233,280,141,3,424
25400,bright,main,20220130,1,0.9911796701180439,209,163,5,377
25400,bright,main,20220130,2,0.9952712192574635,291,118,4,413
25400,bright,main,20220130,3,0.9874379270756903,288,86,8,382
25400,bright,main,20220130,4,0.989035096904535,260,117,5,382
25400,bright,main,20220130,5,0.9903669206993881,234,153,4,391
25400,bright,main,20220130,6,0.9940737340073478,241,158,10,409
25400,bright,main,20220130,7,0.9943437203880677,190,163,8,361
25400,bright,main,20220130,8,0.9903264894214213,213,181,9,403
25400,bright,main,20220130,9,0.9934925596584638,203,199,9,411
21662,bright,main,20220130,0,0.9946168630960716,287,154,3,444
21662,bright,main,20220130,1,0.988647189750195,237,163,3,403
21662,bright,main,20220130,2,0.9962237653672236,314,114,3,431
21662,bright,main,20220130,3,0.994413774619152,296,96,3,395
21662,bright,main,20220130,4,0.9930231880661472,276,115,3,394
21662,bright,main,20220130,5,0.9929106053728051,296,110,8,414
21662,bright,main,20220130,6,0.9959159350198953,333,95,4,432
21662,bright,main,20220130,7,0.9831974927044521,292,76,6,374
21662,bright,main,20220130,8,0.9922108776578211,337,80,6,423
21662,bright,main,20220130,9,0.9928526898172106,326,100,6,432
82633,mwclusgaldeep,sv1,20220130,0,0.9902585347827799,3,391,14,408
82633,mwclusgaldeep,sv1,20220130,1,0.986622816584946,3,379,17,399
82633,mwclusgaldeep,sv1,20220130,2,0.9929445447998891,0,390,11,401
82633,mwclusgaldeep,sv1,20220130,3,0.9892631373352239,3,372,20,395
82633,mwclusgaldeep,sv1,20220130,4,0.9912691288927323,3,357,13,373
82633,mwclusgaldeep,sv1,20220130,5,0.9929398216174873,1,380,9,390
82633,mwclusgaldeep,sv1,20220130,6,0.9942092194062871,2,395,7,404
82633,mwclusgaldeep,sv1,20220130,7,0.9930017421806769,1,348,14,363
82633,mwclusgaldeep,sv1,20220130,8,0.992669655873591,3,378,15,396
82633,mwclusgaldeep,sv1,20220130,9,0.9891222138939296,3,380,17,400
1662,dark,main,20220130,0,0.9813441587540689,300,12,53,365
1662,dark,main,20220130,1,0.9901090961534535,285,12,45,342
1662,dark,main,20220130,2,0.9915932552170108,291,14,63,368
1662,dark,main,20220130,3,0.9928272207381508,304,12,41,357
1662,dark,main,20220130,4,0.9911307630580984,302,11,47,360
1662,dark,main,20220130,5,0.9854033614526199,298,13,50,361
1662,dark,main,20220130,6,0.9941554462032121,310,13,49,372
1662,dark,main,20220130,7,0.9841458129328622,251,13,57,321
1662,dark,main,20220130,8,0.9893917786757359,319,15,43,377
1662,dark,main,20220130,9,0.993982711538903,306,17,44,367
21682,bright,main,20220130,0,0.9879803016208911,283,144,5,432
21682,bright,main,20220130,1,0.9918641514355794,307,88,3,398
21682,bright,main,20220130,2,0.9923597012247437,302,127,1,430
21682,bright,main,20220130,3,0.9901632561163392,312,84,2,398
21682,bright,main,20220130,4,0.9912764191549968,286,104,1,391
21682,bright,main,20220130,5,0.9918351012345276,273,140,3,416
21682,bright,main,20220130,6,0.9908570962723758,307,118,5,430
21682,bright,main,20220130,7,0.9959994590299192,234,132,3,369
21682,bright,main,20220130,8,0.9951699949335875,264,141,6,411
21682,bright,main,20220130,9,0.9934879525135728,305,114,6,425
7744,dark,main,20220130,0,0.9888003296276672,303,12,63,378
7744,dark,main,20220130,1,0.9903645708479109,261,14,74,349
7744,dark,main,20220130,2,0.9900162142245192,330,10,59,399
7744,dark,main,20220130,3,0.9903549656458133,294,10,49,353
7744,dark,main,20220130,4,0.9886126143326847,282,17,57,356
7744,dark,main,20220130,5,0.9940127959802858,265,18,89,372
7744,dark,main,20220130,6,0.9930456244243537,276,15,81,372
7744,dark,main,20220130,7,0.9865294507754974,249,14,53,316
7744,dark,main,20220130,8,0.9957404068357433,297,14,63,374
7744,dark,main,20220130,9,0.9905875944418984,279,15,79,373
9928,dark,main,20220130,0,0.988812345854191,286,17,79,382
9928,dark,main,20220130,1,0.995259558331181,240,19,91,350
9928,dark,main,20220130,2,0.9910555042585087,284,15,90,389
9928,dark,main,20220130,3,0.9937597487972741,283,13,57,353
9928,dark,main,20220130,4,0.9907549393982407,304,15,54,373
9928,dark,main,20220130,5,0.9904079227762519,296,16,75,387
9928,dark,main,20220130,6,0.9954176411470791,266,18,99,383
9928,dark,main,20220130,7,0.9905350310435801,226,25,78,329
9928,dark,main,20220130,8,0.9914316984296009,284,21,56,361
9928,dark,main,20220130,9,0.9944667694337566,281,16,82,379
7197,dark,main,20220130,0,0.9964766204899058,318,16,47,381
7197,dark,main,20220130,1,0.988471149248299,298,13,38,349
7197,dark,main,20220130,2,0.9870060354050799,303,13,49,365
7197,dark,main,20220130,3,0.9903530998163003,294,19,41,354
7197,dark,main,20220130,4,0.9934286730647981,293,13,48,354
7197,dark,main,20220130,5,0.9881598538938317,309,10,33,352
7197,dark,main,20220130,6,0.9931663667556462,295,14,58,367
7197,dark,main,20220130,7,0.990543763391193,252,13,63,328
7197,dark,main,20220130,8,0.9934994705024178,278,15,77,370
7197,dark,main,20220130,9,0.9906173605152401,317,12,57,386
5687,dark,main,20220131,0,0.9930007262258718,321,15,50,386
5687,dark,main,20220131,1,0.9897042786182355,301,18,30,349
5687,dark,main,20220131,2,0.9929300299451288,317,15,42,374
5687,dark,main,20220131,3,0.9860275751893992,276,24,46,346
5687,dark,main,20220131,4,0.9923919257696525,286,16,54,356
5687,dark,main,20220131,5,0.9912629919851107,296,15,48,359
5687,dark,main,20220131,6,0.9890628669175644,306,17,41,364
5687,dark,main,20220131,7,0.9912309944287523,278,14,39,331
5687,dark,main,20220131,8,0.9958432490838777,301,17,36,354
5687,dark,main,20220131,9,0.9858125232781348,319,20,51,390
3042,dark,main,20220131,0,0.9955580262805558,296,14,103,413
3042,dark,main,20220131,1,0.9930326230267347,275,14,60,349
3042,dark,main,20220131,2,0.9898663043434096,309,13,67,389
3042,dark,main,20220131,3,0.9921535707748309,264,12,68,344
3042,dark,main,20220131,4,0.987470735724976,254,20,88,362
3042,dark,main,20220131,5,0.9844364942585961,285,14,73,372
3042,dark,main,20220131,6,0.9921360855242413,283,16,80,379
3042,dark,main,20220131,7,0.9929512629584654,269,17,58,344
3042,dark,main,20220131,8,0.9939385293180022,269,17,91,377
3042,dark,main,20220131,9,0.9931686790427704,279,13,85,377
2520,dark,main,20220131,0,0.9915184390827271,323,15,37,375
2520,dark,main,20220131,1,0.9874623456289092,294,15,39,348
2520,dark,main,20220131,2,0.9918651147021109,322,11,63,396
2520,dark,main,20220131,3,0.9878301939957138,286,13,45,344
2520,dark,main,20220131,4,0.9931349701541496,286,11,35,332
2520,dark,main,20220131,5,0.9933163577689451,292,15,51,358
2520,dark,main,20220131,6,0.9956332555843683,311,16,41,368
2520,dark,main,20220131,7,0.9901031000066174,278,12,36,326
2520,dark,main,20220131,8,0.9877891659907829,296,14,41,351
2520,dark,main,20220131,9,0.9935012274609156,326,17,32,375
7240,dark,main,20220131,0,0.9857471400678012,233,25,41,299
7240,dark,main,20220131,1,0.992799044226858,271,19,50,340
7240,dark,main,20220131,2,0.9894419162907192,323,17,49,389
7240,dark,main,20220131,3,0.9906508630449056,290,14,48,352
7240,dark,main,20220131,4,0.9895512023376574,276,20,48,344
7240,dark,main,20220131,5,0.991260587769595,283,13,65,361
7240,dark,main,20220131,6,0.9874422689106218,305,16,57,378
7240,dark,main,20220131,7,0.9925114838295257,249,12,55,316
7240,dark,main,20220131,8,0.9902020269966576,300,18,49,367
7240,dark,main,20220131,9,0.991238396373215,286,18,46,350
10876,dark,main,20220131,0,0.992489118769128,344,12,38,394
10876,dark,main,20220131,1,0.9918313987293916,280,15,43,338
10876,dark,main,20220131,2,0.9892050589491909,301,15,74,390
10876,dark,main,20220131,3,0.9877927376734839,263,17,77,357
10876,dark,main,20220131,4,0.9860545760368264,247,22,76,345
10876,dark,main,20220131,5,0.9948128699045078,296,9,64,369
10876,dark,main,20220131,6,0.991658787145322,289,16,65,370
10876,dark,main,20220131,7,0.9885981773000659,251,13,54,318
10876,dark,main,20220131,8,0.9929504445171777,295,12,59,366
10876,dark,main,20220131,9,0.9978331504829218,316,12,54,382
5680,dark,main,20220131,0,0.9959477560054409,296,11,90,397
5680,dark,main,20220131,1,0.9850662428258901,248,16,83,347
5680,dark,main,20220131,2,0.9890802306571341,271,20,97,388
5680,dark,main,20220131,3,0.9891358048237437,303,12,44,359
5680,dark,main,20220131,4,0.9893197985312785,292,13,52,357
5680,dark,main,20220131,5,0.9933401634634553,297,12,62,371
5680,dark,main,20220131,6,0.9933780168894029,300,15,63,378
5680,dark,main,20220131,7,0.9872471431043102,282,10,50,342
5680,dark,main,20220131,8,0.9912633662082233,293,14,68,375
5680,dark,main,20220131,9,0.9956584060633904,310,10,75,395
40269,backup,main,20220131,0,0.9897028450987556,8,393,1,402
40269,backup,main,20220131,1,0.9839013487489119,3,361,0,364
40269,backup,main,20220131,2,0.9833248366897304,3,388,1,392
40269,backup,main,20220131,3,0.9908930744582565,7,356,0,363
40269,backup,main,20220131,4,0.9921086994849955,5,354,0,359
40269,backup,main,20220131,5,0.9951462280517267,8,369,1,378
40269,backup,main,20220131,6,0.9943495246807875,4,388,1,393
40269,backup,main,20220131,7,0.9938647613924722,3,330,0,333
40269,backup,main,20220131,8,0.9904931473117345,3,369,4,376
40269,backup,main,20220131,9,0.9915671454365506,2,381,2,385
25272,bright,main,20220131,0,0.9959570582688845,293,126,5,424
25272,bright,main,20220131,1,0.9878515630679624,203,182,3,388
25272,bright,main,20220131,2,0.990320802170347,284,144,4,432
25272,bright,main,20220131,3,0.9907810355036997,215,175,4,394
25272,bright,main,20220131,4,0.9927206116726086,293,100,2,395
25272,bright,main,20220131,5,0.9898563802552562,253,153,3,409
25272,bright,main,20220131,6,0.9947163914340177,240,187,3,430
25272,bright,main,20220131,7,0.9933447653108741,261,105,4,370
25272,bright,main,20220131,8,0.9938586528509861,306,105,5,416
25272,bright,main,20220131,9,0.9882012259280526,275,154,2,431
10339,dark,main,20220131,0,0.9943233112210973,310,17,34,361
10339,dark,main,20220131,1,0.9910983648206665,285,16,33,334
10339,dark,main,20220131,2,0.9936936811090075,301,11,54,366
10339,dark,main,20220131,3,0.987891914045875,274,13,43,330
10339,dark,main,20220131,4,0.9883156119424649,269,11,68,348
10339,dark,main,20220131,5,0.9903123154349381,300,12,65,377
10339,dark,main,20220131,6,0.9944832063720875,303,12,61,376
10339,dark,main,20220131,7,0.9904472579342269,262,12,44,318
10339,dark,main,20220131,8,0.9908477198937531,296,11,54,361
10339,dark,main,20220131,9,0.9856066279815331,287,18,44,349
41260,backup,main,20220131,0,0.9962140840888275,7,440,0,447
41260,backup,main,20220131,1,0.9911624013904811,4,404,0,408
41260,backup,main,20220131,2,0.9932750552698935,9,435,0,444
41260,backup,main,20220131,3,0.9963699688237104,34,373,0,407
41260,backup,main,20220131,4,0.9933837983765552,24,377,0,401
41260,backup,main,20220131,5,0.9941855623279598,28,396,0,424
41260,backup,main,20220131,6,0.990010281945039,13,423,0,436
41260,backup,main,20220131,7,0.9907873515651328,3,376,0,379
41260,backup,main,20220131,8,0.9940774804357461,7,423,0,430
41260,backup,main,20220131,9,0.991528540579238,13,428,0,441
7218,dark,main,20220131,0,0.9879549594707915,294,18,63,375
7218,dark,main,20220131,1,0.9956764282241081,285,16,36,337
7218,dark,main,20220131,2,0.9942454939950676,303,15,49,367
7218,dark,main,20220131,3,0.9919719134923155,276,19,47,342
7218,dark,main,20220131,4,0.9943622425207903,277,13,50,340
7218,dark,main,20220131,5,0.9953177058328792,314,19,38,371
7218,dark,main,20220131,6,0.995743191738178,299,19,50,368
7218,dark,main,20220131,7,0.9922222738928635,274,18,41,333
7218,dark,main,20220131,8,0.9931358526588352,306,17,47,370
7218,dark,main,20220131,9,0.992077429005261,315,16,47,378
21661,bright,main,20220131,0,0.991869448996195,332,108,2,442
21661,bright,main,20220131,1,0.9906848609073626,285,114,4,403
21661,bright,main,20220131,2,0.9920724353841724,299,126,6,431
21661,bright,main,20220131,3,0.9925612405781977,308,84,0,392
21661,bright,main,20220131,4,0.9946277824546216,273,109,6,388
21661,bright,main,20220131,5,0.9963725396588511,270,137,3,410
21661,bright,main,20220131,6,0.9942130518048113,313,108,3,424
21661,bright,main,20220131,7,0.9939572134941789,282,89,2,373
21661,bright,main,20220131,8,0.9910766731891907,314,101,3,418
21661,bright,main,20220131,9,0.9927321000120465,330,94,7,431
7535,dark,main,20220131,0,0.9876431620295761,308,15,65,388
7535,dark,main,20220131,1,0.9938349005495922,275,14,57,346
7535,dark,main,20220131,2,0.9913464534385973,334,14,39,387
7535,dark,main,20220131,3,0.9928039393524389,297,15,45,357
7535,dark,main,20220131,4,0.9938377868537173,294,10,46,350
7535,dark,main,20220131,5,0.9893359682382775,286,13,61,360
7535,dark,main,20220131,6,0.9952695439810815,273,16,80,369
7535,dark,main,20220131,7,0.991027599654863,264,15,64,343
7535,dark,main,20220131,8,0.9790559558223247,278,14,75,367
7535,dark,main,20220131,9,0.9932902272730982,299,14,66,379
8807,dark,main,20220131,0,0.991826131991362,301,17,64,382
8807,dark,main,20220131,1,0.991004510619654,275,11,59,345
8807,dark,main,20220131,2,0.9887211713705494,309,12,52,373
8807,dark,main,20220131,3,0.9931517972042103,293,11,43,347
8807,dark,main,20220131,4,0.9880739527089758,281,11,40,332
8807,dark,main,20220131,5,0.9920375449654546,293,12,51,356
8807,dark,main,20220131,6,0.9939443988032032,311,10,51,372
8807,dark,main,20220131,7,0.9937392503522505,264,11,42,317
8807,dark,main,20220131,8,0.9931637261811496,296,13,44,353
8807,dark,main,20220131,9,0.9907122362025743,301,15,57,373
22939,bright,main,20220131,0,0.9928612616194925,305,123,6,434
22939,bright,main,20220131,1,0.9880936230134072,261,137,2,400
22939,bright,main,20220131,2,0.9850847722371545,295,136,5,436
22939,bright,main,20220131,3,0.9916674326349906,284,113,4,401
22939,bright,main,20220131,4,0.9911117745724756,279,117,2,398
22939,bright,main,20220131,5,0.9935231993508573,292,123,0,415
22939,bright,main,20220131,6,0.9842682981379844,292,132,3,427
22939,bright,main,20220131,7,0.9925757127913848,258,115,0,373
22939,bright,main,20220131,8,0.9912954071159865,321,95,5,421
22939,bright,main,20220131,9,0.9905469359512846,301,129,4,434
6192,dark,main,20220131,0,0.99499016218843,270,14,86,370
6192,dark,main,20220131,1,0.9824694370165336,267,11,54,332
6192,dark,main,20220131,2,0.9950376648481439,278,11,68,357
6192,dark,main,20220131,3,0.9905926180792526,254,15,64,333
6192,dark,main,20220131,4,0.9880777614662919,229,14,90,333
6192,dark,main,20220131,5,0.9917417299211141,247,16,74,337
6192,dark,main,20220131,6,0.9940215435637624,283,11,52,346
6192,dark,main,20220131,7,0.9829915912932002,233,13,45,291
6192,dark,main,20220131,8,0.9837020415010185,255,20,70,345
6192,dark,main,20220131,9,0.9945341551367817,253,14,83,350
4584,dark,main,20220131,0,0.9814833132666037,270,14,103,387
4584,dark,main,20220131,1,0.9965793829207318,283,11,52,346
4584,dark,main,20220131,2,0.9956078563612628,309,11,58,378
4584,dark,main,20220131,3,0.9852127370292025,288,10,53,351
4584,dark,main,20220131,4,0.9950049340376034,278,11,57,346
4584,dark,main,20220131,5,0.9892487644446359,290,17,66,373
4584,dark,main,20220131,6,0.9959425854273833,261,13,93,367
4584,dark,main,20220131,7,0.9831968460197268,224,23,74,321
4584,dark,main,20220131,8,0.9935609192112439,270,16,96,382
4584,dark,main,20220131,9,0.9952874625325667,276,16,91,383
9281,dark,main,20220131,0,0.9914705705782338,305,13,59,377
9281,dark,main,20220131,1,0.9853687039625425,288,15,48,351
9281,dark,main,20220131,2,0.9955994239114615,308,14,57,379
9281,dark,main,20220131,3,0.9914839073567701,293,12,53,358
9281,dark,main,20220131,4,0.9883373332808301,250,12,89,351
9281,dark,main,20220131,5,0.9932695273788512,252,14,94,360
9281,dark,main,20220131,6,0.9936139023005667,264,22,88,374
9281,dark,main,20220131,7,0.9945524949653389,241,13,70,324
9281,dark,main,20220131,8,0.9923375989715342,315,12,52,379
9281,dark,main,20220131,9,0.9893452996130025,295,12,69,376
5650,dark,main,20220131,0,0.9952907220662692,325,13,40,378
5650,dark,main,20220131,1,0.9918000807834113,280,12,50,342
5650,dark,main,20220131,2,0.9844074103644614,306,11,49,366
5650,dark,main,20220131,3,0.9888662560965246,278,13,43,334
5650,dark,main,20220131,4,0.9887148107644287,277,10,50,337
5650,dark,main,20220131,5,0.993936263778422,294,16,39,349
5650,dark,main,20220131,6,0.9920030686636879,315,13,43,371
5650,dark,main,20220131,7,0.9968893928735123,269,14,30,313
5650,dark,main,20220131,8,0.9927177530832718,303,13,41,357
5650,dark,main,20220131,9,0.9945665142718987,307,17,42,366
21689,bright,main,20220131,0,0.9903908711708052,341,87,5,433
21689,bright,main,20220131,1,0.99233415328367,294,102,3,399
21689,bright,main,20220131,2,0.9955404620606666,304,130,0,434
21689,bright,main,20220131,3,0.9963623413901156,302,87,6,395
21689,bright,main,20220131,4,0.9940198413379514,264,122,3,389
21689,bright,main,20220131,5,0.9947527745609946,245,158,8,411
21689,bright,main,20220131,6,0.9939665164620938,261,153,9,423
21689,bright,main,20220131,7,0.9912211433615189,252,110,4,366
21689,bright,main,20220131,8,0.9936127321584761,278,141,2,421
21689,bright,main,20220131,9,0.995122921177181,308,114,7,429
41576,backup,main,20220131,0,0.9908023979547343,2,405,0,407
41576,backup,main,20220131,1,0.9949486305402473,1,359,0,360
41576,backup,main,20220131,2,0.992628820982791,2,386,1,389
41576,backup,main,20220131,3,0.9931626207038682,8,345,1,354
41576,backup,main,20220131,4,0.9906597027607157,3,338,0,341
41576,backup,main,20220131,5,0.9879244512821869,4,358,0,362
41576,backup,main,20220131,6,0.9886523391753032,5,380,0,385
41576,backup,main,20220131,7,0.9943554450817745,2,314,0,316
41576,backup,main,20220131,8,0.9910983655884508,4,370,1,375
41576,backup,main,20220131,9,0.9886167249002288,5,374,1,380
21531,bright,main,20220201,0,0.9927595621600417,196,246,4,446
21531,bright,main,20220201,1,0.9932093681703553,250,151,3,404
21531,bright,main,20220201,2,0.9932206676177842,277,162,3,442
21531,bright,main,20220201,3,0.9887702134239437,196,207,2,405
21531,bright,main,20220201,4,0.9903808765647473,189,208,2,399
21531,bright,main,20220201,5,0.9881862232377742,182,235,2,419
21531,bright,main,20220201,6,0.9908231473834362,250,183,3,436
21531,bright,main,20220201,7,0.9876204613334619,173,202,2,377
21531,bright,main,20220201,8,0.9895672484577323,250,169,5,424
21531,bright,main,20220201,9,0.9953982489062401,251,178,3,432
23134,bright,main,20220202,0,0.989864046098995,232,195,7,434
23134,bright,main,20220202,1,0.9939212037038485,253,138,2,393
23134,bright,main,20220202,2,0.9915965570892923,305,119,11,435
23134,bright,main,20220202,3,0.9917427082300896,235,160,4,399
23134,bright,main,20220202,4,0.9940268850430799,227,159,9,395
23134,bright,main,20220202,5,0.9916804794935585,264,141,6,411
23134,bright,main,20220202,6,0.9935395826189274,294,130,4,428
23134,bright,main,20220202,7,0.9934879328291619,205,164,5,374
23134,bright,main,20220202,8,0.9934569566979741,204,211,4,419
23134,bright,main,20220202,9,0.9933352744338823,186,233,8,427
6283,dark,main,20220202,0,0.9918414480795669,329,14,55,398
6283,dark,main,20220202,1,0.9953060181045709,283,12,56,351
6283,dark,main,20220202,2,0.9926361767883435,301,20,74,395
6283,dark,main,20220202,3,0.9891862494267176,237,18,86,341
6283,dark,main,20220202,4,0.9935372110743991,241,13,89,343
6283,dark,main,20220202,5,0.9936318418974287,245,27,96,368
6283,dark,main,20220202,6,0.9923237900111812,267,19,76,362
6283,dark,main,20220202,7,0.9936026405825135,241,16,72,329
6283,dark,main,20220202,8,0.992632964486246,272,20,68,360
6283,dark,main,20220202,9,0.9962293282454138,294,17,64,375
10345,dark,main,20220202,0,0.9964770070879322,323,16,41,380
10345,dark,main,20220202,1,0.9892392860792236,303,13,37,353
10345,dark,main,20220202,2,0.9926281865145722,342,13,37,392
10345,dark,main,20220202,3,0.9907913742811393,317,12,48,377
10345,dark,main,20220202,4,0.9923315227781114,288,13,46,347
10345,dark,main,20220202,5,0.9927236139642135,322,17,29,368
10345,dark,main,20220202,6,0.9849086171452613,324,16,36,376
10345,dark,main,20220202,7,0.9911960074738979,279,12,41,332
10345,dark,main,20220202,8,0.9897642690596921,303,11,47,361
10345,dark,main,20220202,9,0.98748819411256,326,12,49,387
23719,bright,main,20220202,0,0.99236869331758,349,77,7,433
23719,bright,main,20220202,1,0.9833763897833333,302,96,1,399
23719,bright,main,20220202,2,0.9916740501832118,302,131,2,435
23719,bright,main,20220202,3,0.9922624818605627,298,100,2,400
23719,bright,main,20220202,4,0.9935127248729538,278,107,5,390
23719,bright,main,20220202,5,0.9915120132899763,305,90,5,400
23719,bright,main,20220202,6,0.9960369909072079,311,102,2,415
23719,bright,main,20220202,7,0.9889254441413066,282,93,2,377
23719,bright,main,20220202,8,0.9939399677541182,294,119,2,415
23719,bright,main,20220202,9,0.9907712208924007,292,139,1,432
22053,bright,main,20220202,0,0.995110675193706,249,174,5,428
22053,bright,main,20220202,1,0.9874638649771283,215,166,5,386
22053,bright,main,20220202,2,0.9905006956684675,272,148,9,429
22053,bright,main,20220202,3,0.9912860442217077,302,82,0,384
22053,bright,main,20220202,4,0.9943992436098159,312,68,1,381
22053,bright,main,20220202,5,0.9894861392663985,352,54,3,409
22053,bright,main,20220202,6,0.9949940922258033,362,57,4,423
22053,bright,main,20220202,7,0.9914869876378997,270,95,3,368
22053,bright,main,20220202,8,0.990790607707456,238,165,5,408
22053,bright,main,20220202,9,0.9919782748920428,233,181,7,421
24680,bright,main,20220202,0,0.9911666271747034,317,111,3,431
24680,bright,main,20220202,1,0.9830973078379361,260,120,9,389
24680,bright,main,20220202,2,0.9932563122484576,194,225,5,424
24680,bright,main,20220202,3,0.9914554999216273,247,138,3,388
24680,bright,main,20220202,4,0.9960453643661087,304,79,4,387
24680,bright,main,20220202,5,0.9952392509404023,314,88,3,405
24680,bright,main,20220202,6,0.9896814247727931,325,86,2,413
24680,bright,main,20220202,7,0.990646228600967,288,72,2,362
24680,bright,main,20220202,8,0.9969793700071575,340,71,2,413
24680,bright,main,20220202,9,0.9947624093255893,338,89,3,430
21387,bright,main,20220202,0,0.9932386134844258,245,195,1,441
21387,bright,main,20220202,1,0.9925335702647815,316,84,4,404
21387,bright,main,20220202,2,0.9959422649295424,313,117,4,434
21387,bright,main,20220202,3,0.9935141877347965,212,188,4,404
21387,bright,main,20220202,4,0.9968905994523246,186,213,2,401
21387,bright,main,20220202,5,0.9924862640391074,133,283,2,418
21387,bright,main,20220202,6,0.990048324889251,231,198,3,432
21387,bright,main,20220202,7,0.9924615060458798,183,192,2,377
21387,bright,main,20220202,8,0.9868110681223721,222,203,2,427
21387,bright,main,20220202,9,0.9943298594712654,259,165,4,428
24569,bright,main,20220202,0,0.9938768008402445,225,207,2,434
24569,bright,main,20220202,1,0.9914455660717135,177,217,3,397
24569,bright,main,20220202,2,0.99808689993028,205,214,7,426
24569,bright,main,20220202,3,0.9959718667004792,237,153,4,394
24569,bright,main,20220202,4,0.9900965250245041,249,139,1,389
24569,bright,main,20220202,5,0.9932847714561699,202,209,5,416
24569,bright,main,20220202,6,0.9919643503864075,247,182,1,430
24569,bright,main,20220202,7,0.9918704796918042,218,156,1,375
24569,bright,main,20220202,8,0.9934790050523438,274,141,2,417
24569,bright,main,20220202,9,0.9947454213243704,259,157,9,425
24809,bright,main,20220202,0,0.994793240225009,260,173,4,437
24809,bright,main,20220202,1,0.9940889542084053,189,200,3,392
24809,bright,main,20220202,2,0.9928318677718784,205,222,3,430
24809,bright,main,20220202,3,0.9943121117729447,162,234,2,398
24809,bright,main,20220202,4,0.9942772150285505,154,231,4,389
24809,bright,main,20220202,5,0.9921969094933203,255,157,1,413
24809,bright,main,20220202,6,0.9946244393376956,228,192,4,424
24809,bright,main,20220202,7,0.9824111691648176,202,164,0,366
24809,bright,main,20220202,8,0.9944851951717885,207,201,4,412
24809,bright,main,20220202,9,0.9912418699987184,224,205,2,431
21519,bright,main,20220202,0,0.9948450456748249,227,202,6,435
21519,bright,main,20220202,1,0.9934930110586903,213,178,3,394
21519,bright,main,20220202,2,0.9925389492561194,202,229,4,435
21519,bright,main,20220202,3,0.9914620369202854,165,225,7,397
21519,bright,main,20220202,4,0.9897734849561324,156,234,5,395
21519,bright,main,20220202,5,0.9892161572961263,232,171,3,406
21519,bright,main,20220202,6,0.9914452828649718,249,167,4,420
21519,bright,main,20220202,7,0.9926733828814004,258,107,1,366
21519,bright,main,20220202,8,0.9877297936332448,290,116,7,413
21519,bright,main,20220202,9,0.9929189107043522,292,134,5,431
7705,dark,main,20220202,0,0.989014453473579,324,16,32,372
7705,dark,main,20220202,1,0.9934534750041786,294,15,45,354
7705,dark,main,20220202,2,0.9933117757275568,320,10,60,390
7705,dark,main,20220202,3,0.9900392085412125,297,16,50,363
7705,dark,main,20220202,4,0.9910768344056082,286,14,56,356
7705,dark,main,20220202,5,0.9919849607080325,296,13,51,360
7705,dark,main,20220202,6,0.9933961067178636,292,13,80,385
7705,dark,main,20220202,7,0.9929475833055259,233,15,85,333
7705,dark,main,20220202,8,0.9926743443108952,293,12,63,368
7705,dark,main,20220202,9,0.9921183545442835,329,11,44,384
25290,bright,main,20220202,0,0.9943273139302159,267,151,2,420
25290,bright,main,20220202,1,0.9923493902262626,295,87,5,387
25290,bright,main,20220202,2,0.9863399814916487,353,70,2,425
25290,bright,main,20220202,3,0.995079251210929,314,71,3,388
25290,bright,main,20220202,4,0.9916534729593878,319,67,2,388
25290,bright,main,20220202,5,0.9906389847442423,330,68,6,404
25290,bright,main,20220202,6,0.9945259047541422,322,84,5,411
25290,bright,main,20220202,7,0.9930626759741046,292,65,4,361
25290,bright,main,20220202,8,0.9929163539803418,316,86,2,404
25290,bright,main,20220202,9,0.9942896800765236,291,131,4,426
24677,bright,main,20220202,0,0.9920986830037991,225,205,3,433
24677,bright,main,20220202,1,0.9892085549603251,278,116,2,396
24677,bright,main,20220202,2,0.9883452745048569,333,94,6,433
24677,bright,main,20220202,3,0.9863095656006842,255,139,3,397
24677,bright,main,20220202,4,0.9904731432167189,245,131,3,379
24677,bright,main,20220202,5,0.9923585395449044,184,216,5,405
24677,bright,main,20220202,6,0.9922676758963608,246,171,7,424
24677,bright,main,20220202,7,0.9935792519948772,243,119,3,365
24677,bright,main,20220202,8,0.9914381690998436,256,153,5,414
24677,bright,main,20220202,9,0.9908356642883448,198,227,1,426
23072,bright,main,20220202,0,0.9946690745993648,343,96,5,444
23072,bright,main,20220202,1,0.995699870748504,297,94,7,398
23072,bright,main,20220202,2,0.9905841311227433,306,122,4,432
23072,bright,main,20220202,3,0.9951550858712054,201,194,3,398
23072,bright,main,20220202,4,0.9954262890291893,179,216,2,397
23072,bright,main,20220202,5,0.9933691367379581,183,229,4,416
23072,bright,main,20220202,6,0.9887247356028611,272,160,3,435
23072,bright,main,20220202,7,0.9906896772870932,247,128,1,376
23072,bright,main,20220202,8,0.9934127285240413,270,143,6,419
23072,bright,main,20220202,9,0.988578092740298,340,86,6,432
23730,bright,main,20220202,0,0.9955388447419395,315,105,4,424
23730,bright,main,20220202,1,0.9941652746399412,280,102,4,386
23730,bright,main,20220202,2,0.9910577044372583,347,75,1,423
23730,bright,main,20220202,3,0.9863007256059353,317,74,5,396
23730,bright,main,20220202,4,0.9946430815685005,305,81,1,387
23730,bright,main,20220202,5,0.9943510812949804,339,69,3,411
23730,bright,main,20220202,6,0.9948138037836358,319,96,2,417
23730,bright,main,20220202,7,0.9874962526239168,287,75,5,367
23730,bright,main,20220202,8,0.9924833255090342,323,85,1,409
23730,bright,main,20220202,9,0.991092434251878,325,86,5,416
24787,bright,main,20220202,0,0.9935048729989189,308,130,4,442
24787,bright,main,20220202,1,0.9917189864428082,275,122,3,400
24787,bright,main,20220202,2,0.9896266563195676,268,161,3,432
24787,bright,main,20220202,3,0.9888969745160225,198,198,2,398
24787,bright,main,20220202,4,0.9946684297519613,254,135,2,391
24787,bright,main,20220202,5,0.9931457747010685,243,164,6,413
24787,bright,main,20220202,6,0.9895775316108991,268,160,1,429
24787,bright,main,20220202,7,0.9941322977238547,225,150,0,375
24787,bright,main,20220202,8,0.9900071094153285,227,186,6,419
24787,bright,main,20220202,9,0.9957193159505656,260,172,4,436
8676,dark,main,20220202,0,0.9896220999607394,307,18,50,375
8676,dark,main,20220202,1,0.9961194635952569,295,19,41,355
8676,dark,main,20220202,2,0.9827863474049344,297,21,48,366
8676,dark,main,20220202,3,0.9899116110933649,286,23,33,342
8676,dark,main,20220202,4,0.9873343413876895,306,17,38,361
8676,dark,main,20220202,5,0.9917060883262894,314,19,40,373
8676,dark,main,20220202,6,0.992479506514106,337,20,33,390
8676,dark,main,20220202,7,0.9898141586601836,282,20,32,334
8676,dark,main,20220202,8,0.9964392643559561,296,17,32,345
8676,dark,main,20220202,9,0.989355042680781,311,22,35,368
21561,bright,main,20220202,0,0.9896542029790465,208,217,7,432
21561,bright,main,20220202,1,0.9948888304623649,190,199,3,392
21561,bright,main,20220202,2,0.9939772074498556,236,185,4,425
21561,bright,main,20220202,3,0.9915299092289076,159,220,6,385
21561,bright,main,20220202,4,0.9893462854879768,187,195,5,387
21561,bright,main,20220202,5,0.989933430735551,221,175,9,405
21561,bright,main,20220202,6,0.9953657387565643,288,125,2,415
21561,bright,main,20220202,7,0.9925368897791875,280,75,5,360
21561,bright,main,20220202,8,0.9901288655709064,272,144,3,419
21561,bright,main,20220202,9,0.9869660178129368,275,140,4,419
22042,bright,main,20220202,0,0.9912317849600492,346,72,5,423
22042,bright,main,20220202,1,0.9882332983401695,303,82,4,389
22042,bright,main,20220202,2,0.9916842804596895,294,128,6,428
22042,bright,main,20220202,3,0.9879252408652374,283,99,6,388
22042,bright,main,20220202,4,0.9953990915969442,278,100,10,388
22042,bright,main,20220202,5,0.9955171060574911,348,52,3,403
22042,bright,main,20220202,6,0.992559752432577,362,51,3,416
22042,bright,main,20220202,7,0.9843679323609785,313,51,4,368
22042,bright,main,20220202,8,0.9909570727021032,349,60,3,412
22042,bright,main,20220202,9,0.9916237762109614,328,93,2,423
24780,bright,main,20220202,0,0.9904548711119869,321,110,7,438
24780,bright,main,20220202,1,0.9933070448455996,236,162,3,401
24780,bright,main,20220202,2,0.9902556317715768,252,178,5,435
24780,bright,main,20220202,3,0.994180816218543,244,152,4,400
24780,bright,main,20220202,4,0.9918485983001587,285,104,4,393
24780,bright,main,20220202,5,0.9972574706965621,316,100,1,417
24780,bright,main,20220202,6,0.9919797534270389,313,114,5,432
24780,bright,main,20220202,7,0.9917619573744281,222,152,3,377
24780,bright,main,20220202,8,0.9948046589639706,222,190,10,422
24780,bright,main,20220202,9,0.9955237209112603,274,160,1,435
21369,bright,main,20220202,0,0.9964869876976463,211,227,5,443
21369,bright,main,20220202,1,0.9926095654036127,184,218,1,403
21369,bright,main,20220202,2,0.9910337720841164,221,211,3,435
21369,bright,main,20220202,3,0.9872497720550542,174,225,6,405
21369,bright,main,20220202,4,0.9923205494015724,232,164,4,400
21369,bright,main,20220202,5,0.9921887224866888,248,163,5,416
21369,bright,main,20220202,6,0.9788019629360942,237,189,2,428
21369,bright,main,20220202,7,0.9957157467450111,283,88,6,377
21369,bright,main,20220202,8,0.9895555064261053,325,99,1,425
21369,bright,main,20220202,9,0.9943880153370263,298,133,1,432
21383,bright,main,20220202,0,0.9948009733939858,198,237,3,438
21383,bright,main,20220202,1,0.9945677260928552,217,183,3,403
21383,bright,main,20220202,2,0.9908703483972914,219,223,2,444
21383,bright,main,20220202,3,0.9916490487121234,242,160,3,405
21383,bright,main,20220202,4,0.9954349225354789,250,147,3,400
21383,bright,main,20220202,5,0.9947034169637116,291,123,5,419
21383,bright,main,20220202,6,0.9847612700941007,280,152,3,435
21383,bright,main,20220202,7,0.9977460654501927,249,120,5,374
21383,bright,main,20220202,8,0.9887014763808535,263,156,4,423
21383,bright,main,20220202,9,0.9949743533617659,222,209,2,433
20267,bright,main,20220202,0,0.9930190645731755,284,148,5,437
20267,bright,main,20220202,1,0.9894406583229692,236,155,2,393
20267,bright,main,20220202,2,0.9938984380217842,217,206,5,428
20267,bright,main,20220202,3,0.9917761007499172,214,182,1,397
20267,bright,main,20220202,4,0.9933002693457594,205,175,6,386
20267,bright,main,20220202,5,0.9944120584435849,199,196,5,400
20267,bright,main,20220202,6,0.9944767298081416,258,160,2,420
20267,bright,main,20220202,7,0.9903816302900562,232,133,1,366
20267,bright,main,20220202,8,0.99187864348473,272,128,9,409
20267,bright,main,20220202,9,0.9901998724250797,293,130,6,429
20562,bright,main,20220203,0,0.9882670121456189,342,89,8,439
20562,bright,main,20220203,1,0.9956249313803145,304,79,2,385
20562,bright,main,20220203,2,0.9925579666256037,313,110,7,430
20562,bright,main,20220203,3,0.9943492266913146,273,117,2,392
20562,bright,main,20220203,4,0.9915427469944046,276,109,5,390
20562,bright,main,20220203,5,0.9847044236503496,317,89,6,412
20562,bright,main,20220203,6,0.9834895726244247,334,87,6,427
20562,bright,main,20220203,7,0.9902947911850405,262,99,6,367
20562,bright,main,20220203,8,0.9916818985326458,329,82,4,415
20562,bright,main,20220203,9,0.9822569284357027,333,89,3,425
23082,bright,main,20220203,0,0.9876876678440452,269,163,4,436
23082,bright,main,20220203,1,0.9933086268725169,200,193,5,398
23082,bright,main,20220203,2,0.9916473464568449,260,164,3,427
23082,bright,main,20220203,3,0.9940613080997528,202,184,5,391
23082,bright,main,20220203,4,0.9894357695742071,236,150,2,388
23082,bright,main,20220203,5,0.9915150108716166,305,94,7,406
23082,bright,main,20220203,6,0.9922663297837356,275,140,3,418
23082,bright,main,20220203,7,0.9936543519496243,275,89,2,366
23082,bright,main,20220203,8,0.9955806993223298,314,96,7,417
23082,bright,main,20220203,9,0.9942750088822043,286,133,7,426
40260,backup,main,20220203,0,0.986074456674559,0,407,1,408
40260,backup,main,20220203,1,0.9930315707815619,1,369,0,370
40260,backup,main,20220203,2,0.9957646800585853,0,401,1,402
40260,backup,main,20220203,3,0.9921872415516622,3,365,1,369
40260,backup,main,20220203,4,0.9934264338944611,7,358,0,365
40260,backup,main,20220203,5,0.992274149616218,1,364,1,366
40260,backup,main,20220203,6,0.992691966441587,5,385,0,390
40260,backup,main,20220203,7,0.9898440863313209,2,337,1,340
40260,backup,main,20220203,8,0.9905718350362367,2,377,0,379
40260,backup,main,20220203,9,0.9940468250952981,2,383,0,385
5569,dark,main,20220203,0,0.991509441692347,351,13,35,399
5569,dark,main,20220203,1,0.9920632779986136,319,11,35,365
5569,dark,main,20220203,2,0.994463606704525,318,13,51,382
5569,dark,main,20220203,3,0.991394195409266,298,13,44,355
5569,dark,main,20220203,4,0.9911003436210798,317,13,39,369
5569,dark,main,20220203,5,0.9876436912282724,324,13,53,390
5569,dark,main,20220203,6,0.99589128283215,337,14,44,395
5569,dark,main,20220203,7,0.989273546701222,275,16,29,320
5569,dark,main,20220203,8,0.9904408201436483,319,11,38,368
5569,dark,main,20220203,9,0.9898246637756073,341,13,49,403
23089,bright,main,20220203,0,0.988377855286623,337,92,4,433
23089,bright,main,20220203,1,0.9936728567983093,325,75,0,400
23089,bright,main,20220203,2,0.9916574710738719,285,152,4,441
23089,bright,main,20220203,3,0.992655651655822,315,81,5,401
23089,bright,main,20220203,4,0.9965289379947273,282,112,3,397
23089,bright,main,20220203,5,0.9898797507780343,273,133,6,412
23089,bright,main,20220203,6,0.9917699331745475,316,112,2,430
23089,bright,main,20220203,7,0.9918989741993847,251,122,4,377
23089,bright,main,20220203,8,0.991873979909062,320,99,3,422
23089,bright,main,20220203,9,0.993081487583465,349,83,5,437
5985,dark,main,20220203,0,0.9949179179339849,339,10,39,388
5985,dark,main,20220203,1,0.9867281170138205,292,11,38,341
5985,dark,main,20220203,2,0.992075224498765,306,13,52,371
5985,dark,main,20220203,3,0.9877128912294526,271,14,68,353
5985,dark,main,20220203,4,0.9864438131738844,245,13,83,341
5985,dark,main,20220203,5,0.988608640175121,277,16,75,368
5985,dark,main,20220203,6,0.9854856731195555,283,15,77,375
5985,dark,main,20220203,7,0.9933969838579731,258,16,55,329
5985,dark,main,20220203,8,0.9869650317343284,324,12,40,376
5985,dark,main,20220203,9,0.9925177165466129,319,14,48,381
41561,backup,main,20220203,0,0.993779380076367,0,387,2,389
41561,backup,main,20220203,1,0.9944481798240081,1,350,1,352
41561,backup,main,20220203,2,0.9950674537002845,4,380,2,386
41561,backup,main,20220203,3,0.9832868167623833,5,340,1,346
41561,backup,main,20220203,4,0.9877330880417272,5,341,1,347
41561,backup,main,20220203,5,0.9904307816069912,2,366,0,368
41561,backup,main,20220203,6,0.9889692747266581,2,365,0,367
41561,backup,main,20220203,7,0.9883539674810812,2,314,2,318
41561,backup,main,20220203,8,0.9911314747907608,4,366,0,370
41561,backup,main,20220203,9,0.9920387166776535,4,371,0,375
20270,bright,main,20220203,0,0.9962456544938637,314,125,2,441
20270,bright,main,20220203,1,0.9912994721786051,300,93,4,397
20270,bright,main,20220203,2,0.9922464795764782,350,72,5,427
20270,bright,main,20220203,3,0.9943759606410059,317,78,2,397
20270,bright,main,20220203,4,0.9939422501691246,303,83,5,391
20270,bright,main,20220203,5,0.9918271605823712,255,148,4,407
20270,bright,main,20220203,6,0.991359626944041,211,208,3,422
20270,bright,main,20220203,7,0.9911984538659051,168,196,3,367
20270,bright,main,20220203,8,0.9888258116417212,291,123,2,416
20270,bright,main,20220203,9,0.9895663123218421,314,110,2,426
7840,dark,main,20220203,0,0.9960538146425967,314,21,37,372
7840,dark,main,20220203,1,0.9942531833339024,297,19,29,345
7840,dark,main,20220203,2,0.9941511793587658,323,16,35,374
7840,dark,main,20220203,3,0.9896783592880302,296,14,40,350
7840,dark,main,20220203,4,0.9935762920608484,269,15,51,335
7840,dark,main,20220203,5,0.9762085569117508,96,4,9,109
7840,dark,main,20220203,6,0.9915923211253918,317,14,52,383
7840,dark,main,20220203,7,0.9901191637977236,237,24,47,308
7840,dark,main,20220203,8,0.9909362752988724,313,16,41,370
7840,dark,main,20220203,9,0.990470568580383,295,20,46,361
3939,dark,main,20220203,0,0.989694968617205,326,14,48,388
3939,dark,main,20220203,1,0.975900276275589,298,12,37,347
3939,dark,main,20220203,2,0.992694106453022,308,15,51,374
3939,dark,main,20220203,3,0.9925749332521292,308,15,34,357
3939,dark,main,20220203,4,0.99072912086945,267,23,52,342
3939,dark,main,20220203,5,0.9901629462853239,281,13,53,347
3939,dark,main,20220203,6,0.9858054126443391,303,13,48,364
3939,dark,main,20220203,7,0.9853919393077638,280,12,39,331
3939,dark,main,20220203,8,0.992740459779572,307,17,45,369
3939,dark,main,20220203,9,0.9906841166831772,298,15,44,357
23822,bright,main,20220203,0,0.9904505903126513,272,153,5,430
23822,bright,main,20220203,1,0.9885065267634693,231,154,5,390
23822,bright,main,20220203,2,0.9922383416799562,313,111,4,428
23822,bright,main,20220203,3,0.9933072649041361,237,145,4,386
23822,bright,main,20220203,4,0.9953759623398872,232,147,6,385
23822,bright,main,20220203,5,0.9923237236052724,263,136,5,404
23822,bright,main,20220203,6,0.9870009458851493,261,147,6,414
23822,bright,main,20220203,7,0.991520801971692,263,97,2,362
23822,bright,main,20220203,8,0.9918660412061348,278,138,0,416
23822,bright,main,20220203,9,0.9901561817231381,251,162,1,414
25381,bright,main,20220203,0,0.9944749042486526,310,112,3,425
25381,bright,main,20220203,1,0.9957631506547449,255,132,2,389
25381,bright,main,20220203,2,0.9900888340056494,242,161,8,411
25381,bright,main,20220203,3,0.9881505703407701,225,152,7,384
25381,bright,main,20220203,4,0.9925129967851473,214,163,6,383
25381,bright,main,20220203,5,0.9876881521884757,249,150,5,404
25381,bright,main,20220203,6,0.995758913658523,289,126,8,423
25381,bright,main,20220203,7,0.9923445357710116,257,99,4,360
25381,bright,main,20220203,8,0.9892898237951124,305,104,3,412
25381,bright,main,20220203,9,0.9921140390787513,321,97,3,421
23806,bright,main,20220203,0,0.9900601623213581,367,58,4,429
23806,bright,main,20220203,1,0.9934573300295507,297,83,1,381
23806,bright,main,20220203,2,0.9898250765334881,332,82,4,418
23806,bright,main,20220203,3,0.9892013276990208,289,78,3,370
23806,bright,main,20220203,4,0.9899142326478232,305,73,5,383
23806,bright,main,20220203,5,0.9897415239974243,336,61,4,401
23806,bright,main,20220203,6,0.9943396649258684,325,75,1,401
23806,bright,main,20220203,7,0.9916471919475074,282,72,3,357
23806,bright,main,20220203,8,0.9890119648169714,313,90,5,408
23806,bright,main,20220203,9,0.9935251547395254,346,58,10,414
26242,bright,main,20220203,0,0.99264952732664,306,125,8,439
26242,bright,main,20220203,1,0.9952454970571568,292,104,2,398
26242,bright,main,20220203,2,0.9935264235644182,320,114,2,436
26242,bright,main,20220203,3,0.9891066781730409,272,123,0,395
26242,bright,main,20220203,4,0.9963656146903411,281,103,6,390
26242,bright,main,20220203,5,0.9932863590746852,281,124,6,411
26242,bright,main,20220203,6,0.9954218147161891,282,141,5,428
26242,bright,main,20220203,7,0.9955238536691674,260,110,1,371
26242,bright,main,20220203,8,0.9945299994004355,301,112,6,419
26242,bright,main,20220203,9,0.9936159209904667,304,119,0,423
21568,bright,main,20220203,0,0.9893086501168026,276,142,5,423
21568,bright,main,20220203,1,0.9939453930770803,291,108,3,402
21568,bright,main,20220203,2,0.9917620906925841,314,108,4,426
21568,bright,main,20220203,3,0.990471039350912,234,156,2,392
21568,bright,main,20220203,4,0.9931587582308683,197,183,3,383
21568,bright,main,20220203,5,0.9910511713632916,227,179,4,410
21568,bright,main,20220203,6,0.995122866576038,253,172,1,426
21568,bright,main,20220203,7,0.989386480432775,263,99,6,368
21568,bright,main,20220203,8,0.9932577506072978,329,79,2,410
21568,bright,main,20220203,9,0.9923643110794369,283,142,6,431
41586,backup,main,20220203,0,0.9843384241739207,3,408,1,412
41586,backup,main,20220203,1,0.9946056999982258,1,360,0,361
41586,backup,main,20220203,2,0.9919177703166294,2,386,1,389
41586,backup,main,20220203,3,0.9938720627718904,2,354,2,358
41586,backup,main,20220203,4,0.9936987482527998,5,347,1,353
41586,backup,main,20220203,5,0.990245417683967,4,363,1,368
41586,backup,main,20220203,6,0.9897526857751836,6,371,1,378
41586,backup,main,20220203,7,0.9932877083940101,0,326,2,328
41586,backup,main,20220203,8,0.9947123869033566,1,389,0,390
41586,backup,main,20220203,9,0.9943260936653826,2,389,1,392
40579,backup,main,20220203,0,0.9936736283786473,5,408,1,414
40579,backup,main,20220203,1,0.9898364794070975,8,357,2,367
40579,backup,main,20220203,2,0.9884579690993796,6,385,1,392
40579,backup,main,20220203,3,0.9899142831596127,9,357,0,366
40579,backup,main,20220203,4,0.9934699208396158,3,351,1,355
40579,backup,main,20220203,5,0.9908121292515746,4,377,1,382
40579,backup,main,20220203,6,0.9910140553768529,3,382,2,387
40579,backup,main,20220203,7,0.9866435572999823,3,341,1,345
40579,backup,main,20220203,8,0.9907710567657834,6,391,0,397
40579,backup,main,20220203,9,0.9956336086301908,4,392,3,399
41574,backup,main,20220203,0,0.9943365041333472,6,401,0,407
41574,backup,main,20220203,1,0.9952497011585641,4,367,1,372
41574,backup,main,20220203,2,0.9843053526368797,1,399,1,401
41574,backup,main,20220203,3,0.9856992408506624,6,370,0,376
41574,backup,main,20220203,4,0.9864560308329032,1,350,1,352
41574,backup,main,20220203,5,0.9885989306924609,3,374,2,379
41574,backup,main,20220203,6,0.9944264367979234,1,387,0,388
41574,backup,main,20220203,7,0.9868858714454793,3,331,0,334
41574,backup,main,20220203,8,0.9929830847921892,2,376,1,379
41574,backup,main,20220203,9,0.9858018557271575,3,392,1,396
24807,bright,main,20220203,0,0.9951172640152149,299,136,2,437
24807,bright,main,20220203,1,0.9943098268744116,256,139,2,397
24807,bright,main,20220203,2,0.9969093366671662,292,142,5,439
24807,bright,main,20220203,3,0.9928789648251531,195,195,4,394
24807,bright,main,20220203,4,0.9916575395834156,224,164,2,390
24807,bright,main,20220203,5,0.9957489113237725,195,215,4,414
24807,bright,main,20220203,6,0.9917231927866161,279,149,3,431
24807,bright,main,20220203,7,0.994272244963049,262,106,4,372
24807,bright,main,20220203,8,0.9899929722857735,299,116,3,418
24807,bright,main,20220203,9,0.9874923522150882,293,135,5,433
21510,bright,main,20220204,0,0.9940370821337674,214,216,3,433
21510,bright,main,20220204,1,0.993722992255916,214,189,1,404
21510,bright,main,20220204,2,0.9949995441896605,204,221,5,430
21510,bright,main,20220204,3,0.9926712318409059,146,250,3,399
21510,bright,main,20220204,4,0.9874632399510764,185,202,3,390
21510,bright,main,20220204,5,0.9910048541834517,194,209,8,411
21510,bright,main,20220204,6,0.9923578492047536,272,151,4,427
21510,bright,main,20220204,7,0.9876820767740003,213,150,2,365
21510,bright,main,20220204,8,0.9882730364189216,291,129,3,423
21510,bright,main,20220204,9,0.995227982166295,200,224,3,427
8370,dark,main,20220204,0,0.9941564010757441,243,18,92,353
8370,dark,main,20220204,1,0.9843509843832978,231,25,86,342
8370,dark,main,20220204,2,0.9935946469066452,251,26,92,369
8370,dark,main,20220204,3,0.9819412485907815,244,14,81,339
8370,dark,main,20220204,4,0.9884788870896509,241,16,71,328
8370,dark,main,20220204,5,0.9874045966537212,249,18,87,354
8370,dark,main,20220204,6,0.987923464435934,251,22,87,360
8370,dark,main,20220204,7,0.9937511033668572,236,20,74,330
8370,dark,main,20220204,8,0.99001806451882,258,17,87,362
8370,dark,main,20220204,9,0.9896079464839906,260,21,95,376
23221,bright,main,20220204,0,0.9955110828400097,304,140,2,446
23221,bright,main,20220204,1,0.9878851940462201,328,73,4,405
23221,bright,main,20220204,2,0.9942763534724077,308,121,5,434
23221,bright,main,20220204,3,0.991780912614656,233,170,2,405
23221,bright,main,20220204,4,0.9915459154141931,265,129,2,396
23221,bright,main,20220204,5,0.9933924063460872,246,161,6,413
23221,bright,main,20220204,6,0.991679905335439,254,171,5,430
23221,bright,main,20220204,7,0.9904208603742481,225,136,8,369
23221,bright,main,20220204,8,0.9954677424529915,267,152,3,422
23221,bright,main,20220204,9,0.9961956806796682,271,157,1,429
1277,dark,main,20220204,0,0.9901905851162074,298,22,61,381
1277,dark,main,20220204,1,0.9957992035773584,298,12,55,365
1277,dark,main,20220204,2,0.9913069497607506,325,12,52,389
1277,dark,main,20220204,3,0.9914603792176202,299,15,42,356
1277,dark,main,20220204,4,0.9893858800672124,312,14,20,346
1277,dark,main,20220204,5,0.986940012162151,289,12,51,352
1277,dark,main,20220204,6,0.995271972375725,301,12,75,388
1277,dark,main,20220204,7,0.9872509408790885,297,11,35,343
1277,dark,main,20220204,8,0.9905916037657285,316,10,42,368
1277,dark,main,20220204,9,0.9961426464477565,326,12,43,381
25028,bright,main,20220204,0,0.9933091183329223,214,225,6,445
25028,bright,main,20220204,1,0.9959805247481128,289,112,2,403
25028,bright,main,20220204,2,0.9955122948204683,349,88,2,439
25028,bright,main,20220204,3,0.9919127621322368,284,109,7,400
25028,bright,main,20220204,4,0.9875266546286245,292,96,7,395
25028,bright,main,20220204,5,0.993843129626779,309,104,3,416
25028,bright,main,20220204,6,0.9885902204929921,315,110,2,427
25028,bright,main,20220204,7,0.9913073027323407,302,71,2,375
25028,bright,main,20220204,8,0.9939536545454127,326,94,2,422
25028,bright,main,20220204,9,0.990146510358333,275,160,0,435
21424,bright,main,20220204,0,0.9891037347646258,363,68,2,433
21424,bright,main,20220204,1,0.9926255485488099,294,71,2,367
21424,bright,main,20220204,2,0.9891067969272694,321,92,3,416
21424,bright,main,20220204,3,0.9886345714294359,312,71,2,385
21424,bright,main,20220204,4,0.9914628370986863,296,72,5,373
21424,bright,main,20220204,5,0.9883783417805097,265,128,4,397
21424,bright,main,20220204,6,0.9869489390376381,261,145,5,411
21424,bright,main,20220204,7,0.9901222868583297,239,114,8,361
21424,bright,main,20220204,8,0.9918714895981097,313,93,2,408
21424,bright,main,20220204,9,0.9837196549333559,302,110,4,416
10342,dark,main,20220204,0,0.9886702037251751,302,17,50,369
10342,dark,main,20220204,1,0.9910303567254347,297,15,51,363
10342,dark,main,20220204,2,0.9864295278632045,318,18,56,392
10342,dark,main,20220204,3,0.9865748509999215,300,14,44,358
10342,dark,main,20220204,4,0.9916540004364875,299,16,35,350
10342,dark,main,20220204,5,0.9914209820909635,312,12,50,374
10342,dark,main,20220204,6,0.987954697532922,319,11,42,372
10342,dark,main,20220204,7,0.98746739402127,270,13,48,331
10342,dark,main,20220204,8,0.994007166567618,280,15,70,365
10342,dark,main,20220204,9,0.9906503397139863,328,11,51,390
23053,bright,main,20220204,0,0.9909038164178755,288,143,5,436
23053,bright,main,20220204,1,0.9942046653071582,293,103,6,402
23053,bright,main,20220204,2,0.9904619726803634,266,159,6,431
23053,bright,main,20220204,3,0.9884816064423414,245,149,3,397
23053,bright,main,20220204,4,0.9907734175338648,268,128,2,398
23053,bright,main,20220204,5,0.9950164803848215,277,132,4,413
23053,bright,main,20220204,6,0.9922265377485154,296,138,0,434
23053,bright,main,20220204,7,0.9845914151612655,292,78,2,372
23053,bright,main,20220204,8,0.990582628932357,287,125,5,417
23053,bright,main,20220204,9,0.9906954627748259,285,139,5,429
1498,dark,main,20220204,0,0.9923643314332923,330,13,50,393
1498,dark,main,20220204,1,0.9895873113798077,292,11,57,360
1498,dark,main,20220204,2,0.9908509404193917,283,17,92,392
1498,dark,main,20220204,3,0.9893774210691745,257,16,77,350
1498,dark,main,20220204,4,0.9886714843341626,260,13,68,341
1498,dark,main,20220204,5,0.9946801291626232,274,11,91,376
1498,dark,main,20220204,6,0.9919056306384968,303,17,55,375
1498,dark,main,20220204,7,0.990667980790837,277,14,38,329
1498,dark,main,20220204,8,0.9951372969249498,316,14,43,373
1498,dark,main,20220204,9,0.9944386929901965,340,11,33,384
11762,dark,main,20220204,0,0.9889268931186537,342,24,29,395
11762,dark,main,20220204,1,0.9888285099577989,294,18,43,355
11762,dark,main,20220204,2,0.9872266780107805,319,17,52,388
11762,dark,main,20220204,3,0.9914708153070697,297,13,41,351
11762,dark,main,20220204,4,0.9935384262834579,295,12,39,346
11762,dark,main,20220204,5,0.9872146005137146,303,14,38,355
11762,dark,main,20220204,6,0.9970354724713509,305,18,49,372
11762,dark,main,20220204,7,0.9886295166237455,266,17,39,322
11762,dark,main,20220204,8,0.9947823482806185,316,27,40,383
11762,dark,main,20220204,9,0.9895273428655351,331,28,28,387
10369,dark,main,20220204,0,0.9893528680028039,308,19,44,371
10369,dark,main,20220204,1,0.9913490189710743,296,21,33,350
10369,dark,main,20220204,2,0.9864516520441343,321,17,37,375
10369,dark,main,20220204,3,0.9894218951299308,304,17,38,359
10369,dark,main,20220204,4,0.994890179728881,285,19,34,338
10369,dark,main,20220204,5,0.9965861327204074,312,23,34,369
10369,dark,main,20220204,6,0.9905429292844478,312,20,45,377
10369,dark,main,20220204,7,0.9894081479189666,283,19,29,331
10369,dark,main,20220204,8,0.9858719401092563,297,24,36,357
10369,dark,main,20220204,9,0.9873124310787221,321,23,41,385
7390,dark,main,20220204,0,0.9962400539025491,289,20,65,374
7390,dark,main,20220204,1,0.9882103608009544,265,16,67,348
7390,dark,main,20220204,2,0.9933126672499983,304,13,60,377
7390,dark,main,20220204,3,0.9927519649078125,263,15,63,341
7390,dark,main,20220204,4,0.9801892353305557,270,15,55,340
7390,dark,main,20220204,5,0.9925984461424581,252,16,75,343
7390,dark,main,20220204,6,0.9942282432368982,264,16,63,343
7390,dark,main,20220204,7,0.9917819405245816,227,20,62,309
7390,dark,main,20220204,8,0.9946796284137155,263,22,70,355
7390,dark,main,20220204,9,0.9919118264467773,264,22,63,349
24570,bright,main,20220204,0,0.9948631120787452,301,133,3,437
24570,bright,main,20220204,1,0.9890576666359769,273,115,5,393
24570,bright,main,20220204,2,0.9900300659448475,262,152,4,418
24570,bright,main,20220204,3,0.9941043929556416,252,131,8,391
24570,bright,main,20220204,4,0.99127643262533,240,136,5,381
24570,bright,main,20220204,5,0.9952173590888773,287,119,2,408
24570,bright,main,20220204,6,0.9809945548915991,246,168,4,418
24570,bright,main,20220204,7,0.9920233798681125,143,215,4,362
24570,bright,main,20220204,8,0.992891560381869,267,136,6,409
24570,bright,main,20220204,9,0.9848303832427644,296,130,2,428
3015,dark,main,20220204,0,0.9939512102369468,300,10,64,374
3015,dark,main,20220204,1,0.9883535531814075,265,17,75,357
3015,dark,main,20220204,2,0.988259378166724,284,18,92,394
3015,dark,main,20220204,3,0.9921961758332755,251,16,74,341
3015,dark,main,20220204,4,0.9913701673738983,274,15,52,341
3015,dark,main,20220204,5,0.991585769136804,317,12,44,373
3015,dark,main,20220204,6,0.9919483146817802,312,12,38,362
3015,dark,main,20220204,7,0.9912774169117942,287,14,29,330
3015,dark,main,20220204,8,0.9916859564604111,303,14,37,354
3015,dark,main,20220204,9,0.9864319432779846,313,12,51,376
3683,dark,main,20220204,0,0.995297952779067,309,19,61,389
3683,dark,main,20220204,1,0.990062015619946,262,17,71,350
3683,dark,main,20220204,2,0.9931192812395278,317,17,47,381
3683,dark,main,20220204,3,0.9919137338437232,281,16,59,356
3683,dark,main,20220204,4,0.9824548535273319,253,14,63,330
3683,dark,main,20220204,5,0.9886423636607229,266,15,82,363
3683,dark,main,20220204,6,0.9906894205980603,258,16,92,366
3683,dark,main,20220204,7,0.993563114265055,245,21,67,333
3683,dark,main,20220204,8,0.9851542383452659,244,19,104,367
3683,dark,main,20220204,9,0.9855873254495634,283,20,79,382
2568,dark,main,20220204,0,0.9907958441972472,319,16,46,381
2568,dark,main,20220204,1,0.9853804672488051,289,13,49,351
2568,dark,main,20220204,2,0.9888448864423746,304,17,56,377
2568,dark,main,20220204,3,0.9929334981563207,300,16,43,359
2568,dark,main,20220204,4,0.9819094861063189,281,11,44,336
2568,dark,main,20220204,5,0.9950159723547263,305,11,51,367
2568,dark,main,20220204,6,0.9959469357571412,321,11,52,384
2568,dark,main,20220204,7,0.987773246215323,275,12,49,336
2568,dark,main,20220204,8,0.9924665544229767,299,10,38,347
2568,dark,main,20220204,9,0.9922002996592725,336,11,52,399
9285,dark,main,20220204,0,0.9903669159382165,334,14,39,387
9285,dark,main,20220204,1,0.991649967393639,300,11,27,338
9285,dark,main,20220204,2,0.9933029828940029,316,12,47,375
9285,dark,main,20220204,3,0.9935391679838593,297,14,50,361
9285,dark,main,20220204,4,0.9916652045728431,290,10,44,344
9285,dark,main,20220204,5,0.9934939023340521,281,11,55,347
9285,dark,main,20220204,6,0.9923829107176474,313,14,41,368
9285,dark,main,20220204,7,0.9897594668652798,281,16,43,340
9285,dark,main,20220204,8,0.9926242733569891,320,14,43,377
9285,dark,main,20220204,9,0.9927530199495529,329,12,39,380
4088,dark,main,20220204,0,0.9907499804991423,314,14,54,382
4088,dark,main,20220204,1,0.9927028158622357,283,13,50,346
4088,dark,main,20220204,2,0.9915280249170613,326,14,37,377
4088,dark,main,20220204,3,0.9868444406132802,302,15,40,357
4088,dark,main,20220204,4,0.9901719772761143,301,13,33,347
4088,dark,main,20220204,5,0.9934550046685551,303,19,43,365
4088,dark,main,20220204,6,0.9863459072962287,301,15,48,364
4088,dark,main,20220204,7,0.991626495406377,268,14,50,332
4088,dark,main,20220204,8,0.988778421984888,294,19,53,366
4088,dark,main,20220204,9,0.9949284508489553,327,14,45,386
3696,dark,main,20220204,0,0.9945286713585838,301,17,65,383
3696,dark,main,20220204,1,0.9918431101840913,291,13,48,352
3696,dark,main,20220204,2,0.9899475026265979,322,11,48,381
3696,dark,main,20220204,3,0.9906880189632513,288,13,47,348
3696,dark,main,20220204,4,0.9966555685754439,275,14,56,345
3696,dark,main,20220204,5,0.9907487036749214,263,16,84,363
3696,dark,main,20220204,6,0.9960285467186032,299,17,68,384
3696,dark,main,20220204,7,0.9896656901443408,266,15,56,337
3696,dark,main,20220204,8,0.9888456781138719,288,11,65,364
3696,dark,main,20220204,9,0.9869756085163156,292,16,68,376
6279,dark,main,20220204,0,0.9934059680918458,315,10,52,377
6279,dark,main,20220204,1,0.9962716906723522,256,19,74,349
6279,dark,main,20220204,2,0.9869968823495894,259,15,86,360
6279,dark,main,20220204,3,0.992747278061406,244,17,88,349
6279,dark,main,20220204,4,0.9879467977782113,257,16,77,350
6279,dark,main,20220204,5,0.9884923267820886,281,13,70,364
6279,dark,main,20220204,6,0.9824256568769134,287,11,79,377
6279,dark,main,20220204,7,0.9857332509767881,255,13,73,341
6279,dark,main,20220204,8,0.9873183111030719,270,15,78,363
6279,dark,main,20220204,9,0.9856551015999125,274,22,68,364
3952,dark,main,20220204,0,0.9904395157660925,312,17,51,380
3952,dark,main,20220204,1,0.9954591352261973,308,13,41,362
3952,dark,main,20220204,2,0.9939286924939403,336,20,27,383
3952,dark,main,20220204,3,0.991655452604075,318,22,20,360
3952,dark,main,20220204,4,0.9815859322099693,284,18,40,342
3952,dark,main,20220204,5,0.9898709839565873,286,19,48,353
3952,dark,main,20220204,6,0.9939394135083756,314,13,43,370
3952,dark,main,20220204,7,0.9926540664120443,271,19,41,331
3952,dark,main,20220204,8,0.9874290056060535,301,12,51,364
3952,dark,main,20220204,9,0.9952756284767569,322,15,40,377
23001,bright,main,20220204,0,0.9906682622946623,246,177,3,426
23001,bright,main,20220204,1,0.9952185071173398,245,124,2,371
23001,bright,main,20220204,2,0.9935051434067438,296,119,8,423
23001,bright,main,20220204,3,0.9902588697870625,286,103,2,391
23001,bright,main,20220204,4,0.992183900309066,317,66,5,388
23001,bright,main,20220204,5,0.9927042197178809,323,74,3,400
23001,bright,main,20220204,6,0.9897008392161809,305,110,2,417
23001,bright,main,20220204,7,0.9834703914892183,249,95,8,352
23001,bright,main,20220204,8,0.9946396067741454,265,129,4,398
23001,bright,main,20220204,9,0.9881312898233438,298,117,9,424
2681,dark,main,20220204,0,0.9951615483656711,258,21,67,346
2681,dark,main,20220204,1,0.9907583519155929,253,15,60,328
2681,dark,main,20220204,2,0.994060547191577,270,15,68,353
2681,dark,main,20220204,3,0.982753040877878,226,20,74,320
2681,dark,main,20220204,4,0.9925431900666578,263,13,56,332
2681,dark,main,20220204,5,0.9945872740879577,275,12,56,343
2681,dark,main,20220204,6,0.9914118983398933,280,20,66,366
2681,dark,main,20220204,7,0.9842648703672487,253,17,50,320
2681,dark,main,20220204,8,0.994450415187531,275,15,59,349
2681,dark,main,20220204,9,0.9886397068629965,270,20,65,355
6275,dark,main,20220204,0,0.9917511637523347,277,15,71,363
6275,dark,main,20220204,1,0.9904278779830005,267,13,74,354
6275,dark,main,20220204,2,0.990948706720163,248,14,104,366
6275,dark,main,20220204,3,0.9942110972331761,262,13,78,353
6275,dark,main,20220204,4,0.9866399293485082,232,19,79,330
6275,dark,main,20220204,5,0.9876573050800196,249,16,96,361
6275,dark,main,20220204,6,0.9867332139407475,238,15,102,355
6275,dark,main,20220204,7,0.990796871493096,226,26,75,327
6275,dark,main,20220204,8,0.9941875346960949,271,14,78,363
6275,dark,main,20220204,9,0.99323841132999,283,22,69,374
41533,backup,main,20220205,0,0.9849336984948712,2,444,0,446
41533,backup,main,20220205,1,0.9960916886294245,30,377,0,407
41533,backup,main,20220205,2,0.9929385039706319,27,416,0,443
41533,backup,main,20220205,3,0.9936377772161145,39,368,0,407
41533,backup,main,20220205,4,0.9885445794929363,7,394,0,401
41533,backup,main,20220205,5,0.9956626582484334,3,419,0,422
41533,backup,main,20220205,6,0.9881428960291364,1,436,0,437
41533,backup,main,20220205,7,0.9885206607178904,5,374,0,379
41533,backup,main,20220205,8,0.9926858344084059,18,408,0,426
41533,backup,main,20220205,9,0.9939681104441216,8,431,0,439
10492,dark,main,20220205,0,0.9866353770827659,284,18,63,365
10492,dark,main,20220205,1,0.9895466629904426,277,16,58,351
10492,dark,main,20220205,2,0.9941543856563395,279,20,75,374
10492,dark,main,20220205,3,0.9953100579832131,237,16,77,330
10492,dark,main,20220205,4,0.9858453921755284,254,13,48,315
10492,dark,main,20220205,5,0.9924804891963082,264,17,52,333
10492,dark,main,20220205,6,0.992094951842781,271,15,67,353
10492,dark,main,20220205,7,0.9853414938107993,226,24,60,310
10492,dark,main,20220205,8,0.9882809032224528,287,18,54,359
10492,dark,main,20220205,9,0.9890534726667797,289,15,67,371
10348,dark,main,20220205,0,0.9927219256743453,321,16,51,388
10348,dark,main,20220205,1,0.9929106660456097,293,17,47,357
10348,dark,main,20220205,2,0.9919405536159689,308,17,57,382
10348,dark,main,20220205,3,0.9926325590538171,303,14,50,367
10348,dark,main,20220205,4,0.9835317586481047,286,18,40,344
10348,dark,main,20220205,5,0.9872869138171237,292,19,52,363
10348,dark,main,20220205,6,0.9923824524674305,311,18,47,376
10348,dark,main,20220205,7,0.983280682559707,245,15,71,331
10348,dark,main,20220205,8,0.9922067703082088,289,18,69,376
10348,dark,main,20220205,9,0.9948339257877249,317,18,55,390
21491,bright,main,20220205,0,0.9928784767274192,301,129,5,435
21491,bright,main,20220205,1,0.9870263402855429,258,131,8,397
21491,bright,main,20220205,2,0.9948452027702027,336,91,6,433
21491,bright,main,20220205,3,0.9917748556592967,315,81,4,400
21491,bright,main,20220205,4,0.985919246111333,246,144,7,397
21491,bright,main,20220205,5,0.9938518279752945,254,149,6,409
21491,bright,main,20220205,6,0.9968763174512595,289,137,2,428
21491,bright,main,20220205,7,0.9886761480326359,243,126,2,371
21491,bright,main,20220205,8,0.9940026384854351,289,131,3,423
21491,bright,main,20220205,9,0.9906134938271811,306,120,7,433
21482,bright,main,20220205,0,0.9924029274160119,292,145,3,440
21482,bright,main,20220205,1,0.9903196880915198,274,117,6,397
21482,bright,main,20220205,2,0.9873535594691106,328,96,4,428
21482,bright,main,20220205,3,0.9889828288622206,278,119,3,400
21482,bright,main,20220205,4,0.9899922190312858,289,102,5,396
21482,bright,main,20220205,5,0.9860012066451193,309,96,7,412
21482,bright,main,20220205,6,0.9901287893711727,281,148,3,432
21482,bright,main,20220205,7,0.9919126620724894,222,149,2,373
21482,bright,main,20220205,8,0.9929756686113514,324,92,3,419
21482,bright,main,20220205,9,0.9934259033118695,343,85,6,434
7176,dark,main,20220205,0,0.989393480948605,316,11,78,405
7176,dark,main,20220205,1,0.9905827523499413,295,16,56,367
7176,dark,main,20220205,2,0.9938946389353698,320,15,59,394
7176,dark,main,20220205,3,0.9952779130949502,311,12,41,364
7176,dark,main,20220205,4,0.9873362331574644,296,11,53,360
7176,dark,main,20220205,5,0.9951390407371372,312,13,57,382
7176,dark,main,20220205,6,0.9888080034352206,320,13,69,402
7176,dark,main,20220205,7,0.9928659497077827,305,16,31,352
7176,dark,main,20220205,8,0.994873486254512,324,14,58,396
7176,dark,main,20220205,9,0.9911775547153866,319,13,63,395
23091,bright,main,20220205,0,0.9921064813517149,276,157,2,435
23091,bright,main,20220205,1,0.9892308158876921,239,159,5,403
23091,bright,main,20220205,2,0.9930484825983475,241,197,0,438
23091,bright,main,20220205,3,0.9917037839392239,230,162,6,398
23091,bright,main,20220205,4,0.9947040937237371,193,200,5,398
23091,bright,main,20220205,5,0.992653090572234,175,239,3,417
23091,bright,main,20220205,6,0.9901758897874848,221,203,4,428
23091,bright,main,20220205,7,0.9926635219312322,210,162,4,376
23091,bright,main,20220205,8,0.9969273166680779,235,179,6,420
23091,bright,main,20220205,9,0.994978482917019,270,162,5,437
1008,dark,main,20220205,0,0.9919564366116886,334,14,51,399
1008,dark,main,20220205,1,0.9959123477271583,286,12,62,360
1008,dark,main,20220205,2,0.9937017950186336,329,15,41,385
1008,dark,main,20220205,3,0.9934054096231795,311,14,39,364
1008,dark,main,20220205,4,0.9936614751557908,281,11,53,345
1008,dark,main,20220205,5,0.9925635871620698,292,13,58,363
1008,dark,main,20220205,6,0.9960244670645256,316,18,35,369
1008,dark,main,20220205,7,0.9892774895920253,271,11,48,330
1008,dark,main,20220205,8,0.9872472600849217,313,12,52,377
1008,dark,main,20220205,9,0.9911868064553816,315,12,59,386
7264,dark,main,20220205,0,0.9927526633465334,292,22,61,375
7264,dark,main,20220205,1,0.9929944029902807,276,12,59,347
7264,dark,main,20220205,2,0.9861538001259823,296,17,65,378
7264,dark,main,20220205,3,0.9917434025030378,275,14,58,347
7264,dark,main,20220205,4,0.9903867908621402,254,20,59,333
7264,dark,main,20220205,5,0.9902374780345374,245,18,80,343
7264,dark,main,20220205,6,0.9846051620388857,275,17,61,353
7264,dark,main,20220205,7,0.9874232592785759,227,17,75,319
7264,dark,main,20220205,8,0.9833502831502858,265,16,80,361
7264,dark,main,20220205,9,0.9916263471625134,283,18,80,381
7856,dark,main,20220205,0,0.9908658552936044,280,16,83,379
7856,dark,main,20220205,1,0.9885812145077489,268,18,56,342
7856,dark,main,20220205,2,0.9910900624325298,315,16,67,398
7856,dark,main,20220205,3,0.9911345561362809,274,13,65,352
7856,dark,main,20220205,4,0.9931014352739761,257,18,76,351
7856,dark,main,20220205,5,0.9961715001157865,261,28,87,376
7856,dark,main,20220205,6,0.9883179603878365,298,20,70,388
7856,dark,main,20220205,7,0.9952645867690838,236,17,76,329
7856,dark,main,20220205,8,0.9877371921868462,252,23,94,369
7856,dark,main,20220205,9,0.9856988613248382,268,23,89,380
10341,dark,main,20220205,0,0.9929717895852267,308,21,44,373
10341,dark,main,20220205,1,0.994161470348287,283,15,35,333
10341,dark,main,20220205,2,0.9876664292147407,320,21,42,383
10341,dark,main,20220205,3,0.9902610146162374,282,17,41,340
10341,dark,main,20220205,4,0.9874291161971537,286,10,31,327
10341,dark,main,20220205,5,0.9875857348058154,310,14,40,364
10341,dark,main,20220205,6,0.9896399244230347,320,13,41,374
10341,dark,main,20220205,7,0.9918006477577929,288,14,42,344
10341,dark,main,20220205,8,0.9939706780560909,318,15,42,375
10341,dark,main,20220205,9,0.9945688122139936,325,14,37,376
7213,dark,main,20220205,0,0.9876291308810012,326,23,38,387
7213,dark,main,20220205,1,0.9934656196665864,300,16,33,349
7213,dark,main,20220205,2,0.9942812060665053,308,16,40,364
7213,dark,main,20220205,3,0.9875903939447993,303,19,37,359
7213,dark,main,20220205,4,0.9926987799402104,299,14,36,349
7213,dark,main,20220205,5,0.9777229670380804,300,17,44,361
7213,dark,main,20220205,6,0.9889616186949831,300,13,50,363
7213,dark,main,20220205,7,0.9817339710667042,270,14,43,327
7213,dark,main,20220205,8,0.9813592249451013,309,15,38,362
7213,dark,main,20220205,9,0.9908451736156146,310,13,55,378
10346,dark,main,20220205,0,0.9927276363582639,312,19,49,380
10346,dark,main,20220205,1,0.9863562255602177,287,14,45,346
10346,dark,main,20220205,2,0.9872210266312984,308,16,53,377
10346,dark,main,20220205,3,0.9913345495263606,295,18,34,347
10346,dark,main,20220205,4,0.9905925085152835,280,17,37,334
10346,dark,main,20220205,5,0.9902905981109303,296,16,44,356
10346,dark,main,20220205,6,0.9920933969272292,302,15,45,362
10346,dark,main,20220205,7,0.9906649756666407,277,11,42,330
10346,dark,main,20220205,8,0.9907638937867719,287,14,51,352
10346,dark,main,20220205,9,0.9940318520887903,301,16,46,363
7267,dark,main,20220205,0,0.9937913356565303,322,14,55,391
7267,dark,main,20220205,1,0.9890617549930677,271,15,53,339
7267,dark,main,20220205,2,0.9818598547070642,306,14,41,361
7267,dark,main,20220205,3,0.994399890381585,291,17,43,351
7267,dark,main,20220205,4,0.9917652553860012,293,15,44,352
7267,dark,main,20220205,5,0.9931343835869125,296,10,49,355
7267,dark,main,20220205,6,0.9912519763592356,275,16,81,372
7267,dark,main,20220205,7,0.9794747115353439,238,21,60,319
7267,dark,main,20220205,8,0.9949312757427464,299,21,41,361
7267,dark,main,20220205,9,0.9925680458609601,292,12,61,365
2481,dark,main,20220205,0,0.9944347873421842,316,14,43,373
2481,dark,main,20220205,1,0.9907831276750991,312,12,32,356
2481,dark,main,20220205,2,0.9943258634639074,326,12,36,374
2481,dark,main,20220205,3,0.9919106940068755,294,16,41,351
2481,dark,main,20220205,4,0.9840144462206628,289,16,48,353
2481,dark,main,20220205,5,0.994609811875891,291,18,46,355
2481,dark,main,20220205,6,0.9899380285093157,328,14,39,381
2481,dark,main,20220205,7,0.9867208343480668,294,15,32,341
2481,dark,main,20220205,8,0.9952866875302285,292,22,49,363
2481,dark,main,20220205,9,0.9933600447510075,335,11,40,386
2662,dark,main,20220205,0,0.981962024623291,270,19,72,361
2662,dark,main,20220205,1,0.9914674378887749,247,11,65,323
2662,dark,main,20220205,2,0.9897399305539649,275,16,68,359
2662,dark,main,20220205,3,0.9864151457748381,249,18,66,333
2662,dark,main,20220205,4,0.991575810665652,252,18,69,339
2662,dark,main,20220205,5,0.9943470580894805,282,16,60,358
2662,dark,main,20220205,6,0.989126987937683,286,18,67,371
2662,dark,main,20220205,7,0.9852386659572077,249,16,48,313
2662,dark,main,20220205,8,0.9957436847582642,267,13,55,335
2662,dark,main,20220205,9,0.9822845593210193,245,27,84,356
23223,bright,main,20220205,0,0.9909981342095862,298,128,1,427
23223,bright,main,20220205,1,0.9874802502603193,301,89,5,395
23223,bright,main,20220205,2,0.9911583275710187,284,145,5,434
23223,bright,main,20220205,3,0.9911071655398264,243,156,0,399
23223,bright,main,20220205,4,0.9883090260482601,286,104,5,395
23223,bright,main,20220205,5,0.9940154014026805,289,123,3,415
23223,bright,main,20220205,6,0.9914632750512994,252,176,0,428
23223,bright,main,20220205,7,0.9900212320326449,210,157,5,372
23223,bright,main,20220205,8,0.994169006983099,223,187,6,416
23223,bright,main,20220205,9,0.9930902058529794,272,149,7,428
9283,dark,main,20220205,3,0.989697540192323,282,13,50,345
9283,dark,main,20220205,4,0.989697540192323,282,13,50,345
9283,dark,main,20220205,5,0.989697540192323,282,13,50,345
9283,dark,main,20220205,6,0.989697540192323,282,13,50,345
9283,dark,main,20220205,7,0.9949649519974237,277,15,50,342
9283,dark,main,20220205,8,0.996188457589453,282,16,59,357
9283,dark,main,20220205,9,0.9891534682910946,314,11,52,377
3013,dark,main,20220205,0,0.9950038455703077,315,14,65,394
3013,dark,main,20220205,1,0.9920365658461409,268,17,73,358
3013,dark,main,20220205,2,0.9912838478107666,318,13,64,395
3013,dark,main,20220205,3,0.9910338888073897,262,18,79,359
3013,dark,main,20220205,4,0.9915690504521137,247,15,83,345
3013,dark,main,20220205,5,0.9871472484805593,277,14,75,366
3013,dark,main,20220205,6,0.9954041191537818,317,16,56,389
3013,dark,main,20220205,7,0.9874011719037867,271,12,51,334
3013,dark,main,20220205,8,0.9922757459483528,270,24,79,373
3013,dark,main,20220205,9,0.9927338519930177,338,12,42,392
1459,dark,main,20220205,0,0.9932760837062636,294,14,80,388
1459,dark,main,20220205,1,0.9939665811918607,294,14,54,362
1459,dark,main,20220205,2,0.9915419606198583,302,19,67,388
1459,dark,main,20220205,3,0.9910880032013035,281,11,67,359
1459,dark,main,20220205,4,0.9959681426701835,272,15,62,349
1459,dark,main,20220205,5,0.9917518155912016,290,14,56,360
1459,dark,main,20220205,6,0.9923442367869083,313,15,50,378
1459,dark,main,20220205,7,0.9923268630236608,264,11,48,323
1459,dark,main,20220205,8,0.991796940930612,313,13,42,368
1459,dark,main,20220205,9,0.9929067664709756,309,12,64,385
7257,dark,main,20220205,0,0.9924537698578135,316,11,47,374
7257,dark,main,20220205,1,0.986211526175688,285,17,38,340
7257,dark,main,20220205,2,0.9932952924034846,298,21,47,366
7257,dark,main,20220205,3,0.9901465664862702,287,18,43,348
7257,dark,main,20220205,4,0.9936651546136517,286,14,38,338
7257,dark,main,20220205,5,0.9881890564576203,310,13,36,359
7257,dark,main,20220205,6,0.9916765155862495,306,13,48,367
7257,dark,main,20220205,7,0.9909494136273536,272,12,38,322
7257,dark,main,20220205,8,0.9926852205227783,287,13,49,349
7257,dark,main,20220205,9,0.9955471524882543,314,19,43,376
1579,dark,main,20220205,0,0.9910087241824229,268,19,94,381
1579,dark,main,20220205,1,0.9933986480086271,254,16,78,348
1579,dark,main,20220205,2,0.9952268139998216,320,15,67,402
1579,dark,main,20220205,3,0.9916538075196198,262,14,64,340
1579,dark,main,20220205,4,0.9962759153421473,291,14,59,364
1579,dark,main,20220205,5,0.9955432590279203,265,23,82,370
1579,dark,main,20220205,6,0.9957665907719473,279,13,91,383
1579,dark,main,20220205,7,0.9948760777042505,248,17,68,333
1579,dark,main,20220205,8,0.9889724011286205,298,16,65,379
1579,dark,main,20220205,9,0.9828127904802806,268,21,96,385
3700,dark,main,20220205,0,0.9959209919367625,263,19,106,388
3700,dark,main,20220205,1,0.9949587850046716,249,23,82,354
3700,dark,main,20220205,2,0.9918924369651808,265,25,91,381
3700,dark,main,20220205,3,0.9904243118616278,248,16,91,355
3700,dark,main,20220205,4,0.9970136253703863,242,20,76,338
3700,dark,main,20220205,5,0.9910821456404949,244,17,88,349
3700,dark,main,20220205,6,0.9913967445645668,240,17,100,357
3700,dark,main,20220205,7,0.9879428799768095,230,14,87,331
3700,dark,main,20220205,8,0.9956907167242336,270,23,75,368
3700,dark,main,20220205,9,0.9915863433671425,269,20,89,378
1275,dark,main,20220205,0,0.993303344372398,286,20,84,390
1275,dark,main,20220205,1,0.9946690274824297,265,17,89,371
1275,dark,main,20220205,2,0.989560488383958,291,14,84,389
1275,dark,main,20220205,3,0.9876221042576356,253,17,87,357
1275,dark,main,20220205,4,0.9817644265336121,294,12,49,355
1275,dark,main,20220205,5,0.9956666925304084,286,11,73,370
1275,dark,main,20220205,6,0.9943278262889145,301,24,63,388
1275,dark,main,20220205,7,0.9885057706586311,283,12,48,343
1275,dark,main,20220205,8,0.9945925481223055,294,13,53,360
1275,dark,main,20220205,9,0.992858481228302,291,15,66,372
4402,dark,main,20220205,0,0.9960169079987243,295,13,64,372
4402,dark,main,20220205,1,0.9926562846188519,286,12,51,349
4402,dark,main,20220205,2,0.9891034824190539,313,13,51,377
4402,dark,main,20220205,3,0.9869372335417472,253,19,79,351
4402,dark,main,20220205,4,0.9914257698133101,262,16,78,356
4402,dark,main,20220205,5,0.9944044938722771,279,16,75,370
4402,dark,main,20220205,6,0.9957208618574148,280,18,89,387
4402,dark,main,20220205,7,0.9936070365333114,260,11,69,340
4402,dark,main,20220205,8,0.9878944601960649,136,11,37,184
4402,dark,main,20220205,9,0.9913980894551317,276,17,92,385
3677,dark,main,20220205,0,0.9927203542826393,260,30,97,387
3677,dark,main,20220205,1,0.9869046702727333,238,21,88,347
3677,dark,main,20220205,2,0.9926959190892263,262,25,102,389
3677,dark,main,20220205,3,0.9922529105358304,237,23,86,346
3677,dark,main,20220205,4,0.9939203714819164,223,12,102,337
3677,dark,main,20220205,5,0.9911899840511281,249,15,94,358
3677,dark,main,20220205,6,0.9868197600240501,260,15,82,357
3677,dark,main,20220205,7,0.9803327288647568,217,19,91,327
3677,dark,main,20220205,8,0.9912614356582095,251,25,86,362
3677,dark,main,20220205,9,0.9877681254790966,266,22,90,378
2479,dark,main,20220205,0,0.9946126521950357,349,12,36,397
2479,dark,main,20220205,1,0.993435259330096,307,14,43,364
2479,dark,main,20220205,2,0.9929208255150195,327,12,51,390
2479,dark,main,20220205,3,0.993892522134399,309,10,34,353
2479,dark,main,20220205,4,0.992932581779081,296,13,44,353
2479,dark,main,20220205,5,0.9921480710715778,300,16,58,374
2479,dark,main,20220205,6,0.9954303992592048,323,13,67,403
2479,dark,main,20220205,7,0.991734120795442,242,20,71,333
2479,dark,main,20220205,8,0.9871039172844303,190,16,42,248
2479,dark,main,20220205,9,0.9934752062059712,330,14,61,405
2491,dark,main,20220205,0,0.9934464186208941,324,16,48,388
2491,dark,main,20220205,1,0.9858090892575186,296,17,41,354
2491,dark,main,20220205,2,0.9945690396608478,318,17,44,379
2491,dark,main,20220205,3,0.9882715942295512,296,10,39,345
2491,dark,main,20220205,4,0.9836946578543587,287,13,44,344
2491,dark,main,20220205,5,0.9917511739736484,314,14,41,369
2491,dark,main,20220205,6,0.9938663146058758,318,14,48,380
2491,dark,main,20220205,7,0.9878098951619635,258,11,56,325
2491,dark,main,20220205,8,0.9937898179732076,304,13,60,377
2491,dark,main,20220205,9,0.9958852049738789,340,12,51,403
6273,dark,main,20220205,0,0.9955560097845614,260,19,90,369
6273,dark,main,20220205,1,0.9931133184092803,248,22,86,356
6273,dark,main,20220205,2,0.9859071619410471,281,16,79,376
6273,dark,main,20220205,3,0.9862847066572422,301,15,36,352
6273,dark,main,20220205,4,0.9930582972503171,273,11,57,341
6273,dark,main,20220205,5,0.9969969930850194,305,12,66,383
6273,dark,main,20220205,6,0.9924345678084241,286,12,74,372
6273,dark,main,20220205,7,0.9892233950814165,261,13,63,337
6273,dark,main,20220205,8,0.9835733779311252,250,20,96,366
6273,dark,main,20220205,9,0.9959452515474276,272,23,79,374
2561,dark,main,20220205,0,0.9823218988482798,326,13,44,383
2561,dark,main,20220205,1,0.9908061417142769,285,20,42,347
2561,dark,main,20220205,2,0.9931122442591145,306,22,57,385
2561,dark,main,20220205,3,0.99013607359562,303,13,31,347
2561,dark,main,20220205,4,0.9812603057521417,303,10,37,350
2561,dark,main,20220205,5,0.9886564673280402,305,11,41,357
2561,dark,main,20220205,6,0.9970299406477895,313,13,50,376
2561,dark,main,20220205,7,0.9883324035938815,269,13,43,325
2561,dark,main,20220205,8,0.9909252803605845,295,14,53,362
2561,dark,main,20220205,9,0.9947566808703259,326,11,36,373
3955,dark,main,20220205,0,0.9911374868428492,317,17,49,383
3955,dark,main,20220205,1,0.9933855535758374,272,17,50,339
3955,dark,main,20220205,2,0.9938523190754879,323,12,36,371
3955,dark,main,20220205,3,0.9952350878002724,295,17,53,365
3955,dark,main,20220205,4,0.9908938246391688,282,19,40,341
3955,dark,main,20220205,5,0.990559824425284,290,19,50,359
3955,dark,main,20220205,6,0.9900012676130381,293,25,66,384
3955,dark,main,20220205,7,0.9899455853259341,283,16,41,340
3955,dark,main,20220205,8,0.9880756256724397,293,22,44,359
3955,dark,main,20220205,9,0.9881372414963984,297,19,51,367
10347,dark,main,20220206,0,0.9926205400348174,316,12,42,370
10347,dark,main,20220206,1,0.9889743385744113,289,11,39,339
10347,dark,main,20220206,2,0.991019601487089,309,16,58,383
10347,dark,main,20220206,3,0.9874332209870755,301,18,34,353
10347,dark,main,20220206,4,0.9898447027987047,284,15,47,346
10347,dark,main,20220206,5,0.9963250906560475,321,12,55,388
10347,dark,main,20220206,6,0.991116653689296,320,15,56,391
10347,dark,main,20220206,7,0.9906210391243899,240,20,72,332
10347,dark,main,20220206,8,0.9915202688608151,303,19,47,369
10347,dark,main,20220206,9,0.9899554941274056,313,17,40,370
23254,bright,main,20220206,0,0.9912158516765242,292,137,7,436
23254,bright,main,20220206,1,0.9876872007122808,278,119,1,398
23254,bright,main,20220206,2,0.9914643739381643,257,168,6,431
23254,bright,main,20220206,3,0.9905214001350862,150,243,3,396
23254,bright,main,20220206,4,0.9932361739818706,157,223,6,386
23254,bright,main,20220206,5,0.987705405248234,129,272,3,404
23254,bright,main,20220206,6,0.9945957404362922,174,240,8,422
23254,bright,main,20220206,7,0.9921968715501809,158,210,3,371
23254,bright,main,20220206,8,0.9950785064077559,186,222,5,413
23254,bright,main,20220206,9,0.9863429027782938,216,211,1,428
22146,bright,main,20220206,0,0.992866165311593,232,194,7,433
22146,bright,main,20220206,1,0.9923634506112802,197,193,2,392
22146,bright,main,20220206,2,0.9924651513914567,259,169,3,431
22146,bright,main,20220206,3,0.9882770219567627,280,107,3,390
22146,bright,main,20220206,4,0.9948246691931804,251,135,4,390
22146,bright,main,20220206,5,0.9948700898871424,222,181,7,410
22146,bright,main,20220206,6,0.9950534393576358,246,176,4,426
22146,bright,main,20220206,7,0.9924822646667929,197,173,2,372
22146,bright,main,20220206,8,0.9930029528004367,180,220,3,403
22146,bright,main,20220206,9,0.9938689284158716,140,277,4,421
3711,dark,main,20220206,0,0.9902094818520865,280,24,91,395
3711,dark,main,20220206,1,0.9884476326639184,262,22,76,360
3711,dark,main,20220206,2,0.9901960965614756,280,27,72,379
3711,dark,main,20220206,3,0.9877859428267894,266,31,65,362
3711,dark,main,20220206,4,0.9912808430980273,246,23,81,350
3711,dark,main,20220206,5,0.9837817910033276,286,15,71,372
3711,dark,main,20220206,6,0.9907818611172271,296,18,66,380
3711,dark,main,20220206,7,0.996210101071988,263,17,54,334
3711,dark,main,20220206,8,0.9901267465501636,278,24,79,381
3711,dark,main,20220206,9,0.9902313974261162,277,24,88,389
11802,dark,main,20220206,0,0.9947255818348678,315,13,45,373
11802,dark,main,20220206,1,0.9911342196781838,278,14,47,339
11802,dark,main,20220206,2,0.9861738625611837,296,22,46,364
11802,dark,main,20220206,3,0.9794469213824749,285,22,36,343
11802,dark,main,20220206,4,0.9901619312960086,288,21,40,349
11802,dark,main,20220206,5,0.9933888852001658,299,24,45,368
11802,dark,main,20220206,6,0.993197359460904,297,32,37,366
11802,dark,main,20220206,7,0.9877529936810191,283,25,31,339
11802,dark,main,20220206,8,0.9853536586975187,309,17,47,373
11802,dark,main,20220206,9,0.9883254783256835,307,19,47,373
2539,dark,main,20220206,0,0.9915458230816157,293,17,67,377
2539,dark,main,20220206,1,0.9865832147650418,296,13,48,357
2539,dark,main,20220206,2,0.9937391597559561,324,18,45,387
2539,dark,main,20220206,3,0.9801430807891983,294,16,45,355
2539,dark,main,20220206,4,0.9935628747493851,298,12,38,348
2539,dark,main,20220206,5,0.9843439732969221,301,18,48,367
2539,dark,main,20220206,6,0.9855490786593313,324,14,39,377
2539,dark,main,20220206,7,0.9773427139211375,270,12,39,321
2539,dark,main,20220206,8,0.9866227856075791,295,14,40,349
2539,dark,main,20220206,9,0.9895734511965112,316,23,50,389
25270,bright,main,20220206,0,0.996174663772436,247,188,1,436
25270,bright,main,20220206,1,0.9934906771424252,258,138,1,397
25270,bright,main,20220206,2,0.9937859050171864,312,110,2,424
25270,bright,main,20220206,3,0.989768334320818,215,177,2,394
25270,bright,main,20220206,4,0.9887165956124072,227,151,7,385
25270,bright,main,20220206,5,0.9920200166804983,276,125,6,407
25270,bright,main,20220206,6,0.9924135906606518,237,181,7,425
25270,bright,main,20220206,7,0.9907364679026545,174,192,3,369
25270,bright,main,20220206,8,0.9919715486838041,265,146,4,415
25270,bright,main,20220206,9,0.9941949504351092,217,205,5,427
23636,bright,main,20220206,0,0.9955298734122063,354,71,3,428
23636,bright,main,20220206,1,0.9900529754267616,333,59,1,393
23636,bright,main,20220206,2,0.9902038428401465,362,60,4,426
23636,bright,main,20220206,3,0.9924290720345053,319,63,5,387
23636,bright,main,20220206,4,0.9897388368836191,327,55,2,384
23636,bright,main,20220206,5,0.988031001937489,356,51,4,411
23636,bright,main,20220206,6,0.9952976162787297,347,72,0,419
23636,bright,main,20220206,7,0.9872816529687466,317,38,4,359
23636,bright,main,20220206,8,0.9896002001951424,348,55,4,407
23636,bright,main,20220206,9,0.992613914320055,363,69,2,434
40586,backup,main,20220206,0,0.992523314751812,1,392,0,393
40586,backup,main,20220206,1,0.9917835353206721,1,352,1,354
40586,backup,main,20220206,2,0.9949519747268754,5,389,1,395
40586,backup,main,20220206,3,0.9922074911140488,10,330,3,343
40586,backup,main,20220206,4,0.9918684428897796,2,326,1,329
40586,backup,main,20220206,5,0.9860832807137849,3,354,1,358
40586,backup,main,20220206,6,0.991236566421469,1,376,0,377
40586,backup,main,20220206,7,0.9869261266948077,1,321,0,322
40586,backup,main,20220206,8,0.9910666220430364,5,365,2,372
40586,backup,main,20220206,9,0.9944760570723767,5,372,1,378
25685,bright,main,20220206,0,0.9898333920654095,284,155,6,445
25685,bright,main,20220206,1,0.9924663573471394,258,146,1,405
25685,bright,main,20220206,2,0.991787163763365,286,148,5,439
25685,bright,main,20220206,3,0.9955915664146835,269,134,2,405
25685,bright,main,20220206,4,0.9952521141199668,300,97,4,401
25685,bright,main,20220206,5,0.9934886713916297,346,68,2,416
25685,bright,main,20220206,6,0.9890871167284128,338,88,2,428
25685,bright,main,20220206,7,0.9893418812405429,254,118,3,375
25685,bright,main,20220206,8,0.9930213895739336,276,140,3,419
25685,bright,main,20220206,9,0.996588721258264,353,83,1,437
23225,bright,main,20220206,0,0.9936727698892348,288,140,7,435
23225,bright,main,20220206,1,0.9818893967203062,310,94,4,408
23225,bright,main,20220206,2,0.9893338347264421,278,154,1,433
23225,bright,main,20220206,3,0.9926840077366019,178,211,6,395
23225,bright,main,20220206,4,0.9932771608537979,189,200,6,395
23225,bright,main,20220206,5,0.9941331162083794,168,241,2,411
23225,bright,main,20220206,6,0.993962510502439,236,184,4,424
23225,bright,main,20220206,7,0.9907549728662515,234,134,4,372
23225,bright,main,20220206,8,0.9906308690556223,233,179,7,419
23225,bright,main,20220206,9,0.9959785390703702,242,180,3,425
10203,dark,main,20220206,0,0.9959788384591354,316,28,43,387
10203,dark,main,20220206,1,0.9909386254322831,300,14,28,342
10203,dark,main,20220206,2,0.991990084069452,308,15,50,373
10203,dark,main,20220206,3,0.9886271448866221,294,16,42,352
10203,dark,main,20220206,4,0.9966897412356547,277,18,45,340
10203,dark,main,20220206,5,0.9906660078671452,309,17,39,365
10203,dark,main,20220206,6,0.9932046781028216,304,15,47,366
10203,dark,main,20220206,7,0.9926693513090379,239,37,56,332
10203,dark,main,20220206,8,0.9921907147980223,297,20,39,356
10203,dark,main,20220206,9,0.9869800570137378,307,26,47,380
25293,bright,main,20220206,0,0.9940909827312553,287,143,4,434
25293,bright,main,20220206,1,0.9883860043491947,267,132,2,401
25293,bright,main,20220206,2,0.9904439750254578,372,59,5,436
25293,bright,main,20220206,3,0.9906767538045818,291,100,1,392
25293,bright,main,20220206,4,0.9901018043582756,279,114,2,395
25293,bright,main,20220206,5,0.9917273708262605,278,133,5,416
25293,bright,main,20220206,6,0.9935279650409945,223,197,4,424
25293,bright,main,20220206,7,0.9948550180200838,169,194,3,366
25293,bright,main,20220206,8,0.9962467396881577,241,178,2,421
25293,bright,main,20220206,9,0.9944012453931982,256,171,6,433
10965,dark,main,20220206,0,0.9943779546609389,329,16,33,378
10965,dark,main,20220206,1,0.990994432165281,293,23,25,341
10965,dark,main,20220206,2,0.9921847098944601,305,23,42,370
10965,dark,main,20220206,3,0.9914186580041644,298,19,39,356
10965,dark,main,20220206,4,0.9903644049197998,295,13,37,345
10965,dark,main,20220206,5,0.9900117486300715,314,13,32,359
10965,dark,main,20220206,6,0.9912070355541026,308,20,39,367
10965,dark,main,20220206,7,0.9929159420277752,267,18,41,326
10965,dark,main,20220206,8,0.9867973930474141,313,13,44,370
10965,dark,main,20220206,9,0.9915482130937737,297,21,40,358
9295,dark,main,20220207,0,0.992158311016746,333,11,42,386
9295,dark,main,20220207,1,0.9839795667924786,298,14,39,351
9295,dark,main,20220207,2,0.989999587193069,297,15,71,383
9295,dark,main,20220207,3,0.995617226833302,301,13,52,366
9295,dark,main,20220207,4,0.9930684063593962,296,13,39,348
9295,dark,main,20220207,5,0.9857753878554344,292,16,56,364
9295,dark,main,20220207,6,0.9947937454405498,302,15,64,381
9295,dark,main,20220207,7,0.9881646450136214,276,12,45,333
9295,dark,main,20220207,8,0.9924391785249568,300,14,62,376
9295,dark,main,20220207,9,0.9957125265412771,335,11,39,385
24674,bright,main,20220207,0,0.9891111104670905,240,186,10,436
24674,bright,main,20220207,1,0.9783292364274329,221,166,3,390
24674,bright,main,20220207,2,0.9859500395755305,282,149,4,435
24674,bright,main,20220207,3,0.991857953962388,201,184,6,391
24674,bright,main,20220207,4,0.9926917506132898,193,191,4,388
24674,bright,main,20220207,5,0.9970347186731521,153,245,5,403
24674,bright,main,20220207,6,0.9879356602029915,151,254,9,414
24674,bright,main,20220207,7,0.9949236534117564,158,201,4,363
24674,bright,main,20220207,8,0.9938020748758656,212,195,4,411
24674,bright,main,20220207,9,0.9958057182954224,253,170,2,425
21534,bright,main,20220207,0,0.9914771213132006,327,118,1,446
21534,bright,main,20220207,1,0.9950896906319584,315,86,4,405
21534,bright,main,20220207,2,0.9869603490472774,347,84,3,434
21534,bright,main,20220207,3,0.990023675124848,244,159,3,406
21534,bright,main,20220207,4,0.9920044194488474,263,134,3,400
21534,bright,main,20220207,5,0.9902885563466611,193,225,2,420
21534,bright,main,20220207,6,0.9917526366691731,252,177,1,430
21534,bright,main,20220207,7,0.9959699426187294,223,152,3,378
21534,bright,main,20220207,8,0.9959418157968619,271,152,3,426
21534,bright,main,20220207,9,0.9941024730493883,291,138,5,434
24631,bright,main,20220207,0,0.9894715720644661,315,124,3,442
24631,bright,main,20220207,1,0.9885352926894124,299,104,2,405
24631,bright,main,20220207,2,0.9893581992774579,288,141,6,435
24631,bright,main,20220207,3,0.9929602868019679,257,142,0,399
24631,bright,main,20220207,4,0.9922681695654438,230,160,5,395
24631,bright,main,20220207,5,0.9870559868396825,207,202,1,410
24631,bright,main,20220207,6,0.994979457486539,175,254,4,433
24631,bright,main,20220207,7,0.9935974679405009,156,218,4,378
24631,bright,main,20220207,8,0.9930295855356751,200,224,2,426
24631,bright,main,20220207,9,0.9875469374681072,250,185,3,438
21680,bright,main,20220207,0,0.989568336170182,229,205,6,440
21680,bright,main,20220207,1,0.9839440814620459,229,160,6,395
21680,bright,main,20220207,2,0.993788503717391,261,169,4,434
21680,bright,main,20220207,3,0.9905008114400042,221,168,3,392
21680,bright,main,20220207,4,0.9870755242463753,208,177,6,391
21680,bright,main,20220207,5,0.9925291357089236,151,253,6,410
21680,bright,main,20220207,6,0.9888348535527751,143,280,3,426
21680,bright,main,20220207,7,0.9910958371976698,120,242,3,365
21680,bright,main,20220207,8,0.9950413720698916,140,271,2,413
21680,bright,main,20220207,9,0.9954142035071297,190,235,3,428
24673,bright,main,20220207,0,0.9954116170877708,168,255,3,426
24673,bright,main,20220207,1,0.9915478986531406,203,184,5,392
24673,bright,main,20220207,2,0.9895710006661488,242,181,3,426
24673,bright,main,20220207,3,0.9956383401223423,268,113,8,389
24673,bright,main,20220207,4,0.991497512471801,287,90,8,385
24673,bright,main,20220207,5,0.9914332547564094,296,100,3,399
24673,bright,main,20220207,6,0.9884921915246231,267,132,3,402
24673,bright,main,20220207,7,0.9935496733031046,214,150,4,368
24673,bright,main,20220207,8,0.9921341637686302,185,216,7,408
24673,bright,main,20220207,9,0.9949776012464034,189,222,4,415
11952,dark,main,20220207,0,0.9935387523368523,314,15,49,378
11952,dark,main,20220207,1,0.993560781868687,290,14,49,353
11952,dark,main,20220207,2,0.9855086477872422,326,15,44,385
11952,dark,main,20220207,3,0.9901253862731801,311,13,30,354
11952,dark,main,20220207,4,0.9876042643414029,295,18,33,346
11952,dark,main,20220207,5,0.9941618969723411,316,17,32,365
11952,dark,main,20220207,6,0.9935974593194727,325,21,32,378
11952,dark,main,20220207,7,0.9903892177283231,277,25,25,327
11952,dark,main,20220207,8,0.9928751838464731,301,21,37,359
11952,dark,main,20220207,9,0.9904624606133731,317,15,47,379
41743,backup,main,20220207,0,0.9955807449204385,7,444,1,452
41743,backup,main,20220207,1,0.995287092720757,4,402,0,406
41743,backup,main,20220207,2,0.9957461215891741,1,440,0,441
41743,backup,main,20220207,3,0.992946249785392,8,399,0,407
41743,backup,main,20220207,4,0.9951603698235697,1,419,0,420
41743,backup,main,20220207,5,0.9933561279248856,2,430,0,432
41743,backup,main,20220207,6,0.9934447908196226,3,432,0,435
41743,backup,main,20220207,7,0.9933224699336436,5,378,0,383
41743,backup,main,20220207,8,0.9902259087205869,4,423,1,428
41743,backup,main,20220207,9,0.9922262565461375,23,417,0,440
7043,dark,main,20220207,0,0.994551280003279,325,19,35,379
7043,dark,main,20220207,1,0.9860113833847506,198,23,23,244
7043,dark,main,20220207,2,0.979723349865045,186,23,32,241
7043,dark,main,20220207,3,0.9889835545981658,283,20,44,347
7043,dark,main,20220207,4,0.9932692346684198,276,17,45,338
7043,dark,main,20220207,5,0.9915947821530885,284,14,52,350
7043,dark,main,20220207,6,0.9853330978599413,282,24,48,354
7043,dark,main,20220207,7,0.9911246221455312,264,19,48,331
7043,dark,main,20220207,8,0.9903213728641593,304,18,38,360
7043,dark,main,20220207,9,0.9902375774681881,301,16,48,365
21694,bright,main,20220207,0,0.9850910312403256,327,106,6,439
21694,bright,main,20220207,1,0.9940037198050056,276,125,3,404
21694,bright,main,20220207,2,0.9886568738537428,289,143,5,437
21694,bright,main,20220207,3,0.9892732876516724,278,121,3,402
21694,bright,main,20220207,4,0.9917966980011531,285,110,1,396
21694,bright,main,20220207,5,0.9877881251400552,288,116,6,410
21694,bright,main,20220207,6,0.9915291888768331,344,76,7,427
21694,bright,main,20220207,7,0.9946362079622055,278,89,3,370
21694,bright,main,20220207,8,0.9901713684133161,291,123,6,420
21694,bright,main,20220207,9,0.9944648693638739,336,92,6,434
22978,bright,main,20220207,0,0.9941787621518735,201,238,2,441
22978,bright,main,20220207,1,0.9924410343081833,172,234,1,407
22978,bright,main,20220207,2,0.9935122869650957,273,163,3,439
22978,bright,main,20220207,3,0.9959690960662353,283,116,3,402
22978,bright,main,20220207,4,0.9947769808159913,253,148,1,402
22978,bright,main,20220207,5,0.9920993372874916,287,131,2,420
22978,bright,main,20220207,6,0.9883128061732093,339,87,5,431
22978,bright,main,20220207,7,0.995712267324257,227,146,4,377
22978,bright,main,20220207,8,0.9855089109552462,187,233,4,424
22978,bright,main,20220207,9,0.9951844779411196,151,283,5,439
9284,dark,main,20220207,0,0.9930636325493885,309,14,65,388
9284,dark,main,20220207,1,0.9914348609480214,261,14,81,356
9284,dark,main,20220207,2,0.9937016248549774,265,20,93,378
9284,dark,main,20220207,3,0.9918950737403383,252,16,94,362
9284,dark,main,20220207,4,0.9901752391620892,271,16,68,355
9284,dark,main,20220207,5,0.9825994433213452,276,15,79,370
9284,dark,main,20220207,6,0.9939577361951614,287,14,77,378
9284,dark,main,20220207,7,0.9897191276501535,261,10,59,330
9284,dark,main,20220207,8,0.9880400184177157,308,14,50,372
9284,dark,main,20220207,9,0.990494451483863,293,12,72,377
22914,bright,main,20220207,0,0.9930523726373789,182,256,2,440
22914,bright,main,20220207,1,0.9913281571619855,222,177,5,404
22914,bright,main,20220207,2,0.99307936030304,231,204,2,437
22914,bright,main,20220207,3,0.9927493509371899,212,187,3,402
22914,bright,main,20220207,4,0.9921701382047995,268,129,0,397
22914,bright,main,20220207,5,0.9875787274726632,290,118,5,413
22914,bright,main,20220207,6,0.9960302553603546,294,130,5,429
22914,bright,main,20220207,7,0.9932441363873072,180,197,2,379
22914,bright,main,20220207,8,0.9922711165912065,192,229,3,424
22914,bright,main,20220207,9,0.9944836629150877,164,266,5,435
9937,dark,main,20220207,0,0.9811128751853551,308,12,56,376
9937,dark,main,20220207,1,0.9912381769545471,290,12,43,345
9937,dark,main,20220207,2,0.9881961635380047,307,11,47,365
9937,dark,main,20220207,3,0.9921847361860647,291,13,39,343
9937,dark,main,20220207,4,0.9929647709917149,283,13,57,353
9937,dark,main,20220207,5,0.9789839166825287,298,13,50,361
9937,dark,main,20220207,6,0.9903190430152923,282,16,77,375
9937,dark,main,20220207,7,0.9891716065246033,233,26,65,324
9937,dark,main,20220207,8,0.9922701134324099,307,16,48,371
9937,dark,main,20220207,9,0.9916534855244272,315,15,50,380
3052,dark,main,20220207,0,0.9936370490695676,330,20,36,386
3052,dark,main,20220207,1,0.9916359170367754,293,13,51,357
3052,dark,main,20220207,2,0.9944156877583195,320,14,55,389
3052,dark,main,20220207,3,0.9926679918660362,267,13,67,347
3052,dark,main,20220207,4,0.9816144524391628,258,19,74,351
3052,dark,main,20220207,5,0.9949600414627711,265,14,81,360
3052,dark,main,20220207,6,0.9843456144919517,287,18,82,387
3052,dark,main,20220207,7,0.9877065890951464,282,11,50,343
3052,dark,main,20220207,8,0.991807513682578,287,14,57,358
3052,dark,main,20220207,9,0.9933381111141862,311,16,39,366
3028,dark,main,20220207,0,0.9903756321197381,296,14,77,387
3028,dark,main,20220207,1,0.9923746999993702,265,13,71,349
3028,dark,main,20220207,2,0.9902469244361964,325,14,49,388
3028,dark,main,20220207,3,0.9906771063920783,309,14,36,359
3028,dark,main,20220207,4,0.9878499567687753,290,11,47,348
3028,dark,main,20220207,5,0.9909080894196554,322,12,52,386
3028,dark,main,20220207,6,0.9929286536935593,315,12,58,385
3028,dark,main,20220207,7,0.9905080123839572,286,10,33,329
3028,dark,main,20220207,8,0.9946880004107194,300,13,59,372
3028,dark,main,20220207,9,0.9920314479422553,305,15,59,379
24649,bright,main,20220207,0,0.9905800451825156,261,180,3,444
24649,bright,main,20220207,1,0.9919290085701975,299,104,0,403
24649,bright,main,20220207,2,0.9936355276001544,275,158,2,435
24649,bright,main,20220207,3,0.9889944965083404,232,165,3,400
24649,bright,main,20220207,4,0.9952721722080577,241,151,5,397
24649,bright,main,20220207,5,0.9880735390594612,254,152,8,414
24649,bright,main,20220207,6,0.9951615846163272,266,152,8,426
24649,bright,main,20220207,7,0.9934947762102794,227,136,6,369
24649,bright,main,20220207,8,0.9937903029278423,209,206,3,418
24649,bright,main,20220207,9,0.9932866403649356,241,188,4,433
20991,bright,main,20220207,0,0.9940164388466501,307,138,2,447
20991,bright,main,20220207,1,0.9898529653518825,329,73,4,406
20991,bright,main,20220207,2,0.9964919317003623,342,85,4,431
20991,bright,main,20220207,3,0.9897013409792144,316,85,3,404
20991,bright,main,20220207,4,0.9905072962525787,289,108,2,399
20991,bright,main,20220207,5,0.9910866702410335,247,164,6,417
20991,bright,main,20220207,6,0.9949323434280419,232,195,4,431
20991,bright,main,20220207,7,0.9919512067278704,168,208,2,378
20991,bright,main,20220207,8,0.9860056636112989,272,153,2,427
20991,bright,main,20220207,9,0.9936401680097714,305,126,1,432
22140,bright,main,20220207,0,0.9921390531826071,297,147,3,447
22140,bright,main,20220207,1,0.9960480649830162,317,84,2,403
22140,bright,main,20220207,2,0.9956339150628842,269,168,2,439
22140,bright,main,20220207,3,0.993224748431068,186,215,0,401
22140,bright,main,20220207,4,0.9907820460347981,173,225,1,399
22140,bright,main,20220207,5,0.9963620827547124,190,226,3,419
22140,bright,main,20220207,6,0.9917433069827131,250,181,2,433
22140,bright,main,20220207,7,0.9880107888130653,238,135,5,378
22140,bright,main,20220207,8,0.9902908432688002,313,102,3,418
22140,bright,main,20220207,9,0.9968807368249626,296,137,7,440
8816,dark,main,20220207,0,0.9896721513813433,315,14,48,377
8816,dark,main,20220207,1,0.9941457734481666,300,16,50,366
8816,dark,main,20220207,2,0.9925537796447713,339,17,37,393
8816,dark,main,20220207,3,0.9914528058681027,313,13,36,362
8816,dark,main,20220207,4,0.9901564476177259,289,11,40,340
8816,dark,main,20220207,5,0.9909442346737705,307,15,40,362
8816,dark,main,20220207,6,0.9945958048741828,323,15,40,378
8816,dark,main,20220207,7,0.9873139280153308,292,13,32,337
8816,dark,main,20220207,8,0.9833266590873312,317,16,37,370
8816,dark,main,20220207,9,0.9941199362015147,316,14,55,385
9921,dark,main,20220207,0,0.9959001318529139,295,16,70,381
9921,dark,main,20220207,1,0.9934572650407395,249,15,80,344
9921,dark,main,20220207,2,0.990708601599009,313,15,68,396
9921,dark,main,20220207,3,0.9894738870473776,277,11,55,343
9921,dark,main,20220207,4,0.9884462223089964,263,13,68,344
9921,dark,main,20220207,5,0.9829615682073012,224,19,105,348
9921,dark,main,20220207,6,0.9933143187613132,256,16,81,353
9921,dark,main,20220207,7,0.9900953465259636,217,16,89,322
9921,dark,main,20220207,8,0.9872262202512814,241,22,89,352
9921,dark,main,20220207,9,0.9912514558737294,244,22,106,372
9932,dark,main,20220207,0,0.9835837740351836,309,15,55,379
9932,dark,main,20220207,1,0.9853159426194937,302,11,32,345
9932,dark,main,20220207,2,0.9943593441105297,312,16,46,374
9932,dark,main,20220207,3,0.990646151621372,274,14,60,348
9932,dark,main,20220207,4,0.994903549565605,270,14,61,345
9932,dark,main,20220207,5,0.98728663341189,298,13,38,349
9932,dark,main,20220207,6,0.9932307962269551,309,12,56,377
9932,dark,main,20220207,7,0.9926860792054722,262,13,67,342
9932,dark,main,20220207,8,0.9924998734853457,292,13,61,366
9932,dark,main,20220207,9,0.9936164984725098,295,13,78,386
24816,bright,main,20220207,0,0.9930059885308166,268,169,5,442
24816,bright,main,20220207,1,0.984682016853183,268,119,9,396
24816,bright,main,20220207,2,0.9929309253744906,334,93,3,430
24816,bright,main,20220207,3,0.9903579203364249,294,104,1,399
24816,bright,main,20220207,4,0.991585320501617,274,107,5,386
24816,bright,main,20220207,5,0.9936508559838647,303,108,3,414
24816,bright,main,20220207,6,0.9922107928118002,301,123,2,426
24816,bright,main,20220207,7,0.9925855970027246,207,159,4,370
24816,bright,main,20220207,8,0.9947948843084643,262,154,3,419
24816,bright,main,20220207,9,0.9936769222616448,229,188,6,423
9254,dark,main,20220208,0,0.9897266246886709,320,16,41,377
9254,dark,main,20220208,1,0.990874740551636,293,16,32,341
9254,dark,main,20220208,2,0.9899506734840897,319,14,52,385
9254,dark,main,20220208,3,0.9887832413988187,289,21,45,355
9254,dark,main,20220208,4,0.9936049414886386,290,12,46,348
9254,dark,main,20220208,5,0.991649860701201,300,14,60,374
9254,dark,main,20220208,6,0.9950992639016231,306,11,61,378
9254,dark,main,20220208,7,0.995066605927676,271,13,38,322
9254,dark,main,20220208,8,0.9843531835600582,314,16,36,366
9254,dark,main,20220208,9,0.9874105601266121,308,10,52,370
20952,bright,main,20220208,0,0.9933075379331396,204,237,3,444
20952,bright,main,20220208,1,0.9884797669525013,239,161,3,403
20952,bright,main,20220208,2,0.9932050679676656,272,160,4,436
20952,bright,main,20220208,3,0.9925333437788729,244,155,1,400
20952,bright,main,20220208,4,0.996796077047926,221,171,4,396
20952,bright,main,20220208,5,0.9956974327275777,233,182,3,418
20952,bright,main,20220208,6,0.9912221111220384,226,199,5,430
20952,bright,main,20220208,7,0.991794773436371,185,187,2,374
20952,bright,main,20220208,8,0.9918471072996939,238,173,5,416
20952,bright,main,20220208,9,0.9961394476201046,202,228,4,434
8793,dark,main,20220208,0,0.9918441741282294,323,22,42,387
8793,dark,main,20220208,1,0.9866905510474998,297,16,35,348
8793,dark,main,20220208,2,0.9936554669353824,312,17,47,376
8793,dark,main,20220208,3,0.9939358151933736,285,19,40,344
8793,dark,main,20220208,4,0.991960137113427,296,15,40,351
8793,dark,main,20220208,5,0.9927858589674566,320,15,32,367
8793,dark,main,20220208,6,0.9929172563369392,294,18,72,384
8793,dark,main,20220208,7,0.9901817724571244,249,14,67,330
8793,dark,main,20220208,8,0.9922568990142788,288,15,55,358
8793,dark,main,20220208,9,0.9912535665053609,310,14,38,362
3027,dark,main,20220208,0,0.9896752347377447,310,10,42,362
3027,dark,main,20220208,1,0.9900784096377289,311,12,30,353
3027,dark,main,20220208,2,0.9914158494978198,317,12,51,380
3027,dark,main,20220208,3,0.9862785475653048,287,11,52,350
3027,dark,main,20220208,4,0.9942949136702565,279,11,51,341
3027,dark,main,20220208,5,0.9904302422726478,290,14,64,368
3027,dark,main,20220208,6,0.9927969580315462,288,17,68,373
3027,dark,main,20220208,7,0.9880437811007751,270,16,54,340
3027,dark,main,20220208,8,0.9929855197247991,304,12,50,366
3027,dark,main,20220208,9,0.9933389998709576,317,16,38,371
21562,bright,main,20220208,0,0.9937665072529246,260,160,6,426
21562,bright,main,20220208,1,0.9901299435130884,278,113,1,392
21562,bright,main,20220208,2,0.9950011276795591,323,92,6,421
21562,bright,main,20220208,3,0.9887803776717742,296,88,1,385
21562,bright,main,20220208,4,0.9909609229405582,314,54,3,371
21562,bright,main,20220208,5,0.9859378598011383,339,67,2,408
21562,bright,main,20220208,6,0.9946421415576352,312,96,4,412
21562,bright,main,20220208,7,0.9927596693041337,297,68,3,368
21562,bright,main,20220208,8,0.9956209411612237,304,109,2,415
21562,bright,main,20220208,9,0.9942289276696263,310,98,5,413
3978,dark,main,20220208,0,0.9972190943564219,332,20,31,383
3978,dark,main,20220208,1,0.9950034673465623,288,30,34,352
3978,dark,main,20220208,2,0.9873577251610842,330,11,38,379
3978,dark,main,20220208,3,0.9938865077503821,301,21,36,358
3978,dark,main,20220208,4,0.9888783716182198,303,16,33,352
3978,dark,main,20220208,5,0.9860915939054711,308,21,38,367
3978,dark,main,20220208,6,0.9862266728596594,321,13,38,372
3978,dark,main,20220208,7,0.9940570740837081,265,18,43,326
3978,dark,main,20220208,8,0.9848808597741773,305,21,36,362
3978,dark,main,20220208,9,0.9864209405637656,319,15,37,371
8361,dark,main,20220208,0,0.9927389102370108,278,18,72,368
8361,dark,main,20220208,1,0.9890697654235794,237,19,73,329
8361,dark,main,20220208,2,0.990097754254214,255,16,91,362
8361,dark,main,20220208,3,0.988797142073727,240,21,82,343
8361,dark,main,20220208,4,0.9892299550082375,218,29,88,335
8361,dark,main,20220208,5,0.9954813219926987,243,14,85,342
8361,dark,main,20220208,6,0.993226709229527,266,13,89,368
8361,dark,main,20220208,7,0.9882200083611018,221,15,80,316
8361,dark,main,20220208,8,0.9926431950692298,258,14,66,338
8361,dark,main,20220208,9,0.9844230694434641,238,22,86,346
9255,dark,main,20220208,0,0.9924763906791865,317,12,54,383
9255,dark,main,20220208,1,0.9863572732526558,266,20,75,361
9255,dark,main,20220208,2,0.9934485752368777,308,14,62,384
9255,dark,main,20220208,3,0.9956760511162843,294,15,47,356
9255,dark,main,20220208,4,0.9939155403411369,288,10,57,355
9255,dark,main,20220208,5,0.9884452170455452,303,10,51,364
9255,dark,main,20220208,6,0.9962525293030583,311,10,50,371
9255,dark,main,20220208,7,0.990123696132129,276,15,38,329
9255,dark,main,20220208,8,0.9878000002041154,304,16,44,364
9255,dark,main,20220208,9,0.9907401973224558,310,10,66,386
9925,dark,main,20220208,0,0.9899575550464089,326,13,43,382
9925,dark,main,20220208,1,0.9819904692866669,292,13,41,346
9925,dark,main,20220208,2,0.9951375676756826,315,12,49,376
9925,dark,main,20220208,3,0.9915992672309262,282,17,46,345
9925,dark,main,20220208,4,0.978793805658164,248,13,54,315
9925,dark,main,20220208,5,0.9876742425786008,268,11,66,345
9925,dark,main,20220208,6,0.9958224603406293,283,12,72,367
9925,dark,main,20220208,7,0.9902540696647061,247,19,58,324
9925,dark,main,20220208,8,0.9947386500781641,279,14,68,361
9925,dark,main,20220208,9,0.9943812125120719,302,18,57,377
7228,dark,main,20220208,0,0.9800589998578947,331,17,40,388
7228,dark,main,20220208,1,0.9941369342750058,286,12,48,346
7228,dark,main,20220208,2,0.9792207782367338,336,15,38,389
7228,dark,main,20220208,3,0.9902144891123789,306,15,31,352
7228,dark,main,20220208,4,0.9928529507994736,275,18,52,345
7228,dark,main,20220208,5,0.9916746731647145,317,14,30,361
7228,dark,main,20220208,6,0.9877927468598385,326,15,39,380
7228,dark,main,20220208,7,0.9922982506922978,283,13,36,332
7228,dark,main,20220208,8,0.9849528695298618,332,10,34,376
7228,dark,main,20220208,9,0.9922735138340499,328,15,40,383
9253,dark,main,20220208,0,0.9932688827030499,308,13,71,392
9253,dark,main,20220208,1,0.9917264471115128,282,14,60,356
9253,dark,main,20220208,2,0.9940902737812737,327,12,56,395
9253,dark,main,20220208,3,0.9834399857843624,287,12,58,357
9253,dark,main,20220208,4,0.990762887550718,245,16,91,352
9253,dark,main,20220208,5,0.9894792161681286,286,13,77,376
9253,dark,main,20220208,6,0.9923192653991825,311,13,63,387
9253,dark,main,20220208,7,0.9906494099716112,261,9,57,327
9253,dark,main,20220208,8,0.9961126182589356,254,12,92,358
9253,dark,main,20220208,9,0.9958483304904294,287,13,67,367
24678,bright,main,20220208,0,0.9892540257772916,252,178,4,434
24678,bright,main,20220208,1,0.9900067150468754,218,170,6,394
24678,bright,main,20220208,2,0.9917378518923066,308,122,1,431
24678,bright,main,20220208,3,0.994723504872471,223,170,3,396
24678,bright,main,20220208,4,0.9929068558424766,175,207,7,389
24678,bright,main,20220208,5,0.9863480110753786,124,270,5,399
24678,bright,main,20220208,6,0.9932177792106991,218,195,4,417
24678,bright,main,20220208,7,0.991498903899607,257,107,5,369
24678,bright,main,20220208,8,0.9902049550640003,245,162,6,413
24678,bright,main,20220208,9,0.9934813373959568,261,160,5,426
23227,bright,main,20220208,0,0.9948871146341085,213,220,2,435
23227,bright,main,20220208,1,0.9899931796745685,211,190,3,404
23227,bright,main,20220208,2,0.9929323365146466,208,225,3,436
23227,bright,main,20220208,3,0.9839246556246742,155,240,1,396
23227,bright,main,20220208,4,0.9931928725047433,171,222,1,394
23227,bright,main,20220208,5,0.9844981594139199,217,197,2,416
23227,bright,main,20220208,6,0.988958303350088,219,209,2,430
23227,bright,main,20220208,7,0.9897077501205717,187,187,1,375
23227,bright,main,20220208,8,0.9883536439075519,234,187,3,424
23227,bright,main,20220208,9,0.9875993194788715,260,175,1,436
20277,bright,main,20220208,0,0.9946176532852586,258,167,7,432
20277,bright,main,20220208,1,0.992682242911469,238,142,6,386
20277,bright,main,20220208,2,0.9935691913897308,267,154,4,425
20277,bright,main,20220208,3,0.9923872805010701,308,81,4,393
20277,bright,main,20220208,4,0.9888173410096306,263,118,5,386
20277,bright,main,20220208,5,0.9917237704733715,297,98,5,400
20277,bright,main,20220208,6,0.9878237078153873,281,127,2,410
20277,bright,main,20220208,7,0.9928113551720966,197,155,0,352
20277,bright,main,20220208,8,0.9931775868309395,196,200,6,402
20277,bright,main,20220208,9,0.992862255427057,234,183,5,422
21659,bright,main,20220208,0,0.9926193095207536,266,175,2,443
21659,bright,main,20220208,1,0.9913372554219075,229,171,1,401
21659,bright,main,20220208,2,0.9965262908760977,287,147,4,438
21659,bright,main,20220208,3,0.9946216908318053,266,133,4,403
21659,bright,main,20220208,4,0.9946816139121327,197,199,1,397
21659,bright,main,20220208,5,0.9919953792234362,178,229,1,408
21659,bright,main,20220208,6,0.9914541873166413,213,209,11,433
21659,bright,main,20220208,7,0.9922989427552432,197,175,2,374
21659,bright,main,20220208,8,0.9950503165735877,256,164,5,425
21659,bright,main,20220208,9,0.9898268102643868,278,151,4,433
20988,bright,main,20220208,0,0.9952780649730627,289,145,3,437
20988,bright,main,20220208,1,0.9959308938356142,208,195,2,405
20988,bright,main,20220208,2,0.9920881991318558,262,171,1,434
20988,bright,main,20220208,3,0.9921478366294648,272,125,2,399
20988,bright,main,20220208,4,0.9904320298227862,278,113,3,394
20988,bright,main,20220208,5,0.9930802425839129,298,115,1,414
20988,bright,main,20220208,6,0.9888475802974138,319,110,0,429
20988,bright,main,20220208,7,0.9877358011941241,250,122,3,375
20988,bright,main,20220208,8,0.9909315310731558,307,112,3,422
20988,bright,main,20220208,9,0.9971946310080554,290,141,3,434
22954,bright,main,20220208,0,0.9930775023181365,243,198,4,445
22954,bright,main,20220208,1,0.9953880748783924,179,226,3,408
22954,bright,main,20220208,2,0.9909214392929134,165,275,0,440
22954,bright,main,20220208,3,0.9924258039826995,214,180,3,397
22954,bright,main,20220208,4,0.9950010166678436,209,189,2,400
22954,bright,main,20220208,5,0.9974171737559667,218,196,3,417
22954,bright,main,20220208,6,0.9951034407383855,253,169,3,425
22954,bright,main,20220208,7,0.9926187890341476,158,215,2,375
22954,bright,main,20220208,8,0.989449348293491,159,265,3,427
22954,bright,main,20220208,9,0.9974586292320815,257,169,6,432
1119,dark,main,20220208,0,0.9912895110955404,282,20,68,370
1119,dark,main,20220208,1,0.9928888944432542,234,18,87,339
1119,dark,main,20220208,2,0.9873103738351466,301,13,62,376
1119,dark,main,20220208,3,0.9940983288597208,265,13,66,344
1119,dark,main,20220208,4,0.9917958702897289,249,13,69,331
1119,dark,main,20220208,5,0.9876915856417414,273,18,56,347
1119,dark,main,20220208,6,0.9924678175640524,289,14,58,361
1119,dark,main,20220208,7,0.9789733313763598,244,13,64,321
1119,dark,main,20220208,8,0.9940889367980581,293,17,56,366
1119,dark,main,20220208,9,0.9905500006235426,276,14,68,358
20953,bright,main,20220208,0,0.9916765345252663,241,196,3,440
20953,bright,main,20220208,1,0.9909945831285369,227,176,3,406
20953,bright,main,20220208,2,0.9955793343184411,246,188,0,434
20953,bright,main,20220208,3,0.9911176665737421,263,137,4,404
20953,bright,main,20220208,4,0.9898257342653239,255,139,6,400
20953,bright,main,20220208,5,0.9955787391021892,272,142,1,415
20953,bright,main,20220208,6,0.9913796077191385,291,140,3,434
20953,bright,main,20220208,7,0.9911522647326905,227,150,1,378
20953,bright,main,20220208,8,0.9956511741877724,225,194,4,423
20953,bright,main,20220208,9,0.9917060082075273,207,228,1,436
21375,bright,main,20220208,0,0.9965293171925953,193,243,2,438
21375,bright,main,20220208,1,0.9894159994042155,126,276,2,404
21375,bright,main,20220208,2,0.9927906806644322,125,313,4,442
21375,bright,main,20220208,3,0.99440750233503,161,237,4,402
21375,bright,main,20220208,4,0.9921781896974115,218,179,3,400
21375,bright,main,20220208,5,0.9944216392256413,180,230,6,416
21375,bright,main,20220208,6,0.9951880426566296,333,97,1,431
21375,bright,main,20220208,7,0.9917175586289041,239,113,6,358
21375,bright,main,20220208,8,0.9889924352991945,273,114,6,393
21375,bright,main,20220208,9,0.9920219984676046,235,199,1,435
24967,bright,main,20220208,0,0.9945195997892979,254,174,4,432
24967,bright,main,20220208,1,0.9877600734827489,232,156,2,390
24967,bright,main,20220208,2,0.989750587767055,227,196,7,430
24967,bright,main,20220208,3,0.9957613372300808,227,161,8,396
24967,bright,main,20220208,4,0.9922707677471497,181,203,2,386
24967,bright,main,20220208,5,0.9963152661582868,222,168,8,398
24967,bright,main,20220208,6,0.9965472339097801,183,233,6,422
24967,bright,main,20220208,7,0.9911990894234365,148,218,3,369
24967,bright,main,20220208,8,0.9901498504284323,251,159,3,413
24967,bright,main,20220208,9,0.9929039967840445,235,183,4,422
20996,bright,main,20220208,0,0.9886849300763842,350,88,4,442
20996,bright,main,20220208,1,0.9928301776478207,300,102,3,405
20996,bright,main,20220208,2,0.9959539140223197,315,119,5,439
20996,bright,main,20220208,3,0.9929972226105112,293,110,1,404
20996,bright,main,20220208,4,0.9925128913819686,281,105,7,393
20996,bright,main,20220208,5,0.9920986666384441,288,125,3,416
20996,bright,main,20220208,6,0.9937139845378048,338,85,5,428
20996,bright,main,20220208,7,0.9942049276677624,273,103,2,378
20996,bright,main,20220208,8,0.9952150012762804,310,109,4,423
20996,bright,main,20220208,9,0.9936598508167334,322,108,3,433
22874,bright,main,20220208,0,0.9939424807936327,172,271,3,446
22874,bright,main,20220208,1,0.9879595861926989,142,258,3,403
22874,bright,main,20220208,2,0.9921760424152465,168,249,10,427
22874,bright,main,20220208,3,0.9919528453416676,184,216,2,402
22874,bright,main,20220208,4,0.9958749301404087,243,153,2,398
22874,bright,main,20220208,5,0.9960722007310877,231,186,2,419
22874,bright,main,20220208,6,0.9944100130387253,265,162,3,430
22874,bright,main,20220208,7,0.9922077105161304,230,139,4,373
22874,bright,main,20220208,8,0.9951734375666473,178,243,3,424
22874,bright,main,20220208,9,0.9937549068640392,209,221,7,437
5983,dark,main,20220208,0,0.9922337436326254,321,13,37,371
5983,dark,main,20220208,1,0.9875511434422304,289,15,56,360
5983,dark,main,20220208,2,0.9919107930842751,314,13,61,388
5983,dark,main,20220208,3,0.9904961116856846,267,12,49,328
5983,dark,main,20220208,4,0.9907327765255227,289,13,54,356
5983,dark,main,20220208,5,0.9962536163865628,304,11,48,363
5983,dark,main,20220208,6,0.987702101445962,314,13,59,386
5983,dark,main,20220208,7,0.9858324711725758,233,13,73,319
5983,dark,main,20220208,8,0.9921308143981742,310,13,58,381
5983,dark,main,20220208,9,0.9859682295583401,310,14,54,378
10344,dark,main,20220209,0,0.9913992440356728,325,14,39,378
10344,dark,main,20220209,1,0.9896304405758529,301,13,35,349
10344,dark,main,20220209,2,0.9941424850677081,329,24,33,386
10344,dark,main,20220209,3,0.988500310521001,294,17,41,352
10344,dark,main,20220209,4,0.9868753378623867,285,15,49,349
10344,dark,main,20220209,5,0.9913172794432713,319,17,40,376
10344,dark,main,20220209,6,0.9893284100960258,316,14,40,370
10344,dark,main,20220209,7,0.9923518154137854,271,13,37,321
10344,dark,main,20220209,8,0.9901983876319341,298,18,44,360
10344,dark,main,20220209,9,0.9890187108831819,324,13,44,381
10834,dark,main,20220209,0,0.9951391105033356,323,17,44,384
10834,dark,main,20220209,1,0.9888858142011143,300,14,41,355
10834,dark,main,20220209,2,0.9952355098422583,326,12,39,377
10834,dark,main,20220209,3,0.9894351917928392,304,16,33,353
10834,dark,main,20220209,4,0.9881856607324606,297,12,37,346
10834,dark,main,20220209,5,0.990947674241846,301,11,42,354
10834,dark,main,20220209,6,0.9925774643040998,308,15,38,361
10834,dark,main,20220209,7,0.9895751121916195,252,13,49,314
10834,dark,main,20220209,8,0.9934344731174122,310,11,41,362
10834,dark,main,20220209,9,0.9899455325719138,312,12,41,365
1273,dark,main,20220209,0,0.9877969480837967,319,17,44,380
1273,dark,main,20220209,1,0.9845521603112142,295,12,46,353
1273,dark,main,20220209,2,0.993289885247199,313,17,61,391
1273,dark,main,20220209,3,0.9968116419678353,275,19,54,348
1273,dark,main,20220209,4,0.993188792504649,298,11,44,353
1273,dark,main,20220209,5,0.9902359266071568,292,12,44,348
1273,dark,main,20220209,6,0.9943174514001226,324,11,44,379
1273,dark,main,20220209,7,0.9933918856696338,272,15,41,328
1273,dark,main,20220209,8,0.99664852139711,299,15,53,367
1273,dark,main,20220209,9,0.9907276905022155,325,13,41,379
4125,dark,main,20220209,0,0.9886462084710689,321,29,33,383
4125,dark,main,20220209,1,0.9893557338908912,307,17,35,359
4125,dark,main,20220209,2,0.9919330806735586,315,25,44,384
4125,dark,main,20220209,3,0.9938252103679377,284,25,56,365
4125,dark,main,20220209,4,0.9943571587306118,280,14,51,345
4125,dark,main,20220209,5,0.9902260206297929,287,14,58,359
4125,dark,main,20220209,6,0.994460978835805,310,17,43,370
4125,dark,main,20220209,7,0.9820646262384937,269,18,37,324
4125,dark,main,20220209,8,0.9914485345418266,300,18,43,361
4125,dark,main,20220209,9,0.9878290453180887,325,24,40,389
23229,bright,main,20220209,0,0.9917170998689088,313,129,1,443
23229,bright,main,20220209,1,0.9917084693446454,268,132,4,404
23229,bright,main,20220209,2,0.9912105391616799,295,134,3,432
23229,bright,main,20220209,3,0.9920424118759387,259,132,4,395
23229,bright,main,20220209,4,0.9928628434410693,284,105,9,398
23229,bright,main,20220209,5,0.9965979210614107,262,141,7,410
23229,bright,main,20220209,6,0.9951563756593319,218,210,4,432
23229,bright,main,20220209,7,0.9890931677291631,199,172,4,375
23229,bright,main,20220209,8,0.9902169501010355,257,161,2,420
23229,bright,main,20220209,9,0.9929248794456732,242,191,3,436
10493,dark,main,20220209,0,0.9963468873702779,291,15,67,373
10493,dark,main,20220209,1,0.9928233152171139,265,16,54,335
10493,dark,main,20220209,2,0.9899028616679573,291,17,45,353
10493,dark,main,20220209,3,0.9918267469416838,266,14,50,330
10493,dark,main,20220209,4,0.985220641993851,251,12,60,323
10493,dark,main,20220209,5,0.9906274587319543,282,18,47,347
10493,dark,main,20220209,6,0.9913454187574013,276,13,65,354
10493,dark,main,20220209,7,0.9782793925637007,248,11,47,306
10493,dark,main,20220209,8,0.9961887954617348,298,11,46,355
10493,dark,main,20220209,9,0.9905093918072827,289,15,64,368
24450,bright,main,20220209,0,0.9933947397500179,189,254,3,446
24450,bright,main,20220209,1,0.9885789446297889,208,194,3,405
24450,bright,main,20220209,2,0.991323058834386,242,189,8,439
24450,bright,main,20220209,3,0.9910571495927645,231,165,3,399
24450,bright,main,20220209,4,0.9950034252541033,260,138,2,400
24450,bright,main,20220209,5,0.990956648405713,255,159,1,415
24450,bright,main,20220209,6,0.9933193664297122,199,230,6,435
24450,bright,main,20220209,7,0.9813675948292833,232,136,4,372
24450,bright,main,20220209,8,0.995271432712112,218,202,4,424
24450,bright,main,20220209,9,0.9834663600424792,226,205,5,436
9922,dark,main,20220209,0,0.9947603763481426,307,12,49,368
9922,dark,main,20220209,1,0.9915304732756609,277,13,44,334
9922,dark,main,20220209,2,0.994634530956413,337,12,45,394
9922,dark,main,20220209,3,0.9935998511735566,281,11,64,356
9922,dark,main,20220209,4,0.9919721121239465,278,10,54,342
9922,dark,main,20220209,5,0.9956784039825717,283,14,54,351
9922,dark,main,20220209,6,0.9899483506141677,283,16,61,360
9922,dark,main,20220209,7,0.991308669000331,249,14,49,312
9922,dark,main,20220209,8,0.9927363537228118,308,15,43,366
9922,dark,main,20220209,9,0.9912803801050725,292,15,61,368
10847,dark,main,20220209,0,0.9939893718011295,280,17,86,383
10847,dark,main,20220209,1,0.9954326013807305,274,12,67,353
10847,dark,main,20220209,2,0.9863342795074378,310,14,57,381
10847,dark,main,20220209,3,0.9904577764752289,288,13,46,347
10847,dark,main,20220209,4,0.9919608886059122,282,13,43,338
10847,dark,main,20220209,5,0.9923326765762253,291,11,42,344
10847,dark,main,20220209,6,0.9857093622818149,319,12,36,367
10847,dark,main,20220209,7,0.9913146515030231,272,10,35,317
10847,dark,main,20220209,8,0.9850615068600245,289,10,41,340
10847,dark,main,20220209,9,0.9936969683034851,298,16,68,382
11501,dark,main,20220209,0,0.9869366917248532,300,14,60,374
11501,dark,main,20220209,1,0.9931925422815876,270,19,66,355
11501,dark,main,20220209,2,0.9895432307444126,296,11,68,375
11501,dark,main,20220209,3,0.9807931047965188,275,14,59,348
11501,dark,main,20220209,4,0.9869309758297892,293,11,42,346
11501,dark,main,20220209,5,0.9917899618847785,278,11,52,341
11501,dark,main,20220209,6,0.9910328139842172,307,17,33,357
11501,dark,main,20220209,7,0.9868487281921595,265,13,47,325
11501,dark,main,20220209,8,0.992263347156477,281,12,54,347
11501,dark,main,20220209,9,0.9915918586662381,295,13,64,372
22870,bright,main,20220209,0,0.992427148282915,156,277,3,436
22870,bright,main,20220209,1,0.98688220126093,159,233,6,398
22870,bright,main,20220209,2,0.9947028821080823,177,257,4,438
22870,bright,main,20220209,3,0.9927363208181921,177,224,3,404
22870,bright,main,20220209,4,0.9955769020438107,206,186,4,396
22870,bright,main,20220209,5,0.9937084799096333,220,192,2,414
22870,bright,main,20220209,6,0.9885293953203084,191,235,6,432
22870,bright,main,20220209,7,0.9909402009163455,131,238,1,370
22870,bright,main,20220209,8,0.9909852858758043,121,300,4,425
22870,bright,main,20220209,9,0.9914788205035777,180,245,5,430
22872,bright,main,20220209,0,0.9926990189076981,228,212,2,442
22872,bright,main,20220209,1,0.9877014166888689,220,183,2,405
22872,bright,main,20220209,2,0.9873838643901586,250,187,2,439
22872,bright,main,20220209,3,0.9939871176358088,204,196,5,405
22872,bright,main,20220209,4,0.997561671755984,280,116,2,398
22872,bright,main,20220209,5,0.9915239124948574,323,94,0,417
22872,bright,main,20220209,6,0.9932822883635567,313,117,1,431
22872,bright,main,20220209,7,0.994655931926517,242,126,6,374
22872,bright,main,20220209,8,0.9944628213829559,220,201,2,423
22872,bright,main,20220209,9,0.9960184415563943,198,231,4,433
24084,bright,main,20220209,0,0.9908253282175332,279,143,4,426
24084,bright,main,20220209,1,0.9957032052819795,272,116,3,391
24084,bright,main,20220209,2,0.9940882438827325,261,171,3,435
24084,bright,main,20220209,3,0.9929419521266684,207,186,5,398
24084,bright,main,20220209,4,0.9912499420811638,207,186,3,396
24084,bright,main,20220209,5,0.9936859002902816,239,171,0,410
24084,bright,main,20220209,6,0.9978952801255996,181,239,4,424
24084,bright,main,20220209,7,0.9898638919521303,165,202,2,369
24084,bright,main,20220209,8,0.9904460071399128,254,153,5,412
24084,bright,main,20220209,9,0.9941426448392272,321,100,3,424
24435,bright,main,20220209,0,0.9953285466454915,266,169,4,439
24435,bright,main,20220209,1,0.9942917947266778,263,128,7,398
24435,bright,main,20220209,2,0.991904887971398,236,197,4,437
24435,bright,main,20220209,3,0.9926290291519583,221,179,3,403
24435,bright,main,20220209,4,0.9922550436790071,237,158,3,398
24435,bright,main,20220209,5,0.9933899628791439,291,122,2,415
24435,bright,main,20220209,6,0.9950948349614517,292,129,3,424
24435,bright,main,20220209,7,0.9885867496033851,240,126,4,370
24435,bright,main,20220209,8,0.991407273476808,214,200,6,420
24435,bright,main,20220209,9,0.9877447294587727,262,164,3,429
7081,dark,main,20220209,0,0.9871030755405671,345,21,36,402
7081,dark,main,20220209,1,0.9881891354985373,300,24,34,358
7081,dark,main,20220209,2,0.9966149410676075,320,18,41,379
7081,dark,main,20220209,3,0.9889154257304053,283,15,47,345
7081,dark,main,20220209,4,0.985452757860437,305,20,24,349
7081,dark,main,20220209,5,0.9874514435149503,294,13,50,357
7081,dark,main,20220209,6,0.9886340934216608,334,11,53,398
7081,dark,main,20220209,7,0.9899505824185975,262,18,47,327
7081,dark,main,20220209,8,0.9942154884023086,303,17,46,366
7081,dark,main,20220209,9,0.9880544272245471,312,18,48,378
1276,dark,main,20220209,0,0.9902666033710406,294,12,81,387
1276,dark,main,20220209,1,0.9897821271046783,250,13,98,361
1276,dark,main,20220209,2,0.9954582490989077,283,14,95,392
1276,dark,main,20220209,3,0.9920973846120398,302,11,44,357
1276,dark,main,20220209,4,0.9950830013581541,297,12,35,344
1276,dark,main,20220209,5,0.9901319349070774,290,14,50,354
1276,dark,main,20220209,6,0.9900660736601431,324,14,35,373
1276,dark,main,20220209,7,0.9911244275450286,267,13,51,331
1276,dark,main,20220209,8,0.9936645421505144,267,15,83,365
1276,dark,main,20220209,9,0.9841199538096245,256,22,101,379
8926,dark,main,20220209,0,0.9877977551741882,291,13,43,347
8926,dark,main,20220209,1,0.9902516513277578,268,17,43,328
8926,dark,main,20220209,2,0.9946499436675543,289,17,42,348
8926,dark,main,20220209,3,0.9923024999508945,285,12,41,338
8926,dark,main,20220209,4,0.9899161377371096,264,14,53,331
8926,dark,main,20220209,5,0.9933862880460228,278,15,65,358
8926,dark,main,20220209,6,0.9930357739075146,268,23,66,357
8926,dark,main,20220209,7,0.9879298276571364,255,13,50,318
8926,dark,main,20220209,8,0.9884899005333784,281,17,52,350
8926,dark,main,20220209,9,0.9878621324317857,302,11,50,363
5243,dark,main,20220209,0,0.9963826436324035,303,16,52,371
5243,dark,main,20220209,1,0.9868330214420047,272,10,57,339
5243,dark,main,20220209,2,0.9847150103600479,280,19,69,368
5243,dark,main,20220209,3,0.9924310821785554,262,18,74,354
5243,dark,main,20220209,4,0.9858813487865868,231,26,76,333
5243,dark,main,20220209,5,0.9932271150821992,239,20,88,347
5243,dark,main,20220209,6,0.9958813809737095,247,21,93,361
5243,dark,main,20220209,7,0.9889204476590016,216,17,84,317
5243,dark,main,20220209,8,0.9893519375902124,282,15,67,364
5243,dark,main,20220209,9,0.991339781306663,281,16,69,366
7245,dark,main,20220209,0,0.9967972922354724,326,12,48,386
7245,dark,main,20220209,1,0.9916181066194051,291,18,41,350
7245,dark,main,20220209,2,0.9924632157449016,319,22,32,373
7245,dark,main,20220209,3,0.9893045278139777,275,24,39,338
7245,dark,main,20220209,4,0.9869892473875429,283,13,47,343
7245,dark,main,20220209,5,0.9898776595976572,309,12,35,356
7245,dark,main,20220209,6,0.9925724720159005,326,14,40,380
7245,dark,main,20220209,7,0.992723974811277,281,13,48,342
7245,dark,main,20220209,8,0.9928724892663522,309,11,51,371
7245,dark,main,20220209,9,0.9966787842147334,326,14,48,388
11484,dark,main,20220209,0,0.982003418040856,317,11,49,377
11484,dark,main,20220209,1,0.9916892460460482,253,16,63,332
11484,dark,main,20220209,2,0.9917908760158073,288,17,89,394
11484,dark,main,20220209,3,0.9856282485883423,237,15,76,328
11484,dark,main,20220209,4,0.9935919899612691,240,13,80,333
11484,dark,main,20220209,5,0.9919903026092979,246,15,84,345
11484,dark,main,20220209,6,0.9928900674791495,264,15,65,344
11484,dark,main,20220209,7,0.9927697435443891,254,10,40,304
11484,dark,main,20220209,8,0.98913062103037,286,12,51,349
11484,dark,main,20220209,9,0.9880898066703492,307,18,47,372
9294,dark,main,20220209,0,0.9890090292036257,335,14,43,392
9294,dark,main,20220209,1,0.991585245957104,304,12,35,351
9294,dark,main,20220209,2,0.9957027740361528,309,16,57,382
9294,dark,main,20220209,3,0.9832479716733793,310,12,34,356
9294,dark,main,20220209,4,0.9852163348705317,302,11,39,352
9294,dark,main,20220209,5,0.9905753726749563,325,15,37,377
9294,dark,main,20220209,6,0.994266868439099,312,16,49,377
9294,dark,main,20220209,7,0.994335295482398,288,12,33,333
9294,dark,main,20220209,8,0.9895086563885388,318,14,46,378
9294,dark,main,20220209,9,0.9879441516045372,316,17,38,371
7206,dark,main,20220209,0,0.9935741856059223,312,12,49,373
7206,dark,main,20220209,1,0.989436493221979,290,11,41,342
7206,dark,main,20220209,2,0.9922933122902053,308,16,54,378
7206,dark,main,20220209,3,0.9899711126404243,291,14,47,352
7206,dark,main,20220209,4,0.9943509267804637,288,12,45,345
7206,dark,main,20220209,5,0.9902392467580563,332,13,25,370
7206,dark,main,20220209,6,0.9932861572463629,315,13,46,374
7206,dark,main,20220209,7,0.991568798248795,281,11,37,329
7206,dark,main,20220209,8,0.9855358985838836,321,14,40,375
7206,dark,main,20220209,9,0.9928499079719522,302,13,59,374
8373,dark,main,20220209,0,0.9969165915346507,308,17,49,374
8373,dark,main,20220209,1,0.9859844995356676,298,10,49,357
8373,dark,main,20220209,2,0.9895503374336324,270,12,89,371
8373,dark,main,20220209,3,0.9947961288978654,254,16,72,342
8373,dark,main,20220209,4,0.9874997104165897,236,13,90,339
8373,dark,main,20220209,5,0.9873448879409403,260,14,84,358
8373,dark,main,20220209,6,0.9919054166530425,265,21,99,385
8373,dark,main,20220209,7,0.9884397906240169,234,15,74,323
8373,dark,main,20220209,8,0.9881029996506606,280,11,65,356
8373,dark,main,20220209,9,0.9859039452469027,305,14,43,362
2372,dark,main,20220209,0,0.9863564210900639,342,18,28,388
2372,dark,main,20220209,1,0.9916532112615817,301,17,37,355
2372,dark,main,20220209,2,0.9909385563075126,307,38,34,379
2372,dark,main,20220209,3,0.9891774083340314,304,21,37,362
2372,dark,main,20220209,4,0.9919080231234204,282,17,45,344
2372,dark,main,20220209,5,0.9940870649780044,293,17,60,370
2372,dark,main,20220209,6,0.9920256766677381,319,15,43,377
2372,dark,main,20220209,7,0.9940011927236648,278,15,36,329
2372,dark,main,20220209,8,0.9867768574195007,310,14,51,375
2372,dark,main,20220209,9,0.9857049177773805,308,18,41,367
7216,dark,main,20220209,0,0.9853632680877693,301,23,49,373
7216,dark,main,20220209,1,0.9823496437656971,286,13,36,335
7216,dark,main,20220209,2,0.9899307532242488,322,28,45,395
7216,dark,main,20220209,3,0.9859638938545627,285,15,46,346
7216,dark,main,20220209,4,0.9907525367596446,306,26,26,358
7216,dark,main,20220209,5,0.9925459453989373,301,18,41,360
7216,dark,main,20220209,6,0.9887142243436502,320,18,34,372
7216,dark,main,20220209,7,0.9848207935013152,285,18,23,326
7216,dark,main,20220209,8,0.9867073162514804,307,21,45,373
7216,dark,main,20220209,9,0.9927431166754797,298,16,37,351
21529,bright,main,20220210,0,0.9948107240722636,245,197,2,444
21529,bright,main,20220210,1,0.9962175675723904,188,210,2,400
21529,bright,main,20220210,2,0.9893963347440015,245,189,5,439
21529,bright,main,20220210,3,0.9948908662655953,182,217,4,403
21529,bright,main,20220210,4,0.9956729653536182,279,114,4,397
21529,bright,main,20220210,5,0.9944970097931751,245,159,5,409
21529,bright,main,20220210,6,0.9939373318683048,223,200,3,426
21529,bright,main,20220210,7,0.9840185675807734,222,151,2,375
21529,bright,main,20220210,8,0.9949402778910098,235,187,3,425
21529,bright,main,20220210,9,0.9881949219398128,264,160,6,430
24434,bright,main,20220210,0,0.9956807696910872,359,81,4,444
24434,bright,main,20220210,1,0.9915022798049032,317,83,0,400
24434,bright,main,20220210,2,0.9856576276587629,315,111,4,430
24434,bright,main,20220210,3,0.9901360718922699,263,140,0,403
24434,bright,main,20220210,4,0.9926785315911212,311,80,4,395
24434,bright,main,20220210,5,0.9964549480696746,344,66,4,414
24434,bright,main,20220210,6,0.99258235440942,357,69,3,429
24434,bright,main,20220210,7,0.995318799696026,264,101,3,368
24434,bright,main,20220210,8,0.9928357568881337,323,87,8,418
24434,bright,main,20220210,9,0.9910658099045178,344,79,2,425
3147,dark,main,20220210,0,0.9915423181540816,295,16,79,390
3147,dark,main,20220210,1,0.9876599809081914,260,17,57,334
3147,dark,main,20220210,2,0.9899388553745798,319,15,53,387
3147,dark,main,20220210,3,0.9906147407867604,275,13,74,362
3147,dark,main,20220210,4,0.9906797693676497,278,15,57,350
3147,dark,main,20220210,5,0.9943071665551494,264,18,64,346
3147,dark,main,20220210,6,0.9930417043127683,313,12,49,374
3147,dark,main,20220210,7,0.9868675232301879,262,11,39,312
3147,dark,main,20220210,8,0.9872960894205421,315,13,42,370
3147,dark,main,20220210,9,0.9918944572132521,314,12,50,376
11494,dark,main,20220210,0,0.9900485527587398,320,10,42,372
11494,dark,main,20220210,1,0.9917309342464331,276,13,54,343
11494,dark,main,20220210,2,0.9929179013459531,295,16,60,371
11494,dark,main,20220210,3,0.98654364668623,280,9,51,340
11494,dark,main,20220210,4,0.9947320573321174,261,20,53,334
11494,dark,main,20220210,5,0.984261731174454,278,14,64,356
11494,dark,main,20220210,6,0.9915012651588795,278,15,63,356
11494,dark,main,20220210,7,0.9908169574903635,262,12,34,308
11494,dark,main,20220210,8,0.9916924027540539,279,13,49,341
11494,dark,main,20220210,9,0.9934672950586186,280,13,57,350
4729,dark,main,20220210,0,0.9843918646047888,262,30,97,389
4729,dark,main,20220210,1,0.9894893099018817,230,17,93,340
4729,dark,main,20220210,2,0.9900716099350634,279,20,79,378
4729,dark,main,20220210,3,0.9902350058260085,294,18,47,359
4729,dark,main,20220210,4,0.9910403385830582,277,17,47,341
4729,dark,main,20220210,5,0.9944481999016749,292,15,48,355
4729,dark,main,20220210,6,0.9949493891303514,283,18,69,370
4729,dark,main,20220210,7,0.9840572714172814,227,18,85,330
4729,dark,main,20220210,8,0.9863878402138392,250,17,75,342
4729,dark,main,20220210,9,0.9836342422107511,239,25,107,371
26225,bright,main,20220210,0,0.9903179298439453,329,111,1,441
26225,bright,main,20220210,1,0.9871199797669795,291,102,8,401
26225,bright,main,20220210,2,0.9940580310357269,318,112,6,436
26225,bright,main,20220210,3,0.9952463348497033,254,149,1,404
26225,bright,main,20220210,4,0.991021247602354,241,154,4,399
26225,bright,main,20220210,5,0.9969993118115077,218,191,4,413
26225,bright,main,20220210,6,0.9922075087316936,215,209,1,425
26225,bright,main,20220210,7,0.9936134847174837,183,186,3,372
26225,bright,main,20220210,8,0.9968511603709156,270,144,7,421
26225,bright,main,20220210,9,0.9937977671380236,277,151,1,429
25424,bright,main,20220210,0,0.9907559813805817,243,193,4,440
25424,bright,main,20220210,1,0.9959341887338653,230,170,3,403
25424,bright,main,20220210,2,0.9956370400733817,276,162,1,439
25424,bright,main,20220210,3,0.9861723786949821,246,158,2,406
25424,bright,main,20220210,4,0.9868439922552487,198,199,3,400
25424,bright,main,20220210,5,0.9935108493839423,223,194,3,420
25424,bright,main,20220210,6,0.9908163983683602,294,139,2,435
25424,bright,main,20220210,7,0.9889596811218148,287,87,4,378
25424,bright,main,20220210,8,0.9916477825488489,265,153,7,425
25424,bright,main,20220210,9,0.9922658551447212,281,148,5,434
23080,bright,main,20220210,0,0.9815420471454175,211,215,6,432
23080,bright,main,20220210,1,0.9932256773943727,215,174,5,394
23080,bright,main,20220210,2,0.9918867482253685,253,173,3,429
23080,bright,main,20220210,3,0.9942359394350799,281,107,5,393
23080,bright,main,20220210,4,0.9940175676734835,319,67,3,389
23080,bright,main,20220210,5,0.9914083667014472,318,90,4,412
23080,bright,main,20220210,6,0.9912255257146761,329,91,5,425
23080,bright,main,20220210,7,0.9903392346107499,212,147,6,365
23080,bright,main,20220210,8,0.9943710051315416,205,207,3,415
23080,bright,main,20220210,9,0.9918566128353584,183,241,3,427
10846,dark,main,20220210,0,0.9862122236055175,321,12,51,384
10846,dark,main,20220210,1,0.992297851005072,290,12,43,345
10846,dark,main,20220210,2,0.9863945644662042,319,12,63,394
10846,dark,main,20220210,3,0.9905738019703725,241,16,91,348
10846,dark,main,20220210,4,0.9903572051270437,240,22,77,339
10846,dark,main,20220210,5,0.9887470672909169,268,12,87,367
10846,dark,main,20220210,6,0.9901079588930869,290,15,84,389
10846,dark,main,20220210,7,0.9874594623028533,243,18,81,342
10846,dark,main,20220210,8,0.9885233961741823,290,13,67,370
10846,dark,main,20220210,9,0.9915340428054826,313,18,43,374
10833,dark,main,20220210,0,0.9935513540396237,325,14,50,389
10833,dark,main,20220210,1,0.9929755707608009,298,12,40,350
10833,dark,main,20220210,2,0.9863939908221885,329,12,39,380
10833,dark,main,20220210,3,0.9877669478463018,297,13,43,353
10833,dark,main,20220210,4,0.9881442097639709,290,10,42,342
10833,dark,main,20220210,5,0.9819056358187793,294,9,56,359
10833,dark,main,20220210,6,0.9935180640089919,272,20,93,385
10833,dark,main,20220210,7,0.9916469520162642,252,14,77,343
10833,dark,main,20220210,8,0.9967028983596236,305,12,67,384
10833,dark,main,20220210,9,0.986360230535682,311,14,51,376
21530,bright,main,20220210,0,0.9933478769347752,310,132,0,442
21530,bright,main,20220210,1,0.9960305037655374,254,149,0,403
21530,bright,main,20220210,2,0.9945531205865771,277,154,1,432
21530,bright,main,20220210,3,0.994116735632413,189,208,4,401
21530,bright,main,20220210,4,0.9962553358785584,183,208,6,397
21530,bright,main,20220210,5,0.9956998972500803,186,231,3,420
21530,bright,main,20220210,6,0.9910986005508865,231,196,3,430
21530,bright,main,20220210,7,0.9951140646672278,230,142,2,374
21530,bright,main,20220210,8,0.9913594115914731,241,177,2,420
21530,bright,main,20220210,9,0.9957730895629321,219,210,4,433
23036,bright,main,20220210,0,0.9906994296540755,307,112,6,425
23036,bright,main,20220210,1,0.9884503872001323,304,68,7,379
23036,bright,main,20220210,2,0.989376109160223,354,53,6,413
23036,bright,main,20220210,3,0.989700990310984,326,59,2,387
23036,bright,main,20220210,4,0.9913202790187998,303,65,2,370
23036,bright,main,20220210,5,0.988923259276695,312,75,2,389
23036,bright,main,20220210,6,0.993413620292192,361,50,7,418
23036,bright,main,20220210,7,0.9887759184303782,272,74,5,351
23036,bright,main,20220210,8,0.9853769689332267,284,112,7,403
23036,bright,main,20220210,9,0.9891105471831536,319,88,6,413
4715,dark,main,20220210,0,0.990483931480186,316,16,62,394
4715,dark,main,20220210,1,0.9905007090374909,286,14,54,354
4715,dark,main,20220210,2,0.9920002913208515,324,14,57,395
4715,dark,main,20220210,3,0.9941533179234525,248,22,82,352
4715,dark,main,20220210,4,0.9909301772093967,245,23,82,350
4715,dark,main,20220210,5,0.9847373678743756,276,20,63,359
4715,dark,main,20220210,6,0.989513101737615,301,15,56,372
4715,dark,main,20220210,7,0.9904588246952918,266,15,43,324
4715,dark,main,20220210,8,0.9846926292301699,272,17,75,364
4715,dark,main,20220210,9,0.9950321182713977,304,18,62,384
11502,dark,main,20220210,0,0.9913287942369804,289,29,46,364
11502,dark,main,20220210,1,0.9923135084287321,291,10,50,351
11502,dark,main,20220210,2,0.9906487058813543,321,12,41,374
11502,dark,main,20220210,3,0.9926594720244057,249,20,81,350
11502,dark,main,20220210,4,0.9913046451772212,248,17,86,351
11502,dark,main,20220210,5,0.9910233642074624,242,18,108,368
11502,dark,main,20220210,6,0.9939941010347229,262,13,96,371
11502,dark,main,20220210,7,0.9857359622594621,245,21,70,336
11502,dark,main,20220210,8,0.9923825119441194,285,18,60,363
11502,dark,main,20220210,9,0.9934985465976163,279,18,61,358
11482,dark,main,20220210,0,0.9937512898144337,283,19,58,360
11482,dark,main,20220210,1,0.9866055203796331,234,16,72,322
11482,dark,main,20220210,2,0.9887256634817366,283,18,59,360
11482,dark,main,20220210,3,0.9813603002805128,260,15,52,327
11482,dark,main,20220210,4,0.9936944831467993,257,17,68,342
11482,dark,main,20220210,5,0.9941745329820063,230,19,89,338
11482,dark,main,20220210,6,0.9866056396056374,244,20,89,353
11482,dark,main,20220210,7,0.989941641364809,247,12,53,312
11482,dark,main,20220210,8,0.9848621439092574,284,12,63,359
11482,dark,main,20220210,9,0.9900396659103229,285,16,65,366
2661,dark,main,20220210,0,0.9921288795489221,292,21,60,373
2661,dark,main,20220210,1,0.9901695680813762,268,19,52,339
2661,dark,main,20220210,2,0.9904562832106345,276,19,74,369
2661,dark,main,20220210,3,0.9942421626279325,251,19,61,331
2661,dark,main,20220210,4,0.9928054582653912,242,14,61,317
2661,dark,main,20220210,5,0.9854618489263901,273,15,59,347
2661,dark,main,20220210,6,0.993778596963116,269,14,84,367
2661,dark,main,20220210,7,0.9867810811831235,254,21,44,319
2661,dark,main,20220210,8,0.99023287386714,289,16,52,357
2661,dark,main,20220210,9,0.9960715840892592,280,20,64,364
40554,backup,main,20220210,0,0.9905999951275279,7,393,0,400
40554,backup,main,20220210,1,0.9927826698945945,1,368,0,369
40554,backup,main,20220210,2,0.9968977198621853,4,396,1,401
40554,backup,main,20220210,3,0.9942502354206787,8,347,0,355
40554,backup,main,20220210,4,0.9872843787953736,10,359,0,369
40554,backup,main,20220210,5,0.9924858180408771,3,384,1,388
40554,backup,main,20220210,6,0.9880790700059721,3,394,0,397
40554,backup,main,20220210,7,0.9888146268180623,11,320,1,332
40554,backup,main,20220210,8,0.9929113749432792,6,377,1,384
40554,backup,main,20220210,9,0.9919534662919944,9,389,0,398
26107,bright,main,20220210,0,0.9891130810494269,236,201,5,442
26107,bright,main,20220210,1,0.9904030899350342,225,180,2,407
26107,bright,main,20220210,2,0.9941815107249368,225,200,3,428
26107,bright,main,20220210,3,0.9973105277098254,227,175,2,404
26107,bright,main,20220210,4,0.9950437526856756,236,161,4,401
26107,bright,main,20220210,5,0.9941963661900414,269,145,4,418
26107,bright,main,20220210,6,0.9891775071206317,255,172,6,433
26107,bright,main,20220210,7,0.9940707278905775,245,130,2,377
26107,bright,main,20220210,8,0.9965053174156168,299,118,6,423
26107,bright,main,20220210,9,0.992728034991486,265,165,4,434
23095,bright,main,20220210,0,0.9922005431303299,239,193,8,440
23095,bright,main,20220210,1,0.988184048866091,168,232,5,405
23095,bright,main,20220210,2,0.9968861526098566,167,268,2,437
23095,bright,main,20220210,3,0.996245238999922,215,185,5,405
23095,bright,main,20220210,4,0.9883676788016503,160,237,3,400
23095,bright,main,20220210,5,0.9954215592913025,156,263,1,420
23095,bright,main,20220210,6,0.9893513818481646,232,198,4,434
23095,bright,main,20220210,7,0.9925207559760363,187,186,5,378
23095,bright,main,20220210,8,0.9944881183093971,121,301,3,425
23095,bright,main,20220210,9,0.9958574602232514,218,211,6,435
43081,backup,main,20220210,0,0.9892290296859374,4,436,0,440
43081,backup,main,20220210,1,0.9833635049538579,8,397,0,405
43081,backup,main,20220210,2,0.9915842543648785,9,418,0,427
43081,backup,main,20220210,3,0.9929809234578579,8,385,0,393
43081,backup,main,20220210,4,0.9938025728325276,4,379,0,383
43081,backup,main,20220210,5,0.9867156598312263,2,406,0,408
43081,backup,main,20220210,6,0.9917444192336426,5,416,0,421
43081,backup,main,20220210,7,0.9898837462384834,4,357,0,361
43081,backup,main,20220210,8,0.9899044004275844,6,410,0,416
43081,backup,main,20220210,9,0.9895967006657498,4,420,0,424
25365,bright,main,20220210,0,0.9920960778724274,242,168,5,415
25365,bright,main,20220210,1,0.9921488465694944,263,111,7,381
25365,bright,main,20220210,2,0.9939704391312867,289,123,4,416
25365,bright,main,20220210,3,0.9862702001858373,249,120,2,371
25365,bright,main,20220210,4,0.9930507698800362,274,92,8,374
25365,bright,main,20220210,5,0.9946887822376217,282,108,8,398
25365,bright,main,20220210,6,0.9896942888811145,305,101,4,410
25365,bright,main,20220210,7,0.9867844795823784,238,111,5,354
25365,bright,main,20220210,8,0.9922931000250242,262,142,4,408
25365,bright,main,20220210,9,0.9895406693976475,245,152,9,406
41107,backup,main,20220210,0,0.9930705933749523,4,373,1,378
41107,backup,main,20220210,1,0.9888274277746729,2,309,1,312
41107,backup,main,20220210,2,0.9918744825683679,0,365,0,365
41107,backup,main,20220210,3,0.9948927589549028,6,321,1,328
41107,backup,main,20220210,4,0.9910053033138865,7,303,1,311
41107,backup,main,20220210,5,0.9930949781050297,2,338,0,340
41107,backup,main,20220210,6,0.9928924044951508,1,343,0,344
41107,backup,main,20220210,7,0.9901950873133689,5,303,1,309
41107,backup,main,20220210,8,0.9935172631079459,5,344,1,350
41107,backup,main,20220210,9,0.9909579679173329,4,360,0,364
23240,bright,main,20220210,0,0.9953732534374916,258,172,10,440
23240,bright,main,20220210,1,0.9905572466237972,285,110,4,399
23240,bright,main,20220210,2,0.9933678638412514,265,157,7,429
23240,bright,main,20220210,3,0.9920288044550217,295,105,4,404
23240,bright,main,20220210,4,0.9877425620240147,268,115,3,386
23240,bright,main,20220210,5,0.9924648647909321,324,80,3,407
23240,bright,main,20220210,6,0.9921498334338996,301,124,4,429
23240,bright,main,20220210,7,0.9922127800837376,242,129,0,371
23240,bright,main,20220210,8,0.9924224363969638,269,145,4,418
23240,bright,main,20220210,9,0.9858535559059632,235,188,4,427
24423,bright,main,20220210,0,0.9898212456070462,318,117,5,440
24423,bright,main,20220210,1,0.9934942863426273,278,120,3,401
24423,bright,main,20220210,2,0.9955261666445772,273,157,4,434
24423,bright,main,20220210,3,0.9905983189156916,278,120,3,401
24423,bright,main,20220210,4,0.9952178592321604,249,145,5,399
24423,bright,main,20220210,5,0.9951362188663901,330,84,3,417
24423,bright,main,20220210,6,0.9867618722715271,317,109,0,426
24423,bright,main,20220210,7,0.9923345894465884,298,68,6,372
24423,bright,main,20220210,8,0.9948492893751197,301,110,4,415
24423,bright,main,20220210,9,0.9945873934685744,288,134,9,431
23598,bright,main,20220210,0,0.9924117559929494,393,39,5,437
23598,bright,main,20220210,1,0.9888753136042187,330,57,3,390
23598,bright,main,20220210,2,0.9961458322021163,368,63,0,431
23598,bright,main,20220210,3,0.9916464598603716,307,63,4,374
23598,bright,main,20220210,4,0.9898556368043251,318,64,3,385
23598,bright,main,20220210,5,0.9897415691090792,343,57,4,404
23598,bright,main,20220210,6,0.9945261559629235,362,53,5,420
23598,bright,main,20220210,7,0.9942143729435837,296,58,4,358
23598,bright,main,20220210,8,0.9902508731251812,342,60,6,408
23598,bright,main,20220210,9,0.9897219282516792,355,62,8,425
8908,dark,main,20220210,0,0.9854188099835224,271,18,65,354
8908,dark,main,20220210,1,0.994364546342892,255,16,63,334
8908,dark,main,20220210,2,0.9929185092175054,266,20,58,344
8908,dark,main,20220210,3,0.9799150767583614,257,18,61,336
8908,dark,main,20220210,4,0.9871283750115584,251,28,59,338
8908,dark,main,20220210,5,0.9910336865907783,261,23,59,343
8908,dark,main,20220210,6,0.9879011630829526,295,16,53,364
8908,dark,main,20220210,7,0.9858740094543698,192,22,67,281
8908,dark,main,20220210,8,0.9903265029186662,254,20,66,340
8908,dark,main,20220210,9,0.9867282704325843,242,23,69,334
40578,backup,main,20220210,0,0.9949975474803551,5,396,1,402
40578,backup,main,20220210,1,0.9950047196441635,3,364,0,367
40578,backup,main,20220210,2,0.9926438166644805,4,387,1,392
40578,backup,main,20220210,3,0.987836905732266,3,371,1,375
40578,backup,main,20220210,4,0.9944497894332567,3,362,1,366
40578,backup,main,20220210,5,0.9913203058316927,4,371,0,375
40578,backup,main,20220210,6,0.9926054674802625,7,376,0,383
40578,backup,main,20220210,7,0.9922564366444714,4,330,0,334
40578,backup,main,20220210,8,0.9929713996911039,4,379,2,385
40578,backup,main,20220210,9,0.9883880609720617,8,377,1,386
23127,bright,main,20220211,0,0.9928740817133559,316,84,5,405
23127,bright,main,20220211,1,0.9893862642981337,305,89,7,401
23127,bright,main,20220211,2,0.9954559260440398,333,89,3,425
23127,bright,main,20220211,3,0.993625850804767,278,117,6,401
23127,bright,main,20220211,4,0.9935906992349776,241,152,2,395
23127,bright,main,20220211,5,0.9954530071406618,294,123,3,420
23127,bright,main,20220211,6,0.9947810113927331,305,122,4,431
23127,bright,main,20220211,7,0.988354582024905,213,159,4,376
23127,bright,main,20220211,8,0.9933976771555162,234,182,5,421
23127,bright,main,20220211,9,0.9946597016256224,333,90,8,431
2295,dark,main,20220211,0,0.9969941479868337,336,18,50,404
2295,dark,main,20220211,1,0.9971065499303884,281,18,54,353
2295,dark,main,20220211,2,0.9877462493956294,316,12,50,378
2295,dark,main,20220211,3,0.9850623264675138,284,14,54,352
2295,dark,main,20220211,4,0.9895540497749845,291,13,51,355
2295,dark,main,20220211,5,0.9882969970937073,283,21,52,356
2295,dark,main,20220211,6,0.9891459689222375,286,26,48,360
2295,dark,main,20220211,7,0.9874072831885614,235,24,61,320
2295,dark,main,20220211,8,0.9956814193213278,264,28,55,347
2295,dark,main,20220211,9,0.9934053789435475,305,21,62,388
22857,bright,main,20220211,0,0.9882235196325382,305,136,3,444
22857,bright,main,20220211,1,0.9904147183637455,235,157,5,397
22857,bright,main,20220211,2,0.9929849117548545,221,201,2,424
22857,bright,main,20220211,3,0.9945087287859844,228,167,4,399
22857,bright,main,20220211,4,0.9905239995567476,240,148,7,395
22857,bright,main,20220211,5,0.9899475099494079,237,170,5,412
22857,bright,main,20220211,6,0.9880288913359729,267,147,8,422
22857,bright,main,20220211,7,0.9908521488031037,222,145,3,370
22857,bright,main,20220211,8,0.9889072236619717,250,159,6,415
22857,bright,main,20220211,9,0.9916049636456589,277,149,8,434
24260,bright,main,20220211,0,0.9944007207090533,272,165,1,438
24260,bright,main,20220211,1,0.99529854476714,244,153,4,401
24260,bright,main,20220211,2,0.9928248641585354,200,208,5,413
24260,bright,main,20220211,3,0.9867776282671263,283,112,4,399
24260,bright,main,20220211,4,0.9899641321512248,245,143,2,390
24260,bright,main,20220211,5,0.9927647138533955,267,141,3,411
24260,bright,main,20220211,6,0.9957869427365803,237,185,5,427
24260,bright,main,20220211,7,0.9958223247400435,154,209,5,368
24260,bright,main,20220211,8,0.9920599355975365,246,170,3,419
24260,bright,main,20220211,9,0.992452598249259,273,144,2,419
23000,bright,main,20220211,0,0.9936912818576732,280,139,6,425
23000,bright,main,20220211,1,0.9966848577879354,306,80,4,390
23000,bright,main,20220211,2,0.9948504616308097,357,56,4,417
23000,bright,main,20220211,3,0.988546906858914,285,83,3,371
23000,bright,main,20220211,4,0.9866128060939785,295,89,7,391
23000,bright,main,20220211,5,0.99254093149148,324,81,3,408
23000,bright,main,20220211,6,0.9936178384907631,270,142,7,419
23000,bright,main,20220211,7,0.9876901521181759,248,108,3,359
23000,bright,main,20220211,8,0.9932905145622837,264,134,4,402
23000,bright,main,20220211,9,0.9872908065753568,244,159,7,410
26213,bright,main,20220211,0,0.9938838367713264,172,260,5,437
26213,bright,main,20220211,1,0.9952113779666946,170,224,3,397
26213,bright,main,20220211,2,0.9952552095546514,195,225,4,424
26213,bright,main,20220211,3,0.989091244996186,190,194,9,393
26213,bright,main,20220211,4,0.9878927154552017,233,154,8,395
26213,bright,main,20220211,5,0.9927164880251204,268,144,2,414
26213,bright,main,20220211,6,0.9926526965037521,281,138,6,425
26213,bright,main,20220211,7,0.9883556862598446,188,181,2,371
26213,bright,main,20220211,8,0.9922314773264128,170,243,6,419
26213,bright,main,20220211,9,0.9953737860565058,201,219,6,426
26146,bright,main,20220211,0,0.9946054315814918,326,93,1,420
26146,bright,main,20220211,1,0.9941234572471813,284,88,6,378
26146,bright,main,20220211,2,0.993562540193401,296,103,3,402
26146,bright,main,20220211,3,0.9841404564298731,319,66,6,391
26146,bright,main,20220211,4,0.9859781783773933,285,96,7,388
26146,bright,main,20220211,5,0.9913119530015571,259,136,7,402
26146,bright,main,20220211,6,0.994055625078468,305,115,2,422
26146,bright,main,20220211,7,0.9946589434360381,230,132,5,367
26146,bright,main,20220211,8,0.9949971972736312,312,96,7,415
26146,bright,main,20220211,9,0.9928933705421444,329,86,11,426
24791,bright,main,20220211,0,0.9920785955786686,197,238,1,436
24791,bright,main,20220211,1,0.9940036537704954,151,244,4,399
24791,bright,main,20220211,2,0.991388479841992,229,190,7,426
24791,bright,main,20220211,3,0.9921104529366199,184,216,0,400
24791,bright,main,20220211,4,0.9940307991663386,197,196,3,396
24791,bright,main,20220211,5,0.9936542739685676,241,163,2,406
24791,bright,main,20220211,6,0.9896558054884739,311,102,8,421
24791,bright,main,20220211,7,0.9866250988713058,299,71,2,372
24791,bright,main,20220211,8,0.992735886107938,264,149,8,421
24791,bright,main,20220211,9,0.992553168867171,233,193,8,434
10859,dark,main,20220211,0,0.9900142229308228,333,10,40,383
10859,dark,main,20220211,1,0.9909633036367057,319,11,34,364
10859,dark,main,20220211,2,0.9896296559771893,324,11,36,371
10859,dark,main,20220211,3,0.9961815817923536,306,11,42,359
10859,dark,main,20220211,4,0.9921174639466128,310,12,41,363
10859,dark,main,20220211,5,0.9917142997888382,298,12,52,362
10859,dark,main,20220211,6,0.9904879312734898,320,16,47,383
10859,dark,main,20220211,7,0.9838063736628788,286,11,38,335
10859,dark,main,20220211,8,0.9910103281308552,315,12,44,371
10859,dark,main,20220211,9,0.9904394199299102,339,12,26,377
23107,bright,main,20220211,0,0.9926419272506515,361,75,5,441
23107,bright,main,20220211,1,0.9920159896543503,328,68,4,400
23107,bright,main,20220211,2,0.9878771208525382,336,84,5,425
23107,bright,main,20220211,3,0.9916334810030591,296,93,5,394
23107,bright,main,20220211,4,0.9851773050637272,286,103,5,394
23107,bright,main,20220211,5,0.9887710799709784,249,158,1,408
23107,bright,main,20220211,6,0.9933239966423968,286,135,2,423
23107,bright,main,20220211,7,0.9925563693631904,260,101,5,366
23107,bright,main,20220211,8,0.9940302852984856,284,123,10,417
23107,bright,main,20220211,9,0.9907848076519924,315,101,8,424
26216,bright,main,20220211,0,0.9919570577252689,166,267,5,438
26216,bright,main,20220211,1,0.986703551972581,165,235,2,402
26216,bright,main,20220211,2,0.9919555639106631,229,194,6,429
26216,bright,main,20220211,3,0.9901617596928683,159,236,4,399
26216,bright,main,20220211,4,0.995867048966763,139,248,7,394
26216,bright,main,20220211,5,0.9932547334225384,187,223,1,411
26216,bright,main,20220211,6,0.9915557850339167,246,177,4,427
26216,bright,main,20220211,7,0.9894261339008344,191,180,5,376
26216,bright,main,20220211,8,0.9884736432038602,248,166,4,418
26216,bright,main,20220211,9,0.9879604178052542,246,177,4,427
10491,dark,main,20220211,0,0.9944779507626696,281,15,37,333
10491,dark,main,20220211,1,0.9851634936205156,261,19,33,313
10491,dark,main,20220211,2,0.9926715497181764,279,15,49,343
10491,dark,main,20220211,3,0.9944473919483731,280,17,43,340
10491,dark,main,20220211,4,0.9862580800414091,272,13,45,330
10491,dark,main,20220211,5,0.991392572923737,298,13,38,349
10491,dark,main,20220211,6,0.990106510360099,304,16,48,368
10491,dark,main,20220211,7,0.9946067242120098,239,16,59,314
10491,dark,main,20220211,8,0.9762300032224248,295,14,48,357
10491,dark,main,20220211,9,0.9935735631717082,276,18,56,350
22230,bright,main,20220211,0,0.9950196026005111,286,139,5,430
22230,bright,main,20220211,1,0.9927292460556743,230,142,10,382
22230,bright,main,20220211,2,0.9940142194841545,262,147,9,418
22230,bright,main,20220211,3,0.9938976685618883,207,164,7,378
22230,bright,main,20220211,4,0.9682074705902424,117,79,3,199
22230,bright,main,20220211,5,0.9934096090985248,209,184,8,401
22230,bright,main,20220211,6,0.9932922455371129,246,162,5,413
22230,bright,main,20220211,7,0.9905843549160559,256,98,2,356
22230,bright,main,20220211,8,0.9921668635402723,310,90,8,408
22230,bright,main,20220211,9,0.9958882992543145,269,136,5,410
4134,dark,main,20220211,0,0.9913773043289271,302,14,44,360
4134,dark,main,20220211,1,0.9890908256741346,286,13,43,342
4134,dark,main,20220211,2,0.9875895147082936,301,12,50,363
4134,dark,main,20220211,3,0.9910492674410005,269,11,45,325
4134,dark,main,20220211,4,0.9953747822123834,274,11,43,328
4134,dark,main,20220211,5,0.9838228011978908,298,11,44,353
4134,dark,main,20220211,6,0.9969029897358045,297,14,53,364
4134,dark,main,20220211,7,0.991353577531481,269,10,37,316
4134,dark,main,20220211,8,0.987586361526534,275,15,47,337
4134,dark,main,20220211,9,0.9876923241357793,304,17,48,369
5637,dark,main,20220211,0,0.9905444866745143,311,13,55,379
5637,dark,main,20220211,1,0.991120995938369,295,14,31,340
5637,dark,main,20220211,2,0.991081926551418,309,12,30,351
5637,dark,main,20220211,3,0.9897617340039913,299,13,43,355
5637,dark,main,20220211,4,0.9916779425594651,280,11,42,333
5637,dark,main,20220211,5,0.9937799940928745,291,13,60,364
5637,dark,main,20220211,6,0.9897405699713454,294,11,76,381
5637,dark,main,20220211,7,0.991054540055387,279,12,46,337
5637,dark,main,20220211,8,0.988511701758121,311,12,51,374
5637,dark,main,20220211,9,0.9921442026806353,317,12,40,369
4585,dark,main,20220211,0,0.9910704151595817,320,11,43,374
4585,dark,main,20220211,1,0.9924025283291286,303,12,35,350
4585,dark,main,20220211,2,0.9927772055611418,324,12,33,369
4585,dark,main,20220211,3,0.9946527045860906,290,13,45,348
4585,dark,main,20220211,4,0.9944287671768579,304,13,29,346
4585,dark,main,20220211,5,0.9916446179350341,305,14,53,372
4585,dark,main,20220211,6,0.9924067985123451,279,19,76,374
4585,dark,main,20220211,7,0.9899262199352719,269,17,46,332
4585,dark,main,20220211,8,0.9941112349205612,305,14,60,379
4585,dark,main,20220211,9,0.9907595430452362,335,12,41,388
26133,bright,main,20220211,0,0.987768344480221,351,66,2,419
26133,bright,main,20220211,1,0.9901441366454078,315,61,7,383
26133,bright,main,20220211,2,0.995540237100586,316,79,10,405
26133,bright,main,20220211,3,0.9858183645998428,278,92,7,377
26133,bright,main,20220211,4,0.9943137121639621,289,83,5,377
26133,bright,main,20220211,5,0.9887797132954333,326,69,5,400
26133,bright,main,20220211,6,0.9880536007263953,318,94,2,414
26133,bright,main,20220211,7,0.9922647970416203,296,60,4,360
26133,bright,main,20220211,8,0.9938494992962825,322,75,7,404
26133,bright,main,20220211,9,0.9954817651142439,281,125,4,410
3686,dark,main,20220211,0,0.9948441653827917,325,13,50,388
3686,dark,main,20220211,1,0.9859268195962123,300,13,32,345
3686,dark,main,20220211,2,0.9763918585506548,306,12,41,359
3686,dark,main,20220211,3,0.9857912963091563,287,14,48,349
3686,dark,main,20220211,4,0.9908657499953857,284,16,39,339
3686,dark,main,20220211,5,0.9919117341659105,279,13,66,358
3686,dark,main,20220211,6,0.990812308243814,288,17,71,376
3686,dark,main,20220211,7,0.9886244861972326,289,15,38,342
3686,dark,main,20220211,8,0.9835721577043163,309,14,42,365
3686,dark,main,20220211,9,0.9922078283141497,315,12,54,381
5974,dark,main,20220211,0,0.9903799390730794,346,11,38,395
5974,dark,main,20220211,1,0.9870183130398935,304,15,37,356
5974,dark,main,20220211,2,0.9892474697774581,307,21,44,372
5974,dark,main,20220211,3,0.9799375076164235,293,12,46,351
5974,dark,main,20220211,4,0.9931268519560499,304,9,30,343
5974,dark,main,20220211,5,0.9909899066240775,308,14,37,359
5974,dark,main,20220211,6,0.9897989849257655,313,12,51,376
5974,dark,main,20220211,7,0.9897386636455279,284,14,39,337
5974,dark,main,20220211,8,0.9965935491422926,321,13,32,366
5974,dark,main,20220211,9,0.9924219605585322,344,12,30,386
4636,dark,main,20220211,0,0.9944553039665781,291,13,72,376
4636,dark,main,20220211,1,0.9959719908503816,310,14,42,366
4636,dark,main,20220211,2,0.9961014578601015,310,13,38,361
4636,dark,main,20220211,3,0.9909065032068372,305,12,40,357
4636,dark,main,20220211,4,0.9912207418840658,296,14,39,349
4636,dark,main,20220211,5,0.9944237001341895,300,16,38,354
4636,dark,main,20220211,6,0.9905262208155564,324,12,29,365
4636,dark,main,20220211,7,0.9871060083030511,295,13,28,336
4636,dark,main,20220211,8,0.9886976691230145,311,13,36,360
4636,dark,main,20220211,9,0.9914036879197039,314,13,47,374
5809,dark,main,20220211,0,0.9943372231792418,310,12,42,364
5809,dark,main,20220211,1,0.9855420192721207,258,16,44,318
5809,dark,main,20220211,2,0.9963170633168064,287,10,53,350
5809,dark,main,20220211,3,0.9930961543246913,287,17,34,338
5809,dark,main,20220211,4,0.9928056374228093,286,12,44,342
5809,dark,main,20220211,5,0.9933201892402141,290,11,37,338
5809,dark,main,20220211,6,0.989530457276431,276,16,59,351
5809,dark,main,20220211,7,0.9879010441566135,248,15,48,311
5809,dark,main,20220211,8,0.9946109262734655,272,13,46,331
5809,dark,main,20220211,9,0.991736323247055,297,12,42,351
26241,bright,main,20220211,0,0.9915445797808071,226,196,10,432
26241,bright,main,20220211,1,0.9910104156429212,143,240,6,389
26241,bright,main,20220211,2,0.9933714660769132,176,238,2,416
26241,bright,main,20220211,3,0.9888765297775959,130,248,9,387
26241,bright,main,20220211,4,0.9895497494320883,162,221,6,389
26241,bright,main,20220211,5,0.9927802302756833,204,197,4,405
26241,bright,main,20220211,6,0.994284605122569,216,201,7,424
26241,bright,main,20220211,7,0.9909667511977384,176,184,5,365
26241,bright,main,20220211,8,0.9933615442385137,235,164,6,405
26241,bright,main,20220211,9,0.994496013567219,222,195,4,421
21484,bright,main,20220212,0,0.9954801464716024,250,180,4,434
21484,bright,main,20220212,1,0.9892174422000624,189,200,4,393
21484,bright,main,20220212,2,0.9890344458999848,278,148,9,435
21484,bright,main,20220212,3,0.9895797522309667,243,141,7,391
21484,bright,main,20220212,4,0.9880026740239685,190,206,2,398
21484,bright,main,20220212,5,0.9890389325184987,209,201,4,414
21484,bright,main,20220212,6,0.990376063353357,291,127,6,424
21484,bright,main,20220212,7,0.9872289417866594,259,103,7,369
21484,bright,main,20220212,8,0.9923147565508833,328,84,6,418
21484,bright,main,20220212,9,0.9945988077937581,298,127,2,427
21839,bright,main,20220212,0,0.9960087371998504,365,68,5,438
21839,bright,main,20220212,1,0.988509719787982,301,93,6,400
21839,bright,main,20220212,2,0.9896500835438381,326,96,5,427
21839,bright,main,20220212,3,0.995315911012424,313,76,3,392
21839,bright,main,20220212,4,0.9940302794160074,282,105,5,392
21839,bright,main,20220212,5,0.9932514658620671,271,138,4,413
21839,bright,main,20220212,6,0.9919693158784375,298,111,2,411
21839,bright,main,20220212,7,0.9897334022444826,304,57,3,364
21839,bright,main,20220212,8,0.9942713178302487,349,59,7,415
21839,bright,main,20220212,9,0.991206888262605,359,69,1,429
20680,bright,main,20220212,0,0.9933364653788918,320,91,11,422
20680,bright,main,20220212,1,0.9926475050307494,233,140,5,378
20680,bright,main,20220212,2,0.9947605800068194,214,202,8,424
20680,bright,main,20220212,3,0.9920194567073216,208,174,8,390
20680,bright,main,20220212,4,0.9923692455323943,159,212,7,378
20680,bright,main,20220212,5,0.9968042424609438,249,153,5,407
20680,bright,main,20220212,6,0.9944814112734,277,122,9,408
20680,bright,main,20220212,7,0.987574692056947,260,98,2,360
20680,bright,main,20220212,8,0.9936650602457489,235,156,11,402
20680,bright,main,20220212,9,0.9910604749471452,290,117,7,414
9269,dark,main,20220212,0,0.9919188429943635,302,12,70,384
9269,dark,main,20220212,1,0.9889154261949696,282,13,52,347
9269,dark,main,20220212,2,0.987656666139473,317,15,44,376
9269,dark,main,20220212,3,0.9948885657607023,308,11,42,361
9269,dark,main,20220212,4,0.9907248010099249,308,12,23,343
9269,dark,main,20220212,5,0.9941214703370692,307,12,40,359
9269,dark,main,20220212,6,0.9897943156530736,333,15,27,375
9269,dark,main,20220212,7,0.9931059300711338,280,11,39,330
9269,dark,main,20220212,8,0.9913073360230061,315,17,41,373
9269,dark,main,20220212,9,0.9854128903815846,336,17,43,396
10490,dark,main,20220212,0,0.9889196205192341,304,12,50,366
10490,dark,main,20220212,1,0.9873473089142834,265,24,56,345
10490,dark,main,20220212,2,0.9940860289425918,313,17,44,374
10490,dark,main,20220212,3,0.9904035174139754,265,18,64,347
10490,dark,main,20220212,4,0.9910443922642079,271,13,58,342
10490,dark,main,20220212,5,0.9916095411253502,279,11,56,346
10490,dark,main,20220212,6,0.9875751791839663,289,15,65,369
10490,dark,main,20220212,7,0.9941258221961353,223,21,76,320
10490,dark,main,20220212,8,0.9948678327458372,275,15,71,361
10490,dark,main,20220212,9,0.9856963283816398,277,16,50,343
21292,bright,main,20220212,0,0.9962135280396687,331,100,2,433
21292,bright,main,20220212,1,0.9943158202551808,243,151,2,396
21292,bright,main,20220212,2,0.9878850785927659,312,118,5,435
21292,bright,main,20220212,3,0.9926723426477635,215,170,6,391
21292,bright,main,20220212,4,0.9856533926781504,207,171,9,387
21292,bright,main,20220212,5,0.9888665634969211,210,186,6,402
21292,bright,main,20220212,6,0.994697430199057,330,92,3,425
21292,bright,main,20220212,7,0.9894730800628231,257,102,2,361
21292,bright,main,20220212,8,0.9909996436369956,309,101,0,410
21292,bright,main,20220212,9,0.9902588560914178,343,80,4,427
20447,bright,main,20220212,0,0.9943703191867821,324,101,4,429
20447,bright,main,20220212,1,0.9920587176960379,304,80,4,388
20447,bright,main,20220212,2,0.988790590407726,285,128,5,418
20447,bright,main,20220212,3,0.98341604554174,311,77,6,394
20447,bright,main,20220212,4,0.9939343244308861,335,48,1,384
20447,bright,main,20220212,5,0.9933863788539934,355,46,4,405
20447,bright,main,20220212,6,0.9939942244645893,377,47,2,426
20447,bright,main,20220212,7,0.9884027524454694,303,52,7,362
20447,bright,main,20220212,8,0.9949859207518612,350,58,4,412
20447,bright,main,20220212,9,0.9943185374464246,327,95,4,426
24671,bright,main,20220212,0,0.9938564577482694,308,117,3,428
24671,bright,main,20220212,1,0.9908792607384164,232,155,2,389
24671,bright,main,20220212,2,0.989890110492534,280,143,6,429
24671,bright,main,20220212,3,0.9883284319953312,254,132,3,389
24671,bright,main,20220212,4,0.995191508894423,270,116,2,388
24671,bright,main,20220212,5,0.9914005807416063,307,97,6,410
24671,bright,main,20220212,6,0.9894941106233542,305,102,4,411
24671,bright,main,20220212,7,0.9934338781494474,302,63,6,371
24671,bright,main,20220212,8,0.9902562962905911,309,96,4,409
24671,bright,main,20220212,9,0.988008450602899,310,103,6,419
4731,dark,main,20220212,0,0.9893482497037024,286,13,72,371
4731,dark,main,20220212,1,0.9758316030925036,276,16,67,359
4731,dark,main,20220212,2,0.9970030094290877,323,12,51,386
4731,dark,main,20220212,3,0.9944038713482914,293,11,58,362
4731,dark,main,20220212,4,0.992668574592588,290,15,40,345
4731,dark,main,20220212,5,0.9923932860947712,302,13,50,365
4731,dark,main,20220212,6,0.9920112971890908,285,19,57,361
4731,dark,main,20220212,7,0.9903539372397917,248,15,60,323
4731,dark,main,20220212,8,0.9912739791044697,289,28,62,379
4731,dark,main,20220212,9,0.9933253784255689,305,15,53,373
6289,dark,main,20220212,0,0.9948038356259218,321,12,58,391
6289,dark,main,20220212,1,0.9836548813411855,291,14,44,349
6289,dark,main,20220212,2,0.990898702088535,337,13,47,397
6289,dark,main,20220212,3,0.9897334959368431,290,11,48,349
6289,dark,main,20220212,4,0.9944964337488327,278,12,52,342
6289,dark,main,20220212,5,0.9926804821585741,261,19,66,346
6289,dark,main,20220212,6,0.9934663677715718,298,15,62,375
6289,dark,main,20220212,7,0.9898889899223201,266,16,47,329
6289,dark,main,20220212,8,0.9906078380133149,282,17,76,375
6289,dark,main,20220212,9,0.9942018000717211,307,16,64,387
22150,bright,main,20220212,0,0.993523423811603,251,175,7,433
22150,bright,main,20220212,1,0.9868828062825,222,167,3,392
22150,bright,main,20220212,2,0.9954826979407352,275,145,7,427
22150,bright,main,20220212,3,0.9924712768726067,227,156,8,391
22150,bright,main,20220212,4,0.9894295600984079,217,168,4,389
22150,bright,main,20220212,5,0.9852887946557239,256,146,6,408
22150,bright,main,20220212,6,0.9930499224571304,319,100,1,420
22150,bright,main,20220212,7,0.98378062217993,238,119,4,361
22150,bright,main,20220212,8,0.9937090024702394,250,153,3,406
22150,bright,main,20220212,9,0.9935516610043886,263,147,6,416
21848,bright,main,20220212,0,0.9951545309060886,218,209,8,435
21848,bright,main,20220212,1,0.9905769687180249,183,201,8,392
21848,bright,main,20220212,2,0.9915420250843321,193,220,9,422
21848,bright,main,20220212,3,0.9952580252294502,213,169,6,388
21848,bright,main,20220212,4,0.9930996505094004,203,178,4,385
21848,bright,main,20220212,5,0.9934919929910004,230,171,4,405
21848,bright,main,20220212,6,0.9924523932539269,266,148,9,423
21848,bright,main,20220212,7,0.9953283031265528,244,112,5,361
21848,bright,main,20220212,8,0.9913083477375184,228,178,6,412
21848,bright,main,20220212,9,0.9910141749701985,260,151,7,418
21293,bright,main,20220212,0,0.9920662726149785,319,112,5,436
21293,bright,main,20220212,1,0.9892675363942226,283,111,2,396
21293,bright,main,20220212,2,0.9949984824165142,266,156,10,432
21293,bright,main,20220212,3,0.9933011007997167,212,186,5,403
21293,bright,main,20220212,4,0.9951087904166429,250,144,2,396
21293,bright,main,20220212,5,0.9957438625507762,292,111,5,408
21293,bright,main,20220212,6,0.9896336082084867,290,129,6,425
21293,bright,main,20220212,7,0.9909553368773425,236,123,4,363
21293,bright,main,20220212,8,0.9939947586429929,318,92,6,416
21293,bright,main,20220212,9,0.990986722944409,339,82,5,426
23852,bright,main,20220212,0,0.9886611294463801,250,162,2,414
23852,bright,main,20220212,1,0.9879429123778333,246,125,10,381
23852,bright,main,20220212,2,0.9954410802433233,294,120,8,422
23852,bright,main,20220212,3,0.993428784382074,267,112,6,385
23852,bright,main,20220212,4,0.9933411632322197,190,179,6,375
23852,bright,main,20220212,5,0.9906601364269314,218,174,5,397
23852,bright,main,20220212,6,0.9917649521155405,271,134,7,412
23852,bright,main,20220212,7,0.9848797299870139,252,100,7,359
23852,bright,main,20220212,8,0.9944978092986902,323,85,10,418
23852,bright,main,20220212,9,0.9925453031316179,259,149,0,408
21578,bright,main,20220212,0,0.9920022951422443,309,117,6,432
21578,bright,main,20220212,1,0.995032256226581,225,158,8,391
21578,bright,main,20220212,2,0.9912476001269406,278,137,3,418
21578,bright,main,20220212,3,0.9934720436071068,199,191,2,392
21578,bright,main,20220212,4,0.9921483149468299,199,179,5,383
21578,bright,main,20220212,5,0.9947021913223472,234,164,8,406
21578,bright,main,20220212,6,0.9916851875601371,200,212,5,417
21578,bright,main,20220212,7,0.9904000775105066,164,194,5,363
21578,bright,main,20220212,8,0.9948117804930156,207,201,5,413
21578,bright,main,20220212,9,0.9956809995681671,273,151,5,429
7368,dark,main,20220212,0,0.9923388641121759,305,16,50,371
7368,dark,main,20220212,1,0.9840396352390736,269,14,57,340
7368,dark,main,20220212,2,0.9939611343430063,309,11,51,371
7368,dark,main,20220212,3,0.9881874455335636,275,13,45,333
7368,dark,main,20220212,4,0.9933441423140129,278,16,49,343
7368,dark,main,20220212,5,0.9893818706528569,268,17,69,354
7368,dark,main,20220212,6,0.9904858894503007,272,21,52,345
7368,dark,main,20220212,7,0.9940311662594908,237,20,56,313
7368,dark,main,20220212,8,0.9841963588664684,246,22,71,339
7368,dark,main,20220212,9,0.9932618106281412,276,23,55,354
26246,bright,main,20220212,0,0.9899415471074356,332,94,7,433
26246,bright,main,20220212,1,0.9938831082084802,234,158,5,397
26246,bright,main,20220212,2,0.994187418351461,241,183,4,428
26246,bright,main,20220212,3,0.9951904685538053,190,189,4,383
26246,bright,main,20220212,4,0.9958366429270896,216,174,1,391
26246,bright,main,20220212,5,0.997419948494967,226,181,3,410
26246,bright,main,20220212,6,0.9882477794378355,199,222,3,424
26246,bright,main,20220212,7,0.9900089017674789,141,222,3,366
26246,bright,main,20220212,8,0.9911674107284932,138,252,9,399
26246,bright,main,20220212,9,0.99651540089205,176,241,4,421
23122,bright,main,20220212,0,0.9927482516875357,284,147,4,435
23122,bright,main,20220212,1,0.9858310307370974,269,117,13,399
23122,bright,main,20220212,2,0.9953912299892954,343,90,2,435
23122,bright,main,20220212,3,0.9935774558380454,243,152,2,397
23122,bright,main,20220212,4,0.9941386951599835,250,136,7,393
23122,bright,main,20220212,5,0.9879779449586878,272,135,1,408
23122,bright,main,20220212,6,0.9912891458967257,245,182,4,431
23122,bright,main,20220212,7,0.9928182396821923,251,122,1,374
23122,bright,main,20220212,8,0.9936723794681573,181,225,6,412
23122,bright,main,20220212,9,0.9930555279179095,243,175,4,422
26179,bright,main,20220212,0,0.9921275460756256,338,94,2,434
26179,bright,main,20220212,1,0.9950588429701097,290,80,11,381
26179,bright,main,20220212,2,0.9925473939583527,329,101,1,431
26179,bright,main,20220212,3,0.991695404239329,268,107,5,380
26179,bright,main,20220212,4,0.9888746569871669,305,79,4,388
26179,bright,main,20220212,5,0.985395865422036,322,79,7,408
26179,bright,main,20220212,6,0.991891488115628,342,83,1,426
26179,bright,main,20220212,7,0.9944123361343549,285,81,2,368
26179,bright,main,20220212,8,0.9930892894221264,278,128,6,412
26179,bright,main,20220212,9,0.9894173982677968,309,105,5,419
26244,bright,main,20220212,0,0.9877552505039744,276,153,3,432
26244,bright,main,20220212,1,0.993735094930841,255,135,4,394
26244,bright,main,20220212,2,0.994529200248195,229,197,5,431
26244,bright,main,20220212,3,0.9954694727907538,248,142,4,394
26244,bright,main,20220212,4,0.9952540524340945,237,154,1,392
26244,bright,main,20220212,5,0.9907452273389574,301,104,3,408
26244,bright,main,20220212,6,0.9926488014227198,247,170,9,426
26244,bright,main,20220212,7,0.9898005405402095,139,214,7,360
26244,bright,main,20220212,8,0.9928766625073948,248,163,1,412
26244,bright,main,20220212,9,0.9916368910470076,232,187,8,427
22068,bright,main,20220212,0,0.9940126145035232,235,181,2,418
22068,bright,main,20220212,1,0.994768581238426,213,166,7,386
22068,bright,main,20220212,2,0.9913894916345912,270,147,4,421
22068,bright,main,20220212,3,0.9907758748366537,305,76,4,385
22068,bright,main,20220212,4,0.9941877660124298,285,93,9,387
22068,bright,main,20220212,5,0.9898776357450976,272,128,4,404
22068,bright,main,20220212,6,0.9905405164204446,266,136,4,406
22068,bright,main,20220212,7,0.9934708880997398,226,137,2,365
22068,bright,main,20220212,8,0.9928142821142483,241,157,7,405
22068,bright,main,20220212,9,0.9959801766067616,306,115,5,426
25989,bright,main,20220212,0,0.99547582484153,283,151,3,437
25989,bright,main,20220212,1,0.9946106397701251,175,214,10,399
25989,bright,main,20220212,2,0.9964048176065718,290,137,5,432
25989,bright,main,20220212,3,0.9929747920047922,278,102,7,387
25989,bright,main,20220212,4,0.9899122112430698,300,90,2,392
25989,bright,main,20220212,5,0.9933192430226091,323,87,3,413
25989,bright,main,20220212,6,0.9876835734893122,325,83,8,416
25989,bright,main,20220212,7,0.988916981107108,256,108,2,366
25989,bright,main,20220212,8,0.9931293542891477,258,142,9,409
25989,bright,main,20220212,9,0.9951432883969421,247,171,5,423
42868,backup,main,20220212,0,0.9943458941818342,28,394,2,424
42868,backup,main,20220212,1,0.9934832165134999,15,355,1,371
42868,backup,main,20220212,2,0.9927553649160409,26,388,1,415
42868,backup,main,20220212,3,0.9958191956291498,24,342,1,367
42868,backup,main,20220212,4,0.9925669687934726,29,341,0,370
42868,backup,main,20220212,5,0.9915749626359053,21,372,0,393
42868,backup,main,20220212,6,0.9957580159089522,32,388,0,420
42868,backup,main,20220212,7,0.9934959516613189,17,331,0,348
42868,backup,main,20220212,8,0.9897350206395353,27,370,1,398
42868,backup,main,20220212,9,0.9857888455710367,20,380,0,400
26169,bright,main,20220212,0,0.9928008761920494,257,171,3,431
26169,bright,main,20220212,1,0.9886256142574237,148,228,9,385
26169,bright,main,20220212,2,0.9896856539032781,161,234,10,405
26169,bright,main,20220212,3,0.992495771554616,152,231,2,385
26169,bright,main,20220212,4,0.9957653395950212,146,225,5,376
26169,bright,main,20220212,5,0.99343211793242,159,245,3,407
26169,bright,main,20220212,6,0.9942550049679751,208,206,6,420
26169,bright,main,20220212,7,0.9907121902145848,286,80,0,366
26169,bright,main,20220212,8,0.9838065945991199,293,106,10,409
26169,bright,main,20220212,9,0.9892426463060261,241,176,3,420
23412,bright,main,20220212,0,0.9932131089524037,374,56,4,434
23412,bright,main,20220212,1,0.9868855855624381,320,60,3,383
23412,bright,main,20220212,2,0.9922950205016018,304,107,4,415
23412,bright,main,20220212,3,0.9921272214475353,259,116,7,382
23412,bright,main,20220212,4,0.9951552571187533,185,190,6,381
23412,bright,main,20220212,5,0.9897858207271961,155,225,9,389
23412,bright,main,20220212,6,0.993239219130293,191,207,6,404
23412,bright,main,20220212,7,0.9928779854247853,248,114,8,370
23412,bright,main,20220212,8,0.9903497398031949,280,129,3,412
23412,bright,main,20220212,9,0.9910688082410827,358,58,8,424
3153,dark,main,20220212,0,0.9894477908627869,311,17,58,386
3153,dark,main,20220212,1,0.992543908962165,277,19,52,348
3153,dark,main,20220212,2,0.9934995940792153,306,13,64,383
3153,dark,main,20220212,3,0.9952611335360376,300,11,44,355
3153,dark,main,20220212,4,0.994500705835226,302,11,42,355
3153,dark,main,20220212,5,0.9933078300399026,315,11,47,373
3153,dark,main,20220212,6,0.9973412082485172,314,14,60,388
3153,dark,main,20220212,7,0.9932255170932878,269,12,48,329
3153,dark,main,20220212,8,0.9886240665110871,308,14,51,373
3153,dark,main,20220212,9,0.9938882335324596,319,11,49,379
26243,bright,main,20220212,0,0.9836785213994951,306,128,5,439
26243,bright,main,20220212,1,0.9887575105269965,268,114,5,387
26243,bright,main,20220212,2,0.9922460947163986,276,140,6,422
26243,bright,main,20220212,3,0.983992189820211,296,94,3,393
26243,bright,main,20220212,4,0.9880741131139481,307,80,4,391
26243,bright,main,20220212,5,0.9900667575004035,289,115,2,406
26243,bright,main,20220212,6,0.989045323532058,245,174,2,421
26243,bright,main,20220212,7,0.9935754323846182,211,156,5,372
26243,bright,main,20220212,8,0.9939248208700465,238,171,3,412
26243,bright,main,20220212,9,0.985231827975273,258,163,4,425
26249,bright,main,20220212,0,0.9941364039352487,361,67,8,436
26249,bright,main,20220212,1,0.993736890083708,302,88,7,397
26249,bright,main,20220212,2,0.9904561792398348,283,137,9,429
26249,bright,main,20220212,3,0.9883055964649217,230,157,4,391
26249,bright,main,20220212,4,0.9944268598481372,200,185,3,388
26249,bright,main,20220212,5,0.9956168700118202,249,154,2,405
26249,bright,main,20220212,6,0.992871929662806,338,80,11,429
26249,bright,main,20220212,7,0.9971427822320841,287,81,2,370
26249,bright,main,20220212,8,0.9883797671872536,342,66,6,414
26249,bright,main,20220212,9,0.9896813980205593,332,90,2,424
23224,bright,main,20220212,0,0.992438394319204,293,143,5,441
23224,bright,main,20220212,1,0.9860248411075824,279,117,4,400
23224,bright,main,20220212,2,0.9881367952714516,274,159,3,436
23224,bright,main,20220212,3,0.992733559642215,279,123,1,403
23224,bright,main,20220212,4,0.9886377707895156,297,102,1,400
23224,bright,main,20220212,5,0.9902745327725339,303,107,4,414
23224,bright,main,20220212,6,0.9945840074636796,324,101,5,430
23224,bright,main,20220212,7,0.9925239208969651,256,115,3,374
23224,bright,main,20220212,8,0.9946694736566134,248,172,1,421
23224,bright,main,20220212,9,0.9926920058594609,255,172,1,428
25276,bright,main,20220212,0,0.9961703921038129,305,48,8,361
25276,bright,main,20220212,1,0.9882759505824701,239,55,5,299
25276,bright,main,20220212,2,0.9943495784224845,363,67,4,434
25276,bright,main,20220212,3,0.9938850070373313,289,101,5,395
25276,bright,main,20220212,4,0.9906429907368759,263,119,7,389
25276,bright,main,20220212,5,0.9861499410725479,213,190,8,411
25276,bright,main,20220212,6,0.9946287433043833,192,228,8,428
25276,bright,main,20220212,7,0.9851611042872754,244,127,1,372
25276,bright,main,20220212,8,0.9924521828005344,334,74,9,417
25276,bright,main,20220212,9,0.9960597073474217,364,59,4,427
23585,bright,main,20220212,0,0.9899284234325136,308,107,10,425
23585,bright,main,20220212,1,0.9918651507619433,273,114,1,388
23585,bright,main,20220212,2,0.9918127593047051,256,162,4,422
23585,bright,main,20220212,3,0.9928546536490517,300,76,6,382
23585,bright,main,20220212,4,0.9949190361999085,260,110,9,379
23585,bright,main,20220212,5,0.9948104587558341,247,147,8,402
23585,bright,main,20220212,6,0.990402601188021,277,136,6,419
23585,bright,main,20220212,7,0.9970148453237035,258,104,6,368
23585,bright,main,20220212,8,0.9926534834176687,292,105,9,406
23585,bright,main,20220212,9,0.9941628910036834,328,78,8,414
23404,bright,main,20220213,0,0.9923593134245126,344,76,5,425
23404,bright,main,20220213,1,0.9908345994517469,317,66,6,389
23404,bright,main,20220213,2,0.9926915776575359,306,110,4,420
23404,bright,main,20220213,3,0.9922197801344123,266,116,2,384
23404,bright,main,20220213,4,0.9937779759428595,265,119,1,385
23404,bright,main,20220213,5,0.9939365705112919,269,122,6,397
23404,bright,main,20220213,6,0.9926709874892422,305,110,5,420
23404,bright,main,20220213,7,0.9920587880772188,284,69,6,359
23404,bright,main,20220213,8,0.9938855788531368,355,50,4,409
23404,bright,main,20220213,9,0.9945762873810668,357,56,7,420
23226,bright,main,20220213,0,0.9905972074392632,199,234,3,436
23226,bright,main,20220213,1,0.9945512502197622,214,183,2,399
23226,bright,main,20220213,2,0.9896877038695736,297,130,3,430
23226,bright,main,20220213,3,0.9879930048111838,261,135,6,402
23226,bright,main,20220213,4,0.990886445695858,258,132,4,394
23226,bright,main,20220213,5,0.9922131474531971,239,163,9,411
23226,bright,main,20220213,6,0.9931559607198385,268,152,8,428
23226,bright,main,20220213,7,0.9873230101513955,227,141,8,376
23226,bright,main,20220213,8,0.9872397632564005,222,189,6,417
23226,bright,main,20220213,9,0.9945366306453681,263,166,4,433
23003,bright,main,20220213,0,0.9914708945347115,290,125,11,426
23003,bright,main,20220213,1,0.992965979329439,296,71,7,374
23003,bright,main,20220213,2,0.9966917754613517,349,76,2,427
23003,bright,main,20220213,3,0.9941341566637841,337,50,7,394
23003,bright,main,20220213,4,0.9942892853353401,292,94,7,393
23003,bright,main,20220213,5,0.9904551316570698,229,167,7,403
23003,bright,main,20220213,6,0.9917641448208044,224,192,6,422
23003,bright,main,20220213,7,0.9804451048503502,259,105,6,370
23003,bright,main,20220213,8,0.9938588630832211,295,119,4,418
23003,bright,main,20220213,9,0.992316501040658,312,105,3,420
23245,bright,main,20220213,0,0.995541174311819,264,173,1,438
23245,bright,main,20220213,1,0.9915182590354374,194,199,3,396
23245,bright,main,20220213,2,0.9956980091614693,157,275,2,434
23245,bright,main,20220213,3,0.9915479965133631,181,205,7,393
23245,bright,main,20220213,4,0.9965012611411936,153,235,3,391
23245,bright,main,20220213,5,0.9930286612485731,169,240,6,415
23245,bright,main,20220213,6,0.9927465726046846,282,146,5,433
23245,bright,main,20220213,7,0.9931375111548285,172,195,3,370
23245,bright,main,20220213,8,0.9948631656739654,218,198,2,418
23245,bright,main,20220213,9,0.9934862226020015,267,155,4,426
24456,bright,main,20220213,0,0.9850670722292696,229,184,8,421
24456,bright,main,20220213,1,0.9904562642197899,269,115,5,389
24456,bright,main,20220213,2,0.9938327653759309,235,172,6,413
24456,bright,main,20220213,3,0.995459390144589,258,123,7,388
24456,bright,main,20220213,4,0.9902055077855846,267,110,6,383
24456,bright,main,20220213,5,0.9912948192090659,324,72,5,401
24456,bright,main,20220213,6,0.9906812815679024,304,109,5,418
24456,bright,main,20220213,7,0.992392039338122,245,109,4,358
24456,bright,main,20220213,8,0.9942192769454933,286,114,8,408
24456,bright,main,20220213,9,0.9924773203761796,205,202,5,412
23407,bright,main,20220213,0,0.994356499560565,365,61,5,431
23407,bright,main,20220213,1,0.9893998593297907,315,75,6,396
23407,bright,main,20220213,2,0.9922646457064374,289,131,7,427
23407,bright,main,20220213,3,0.9926910554923286,275,107,7,389
23407,bright,main,20220213,4,0.9900592450958062,270,124,2,396
23407,bright,main,20220213,5,0.9893430081288426,301,96,6,403
23407,bright,main,20220213,6,0.9934729655559493,305,108,5,418
23407,bright,main,20220213,7,0.9938000509172109,281,78,4,363
23407,bright,main,20220213,8,0.9907459840687638,335,75,4,414
23407,bright,main,20220213,9,0.9924694558990629,344,79,3,426
23403,bright,main,20220213,0,0.9911459620494446,322,107,7,436
23403,bright,main,20220213,1,0.9906477903726618,292,91,4,387
23403,bright,main,20220213,2,0.9914279417765417,280,126,7,413
23403,bright,main,20220213,3,0.9884540534588991,234,147,3,384
23403,bright,main,20220213,4,0.992503770865815,273,111,3,387
23403,bright,main,20220213,5,0.9917425915831939,280,121,2,403
23403,bright,main,20220213,6,0.9938304653746821,219,201,3,423
23403,bright,main,20220213,7,0.9922844164485246,222,142,3,367
23403,bright,main,20220213,8,0.9933146057038963,247,158,2,407
23403,bright,main,20220213,9,0.9968619231799948,255,158,8,421
24981,bright,main,20220213,0,0.9899593980863377,218,215,2,435
24981,bright,main,20220213,1,0.9921461407794195,264,129,2,395
24981,bright,main,20220213,2,0.9919799513135115,270,148,7,425
24981,bright,main,20220213,3,0.9946218882974529,276,101,7,384
24981,bright,main,20220213,4,0.9904274510233649,315,60,11,386
24981,bright,main,20220213,5,0.9914871487786378,325,79,3,407
24981,bright,main,20220213,6,0.9905883819509034,276,134,4,414
24981,bright,main,20220213,7,0.9881796262702948,249,111,2,362
24981,bright,main,20220213,8,0.995665206435826,318,94,4,416
24981,bright,main,20220213,9,0.9963439513770371,258,157,11,426
25825,bright,main,20220213,0,0.9920811166373524,339,82,9,430
25825,bright,main,20220213,1,0.9938800546420778,298,69,10,377
25825,bright,main,20220213,2,0.9938148187708273,297,114,10,421
25825,bright,main,20220213,3,0.9883899132262041,310,65,2,377
25825,bright,main,20220213,4,0.9947301759768515,303,76,4,383
25825,bright,main,20220213,5,0.9936336534157357,309,80,4,393
25825,bright,main,20220213,6,0.9925854958708972,332,69,8,409
25825,bright,main,20220213,7,0.9947463292748147,292,73,4,369
25825,bright,main,20220213,8,0.9951590341483969,311,85,6,402
25825,bright,main,20220213,9,0.9925895045183933,338,80,5,423
23246,bright,main,20220213,0,0.99254740874972,192,239,5,436
23246,bright,main,20220213,1,0.9934444822887631,184,205,5,394
23246,bright,main,20220213,2,0.9880104910336043,222,209,4,435
23246,bright,main,20220213,3,0.9865794993565843,253,142,5,400
23246,bright,main,20220213,4,0.9927168058150776,289,100,5,394
23246,bright,main,20220213,5,0.9952229313389664,258,144,3,405
23246,bright,main,20220213,6,0.9918518841113889,265,155,7,427
23246,bright,main,20220213,7,0.9865679400955347,255,111,2,368
23246,bright,main,20220213,8,0.9912742141346675,213,202,6,421
23246,bright,main,20220213,9,0.9922555902798027,252,177,6,435
26197,bright,main,20220213,0,0.9882705535251639,267,162,6,435
26197,bright,main,20220213,1,0.9922234700902836,258,138,5,401
26197,bright,main,20220213,2,0.9897454439606372,276,154,6,436
26197,bright,main,20220213,3,0.991099406539627,228,164,3,395
26197,bright,main,20220213,4,0.992331310995171,203,194,0,397
26197,bright,main,20220213,5,0.9943365270642778,197,205,7,409
26197,bright,main,20220213,6,0.9955248480440121,163,265,3,431
26197,bright,main,20220213,7,0.991916218278955,177,190,5,372
26197,bright,main,20220213,8,0.9922829175874116,201,208,2,411
26197,bright,main,20220213,9,0.9939139931982552,249,175,2,426
24818,bright,main,20220213,0,0.9939036469879413,172,253,8,433
24818,bright,main,20220213,1,0.9882414167041265,228,161,10,399
24818,bright,main,20220213,2,0.9923931187629285,222,202,5,429
24818,bright,main,20220213,3,0.9911515512451238,166,222,6,394
24818,bright,main,20220213,4,0.9928253951159557,140,236,9,385
24818,bright,main,20220213,5,0.989339725855043,231,157,8,396
24818,bright,main,20220213,6,0.9901262327017429,283,141,3,427
24818,bright,main,20220213,7,0.9938972418479097,245,121,7,373
24818,bright,main,20220213,8,0.9937072210429796,186,221,6,413
24818,bright,main,20220213,9,0.9973009625536369,178,233,8,419
24579,bright,main,20220213,0,0.9867834504721341,298,131,5,434
24579,bright,main,20220213,1,0.9919423738642038,304,89,4,397
24579,bright,main,20220213,2,0.99461843695128,350,65,8,423
24579,bright,main,20220213,3,0.9887038102155696,303,87,7,397
24579,bright,main,20220213,4,0.994283686485588,307,75,4,386
24579,bright,main,20220213,5,0.9904824310588574,217,179,10,406
24579,bright,main,20220213,6,0.9930179850824955,194,221,6,421
24579,bright,main,20220213,7,0.9901888530198063,226,137,7,370
24579,bright,main,20220213,8,0.9928234477093151,227,179,6,412
24579,bright,main,20220213,9,0.9825896514979113,243,162,7,412
24970,bright,main,20220213,0,0.9896250085391866,259,152,12,423
24970,bright,main,20220213,1,0.9960284329485569,269,128,2,399
24970,bright,main,20220213,2,0.9885881629221112,299,119,4,422
24970,bright,main,20220213,3,0.9915064039055781,225,163,8,396
24970,bright,main,20220213,4,0.9862994691453161,277,104,7,388
24970,bright,main,20220213,5,0.9962719118039919,244,153,6,403
24970,bright,main,20220213,6,0.9930343223189442,228,182,8,418
24970,bright,main,20220213,7,0.9937174272106024,250,112,6,368
24970,bright,main,20220213,8,0.9925237132903331,344,66,8,418
24970,bright,main,20220213,9,0.993536791595861,299,118,8,425
25823,bright,main,20220213,0,0.9949554607042518,320,102,5,427
25823,bright,main,20220213,1,0.989420484050295,283,100,8,391
25823,bright,main,20220213,2,0.9942606134570081,346,78,2,426
25823,bright,main,20220213,3,0.9791798344603855,310,77,4,391
25823,bright,main,20220213,4,0.9929315197327768,318,62,8,388
25823,bright,main,20220213,5,0.9881799103110173,329,54,5,388
25823,bright,main,20220213,6,0.9908954353042405,322,94,3,419
25823,bright,main,20220213,7,0.9935580330627676,279,84,2,365
25823,bright,main,20220213,8,0.9921159436583886,322,83,2,407
25823,bright,main,20220213,9,0.9919710938385309,333,80,5,418
24819,bright,main,20220213,0,0.9937602496641444,272,157,5,434
24819,bright,main,20220213,1,0.9973598976852974,232,157,7,396
24819,bright,main,20220213,2,0.9938640051055766,250,179,5,434
24819,bright,main,20220213,3,0.9948006137414525,240,155,3,398
24819,bright,main,20220213,4,0.9947440337229252,179,209,1,389
24819,bright,main,20220213,5,0.994692869169064,181,224,4,409
24819,bright,main,20220213,6,0.9914442285012879,179,241,3,423
24819,bright,main,20220213,7,0.9919693703676669,174,192,2,368
24819,bright,main,20220213,8,0.9962446494079465,174,237,3,414
24819,bright,main,20220213,9,0.9929701732578698,227,198,3,428
23825,bright,main,20220213,0,0.9950188638312042,314,112,2,428
23825,bright,main,20220213,1,0.9922074302533306,300,81,6,387
23825,bright,main,20220213,2,0.9909898865109024,346,72,4,422
23825,bright,main,20220213,3,0.9851257078706274,324,64,3,391
23825,bright,main,20220213,4,0.984943289191117,307,77,3,387
23825,bright,main,20220213,5,0.9929122376371631,294,95,9,398
23825,bright,main,20220213,6,0.9931929505020215,334,82,4,420
23825,bright,main,20220213,7,0.9913211661232022,282,79,2,363
23825,bright,main,20220213,8,0.9877734590126729,335,75,1,411
23825,bright,main,20220213,9,0.9951557666283817,310,109,6,425
23581,bright,main,20220213,0,0.9937173162272663,327,86,3,416
23581,bright,main,20220213,1,0.9886459830911961,277,96,3,376
23581,bright,main,20220213,2,0.9951417171302207,322,88,7,417
23581,bright,main,20220213,3,0.9871904099995181,282,86,7,375
23581,bright,main,20220213,4,0.9950286394003632,303,71,5,379
23581,bright,main,20220213,5,0.9925739125686864,332,62,1,395
23581,bright,main,20220213,6,0.9939297981224263,337,73,3,413
23581,bright,main,20220213,7,0.9939973604217511,286,69,2,357
23581,bright,main,20220213,8,0.9887458842906072,346,51,11,408
23581,bright,main,20220213,9,0.98982355843663,340,68,8,416
22697,bright,main,20220213,0,0.9926957630724431,287,141,8,436
22697,bright,main,20220213,1,0.9919471064081966,255,132,2,389
22697,bright,main,20220213,2,0.9918241042593056,342,76,7,425
22697,bright,main,20220213,3,0.993516115235422,346,45,3,394
22697,bright,main,20220213,4,0.9891182015253909,327,59,4,390
22697,bright,main,20220213,5,0.9904632974971528,330,57,7,394
22697,bright,main,20220213,6,0.993038993129051,353,58,6,417
22697,bright,main,20220213,7,0.9938158852120665,266,91,5,362
22697,bright,main,20220213,8,0.9970077568071521,245,158,4,407
22697,bright,main,20220213,9,0.9915119649900344,292,124,6,422
10498,dark,main,20220213,0,0.9872541724943483,252,24,61,337
10498,dark,main,20220213,1,0.9909797504383046,259,13,56,328
10498,dark,main,20220213,2,0.9930090674412133,304,14,49,367
10498,dark,main,20220213,3,0.9913034119724339,284,12,43,339
10498,dark,main,20220213,4,0.9936232061572406,273,13,43,329
10498,dark,main,20220213,5,0.995664130732722,310,16,36,362
10498,dark,main,20220213,6,0.99356775117625,292,15,52,359
10498,dark,main,20220213,7,0.9921579742869915,232,16,65,313
10498,dark,main,20220213,8,0.9925252919246536,255,28,81,364
10498,dark,main,20220213,9,0.9919368434148754,287,17,58,362
20445,bright,main,20220213,0,0.993846723453382,370,53,3,426
20445,bright,main,20220213,1,0.9917152352091504,326,57,6,389
20445,bright,main,20220213,2,0.9949514527339458,341,75,2,418
20445,bright,main,20220213,3,0.9890521056800491,333,46,5,384
20445,bright,main,20220213,4,0.994045979804567,309,69,7,385
20445,bright,main,20220213,5,0.9903768231409448,305,89,4,398
20445,bright,main,20220213,6,0.9927054050004221,326,80,2,408
20445,bright,main,20220213,7,0.9928604771264674,283,76,6,365
20445,bright,main,20220213,8,0.9914416536991022,304,86,7,397
20445,bright,main,20220213,9,0.9954518597697178,343,66,4,413
20474,bright,main,20220213,0,0.9923498637213866,243,176,8,427
20474,bright,main,20220213,1,0.9873701953069408,267,124,4,395
20474,bright,main,20220213,2,0.9945399152444424,308,111,2,421
20474,bright,main,20220213,3,0.9897969880536918,320,69,2,391
20474,bright,main,20220213,4,0.9919561073112606,335,54,2,391
20474,bright,main,20220213,5,0.9874873514233925,341,51,3,395
20474,bright,main,20220213,6,0.9942254326288099,362,55,7,424
20474,bright,main,20220213,7,0.9876607378343872,302,60,3,365
20474,bright,main,20220213,8,0.9903835745597597,315,94,4,413
20474,bright,main,20220213,9,0.9945074719001018,234,182,9,425
20681,bright,main,20220213,0,0.993228967250507,229,193,8,430
20681,bright,main,20220213,1,0.9947586754980855,265,117,6,388
20681,bright,main,20220213,2,0.9937884340436113,334,84,4,422
20681,bright,main,20220213,3,0.9881504501976052,321,60,6,387
20681,bright,main,20220213,4,0.9923766136917608,292,62,8,362
20681,bright,main,20220213,5,0.9934583420263917,183,78,3,264
20681,bright,main,20220213,6,0.9909050798439109,276,67,11,354
20681,bright,main,20220213,7,0.9854532952382768,281,67,3,351
20681,bright,main,20220213,8,0.9900956827570165,302,98,3,403
20681,bright,main,20220213,9,0.9918337835452148,295,119,4,418
20676,bright,main,20220213,0,0.9937876298330989,358,61,2,421
20676,bright,main,20220213,1,0.994694265714455,305,74,5,384
20676,bright,main,20220213,2,0.9921826215309028,373,46,2,421
20676,bright,main,20220213,3,0.9888887114057938,269,105,4,378
20676,bright,main,20220213,4,0.9957707780466142,244,131,6,381
20676,bright,main,20220213,5,0.9935873236923408,301,92,6,399
20676,bright,main,20220213,6,0.9948234120307942,269,140,2,411
20676,bright,main,20220213,7,0.9844899901889461,216,129,6,351
20676,bright,main,20220213,8,0.9933962558651004,249,141,3,393
20676,bright,main,20220213,9,0.9919090976374876,299,102,5,406
20259,bright,main,20220213,0,0.9761867597242214,246,54,4,304
20259,bright,main,20220213,1,0.9962268690255206,257,88,4,349
20259,bright,main,20220213,2,0.9921858702345535,300,126,10,436
20259,bright,main,20220213,3,0.9940497383139186,258,125,13,396
20259,bright,main,20220213,4,0.9937391603013573,239,139,5,383
20259,bright,main,20220213,5,0.9898148797867247,304,95,6,405
20259,bright,main,20220213,6,0.9883623340825439,346,72,5,423
20259,bright,main,20220213,7,0.9915261887468584,234,128,4,366
20259,bright,main,20220213,8,0.9927437432572092,283,124,5,412
20259,bright,main,20220213,9,0.9959547277221037,222,118,5,345
21299,bright,main,20220213,0,0.994384758659877,345,79,4,428
21299,bright,main,20220213,1,0.9901413564497955,325,62,3,390
21299,bright,main,20220213,2,0.9918199634532764,373,53,4,430
21299,bright,main,20220213,3,0.9943053935000085,315,74,5,394
21299,bright,main,20220213,4,0.9928128229789203,336,46,2,384
21299,bright,main,20220213,5,0.996239796186347,322,68,5,395
21299,bright,main,20220213,6,0.9930341474219689,343,68,5,416
21299,bright,main,20220213,7,0.9929277970217458,280,67,10,357
21299,bright,main,20220213,8,0.9925758006554416,313,80,9,402
21299,bright,main,20220213,9,0.989015246404365,339,72,10,421
22683,bright,main,20220213,0,0.9955156776231622,320,115,1,436
22683,bright,main,20220213,1,0.9934298675959654,265,118,5,388
22683,bright,main,20220213,2,0.9950889497796886,232,188,3,423
22683,bright,main,20220213,3,0.9927979196918391,245,139,6,390
22683,bright,main,20220213,4,0.9859399477549787,279,105,3,387
22683,bright,main,20220213,5,0.9856863857622427,304,91,6,401
22683,bright,main,20220213,6,0.9928548180998176,311,109,1,421
22683,bright,main,20220213,7,0.9914466244819503,253,115,3,371
22683,bright,main,20220213,8,0.9960962448969326,305,106,6,417
22683,bright,main,20220213,9,0.9880022482365899,269,152,4,425
24793,bright,main,20220213,0,0.9900541170751853,333,106,3,442
24793,bright,main,20220213,1,0.9900426977113397,291,109,5,405
24793,bright,main,20220213,2,0.9904968716151232,343,92,7,442
24793,bright,main,20220213,3,0.9888327841883889,330,71,2,403
24793,bright,main,20220213,4,0.9932269498206626,302,88,4,394
24793,bright,main,20220213,5,0.9905062630484793,282,126,4,412
24793,bright,main,20220213,6,0.9942805130371163,314,110,5,429
24793,bright,main,20220213,7,0.9883477381727801,185,184,5,374
24793,bright,main,20220213,8,0.9942631859264311,240,176,5,421
24793,bright,main,20220213,9,0.994988310272866,273,154,5,432
22157,bright,main,20220213,0,0.9958713354983846,250,184,3,437
22157,bright,main,20220213,1,0.9929064487456793,191,199,7,397
22157,bright,main,20220213,2,0.9953697465375494,292,141,2,435
22157,bright,main,20220213,3,0.9954511095433003,330,58,6,394
22157,bright,main,20220213,4,0.9894725388114926,314,73,2,389
22157,bright,main,20220213,5,0.9930361821339946,287,119,3,409
22157,bright,main,20220213,6,0.9922453491231648,310,114,3,427
22157,bright,main,20220213,7,0.9895372834259977,254,112,3,369
22157,bright,main,20220213,8,0.9958299082791062,225,189,7,421
22157,bright,main,20220213,9,0.9921850418106787,273,151,3,427
22160,bright,main,20220213,0,0.9943015606654748,318,118,4,440
22160,bright,main,20220213,1,0.9929807443293278,223,164,7,394
22160,bright,main,20220213,2,0.9961431817646799,275,155,3,433
22160,bright,main,20220213,3,0.9954404909052649,321,77,3,401
22160,bright,main,20220213,4,0.9873434319429669,307,86,0,393
22160,bright,main,20220213,5,0.9969683225960471,222,187,3,412
22160,bright,main,20220213,6,0.996554799457272,281,129,4,414
22160,bright,main,20220213,7,0.9915766800302886,284,88,2,374
22160,bright,main,20220213,8,0.990310881437668,293,117,5,415
22160,bright,main,20220213,9,0.9888724805350726,292,127,5,424
22159,bright,main,20220213,0,0.9881777497401607,338,96,3,437
22159,bright,main,20220213,1,0.9888077638359303,306,78,7,391
22159,bright,main,20220213,2,0.9951197950213212,313,110,5,428
22159,bright,main,20220213,3,0.992968364234089,294,97,5,396
22159,bright,main,20220213,4,0.9931322031810302,259,125,4,388
22159,bright,main,20220213,5,0.9840731668194949,309,90,3,402
22159,bright,main,20220213,6,0.9902952797256075,340,73,1,414
22159,bright,main,20220213,7,0.9850810765629033,307,47,9,363
22159,bright,main,20220213,8,0.9946006636826404,316,78,10,404
22159,bright,main,20220213,9,0.9882749049587581,352,69,5,426
26180,bright,main,20220213,0,0.9949135911837498,330,102,6,438
26180,bright,main,20220213,1,0.9930118568055609,288,110,2,400
26180,bright,main,20220213,2,0.9950083047433244,303,129,6,438
26180,bright,main,20220213,3,0.9940475450279258,212,183,5,400
26180,bright,main,20220213,4,0.988114136463556,225,165,4,394
26180,bright,main,20220213,5,0.9877007036633456,220,189,5,414
26180,bright,main,20220213,6,0.9935609215624511,282,147,2,431
26180,bright,main,20220213,7,0.9883507525941377,232,135,3,370
26180,bright,main,20220213,8,0.9956929309802687,265,148,8,421
26180,bright,main,20220213,9,0.992469084007383,257,164,8,429
24964,bright,main,20220213,0,0.994389128703771,299,120,5,424
24964,bright,main,20220213,1,0.9928386803930076,237,146,7,390
24964,bright,main,20220213,2,0.9947165345013367,275,147,8,430
24964,bright,main,20220213,3,0.9882198070783208,224,160,3,387
24964,bright,main,20220213,4,0.9922316078076961,225,162,6,393
24964,bright,main,20220213,5,0.9900671848746557,279,127,2,408
24964,bright,main,20220213,6,0.9928072900299159,293,117,7,417
24964,bright,main,20220213,7,0.9953086753334003,228,134,5,367
24964,bright,main,20220213,8,0.9962861166077777,242,150,11,403
24964,bright,main,20220213,9,0.9934405218693565,283,132,6,421
20260,bright,main,20220213,0,0.9873894484420024,285,139,5,429
20260,bright,main,20220213,1,0.9895250208012334,283,105,3,391
20260,bright,main,20220213,2,0.9955501674266809,275,143,3,421
20260,bright,main,20220213,3,0.9917441064000394,244,127,2,373
20260,bright,main,20220213,4,0.9928264166201434,217,161,3,381
20260,bright,main,20220213,5,0.9960398522463229,213,188,3,404
20260,bright,main,20220213,6,0.9903984112389825,196,208,9,413
20260,bright,main,20220213,7,0.9929703881292647,160,201,2,363
20260,bright,main,20220213,8,0.988435529251649,256,150,7,413
20260,bright,main,20220213,9,0.9919147231328579,312,109,3,424
22864,bright,main,20220213,0,0.9974631130160476,307,121,4,432
22864,bright,main,20220213,1,0.9936901421095973,312,75,4,391
22864,bright,main,20220213,2,0.9953546075447361,355,64,4,423
22864,bright,main,20220213,3,0.9928361574187231,317,70,5,392
22864,bright,main,20220213,4,0.9969379833945359,309,75,3,387
22864,bright,main,20220213,5,0.9876349735837326,322,81,3,406
22864,bright,main,20220213,6,0.9927943993862859,288,116,5,409
22864,bright,main,20220213,7,0.9920572343416407,184,168,3,355
22864,bright,main,20220213,8,0.9939430636269784,234,166,10,410
22864,bright,main,20220213,9,0.9927145819082396,315,99,5,419
22158,bright,main,20220213,0,0.9950441336120264,253,179,4,436
22158,bright,main,20220213,1,0.9906763719112653,256,137,3,396
22158,bright,main,20220213,2,0.9903587600769381,274,151,3,428
22158,bright,main,20220213,3,0.9932375234473603,321,75,3,399
22158,bright,main,20220213,4,0.9934122833342517,254,130,5,389
22158,bright,main,20220213,5,0.9930273816549047,251,154,0,405
22158,bright,main,20220213,6,0.9901633702500381,253,148,7,408
22158,bright,main,20220213,7,0.9892356958864248,240,126,4,370
22158,bright,main,20220213,8,0.995967675041303,186,214,7,407
22158,bright,main,20220213,9,0.9888159319698281,237,173,6,416
24320,bright,main,20220217,0,0.9909370624476568,303,103,8,414
24320,bright,main,20220217,1,0.9901801521091611,241,123,6,370
24320,bright,main,20220217,2,0.9926834612560147,307,107,4,418
24320,bright,main,20220217,3,0.9908695896316236,255,121,8,384
24320,bright,main,20220217,4,0.9900622302922764,216,158,4,378
24320,bright,main,20220217,5,0.9887063902651745,221,159,13,393
24320,bright,main,20220217,6,0.9928149119282048,248,149,4,401
24320,bright,main,20220217,7,0.9926808443173191,229,123,3,355
24320,bright,main,20220217,8,0.9963942957872619,250,131,7,388
24320,bright,main,20220217,9,0.9874127303149989,310,101,3,414
24074,bright,main,20220217,0,0.9866294940202827,335,85,5,425
24074,bright,main,20220217,1,0.9959088812550644,320,72,5,397
24074,bright,main,20220217,2,0.9910140532370397,315,105,3,423
24074,bright,main,20220217,3,0.9867118748309978,325,66,5,396
24074,bright,main,20220217,4,0.9927597817485047,346,42,5,393
24074,bright,main,20220217,5,0.9920324812149989,327,70,9,406
24074,bright,main,20220217,6,0.9893809426208989,333,86,2,421
24074,bright,main,20220217,7,0.996100554534825,309,60,2,371
24074,bright,main,20220217,8,0.9949058015177519,345,54,7,406
24074,bright,main,20220217,9,0.9973008244325884,379,45,5,429
22758,bright,main,20220217,0,0.9908004548164961,295,124,6,425
22758,bright,main,20220217,1,0.9905347498888383,265,109,5,379
22758,bright,main,20220217,2,0.9927994036868422,314,110,5,429
22758,bright,main,20220217,3,0.9871482632472989,255,117,5,377
22758,bright,main,20220217,4,0.9936711532691901,250,129,3,382
22758,bright,main,20220217,5,0.9951071709359776,304,89,2,395
22758,bright,main,20220217,6,0.9926738814862369,283,122,3,408
22758,bright,main,20220217,7,0.9938607652818924,234,121,4,359
22758,bright,main,20220217,8,0.9895064313053925,283,116,4,403
22758,bright,main,20220217,9,0.9886499261322347,298,106,10,414
25862,bright,main,20220217,0,0.9942794420079791,341,83,5,429
25862,bright,main,20220217,1,0.9942204062063366,306,67,8,381
25862,bright,main,20220217,2,0.9954987781975123,278,130,7,415
25862,bright,main,20220217,3,0.9881778081779978,235,138,3,376
25862,bright,main,20220217,4,0.9872384964017432,210,151,3,364
25862,bright,main,20220217,5,0.9929561677761511,231,146,6,383
25862,bright,main,20220217,6,0.9961272148497621,281,121,4,406
25862,bright,main,20220217,7,0.9955195300810198,268,84,2,354
25862,bright,main,20220217,8,0.9887604594807767,300,98,4,402
25862,bright,main,20220217,9,0.9870805418962247,320,96,4,420
24468,bright,main,20220217,0,0.9943869370015573,282,128,12,422
24468,bright,main,20220217,1,0.9922044586388614,269,105,4,378
24468,bright,main,20220217,2,0.994806296737626,315,100,10,425
24468,bright,main,20220217,3,0.9894412142119824,276,110,4,390
24468,bright,main,20220217,4,0.9901844672258093,286,76,6,368
24468,bright,main,20220217,5,0.9884896376615689,283,95,1,379
24468,bright,main,20220217,6,0.9953426055893008,348,68,3,419
24468,bright,main,20220217,7,0.992087525389579,271,69,2,342
24468,bright,main,20220217,8,0.9938555970934105,332,61,3,396
24468,bright,main,20220217,9,0.9922196146865871,317,91,4,412
25637,bright,main,20220217,0,0.9966783616575614,276,152,3,431
25637,bright,main,20220217,1,0.9911327052875694,295,97,4,396
25637,bright,main,20220217,2,0.992389257544287,283,135,6,424
25637,bright,main,20220217,3,0.9918078112042154,251,143,1,395
25637,bright,main,20220217,4,0.9920719677496054,282,98,3,383
25637,bright,main,20220217,5,0.993470442714369,271,134,4,409
25637,bright,main,20220217,6,0.991803435230021,215,180,5,400
25637,bright,main,20220217,7,0.9933375306677282,211,147,5,363
25637,bright,main,20220217,8,0.9920715754722322,228,167,8,403
25637,bright,main,20220217,9,0.9951660330375005,286,130,5,421
25358,bright,main,20220217,0,0.9846670994199357,359,70,2,431
25358,bright,main,20220217,1,0.9911561804074703,305,64,4,373
25358,bright,main,20220217,2,0.9918055053637203,357,53,8,418
25358,bright,main,20220217,3,0.9875172322380885,309,63,3,375
25358,bright,main,20220217,4,0.9891552350726389,306,71,6,383
25358,bright,main,20220217,5,0.9926243304816469,340,58,5,403
25358,bright,main,20220217,6,0.9920677153855801,348,55,7,410
25358,bright,main,20220217,7,0.9946711104387149,312,52,4,368
25358,bright,main,20220217,8,0.9979252014612867,329,67,2,398
25358,bright,main,20220217,9,0.9954529541778694,340,76,6,422
25353,bright,main,20220217,0,0.9895906842320581,330,71,5,406
25353,bright,main,20220217,1,0.9912690936338555,294,68,4,366
25353,bright,main,20220217,2,0.9929563035210845,332,63,8,403
25353,bright,main,20220217,3,0.9932696845593386,297,66,7,370
25353,bright,main,20220217,4,0.9865635864341133,311,62,6,379
25353,bright,main,20220217,5,0.9929606223382873,313,69,5,387
25353,bright,main,20220217,6,0.9950193181328588,338,64,4,406
25353,bright,main,20220217,7,0.9857674070476069,291,55,4,350
25353,bright,main,20220217,8,0.9847246648098759,322,69,6,397
25353,bright,main,20220217,9,0.9956901562734518,351,63,2,416
22525,bright,main,20220217,0,0.9931391007763917,280,136,4,420
22525,bright,main,20220217,1,0.987900536215973,266,119,5,390
22525,bright,main,20220217,2,0.9954908946855643,295,123,5,423
22525,bright,main,20220217,3,0.9947449495873316,308,77,6,391
22525,bright,main,20220217,4,0.9904942239565684,310,73,2,385
22525,bright,main,20220217,5,0.9942330427520364,329,70,4,403
22525,bright,main,20220217,6,0.9928126117365289,325,69,7,401
22525,bright,main,20220217,7,0.9929864569638382,266,92,3,361
22525,bright,main,20220217,8,0.9914611418108557,273,122,6,401
22525,bright,main,20220217,9,0.9915821741908993,322,101,2,425
41653,backup,main,20220217,0,0.9896549997074147,8,358,1,367
41653,backup,main,20220217,1,0.9965303534009057,3,329,2,334
41653,backup,main,20220217,2,0.9951967115046713,5,375,1,381
41653,backup,main,20220217,3,0.989500503800157,9,331,0,340
41653,backup,main,20220217,4,0.9943049504658091,3,326,3,332
41653,backup,main,20220217,5,0.9913324987219668,5,343,0,348
41653,backup,main,20220217,6,0.9866731074868205,4,347,1,352
41653,backup,main,20220217,7,0.9922301037935934,0,311,0,311
41653,backup,main,20220217,8,0.9863911836841577,3,346,1,350
41653,backup,main,20220217,9,0.9911245589513993,3,368,1,372
25855,bright,main,20220217,0,0.9958879002893962,288,130,7,425
25855,bright,main,20220217,1,0.9935562612865912,265,108,7,380
25855,bright,main,20220217,2,0.9927789367135561,312,110,5,427
25855,bright,main,20220217,3,0.9905645341278023,297,83,4,384
25855,bright,main,20220217,4,0.9895169643045842,233,139,6,378
25855,bright,main,20220217,5,0.9918819234204186,277,113,5,395
25855,bright,main,20220217,6,0.9916252480567966,305,108,8,421
25855,bright,main,20220217,7,0.991565926838035,272,82,5,359
25855,bright,main,20220217,8,0.9918288084660807,335,60,3,398
25855,bright,main,20220217,9,0.9856182570230794,318,85,5,408
24459,bright,main,20220217,0,0.9934542889720271,279,109,6,394
24459,bright,main,20220217,1,0.9866206394998049,277,74,11,362
24459,bright,main,20220217,2,0.990077720731071,316,76,6,398
24459,bright,main,20220217,3,0.9921368846546779,264,81,6,351
24459,bright,main,20220217,4,0.9925359318024368,212,129,5,346
24459,bright,main,20220217,5,0.9870760783080149,226,125,7,358
24459,bright,main,20220217,6,0.9877417174495149,234,135,3,372
24459,bright,main,20220217,7,0.9949606220277287,234,99,2,335
24459,bright,main,20220217,8,0.9953865387159359,239,140,5,384
24459,bright,main,20220217,9,0.9967802103065262,264,129,5,398
41649,backup,main,20220217,0,0.991646377738658,8,344,3,355
41649,backup,main,20220217,1,0.9919622553442663,3,313,0,316
41649,backup,main,20220217,2,0.9879920449434879,9,336,1,346
41649,backup,main,20220217,3,0.9900099476472151,2,296,0,298
41649,backup,main,20220217,4,0.9947509500750573,3,300,1,304
41649,backup,main,20220217,5,0.9910405568144146,11,330,0,341
41649,backup,main,20220217,6,0.9913245282819741,2,360,0,362
41649,backup,main,20220217,7,0.9898470388956171,5,297,3,305
41649,backup,main,20220217,8,0.9863393710411137,2,324,3,329
41649,backup,main,20220217,9,0.9926221950540554,8,343,2,353
22908,bright,main,20220217,0,0.9918184668121263,294,122,8,424
22908,bright,main,20220217,1,0.99084012314612,282,100,4,386
22908,bright,main,20220217,2,0.9925217691353058,300,118,6,424
22908,bright,main,20220217,3,0.9910372945344268,253,119,7,379
22908,bright,main,20220217,4,0.9957578728903516,293,83,6,382
22908,bright,main,20220217,5,0.9933900721404086,308,82,6,396
22908,bright,main,20220217,6,0.9950144197070417,324,86,6,416
22908,bright,main,20220217,7,0.9892230861994341,301,59,4,364
22908,bright,main,20220217,8,0.9950406789625924,287,110,1,398
22908,bright,main,20220217,9,0.9874112009713715,261,132,9,402
41651,backup,main,20220217,0,0.9938667847742076,8,364,0,372
41651,backup,main,20220217,1,0.9848002770528471,7,318,1,326
41651,backup,main,20220217,2,0.9912186785046833,7,336,0,343
41651,backup,main,20220217,3,0.9955052411250854,12,322,1,335
41651,backup,main,20220217,4,0.9949464686454152,5,325,3,333
41651,backup,main,20220217,5,0.9876260106599714,6,340,0,346
41651,backup,main,20220217,6,0.9882470053886883,6,350,0,356
41651,backup,main,20220217,7,0.9875922094730931,3,307,1,311
41651,backup,main,20220217,8,0.9946049742838269,6,343,1,350
41651,backup,main,20220217,9,0.9935261563696889,4,350,2,356
41646,backup,main,20220217,0,0.9946382652779365,9,362,3,374
41646,backup,main,20220217,1,0.9900836567408947,5,307,2,314
41646,backup,main,20220217,2,0.9901986939860107,1,339,1,341
41646,backup,main,20220217,3,0.9880939698824424,4,319,2,325
41646,backup,main,20220217,4,0.9901658724096446,4,318,1,323
41646,backup,main,20220217,5,0.9934007810441485,6,322,2,330
41646,backup,main,20220217,6,0.9840518332754289,5,331,3,339
41646,backup,main,20220217,7,0.9859704986957479,5,297,1,303
41646,backup,main,20220217,8,0.9919413432460258,5,332,3,340
41646,backup,main,20220217,9,0.9903990085328672,6,347,1,354
21669,bright,main,20220217,0,0.9856124829866644,206,95,3,304
21669,bright,main,20220217,1,0.9901156969113577,246,139,2,387
21669,bright,main,20220217,2,0.9961806228217694,295,142,2,439
21669,bright,main,20220217,3,0.991212276962025,234,162,6,402
21669,bright,main,20220217,4,0.9895713697332901,231,166,3,400
21669,bright,main,20220217,5,0.9908063379169609,259,154,7,420
21669,bright,main,20220217,6,0.9929081001882427,321,106,6,433
21669,bright,main,20220217,7,0.9902014240074085,266,107,3,376
21669,bright,main,20220217,8,0.9948894254275842,290,133,1,424
21669,bright,main,20220217,9,0.9898017480221999,328,102,3,433
41280,backup,main,20220217,0,0.996063944228963,43,401,2,446
41280,backup,main,20220217,1,0.992493586048602,17,389,0,406
41280,backup,main,20220217,2,0.9926125385353278,25,419,0,444
41280,backup,main,20220217,3,0.9878996857069228,29,374,1,404
41280,backup,main,20220217,4,0.9875950182552835,32,388,0,420
41280,backup,main,20220217,5,0.9934787152403612,15,421,0,436
41280,backup,main,20220217,6,0.9953902628220989,13,424,0,437
41280,backup,main,20220217,7,0.9892196883789706,10,377,0,387
41280,backup,main,20220217,8,0.991139107855424,10,419,0,429
41280,backup,main,20220217,9,0.9863186626396448,23,416,0,439
41612,backup,main,20220217,0,0.9901210976976841,8,355,2,365
41612,backup,main,20220217,1,0.989159859358161,9,314,3,326
41612,backup,main,20220217,2,0.9929078376827677,10,337,0,347
41612,backup,main,20220217,3,0.990682313439629,8,315,2,325
41612,backup,main,20220217,4,0.9904578714579558,7,306,1,314
41612,backup,main,20220217,5,0.9939246444375514,9,334,2,345
41612,backup,main,20220217,6,0.9927806567657474,7,343,0,350
41612,backup,main,20220217,7,0.9881917936339718,6,300,0,306
41612,backup,main,20220217,8,0.9852179708190801,4,334,2,340
41612,backup,main,20220217,9,0.9934083028244242,5,318,1,324
26070,bright,main,20220217,0,0.9878452479022048,261,178,2,441
26070,bright,main,20220217,1,0.995005118500414,173,225,1,399
26070,bright,main,20220217,2,0.9939720538448595,133,300,2,435
26070,bright,main,20220217,3,0.9916110107283395,233,164,5,402
26070,bright,main,20220217,4,0.9857273138566955,303,94,3,400
26070,bright,main,20220217,5,0.9861869783382976,259,148,3,410
26070,bright,main,20220217,6,0.9924224338786228,285,144,1,430
26070,bright,main,20220217,7,0.99405651935907,288,84,2,374
26070,bright,main,20220217,8,0.9898290478447217,317,99,4,420
26070,bright,main,20220217,9,0.9906235629069047,278,151,5,434
42665,backup,main,20220217,0,0.99033574615259,6,379,1,386
42665,backup,main,20220217,1,0.9935030236648423,4,337,2,343
42665,backup,main,20220217,2,0.9943939643624571,1,371,0,372
42665,backup,main,20220217,3,0.9892849094692857,1,352,1,354
42665,backup,main,20220217,4,0.9805637416497964,4,346,2,352
42665,backup,main,20220217,5,0.9875657796651706,3,368,1,372
42665,backup,main,20220217,6,0.9893277840999558,8,365,1,374
42665,backup,main,20220217,7,0.9913255940203342,4,317,0,321
42665,backup,main,20220217,8,0.9935719846622401,2,355,1,358
42665,backup,main,20220217,9,0.992747784142784,6,358,5,369
42669,backup,main,20220217,0,0.9930315408279262,0,380,1,381
42669,backup,main,20220217,1,0.9935968341329847,2,331,2,335
42669,backup,main,20220217,2,0.9948697108223195,2,372,3,377
42669,backup,main,20220217,3,0.989705225736922,6,339,1,346
42669,backup,main,20220217,4,0.9959000477497777,3,341,0,344
42669,backup,main,20220217,5,0.9920162515841682,6,342,1,349
42669,backup,main,20220217,6,0.9937582827175411,4,347,0,351
42669,backup,main,20220217,7,0.9886397278790526,2,311,0,313
42669,backup,main,20220217,8,0.9927202096532651,6,348,0,354
42669,backup,main,20220217,9,0.9940336685631114,6,361,1,368
41654,backup,main,20220217,0,0.9936045298223201,6,363,2,371
41654,backup,main,20220217,1,0.9895988035390691,4,318,0,322
41654,backup,main,20220217,2,0.9955435119446876,2,355,0,357
41654,backup,main,20220217,3,0.9938510516954632,6,324,2,332
41654,backup,main,20220217,4,0.9887353354429695,5,333,1,339
41654,backup,main,20220217,5,0.9947055859126485,6,339,1,346
41654,backup,main,20220217,6,0.9897260096676406,6,358,1,365
41654,backup,main,20220217,7,0.9902548281539391,4,299,0,303
41654,backup,main,20220217,8,0.9897106239586094,0,347,0,347
41654,backup,main,20220217,9,0.9906478033910036,8,339,2,349
41644,backup,main,20220217,0,0.9933502175493009,6,346,0,352
41644,backup,main,20220217,1,0.9869660442658178,4,304,1,309
41644,backup,main,20220217,2,0.988390516787015,3,341,3,347
41644,backup,main,20220217,3,0.9950387188809335,7,325,3,335
41644,backup,main,20220217,4,0.9866617583382339,3,320,0,323
41644,backup,main,20220217,5,0.9883510859650974,2,343,1,346
41644,backup,main,20220217,6,0.9921509953949699,6,347,0,353
41644,backup,main,20220217,7,0.9887360914048176,4,298,2,304
41644,backup,main,20220217,8,0.9918423390531469,7,322,3,332
41644,backup,main,20220217,9,0.9912660736787443,3,343,1,347
41661,backup,main,20220217,0,0.9944240593430971,3,334,3,340
41661,backup,main,20220217,1,0.9881487826182624,1,300,1,302
41661,backup,main,20220217,2,0.987840850950509,8,324,1,333
41661,backup,main,20220217,3,0.9941356656225169,5,299,1,305
41661,backup,main,20220217,4,0.9835613152646568,2,294,3,299
41661,backup,main,20220217,5,0.9838758570289823,2,332,1,335
41661,backup,main,20220217,6,0.987169763429654,5,332,2,339
41661,backup,main,20220217,7,0.9918266905986408,5,285,2,292
41661,backup,main,20220217,8,0.9953179313182425,5,310,2,317
41661,backup,main,20220217,9,0.9882845801348573,3,320,0,323
42660,backup,main,20220217,0,0.9900915802469451,9,381,0,390
42660,backup,main,20220217,1,0.9915720991235882,1,343,0,344
42660,backup,main,20220217,2,0.9901067063772283,3,375,1,379
42660,backup,main,20220217,3,0.9932919296207933,6,335,2,343
42660,backup,main,20220217,4,0.9917111969154763,5,347,0,352
42660,backup,main,20220217,5,0.99369903922307,6,350,0,356
42660,backup,main,20220217,6,0.9889988885427877,2,373,1,376
42660,backup,main,20220217,7,0.9858421605638181,4,313,1,318
42660,backup,main,20220217,8,0.9860209362956187,4,352,0,356
42660,backup,main,20220217,9,0.9958322453197659,9,367,0,376
26083,bright,main,20220217,0,0.9896384381625603,175,261,2,438
26083,bright,main,20220217,1,0.9903029079251342,159,240,2,401
26083,bright,main,20220217,2,0.9940103045117065,160,268,4,432
26083,bright,main,20220217,3,0.9933497874090051,173,229,2,404
26083,bright,main,20220217,4,0.9957409516297419,140,257,1,398
26083,bright,main,20220217,5,0.9944253998846773,163,252,3,418
26083,bright,main,20220217,6,0.9899866362064883,152,274,2,428
26083,bright,main,20220217,7,0.9942145313440114,165,211,1,377
26083,bright,main,20220217,8,0.9910207740239398,150,273,1,424
26083,bright,main,20220217,9,0.9941093192383398,146,284,4,434
42666,backup,main,20220217,0,0.9970067072856387,1,374,1,376
42666,backup,main,20220217,1,0.9939675803141543,7,346,1,354
42666,backup,main,20220217,2,0.9935709525437665,4,368,0,372
42666,backup,main,20220217,3,0.9884185856999516,8,336,0,344
42666,backup,main,20220217,4,0.9837432543084854,6,333,1,340
42666,backup,main,20220217,5,0.9944753810618954,6,353,3,362
42666,backup,main,20220217,6,0.9938754491252255,9,350,1,360
42666,backup,main,20220217,7,0.992300831308361,5,297,1,303
42666,backup,main,20220217,8,0.9889919414503123,3,351,0,354
42666,backup,main,20220217,9,0.988656553186138,10,346,1,357
41656,backup,main,20220217,0,0.9915652040126922,4,329,4,337
41656,backup,main,20220217,1,0.989457124012765,3,308,1,312
41656,backup,main,20220217,2,0.9855385171216284,7,338,2,347
41656,backup,main,20220217,3,0.9961355354193608,11,301,6,318
41656,backup,main,20220217,4,0.9944861678518221,7,304,1,312
41656,backup,main,20220217,5,0.9871184351446818,2,329,2,333
41656,backup,main,20220217,6,0.9922709535630737,3,341,2,346
41656,backup,main,20220217,7,0.9892374112432535,3,287,3,293
41656,backup,main,20220217,8,0.9911274477424312,3,330,0,333
41656,backup,main,20220217,9,0.9947284554021835,3,343,2,348
25078,bright,main,20220218,0,0.9951827730513655,238,169,4,411
25078,bright,main,20220218,1,0.9904068892526509,226,143,10,379
25078,bright,main,20220218,2,0.9933451931523348,220,189,6,415
25078,bright,main,20220218,3,0.9884472179443706,248,127,6,381
25078,bright,main,20220218,4,0.9911280746052974,308,61,8,377
25078,bright,main,20220218,5,0.9953033906299148,327,69,5,401
25078,bright,main,20220218,6,0.9932290179716793,350,61,4,415
25078,bright,main,20220218,7,0.9931820685693877,286,73,2,361
25078,bright,main,20220218,8,0.99714406732245,307,82,10,399
25078,bright,main,20220218,9,0.9935734779674835,299,109,6,414
25350,bright,main,20220218,0,0.9949124442299515,370,51,3,424
25350,bright,main,20220218,1,0.9944540641774755,309,74,3,386
25350,bright,main,20220218,2,0.9935610280055093,315,93,4,412
25350,bright,main,20220218,3,0.9934558614188003,318,60,4,382
25350,bright,main,20220218,4,0.9891820804497946,253,109,6,368
25350,bright,main,20220218,5,0.9904069490617099,283,98,4,385
25350,bright,main,20220218,6,0.9898143680235718,364,40,6,410
25350,bright,main,20220218,7,0.9873908920350718,308,47,5,360
25350,bright,main,20220218,8,0.9950345916598834,317,73,5,395
25350,bright,main,20220218,9,0.9940567688686747,330,70,4,404
22214,bright,main,20220218,0,0.9929366522517148,365,54,4,423
22214,bright,main,20220218,1,0.9970469602457929,337,50,2,389
22214,bright,main,20220218,2,0.9928521559635707,345,64,5,414
22214,bright,main,20220218,3,0.9955007226238367,268,95,6,369
22214,bright,main,20220218,4,0.9917015516341294,288,85,6,379
22214,bright,main,20220218,5,0.9880183046840939,318,75,3,396
22214,bright,main,20220218,6,0.993501197959099,306,84,4,394
22214,bright,main,20220218,7,0.982908497437298,325,35,7,367
22214,bright,main,20220218,8,0.9892297831107049,338,56,8,402
22214,bright,main,20220218,9,0.9921855685486831,349,60,3,412
23743,bright,main,20220218,0,0.9840177737810313,350,59,3,412
23743,bright,main,20220218,1,0.9853618601675715,276,97,5,378
23743,bright,main,20220218,2,0.9851982947704786,299,96,4,399
23743,bright,main,20220218,3,0.9907264180241789,307,70,3,380
23743,bright,main,20220218,4,0.9872532324963255,306,69,4,379
23743,bright,main,20220218,5,0.9956903205584464,289,89,4,382
23743,bright,main,20220218,6,0.9914897453114904,320,87,5,412
23743,bright,main,20220218,7,0.9901294543915699,303,55,3,361
23743,bright,main,20220218,8,0.9948170058464124,334,60,3,397
23743,bright,main,20220218,9,0.9940769948130902,353,52,4,409
23794,bright,main,20220218,0,0.9929839739108154,344,72,2,418
23794,bright,main,20220218,1,0.9884086117943511,284,87,13,384
23794,bright,main,20220218,2,0.995468529296888,319,87,9,415
23794,bright,main,20220218,3,0.990676819294109,321,65,3,389
23794,bright,main,20220218,4,0.9828292371783792,303,70,4,377
23794,bright,main,20220218,5,0.991416499367837,331,69,3,403
23794,bright,main,20220218,6,0.9865409133212045,343,61,6,410
23794,bright,main,20220218,7,0.9908582933844878,298,57,5,360
23794,bright,main,20220218,8,0.9890232600741926,337,64,2,403
23794,bright,main,20220218,9,0.9898697901016072,326,87,4,417
25863,bright,main,20220218,0,0.9947639801906187,302,117,6,425
25863,bright,main,20220218,1,0.9908411355057365,259,124,5,388
25863,bright,main,20220218,2,0.9954880284570188,276,139,7,422
25863,bright,main,20220218,3,0.9961073801638884,258,109,13,380
25863,bright,main,20220218,4,0.9869623840479337,265,119,2,386
25863,bright,main,20220218,5,0.9901664527665425,278,111,5,394
25863,bright,main,20220218,6,0.987075402781405,260,147,0,407
25863,bright,main,20220218,7,0.9952806283657245,274,86,3,363
25863,bright,main,20220218,8,0.9933737326447125,311,90,4,405
25863,bright,main,20220218,9,0.9927205159621757,312,104,4,420
25088,bright,main,20220218,0,0.9938342907429686,362,58,4,424
25088,bright,main,20220218,1,0.9910903405091326,293,81,6,380
25088,bright,main,20220218,2,0.9903733094113425,356,62,4,422
25088,bright,main,20220218,3,0.9923670240103478,314,64,4,382
25088,bright,main,20220218,4,0.9951661496663484,292,85,5,382
25088,bright,main,20220218,5,0.9914478649957492,317,69,11,397
25088,bright,main,20220218,6,0.9941977004721579,371,40,1,412
25088,bright,main,20220218,7,0.9889169540579622,304,51,7,362
25088,bright,main,20220218,8,0.9933089641833055,361,43,4,408
25088,bright,main,20220218,9,0.9911946881400377,341,70,6,417
25073,bright,main,20220218,0,0.9952292361599042,319,99,10,428
25073,bright,main,20220218,1,0.9931247728384753,313,70,3,386
25073,bright,main,20220218,2,0.9946676050001978,323,81,3,407
25073,bright,main,20220218,3,0.9875322956022415,276,104,2,382
25073,bright,main,20220218,4,0.9916782168040718,282,95,7,384
25073,bright,main,20220218,5,0.9924742167252106,267,118,5,390
25073,bright,main,20220218,6,0.9895408628287847,303,108,6,417
25073,bright,main,20220218,7,0.9915751080440542,216,129,12,357
25073,bright,main,20220218,8,0.9939519366063757,309,73,9,391
25073,bright,main,20220218,9,0.9910880383405484,323,80,6,409
25902,bright,main,20220218,0,0.9915368629173865,298,127,3,428
25902,bright,main,20220218,1,0.993131687910015,278,100,5,383
25902,bright,main,20220218,2,0.9927173459546212,314,97,6,417
25902,bright,main,20220218,3,0.9912646496404542,273,105,5,383
25902,bright,main,20220218,4,0.9825775953836798,275,98,6,379
25902,bright,main,20220218,5,0.9900798270288251,286,109,3,398
25902,bright,main,20220218,6,0.9947296422925561,334,81,3,418
25902,bright,main,20220218,7,0.9910029440497993,297,72,2,371
25902,bright,main,20220218,8,0.9848442446077256,312,87,4,403
25902,bright,main,20220218,9,0.9873580212692527,303,117,4,424
25302,bright,main,20220218,0,0.9959504784134664,321,92,4,417
25302,bright,main,20220218,1,0.9942637139312815,281,87,5,373
25302,bright,main,20220218,2,0.9931382850534431,267,127,6,400
25302,bright,main,20220218,3,0.9922395943156536,290,84,3,377
25302,bright,main,20220218,4,0.9914449910748726,285,85,10,380
25302,bright,main,20220218,5,0.9881814100116991,267,119,5,391
25302,bright,main,20220218,6,0.9884296920859982,299,103,3,405
25302,bright,main,20220218,7,0.9902059787781051,272,85,2,359
25302,bright,main,20220218,8,0.9918046923800204,324,77,7,408
25302,bright,main,20220218,9,0.9928989966867598,319,89,6,414
21417,bright,main,20220218,0,0.9946202690971301,362,74,2,438
21417,bright,main,20220218,1,0.9918675779955284,318,73,8,399
21417,bright,main,20220218,2,0.9862637192516854,369,64,7,440
21417,bright,main,20220218,3,0.9952396074701209,304,89,4,397
21417,bright,main,20220218,4,0.9945953235557335,298,88,6,392
21417,bright,main,20220218,5,0.9950797569269556,332,80,2,414
21417,bright,main,20220218,6,0.9831345522402996,362,56,6,424
21417,bright,main,20220218,7,0.992003933267768,248,108,6,362
21417,bright,main,20220218,8,0.9911324527279195,322,84,6,412
21417,bright,main,20220218,9,0.9899326494101627,317,99,5,421
25865,bright,main,20220218,0,0.9964703570423425,284,132,4,420
25865,bright,main,20220218,1,0.992703831870029,323,63,4,390
25865,bright,main,20220218,2,0.9943603856014505,319,102,4,425
25865,bright,main,20220218,3,0.9916177642189694,251,117,8,376
25865,bright,main,20220218,4,0.9903373377808714,271,104,7,382
25865,bright,main,20220218,5,0.989490287633162,263,134,6,403
25865,bright,main,20220218,6,0.9944075463295361,303,106,9,418
25865,bright,main,20220218,7,0.9915014760497733,297,65,5,367
25865,bright,main,20220218,8,0.9931760663974912,340,70,2,412
25865,bright,main,20220218,9,0.9918493422315919,305,107,4,416
25074,bright,main,20220218,0,0.9934166922506529,344,67,4,415
25074,bright,main,20220218,1,0.9974426964980543,278,87,10,375
25074,bright,main,20220218,2,0.9955137575986757,346,69,4,419
25074,bright,main,20220218,3,0.9901502704207272,312,62,2,376
25074,bright,main,20220218,4,0.9906298570049857,311,60,6,377
25074,bright,main,20220218,5,0.9836630900560894,354,39,4,397
25074,bright,main,20220218,6,0.9945798919571801,340,69,4,413
25074,bright,main,20220218,7,0.9957368096893731,311,46,1,358
25074,bright,main,20220218,8,0.9927487921664248,350,54,7,411
25074,bright,main,20220218,9,0.992479693861526,346,63,5,414
5503,dark,main,20220218,0,0.9956716522603971,321,12,44,377
5503,dark,main,20220218,1,0.985464232623115,289,17,46,352
5503,dark,main,20220218,2,0.9911008909375911,318,14,52,384
5503,dark,main,20220218,3,0.9946696170058899,300,16,41,357
5503,dark,main,20220218,4,0.9913138973476112,291,8,45,344
5503,dark,main,20220218,5,0.9937229755288566,281,17,57,355
5503,dark,main,20220218,6,0.9928404559615625,297,21,57,375
5503,dark,main,20220218,7,0.989527064204471,273,13,38,324
5503,dark,main,20220218,8,0.9862427302791971,307,17,46,370
5503,dark,main,20220218,9,0.9921838443201704,321,12,42,375
23138,bright,main,20220218,0,0.9909567217110066,339,71,7,417
23138,bright,main,20220218,1,0.9908572325746042,295,68,5,368
23138,bright,main,20220218,2,0.9899386980018143,322,87,4,413
23138,bright,main,20220218,3,0.9980578794143067,302,71,5,378
23138,bright,main,20220218,4,0.9930388888453402,308,65,3,376
23138,bright,main,20220218,5,0.9899522319293032,326,70,2,398
23138,bright,main,20220218,6,0.9927089727276158,294,99,3,396
23138,bright,main,20220218,7,0.9937916870037967,285,72,2,359
23138,bright,main,20220218,8,0.9922869649702187,319,73,5,397
23138,bright,main,20220218,9,0.9965161370317898,331,65,8,404
24606,bright,main,20220218,0,0.9944427254326298,334,103,5,442
24606,bright,main,20220218,1,0.9868719799815686,304,86,4,394
24606,bright,main,20220218,2,0.9899777374971364,311,114,3,428
24606,bright,main,20220218,3,0.9919352386855148,248,143,2,393
24606,bright,main,20220218,4,0.995514856408597,256,132,6,394
24606,bright,main,20220218,5,0.9932827043495058,218,186,6,410
24606,bright,main,20220218,6,0.9894823137180615,189,225,8,422
24606,bright,main,20220218,7,0.9948781404899001,263,104,4,371
24606,bright,main,20220218,8,0.9874714312885862,303,109,4,416
24606,bright,main,20220218,9,0.9930825093815553,324,104,4,432
25089,bright,main,20220218,0,0.9940155687686133,336,73,3,412
25089,bright,main,20220218,1,0.9940083511236232,330,44,6,380
25089,bright,main,20220218,2,0.9947646528193395,344,68,1,413
25089,bright,main,20220218,3,0.9884626453958679,305,65,1,371
25089,bright,main,20220218,4,0.9919421286446952,305,53,6,364
25089,bright,main,20220218,5,0.9917697132906712,331,62,5,398
25089,bright,main,20220218,6,0.9886394583133249,312,86,4,402
25089,bright,main,20220218,7,0.9855571136985282,277,59,4,340
25089,bright,main,20220218,8,0.9921262231516982,322,72,5,399
25089,bright,main,20220218,9,0.9940969164679874,329,66,5,400
22757,bright,main,20220218,0,0.9893940138726872,296,120,8,424
22757,bright,main,20220218,1,0.992291005630787,304,82,6,392
22757,bright,main,20220218,2,0.9907096207348732,336,79,5,420
22757,bright,main,20220218,3,0.9938878133174985,262,117,8,387
22757,bright,main,20220218,4,0.9889003443585036,264,118,5,387
22757,bright,main,20220218,5,0.9921300069968,265,131,4,400
22757,bright,main,20220218,6,0.9945568934410751,306,103,6,415
22757,bright,main,20220218,7,0.9905573983971411,267,89,7,363
22757,bright,main,20220218,8,0.9921908604413638,308,87,11,406
22757,bright,main,20220218,9,0.993402318947507,280,134,3,417
24612,bright,main,20220218,0,0.987755014479276,241,194,5,440
24612,bright,main,20220218,1,0.9897040904397811,285,111,3,399
24612,bright,main,20220218,2,0.9929772929913087,250,179,8,437
24612,bright,main,20220218,3,0.9930897664591763,191,203,1,395
24612,bright,main,20220218,4,0.99427664558029,179,206,10,395
24612,bright,main,20220218,5,0.9936117980471177,154,255,4,413
24612,bright,main,20220218,6,0.9920080899017794,139,289,5,433
24612,bright,main,20220218,7,0.9944839489431186,117,247,6,370
24612,bright,main,20220218,8,0.9936073305591162,173,249,1,423
24612,bright,main,20220218,9,0.9931975157921928,207,224,4,435
21577,bright,main,20220218,0,0.997871852646297,295,136,2,433
21577,bright,main,20220218,1,0.9896630549161644,250,131,8,389
21577,bright,main,20220218,2,0.9937981456779854,295,118,4,417
21577,bright,main,20220218,3,0.991128527240317,222,162,6,390
21577,bright,main,20220218,4,0.9854295226114417,279,100,4,383
21577,bright,main,20220218,5,0.9841567130953737,301,98,8,407
21577,bright,main,20220218,6,0.9915380853139039,328,94,3,425
21577,bright,main,20220218,7,0.988519714255273,294,70,4,368
21577,bright,main,20220218,8,0.9965372438487895,282,123,4,409
21577,bright,main,20220218,9,0.9922659441804647,314,104,4,422
9397,dark,main,20220218,0,0.9939516438166665,328,18,45,391
9397,dark,main,20220218,1,0.9932334946659714,289,23,42,354
9397,dark,main,20220218,2,0.9924387135120663,312,18,66,396
9397,dark,main,20220218,3,0.9953879997738304,281,22,55,358
9397,dark,main,20220218,4,0.9929358541137332,263,14,64,341
9397,dark,main,20220218,5,0.9913788555132127,284,16,58,358
9397,dark,main,20220218,6,0.9945494864615199,303,14,54,371
9397,dark,main,20220218,7,0.9881934316681621,261,18,35,314
9397,dark,main,20220218,8,0.9901365008411118,329,16,36,381
9397,dark,main,20220218,9,0.991634710050315,300,13,58,371
22283,bright,main,20220218,0,0.9910878100807838,276,140,3,419
22283,bright,main,20220218,1,0.9877565013991331,250,134,8,392
22283,bright,main,20220218,2,0.9954870759094596,272,148,7,427
22283,bright,main,20220218,3,0.9937407369009024,210,172,7,389
22283,bright,main,20220218,4,0.9922932717642247,215,171,4,390
22283,bright,main,20220218,5,0.9920407248128807,253,145,8,406
22283,bright,main,20220218,6,0.9933006989628498,239,167,9,415
22283,bright,main,20220218,7,0.9940573250394945,190,159,5,354
22283,bright,main,20220218,8,0.993281404292645,240,154,5,399
22283,bright,main,20220218,9,0.992547025622331,307,106,3,416
20595,bright,main,20220218,0,0.9936589400946543,362,52,4,418
20595,bright,main,20220218,1,0.9868254723202582,301,62,5,368
20595,bright,main,20220218,2,0.9897848245711031,383,33,6,422
20595,bright,main,20220218,3,0.9896209468329252,326,59,2,387
20595,bright,main,20220218,4,0.9914405872050046,302,82,4,388
20595,bright,main,20220218,5,0.9918641305867961,331,71,3,405
20595,bright,main,20220218,6,0.9947048971157295,333,82,2,417
20595,bright,main,20220218,7,0.9861633066078628,283,72,3,358
20595,bright,main,20220218,8,0.9901704341731477,343,56,5,404
20595,bright,main,20220218,9,0.9933087601315153,371,43,1,415
20239,bright,main,20220218,0,0.9929053991875813,342,78,8,428
20239,bright,main,20220218,1,0.9872538936077722,336,55,5,396
20239,bright,main,20220218,2,0.9892252432020873,361,68,5,434
20239,bright,main,20220218,3,0.9870804600329687,303,79,7,389
20239,bright,main,20220218,4,0.9906674745443117,323,57,6,386
20239,bright,main,20220218,5,0.9939255319408086,337,69,5,411
20239,bright,main,20220218,6,0.9879827808078416,372,50,4,426
20239,bright,main,20220218,7,0.991038320799915,308,56,4,368
20239,bright,main,20220218,8,0.986213067392645,352,55,5,412
20239,bright,main,20220218,9,0.9953491358642456,366,55,7,428
25083,bright,main,20220218,0,0.989081255042585,345,70,3,418
25083,bright,main,20220218,1,0.9912357352024451,303,71,6,380
25083,bright,main,20220218,2,0.991188659203993,322,82,9,413
25083,bright,main,20220218,3,0.9907527489727047,299,65,8,372
25083,bright,main,20220218,4,0.9876030734641851,322,55,5,382
25083,bright,main,20220218,5,0.9924498888197574,347,48,5,400
25083,bright,main,20220218,6,0.995128637650884,313,77,4,394
25083,bright,main,20220218,7,0.9907700992316668,295,63,2,360
25083,bright,main,20220218,8,0.9925785228211298,323,66,4,393
25083,bright,main,20220218,9,0.9886777553471315,360,45,1,406
7078,dark,main,20220218,0,0.9927936549621384,326,17,45,388
7078,dark,main,20220218,1,0.991689371757342,292,22,35,349
7078,dark,main,20220218,2,0.9921480297842715,314,18,38,370
7078,dark,main,20220218,3,0.9929648209760231,298,14,41,353
7078,dark,main,20220218,4,0.9925483412459646,299,14,34,347
7078,dark,main,20220218,5,0.9934153714024682,313,15,48,376
7078,dark,main,20220218,6,0.9950015957954782,308,11,52,371
7078,dark,main,20220218,7,0.9926963081194138,277,11,46,334
7078,dark,main,20220218,8,0.9834360929657089,292,21,47,360
7078,dark,main,20220218,9,0.9895715560087751,323,17,40,380
20600,bright,main,20220218,0,0.9893046534724235,371,52,2,425
20600,bright,main,20220218,1,0.9879924230575731,303,69,5,377
20600,bright,main,20220218,2,0.9906713976866467,317,82,6,405
20600,bright,main,20220218,3,0.9937910885706964,289,73,6,368
20600,bright,main,20220218,4,0.9819417933580539,305,58,4,367
20600,bright,main,20220218,5,0.9917648819022846,333,54,3,390
20600,bright,main,20220218,6,0.9926281643871817,341,58,8,407
20600,bright,main,20220218,7,0.9910831375903184,277,63,2,342
20600,bright,main,20220218,8,0.9873423727886601,320,76,3,399
20600,bright,main,20220218,9,0.9935472757189409,320,70,7,397
20624,bright,main,20220218,0,0.9882861252592182,351,58,4,413
20624,bright,main,20220218,1,0.9938432182373942,332,46,4,382
20624,bright,main,20220218,2,0.9964650613157132,365,54,6,425
20624,bright,main,20220218,3,0.9894011624306783,325,54,3,382
20624,bright,main,20220218,4,0.991655194218412,333,48,6,387
20624,bright,main,20220218,5,0.9906161327601871,307,84,2,393
20624,bright,main,20220218,6,0.9930001954195645,324,69,5,398
20624,bright,main,20220218,7,0.9936016585465721,261,82,1,344
20624,bright,main,20220218,8,0.9918594917688822,318,65,7,390
20624,bright,main,20220218,9,0.9910333624585074,340,69,9,418
8748,dark,main,20220218,0,0.9941241096521755,328,12,46,386
8748,dark,main,20220218,1,0.9941876083447865,299,14,39,352
8748,dark,main,20220218,2,0.994370649639759,329,14,58,401
8748,dark,main,20220218,3,0.9946066174318402,292,17,40,349
8748,dark,main,20220218,4,0.9882638866993866,295,14,38,347
8748,dark,main,20220218,5,0.9861937687477915,290,14,57,361
8748,dark,main,20220218,6,0.9889806910093234,303,18,52,373
8748,dark,main,20220218,7,0.9922786008485065,275,12,44,331
8748,dark,main,20220218,8,0.9916980681657179,310,13,53,376
8748,dark,main,20220218,9,0.9968950106028533,330,13,39,382
25076,bright,main,20220218,0,0.9911985000233758,276,134,5,415
25076,bright,main,20220218,1,0.9935196204240457,258,113,5,376
25076,bright,main,20220218,2,0.9902211571838172,309,103,4,416
25076,bright,main,20220218,3,0.9901422246627752,257,112,8,377
25076,bright,main,20220218,4,0.9915203916290017,308,64,3,375
25076,bright,main,20220218,5,0.9952315427429643,317,70,4,391
25076,bright,main,20220218,6,0.9948612417301986,326,79,3,408
25076,bright,main,20220218,7,0.9927107229477499,263,80,3,346
25076,bright,main,20220218,8,0.9959266674211971,259,121,4,384
25076,bright,main,20220218,9,0.9939153928861599,282,125,9,416
22162,bright,main,20220218,0,0.9932749257039659,343,68,5,416
22162,bright,main,20220218,1,0.9928564074791512,306,60,5,371
22162,bright,main,20220218,2,0.9804547473424293,327,72,3,402
22162,bright,main,20220218,3,0.9904508442232098,299,65,4,368
22162,bright,main,20220218,4,0.9934502556836868,305,61,9,375
22162,bright,main,20220218,5,0.9924560727174815,318,71,3,392
22162,bright,main,20220218,6,0.9922171629934144,347,68,2,417
22162,bright,main,20220218,7,0.9931898493567674,293,56,4,353
22162,bright,main,20220218,8,0.9916790859338321,341,54,5,400
22162,bright,main,20220218,9,0.9932884935548727,342,65,5,412
22171,bright,main,20220218,0,0.9943778464652963,355,55,6,416
22171,bright,main,20220218,1,0.9939885742313841,319,56,6,381
22171,bright,main,20220218,2,0.9882057925343165,358,57,9,424
22171,bright,main,20220218,3,0.9918356789385049,313,71,3,387
22171,bright,main,20220218,4,0.9932008177507461,287,83,5,375
22171,bright,main,20220218,5,0.9932641269157944,331,65,5,401
22171,bright,main,20220218,6,0.9926760096156556,360,55,2,417
22171,bright,main,20220218,7,0.992590900212073,288,57,3,348
22171,bright,main,20220218,8,0.9885773177437888,335,59,4,398
22171,bright,main,20220218,9,0.991234784726806,316,70,7,393
22184,bright,main,20220218,0,0.9932983397859795,335,72,4,411
22184,bright,main,20220218,1,0.9911720608078205,307,55,3,365
22184,bright,main,20220218,2,0.9898610143270249,346,66,4,416
22184,bright,main,20220218,3,0.9920135299897088,305,70,3,378
22184,bright,main,20220218,4,0.992725774702477,276,79,8,363
22184,bright,main,20220218,5,0.9932063536288704,356,41,5,402
22184,bright,main,20220218,6,0.9929821253270789,337,58,5,400
22184,bright,main,20220218,7,0.9950175326299492,310,41,3,354
22184,bright,main,20220218,8,0.9896529556037995,326,69,12,407
22184,bright,main,20220218,9,0.9833768045653577,357,56,3,416
20648,bright,main,20220218,0,0.9956958336272589,344,69,6,419
20648,bright,main,20220218,1,0.9868830580452804,298,61,9,368
20648,bright,main,20220218,2,0.9916002011743034,291,99,2,392
20648,bright,main,20220218,3,0.9949954342298652,301,65,4,370
20648,bright,main,20220218,4,0.9949581525895576,283,78,4,365
20648,bright,main,20220218,5,0.994314219060303,310,91,4,405
20648,bright,main,20220218,6,0.9864366549916149,283,126,3,412
20648,bright,main,20220218,7,0.9917408318589629,260,78,6,344
20648,bright,main,20220218,8,0.9928173482737872,319,60,8,387
20648,bright,main,20220218,9,0.9953629190954872,355,51,4,410
22224,bright,main,20220218,0,0.992053401412236,352,72,6,430
22224,bright,main,20220218,1,0.9947334372963001,311,70,5,386
22224,bright,main,20220218,2,0.9935698879831788,366,52,5,423
22224,bright,main,20220218,3,0.9928879435983241,309,64,5,378
22224,bright,main,20220218,4,0.9921420296201129,317,61,8,386
22224,bright,main,20220218,5,0.9919793989189402,329,65,8,402
22224,bright,main,20220218,6,0.9907218909548969,335,75,2,412
22224,bright,main,20220218,7,0.9874557413174466,275,76,2,353
22224,bright,main,20220218,8,0.9941913418593391,270,117,3,390
22224,bright,main,20220218,9,0.997030318491883,315,94,2,411
22185,bright,main,20220218,0,0.9956447965810508,336,85,5,426
22185,bright,main,20220218,1,0.9837409280825558,250,105,9,364
22185,bright,main,20220218,2,0.9881204238990917,266,134,5,405
22185,bright,main,20220218,3,0.9969254138297099,298,80,6,384
22185,bright,main,20220218,4,0.9934002221860303,282,89,3,374
22185,bright,main,20220218,5,0.9963749953615745,298,91,6,395
22185,bright,main,20220218,6,0.9915034527221774,304,93,5,402
22185,bright,main,20220218,7,0.9889081909668601,260,83,7,350
22185,bright,main,20220218,8,0.9853557610239838,291,100,7,398
22185,bright,main,20220218,9,0.9959936620069211,341,73,5,419
22186,bright,main,20220218,0,0.9940257857534719,350,72,5,427
22186,bright,main,20220218,1,0.9879504626203505,318,62,5,385
22186,bright,main,20220218,2,0.9883907479297056,355,53,8,416
22186,bright,main,20220218,3,0.9929001683011883,318,61,6,385
22186,bright,main,20220218,4,0.9913397116663893,302,73,4,379
22186,bright,main,20220218,5,0.984691741034579,317,63,4,384
22186,bright,main,20220218,6,0.9889978198545878,342,64,4,410
22186,bright,main,20220218,7,0.9843905595382508,293,55,9,357
22186,bright,main,20220218,8,0.9896389233339697,318,67,9,394
22186,bright,main,20220218,9,0.989673180437874,354,49,7,410
22338,bright,main,20220218,0,0.9951596571225141,353,73,3,429
22338,bright,main,20220218,1,0.9945597105780946,296,86,5,387
22338,bright,main,20220218,2,0.9905229060902112,315,107,2,424
22338,bright,main,20220218,3,0.9908477054589847,271,113,2,386
22338,bright,main,20220218,4,0.9895974020606392,273,89,14,376
22338,bright,main,20220218,5,0.9911391381195134,287,112,5,404
22338,bright,main,20220218,6,0.9931762795026199,286,118,6,410
22338,bright,main,20220218,7,0.9898053165844228,250,106,3,359
22338,bright,main,20220218,8,0.9910015451108974,316,89,5,410
22338,bright,main,20220218,9,0.995270495294491,341,75,1,417
21958,bright,main,20220219,0,0.9931355490662002,356,58,10,424
21958,bright,main,20220219,1,0.9930454333717537,313,59,1,373
21958,bright,main,20220219,2,0.9942831508300748,359,57,3,419
21958,bright,main,20220219,3,0.9825358106598893,299,68,6,373
21958,bright,main,20220219,4,0.9879668862306209,292,67,9,368
21958,bright,main,20220219,5,0.9944551569045633,309,71,6,386
21958,bright,main,20220219,6,0.9887723854938707,342,66,2,410
21958,bright,main,20220219,7,0.9839421609311175,309,47,3,359
21958,bright,main,20220219,8,0.9947298822573634,341,61,3,405
21958,bright,main,20220219,9,0.9957963786851857,333,71,0,404
3954,dark,main,20220219,0,0.9951816457246931,308,18,47,373
3954,dark,main,20220219,1,0.9885888618341551,298,19,30,347
3954,dark,main,20220219,2,0.9898283243488011,332,21,40,393
3954,dark,main,20220219,3,0.984773276443011,267,19,55,341
3954,dark,main,20220219,4,0.9910016873996669,281,15,44,340
3954,dark,main,20220219,5,0.9929442941439292,298,13,36,347
3954,dark,main,20220219,6,0.9876633517395433,300,16,52,368
3954,dark,main,20220219,7,0.9892007310913461,269,12,30,311
3954,dark,main,20220219,8,0.9925217228339974,284,17,60,361
3954,dark,main,20220219,9,0.9933958960569088,298,16,60,374
7914,dark,main,20220219,0,0.9897225887295965,324,13,55,392
7914,dark,main,20220219,1,0.9945469892348755,310,12,43,365
7914,dark,main,20220219,2,0.9941079384016148,293,12,87,392
7914,dark,main,20220219,3,0.9950014054848255,277,15,77,369
7914,dark,main,20220219,4,0.9919595527755274,233,13,112,358
7914,dark,main,20220219,5,0.9918421925476777,250,13,104,367
7914,dark,main,20220219,6,0.9958100417064084,262,17,99,378
7914,dark,main,20220219,7,0.9899336876136845,248,19,71,338
7914,dark,main,20220219,8,0.9906350179330397,295,12,64,371
7914,dark,main,20220219,9,0.9948640449359171,314,22,59,395
2563,dark,main,20220219,0,0.9877986808112805,326,13,39,378
2563,dark,main,20220219,1,0.9912359552814061,304,16,34,354
2563,dark,main,20220219,2,0.992124772926789,320,12,45,377
2563,dark,main,20220219,3,0.9930026838341695,299,12,46,357
2563,dark,main,20220219,4,0.9930642434978836,302,16,35,353
2563,dark,main,20220219,5,0.9935797907212547,332,14,24,370
2563,dark,main,20220219,6,0.9929555279869203,330,14,36,380
2563,dark,main,20220219,7,0.9929930946458966,270,14,40,324
2563,dark,main,20220219,8,0.9906467249960269,315,17,45,377
2563,dark,main,20220219,9,0.991092198367818,322,17,45,384
8801,dark,main,20220219,0,0.985874625920884,320,23,32,375
8801,dark,main,20220219,1,0.990735974042835,299,19,42,360
8801,dark,main,20220219,2,0.9893048801587196,311,18,51,380
8801,dark,main,20220219,3,0.990954118329472,301,24,46,371
8801,dark,main,20220219,4,0.9903811704978235,300,15,37,352
8801,dark,main,20220219,5,0.9933153573539562,303,13,49,365
8801,dark,main,20220219,6,0.9919607636220915,312,17,51,380
8801,dark,main,20220219,7,0.9958230819368022,271,14,39,324
8801,dark,main,20220219,8,0.9952853395344796,310,15,52,377
8801,dark,main,20220219,9,0.986904656268617,318,20,39,377
20322,bright,main,20220219,0,0.992764997167288,372,51,7,430
20322,bright,main,20220219,1,0.9925439969836682,318,60,5,383
20322,bright,main,20220219,2,0.9910127088777663,308,79,6,393
20322,bright,main,20220219,3,0.9896885253652427,321,63,7,391
20322,bright,main,20220219,4,0.9938724228518155,316,48,8,372
20322,bright,main,20220219,5,0.9935186910121598,322,64,6,392
20322,bright,main,20220219,6,0.994360702559561,341,66,7,414
20322,bright,main,20220219,7,0.992121066190759,294,50,7,351
20322,bright,main,20220219,8,0.9939006833475768,314,76,8,398
20322,bright,main,20220219,9,0.9923797291621183,353,57,5,415
3950,dark,main,20220219,0,0.9871520276742097,291,30,37,358
3950,dark,main,20220219,1,0.9957907084706543,287,20,33,340
3950,dark,main,20220219,2,0.9893915285202337,300,24,53,377
3950,dark,main,20220219,3,0.9891970238025327,288,16,34,338
3950,dark,main,20220219,4,0.9874183228065723,276,23,42,341
3950,dark,main,20220219,5,0.991541331009434,283,43,31,357
3950,dark,main,20220219,6,0.990112033030421,337,15,35,387
3950,dark,main,20220219,7,0.9870520032075107,257,19,37,313
3950,dark,main,20220219,8,0.9921438915578982,291,22,55,368
3950,dark,main,20220219,9,0.989581377089123,314,21,44,379
7217,dark,main,20220219,0,0.9857626777542393,314,20,35,369
7217,dark,main,20220219,1,0.9901306286101397,313,20,37,370
7217,dark,main,20220219,2,0.9968155724993402,336,22,38,396
7217,dark,main,20220219,3,0.9928503356775313,305,17,38,360
7217,dark,main,20220219,4,0.9916948856719978,301,16,29,346
7217,dark,main,20220219,5,0.9900704049507578,316,15,27,358
7217,dark,main,20220219,6,0.9909760233526926,313,24,30,367
7217,dark,main,20220219,7,0.9836570143301898,260,17,40,317
7217,dark,main,20220219,8,0.9845615405786394,309,19,36,364
7217,dark,main,20220219,9,0.9930501158454815,336,23,28,387
1650,dark,main,20220219,0,0.9911114808227265,324,10,54,388
1650,dark,main,20220219,1,0.9941595914562744,283,17,50,350
1650,dark,main,20220219,2,0.9848081516560399,297,10,81,388
1650,dark,main,20220219,3,0.992466865041422,275,13,80,368
1650,dark,main,20220219,4,0.9887755042119117,262,17,83,362
1650,dark,main,20220219,5,0.9915182772392058,271,10,84,365
1650,dark,main,20220219,6,0.9935162328556585,282,14,88,384
1650,dark,main,20220219,7,0.9911943385223998,278,16,42,336
1650,dark,main,20220219,8,0.9829088965768218,303,14,51,368
1650,dark,main,20220219,9,0.9899163705349373,298,12,76,386
3715,dark,main,20220219,0,0.9950949285791726,269,33,76,378
3715,dark,main,20220219,1,0.9804325557234347,217,29,92,338
3715,dark,main,20220219,2,0.99346368217292,292,20,87,399
3715,dark,main,20220219,3,0.9874819295007574,269,20,76,365
3715,dark,main,20220219,4,0.9950860580820227,289,20,43,352
3715,dark,main,20220219,5,0.9951091847471445,295,16,34,345
3715,dark,main,20220219,6,0.992664999055484,294,18,38,350
3715,dark,main,20220219,7,0.9940354292620516,261,22,26,309
3715,dark,main,20220219,8,0.9918769028849194,284,26,42,352
3715,dark,main,20220219,9,0.9908902214146682,287,25,69,381
1611,dark,main,20220219,0,0.9846151157070839,339,12,49,400
1611,dark,main,20220219,1,0.9939494168519568,277,12,68,357
1611,dark,main,20220219,2,0.9951382497675061,296,15,87,398
1611,dark,main,20220219,3,0.9900830716194553,260,14,78,352
1611,dark,main,20220219,4,0.9863674252473106,273,10,71,354
1611,dark,main,20220219,5,0.9920638012854419,280,14,69,363
1611,dark,main,20220219,6,0.994285309128179,296,11,89,396
1611,dark,main,20220219,7,0.9927812362051938,242,15,76,333
1611,dark,main,20220219,8,0.9899885426316579,296,13,62,371
1611,dark,main,20220219,9,0.994579398527145,309,12,69,390
23006,bright,main,20220219,0,0.9921055507623479,289,142,4,435
23006,bright,main,20220219,1,0.9908134406824846,312,71,5,388
23006,bright,main,20220219,2,0.989695405249761,350,74,6,430
23006,bright,main,20220219,3,0.9889103261496179,335,55,5,395
23006,bright,main,20220219,4,0.9952026307207478,261,127,2,390
23006,bright,main,20220219,5,0.990976618995347,178,216,6,400
23006,bright,main,20220219,6,0.9879243131085272,183,220,7,410
23006,bright,main,20220219,7,0.9960198599849781,163,186,7,356
23006,bright,main,20220219,8,0.9906948185348946,260,146,9,415
23006,bright,main,20220219,9,0.9853523868995828,301,109,6,416
3143,dark,main,20220219,0,0.9974752126170454,297,19,62,378
3143,dark,main,20220219,1,0.9890663836295078,290,13,41,344
3143,dark,main,20220219,2,0.9907505120920217,299,21,45,365
3143,dark,main,20220219,3,0.99115960207412,273,32,45,350
3143,dark,main,20220219,4,0.9842446946805159,285,16,46,347
3143,dark,main,20220219,5,0.9866165525718233,262,18,77,357
3143,dark,main,20220219,6,0.9900565212828857,260,24,97,381
3143,dark,main,20220219,7,0.9862747271651069,252,16,55,323
3143,dark,main,20220219,8,0.9935363268942004,291,20,60,371
3143,dark,main,20220219,9,0.9921681578987882,294,25,70,389
11566,dark,main,20220219,0,0.9947285662374091,285,20,89,394
11566,dark,main,20220219,1,0.9909071936141844,257,15,75,347
11566,dark,main,20220219,2,0.9921317824722596,290,15,75,380
11566,dark,main,20220219,3,0.9936078844183549,270,10,75,355
11566,dark,main,20220219,4,0.990448080216441,259,13,76,348
11566,dark,main,20220219,5,0.9896040557602562,272,12,83,367
11566,dark,main,20220219,6,0.9955487328715235,278,13,94,385
11566,dark,main,20220219,7,0.9924703068680552,237,10,78,325
11566,dark,main,20220219,8,0.9934636264369252,281,13,85,379
11566,dark,main,20220219,9,0.9887532651580285,285,19,79,383
7893,dark,main,20220219,0,0.9909525666048652,294,14,88,396
7893,dark,main,20220219,1,0.9893852937548749,275,12,72,359
7893,dark,main,20220219,2,0.991933941664034,296,11,91,398
7893,dark,main,20220219,3,0.995109869029683,260,12,85,357
7893,dark,main,20220219,4,0.9867471227818964,267,13,71,351
7893,dark,main,20220219,5,0.9927994804935568,290,16,71,377
7893,dark,main,20220219,6,0.9898389537241333,278,12,91,381
7893,dark,main,20220219,7,0.992275459949974,232,12,82,326
7893,dark,main,20220219,8,0.9939618417857321,280,15,79,374
7893,dark,main,20220219,9,0.9952873843056199,301,16,73,390
21948,bright,main,20220219,0,0.9940327923133746,354,55,4,413
21948,bright,main,20220219,1,0.9926147289191912,310,60,6,376
21948,bright,main,20220219,2,0.9939395512250828,347,61,5,413
21948,bright,main,20220219,3,0.9898109379928524,305,66,5,376
21948,bright,main,20220219,4,0.9904948631405288,288,76,5,369
21948,bright,main,20220219,5,0.992080821562724,325,63,6,394
21948,bright,main,20220219,6,0.9885762960197215,353,49,4,406
21948,bright,main,20220219,7,0.9905428607677591,306,46,4,356
21948,bright,main,20220219,8,0.9945173380190268,325,68,8,401
21948,bright,main,20220219,9,0.9941529848098881,334,66,3,403
1610,dark,main,20220219,0,0.9886702432560597,302,15,83,400
1610,dark,main,20220219,1,0.9896102019458022,271,12,75,358
1610,dark,main,20220219,2,0.9887785411480416,281,13,100,394
1610,dark,main,20220219,3,0.9848988457933165,263,13,82,358
1610,dark,main,20220219,4,0.9923636551862806,268,10,80,358
1610,dark,main,20220219,5,0.9887437196503537,279,13,76,368
1610,dark,main,20220219,6,0.9913693730054651,294,11,82,387
1610,dark,main,20220219,7,0.9909957609623735,256,13,65,334
1610,dark,main,20220219,8,0.9904204099160415,274,15,85,374
1610,dark,main,20220219,9,0.98848681168768,282,14,105,401
21919,bright,main,20220219,0,0.9938299043439213,327,77,5,409
21919,bright,main,20220219,1,0.9877665005676761,298,64,6,368
21919,bright,main,20220219,2,0.9900698957030621,326,74,5,405
21919,bright,main,20220219,3,0.9873755463405328,274,80,4,358
21919,bright,main,20220219,4,0.9931346648498628,275,74,7,356
21919,bright,main,20220219,5,0.9902309394125316,305,79,6,390
21919,bright,main,20220219,6,0.9923523885779206,331,70,1,402
21919,bright,main,20220219,7,0.9935410546592447,295,56,2,353
21919,bright,main,20220219,8,0.9866484072850751,292,98,4,394
21919,bright,main,20220219,9,0.9898377966825466,339,63,8,410
7067,dark,main,20220219,0,0.991294155186481,317,22,34,373
7067,dark,main,20220219,1,0.9930815126609172,271,41,37,349
7067,dark,main,20220219,2,0.9890065102117439,325,15,35,375
7067,dark,main,20220219,3,0.9904858821701582,300,25,30,355
7067,dark,main,20220219,4,0.9861531996596551,290,15,40,345
7067,dark,main,20220219,5,0.9902355805947046,291,14,59,364
7067,dark,main,20220219,6,0.9902885812905564,308,17,41,366
7067,dark,main,20220219,7,0.9849057876742199,257,23,35,315
7067,dark,main,20220219,8,0.9956225173589298,294,16,52,362
7067,dark,main,20220219,9,0.9925965572339631,295,17,41,353
25090,bright,main,20220219,0,0.9921733119165046,345,65,6,416
25090,bright,main,20220219,1,0.9975995484108401,310,60,5,375
25090,bright,main,20220219,2,0.994302695169049,364,40,11,415
25090,bright,main,20220219,3,0.9900498657269671,312,55,3,370
25090,bright,main,20220219,4,0.9929216761030213,322,52,6,380
25090,bright,main,20220219,5,0.9944599403525533,342,46,6,394
25090,bright,main,20220219,6,0.9850502592693514,353,54,4,411
25090,bright,main,20220219,7,0.99060161315275,298,49,8,355
25090,bright,main,20220219,8,0.9930561137403138,318,68,6,392
25090,bright,main,20220219,9,0.9954302856700924,373,42,7,422
6055,dark,main,20220219,0,0.9937709442316122,316,11,56,383
6055,dark,main,20220219,1,0.9859495639447672,273,16,65,354
6055,dark,main,20220219,2,0.9951636798076285,277,14,91,382
6055,dark,main,20220219,3,0.9951284745429976,273,12,73,358
6055,dark,main,20220219,4,0.9938671981047759,263,16,71,350
6055,dark,main,20220219,5,0.9883907492457338,288,15,65,368
6055,dark,main,20220219,6,0.9959809834890918,303,13,62,378
6055,dark,main,20220219,7,0.9843991796463586,263,12,62,337
6055,dark,main,20220219,8,0.9946686893316213,289,14,71,374
6055,dark,main,20220219,9,0.9918366396101354,322,11,51,384
21918,bright,main,20220219,0,0.9887970815775476,311,98,7,416
21918,bright,main,20220219,1,0.990195404159939,275,92,12,379
21918,bright,main,20220219,2,0.9915690685221858,312,95,6,413
21918,bright,main,20220219,3,0.9965743394509687,297,66,7,370
21918,bright,main,20220219,4,0.9907774714580398,342,42,2,386
21918,bright,main,20220219,5,0.9928366619527981,321,66,5,392
21918,bright,main,20220219,6,0.9937193897700037,324,72,6,402
21918,bright,main,20220219,7,0.989595725083104,275,68,8,351
21918,bright,main,20220219,8,0.9860866817975799,311,81,4,396
21918,bright,main,20220219,9,0.9877979722992907,302,94,8,404
10188,dark,main,20220219,0,0.9953149059626203,317,20,48,385
10188,dark,main,20220219,1,0.9933208133324318,303,12,40,355
10188,dark,main,20220219,2,0.9870662029034962,307,12,57,376
10188,dark,main,20220219,3,0.9909866259844079,258,20,87,365
10188,dark,main,20220219,4,0.9916818387377843,264,19,63,346
10188,dark,main,20220219,5,0.9922209350853256,293,14,64,371
10188,dark,main,20220219,6,0.9879335230694083,299,15,67,381
10188,dark,main,20220219,7,0.9721436437251345,272,11,47,330
10188,dark,main,20220219,8,0.9948360537867533,303,21,57,381
10188,dark,main,20220219,9,0.9946370520382111,305,18,61,384
25379,bright,main,20220219,0,0.993204566735087,302,119,4,425
25379,bright,main,20220219,1,0.9874125757230878,293,90,3,386
25379,bright,main,20220219,2,0.9925176788350101,344,81,2,427
25379,bright,main,20220219,3,0.9901869082509746,292,87,5,384
25379,bright,main,20220219,4,0.9938810056246694,196,183,5,384
25379,bright,main,20220219,5,0.994932111415473,146,236,7,389
25379,bright,main,20220219,6,0.9941194862172342,211,200,8,419
25379,bright,main,20220219,7,0.9893098713060066,222,136,2,360
25379,bright,main,20220219,8,0.9909095288696246,274,119,9,402
25379,bright,main,20220219,9,0.9907866007790925,322,102,1,425
10193,dark,main,20220219,0,0.9866695263059302,312,20,45,377
10193,dark,main,20220219,1,0.9894287081208425,305,21,36,362
10193,dark,main,20220219,2,0.9898622233704304,319,18,39,376
10193,dark,main,20220219,3,0.9931677115773886,304,15,33,352
10193,dark,main,20220219,4,0.9909040355955424,280,19,41,340
10193,dark,main,20220219,5,0.9904838845692172,301,20,35,356
10193,dark,main,20220219,6,0.9873289844515816,312,17,43,372
10193,dark,main,20220219,7,0.9930249407875898,275,17,37,329
10193,dark,main,20220219,8,0.9906735371579437,314,17,36,367
10193,dark,main,20220219,9,0.9891067455703595,306,25,37,368
10006,dark,main,20220219,0,0.9935684557320568,302,17,73,392
10006,dark,main,20220219,1,0.9927292199765733,306,11,43,360
10006,dark,main,20220219,2,0.9949096723988886,302,16,70,388
10006,dark,main,20220219,3,0.9855351817759048,285,13,59,357
10006,dark,main,20220219,4,0.9821270244969487,294,12,49,355
10006,dark,main,20220219,5,0.9868632493431979,309,11,64,384
10006,dark,main,20220219,6,0.9861777765143878,296,14,69,379
10006,dark,main,20220219,7,0.9926760682912057,241,12,74,327
10006,dark,main,20220219,8,0.9971679026110611,271,12,89,372
10006,dark,main,20220219,9,0.9907152167967661,287,11,82,380
3525,dark,main,20220220,0,0.9851632513675798,327,12,38,377
3525,dark,main,20220220,1,0.9881148233264674,279,12,57,348
3525,dark,main,20220220,2,0.9932248978243782,322,13,51,386
3525,dark,main,20220220,3,0.9959753968242404,291,12,48,351
3525,dark,main,20220220,4,0.991017543991263,280,13,54,347
3525,dark,main,20220220,5,0.9922346812446488,278,14,69,361
3525,dark,main,20220220,6,0.9859678938659716,283,10,57,350
3525,dark,main,20220220,7,0.980909786818731,248,13,63,324
3525,dark,main,20220220,8,0.9920419588143415,306,12,50,368
3525,dark,main,20220220,9,0.9947935480369834,321,12,49,382
6669,dark,main,20220220,0,0.9915675241928751,289,15,98,402
6669,dark,main,20220220,1,0.9850145389607601,253,15,91,359
6669,dark,main,20220220,2,0.9909687899985484,301,14,87,402
6669,dark,main,20220220,3,0.991578441515672,256,16,92,364
6669,dark,main,20220220,4,0.9903912384022515,249,14,93,356
6669,dark,main,20220220,5,0.989511840476074,280,14,81,375
6669,dark,main,20220220,6,0.9907839803996463,247,13,113,373
6669,dark,main,20220220,7,0.9834470263199445,220,16,92,328
6669,dark,main,20220220,8,0.988262428044629,292,14,75,381
6669,dark,main,20220220,9,0.9899809641175923,285,11,91,387
5473,dark,main,20220220,0,0.9931766562435678,283,11,80,374
5473,dark,main,20220220,1,0.9910864699802127,298,14,42,354
5473,dark,main,20220220,2,0.9911363282649476,298,13,70,381
5473,dark,main,20220220,3,0.9916845147866443,264,17,78,359
5473,dark,main,20220220,4,0.98743527596955,267,12,79,358
5473,dark,main,20220220,5,0.9950640334473202,258,12,86,356
5473,dark,main,20220220,6,0.9897095542392925,268,18,85,371
5473,dark,main,20220220,7,0.9928201031851005,233,14,74,321
5473,dark,main,20220220,8,0.9933490242291386,281,12,89,382
5473,dark,main,20220220,9,0.9897262737683262,293,12,76,381
3496,dark,main,20220220,0,0.9865821901450367,293,13,89,395
3496,dark,main,20220220,1,0.9911855855781541,267,12,73,352
3496,dark,main,20220220,2,0.9913774401978055,288,22,76,386
3496,dark,main,20220220,3,0.9919183823822028,254,19,76,349
3496,dark,main,20220220,4,0.9827162946568841,239,14,82,335
3496,dark,main,20220220,5,0.9897506179372725,284,13,93,390
3496,dark,main,20220220,6,0.9909068019065957,266,16,103,385
3496,dark,main,20220220,7,0.9872768627600194,219,16,94,329
3496,dark,main,20220220,8,0.9907085439419259,261,15,97,373
3496,dark,main,20220220,9,0.9877664148520124,281,16,89,386
24630,bright,main,20220220,0,0.994759225965571,154,281,5,440
24630,bright,main,20220220,1,0.989079272821008,183,212,5,400
24630,bright,main,20220220,2,0.9954722229313806,197,232,2,431
24630,bright,main,20220220,3,0.9904423591038867,208,193,3,404
24630,bright,main,20220220,4,0.9919575827833363,254,141,1,396
24630,bright,main,20220220,5,0.9959663082989479,263,147,6,416
24630,bright,main,20220220,6,0.9873067493819749,218,208,4,430
24630,bright,main,20220220,7,0.9906750528091615,161,216,2,379
24630,bright,main,20220220,8,0.9977208914473572,145,275,4,424
24630,bright,main,20220220,9,0.9938728574464226,197,235,4,436
6683,dark,main,20220220,0,0.9954479891608182,307,14,56,377
6683,dark,main,20220220,1,0.985986963546518,298,14,48,360
6683,dark,main,20220220,2,0.9928883523322258,309,17,54,380
6683,dark,main,20220220,3,0.9820391836913644,291,16,36,343
6683,dark,main,20220220,4,0.9897685203947698,269,13,56,338
6683,dark,main,20220220,5,0.9891970179959885,302,14,53,369
6683,dark,main,20220220,6,0.9885917122431482,290,18,67,375
6683,dark,main,20220220,7,0.9952623060194438,277,12,48,337
6683,dark,main,20220220,8,0.9928953640741035,308,13,52,373
6683,dark,main,20220220,9,0.9926515688161803,305,14,51,370
21820,bright,main,20220220,0,0.9895813160601152,370,56,5,431
21820,bright,main,20220220,1,0.9917929687605723,320,73,7,400
21820,bright,main,20220220,2,0.9947463739440323,275,147,2,424
21820,bright,main,20220220,3,0.9909048138257688,255,124,6,385
21820,bright,main,20220220,4,0.9870410726146562,249,133,2,384
21820,bright,main,20220220,5,0.983303686511667,284,124,1,409
21820,bright,main,20220220,6,0.995182874455883,345,73,2,420
21820,bright,main,20220220,7,0.9903843056650447,258,100,5,363
21820,bright,main,20220220,8,0.9927196145510606,332,71,5,408
21820,bright,main,20220220,9,0.9939148427562693,291,124,2,417
5089,dark,main,20220220,0,0.9945675347776031,299,14,92,405
5089,dark,main,20220220,1,0.9838658591808666,275,11,65,351
5089,dark,main,20220220,2,0.9870006343144311,254,15,112,381
5089,dark,main,20220220,3,0.9931029508788838,274,15,81,370
5089,dark,main,20220220,4,0.9878352773984654,263,13,81,357
5089,dark,main,20220220,5,0.9922626846144766,263,17,89,369
5089,dark,main,20220220,6,0.9943286003403419,290,14,88,392
5089,dark,main,20220220,7,0.9956291833670863,254,17,66,337
5089,dark,main,20220220,8,0.9868113681453228,284,15,82,381
5089,dark,main,20220220,9,0.9941601616964894,265,14,100,379
20381,bright,main,20220221,0,0.9940958856084501,303,97,5,405
20381,bright,main,20220221,1,0.9930590418656356,296,71,4,371
20381,bright,main,20220221,2,0.9942728645038166,342,64,4,410
20381,bright,main,20220221,3,0.9932646581428556,319,50,2,371
20381,bright,main,20220221,4,0.9933779437558138,317,52,11,380
20381,bright,main,20220221,5,0.9959570756172204,311,76,8,395
20381,bright,main,20220221,6,0.9955339430903514,325,66,8,399
20381,bright,main,20220221,7,0.9881584088665932,266,66,4,336
20381,bright,main,20220221,8,0.9884079516820933,300,84,6,390
20381,bright,main,20220221,9,0.9955811359398028,319,79,5,403
23481,bright,main,20220221,0,0.9927284270271949,361,67,3,431
23481,bright,main,20220221,1,0.9929170770871226,307,66,5,378
23481,bright,main,20220221,2,0.9888225185806263,345,71,4,420
23481,bright,main,20220221,3,0.9881335702233093,327,52,6,385
23481,bright,main,20220221,4,0.9936756283654532,304,65,7,376
23481,bright,main,20220221,5,0.9918912442498153,285,94,8,387
23481,bright,main,20220221,6,0.9940211431369377,293,104,5,402
23481,bright,main,20220221,7,0.9848726581795852,263,81,3,347
23481,bright,main,20220221,8,0.9927976787554654,279,121,6,406
23481,bright,main,20220221,9,0.9899118550487538,321,94,2,417
22920,bright,main,20220221,0,0.9955876826732466,321,114,5,440
22920,bright,main,20220221,1,0.9910506857648385,294,96,1,391
22920,bright,main,20220221,2,0.9950332351305111,329,100,5,434
22920,bright,main,20220221,3,0.9917469444154899,294,107,1,402
22920,bright,main,20220221,4,0.9889217624215499,304,81,4,389
22920,bright,main,20220221,5,0.9916295683418808,316,85,5,406
22920,bright,main,20220221,6,0.9860826570375886,339,79,2,420
22920,bright,main,20220221,7,0.9917928789831576,298,67,7,372
22920,bright,main,20220221,8,0.9953358280584923,342,74,4,420
22920,bright,main,20220221,9,0.9950208522005042,324,103,1,428
22505,bright,main,20220221,0,0.9964807511639021,255,186,4,445
22505,bright,main,20220221,1,0.9944340416094369,248,150,3,401
22505,bright,main,20220221,2,0.9866439925184968,291,143,6,440
22505,bright,main,20220221,3,0.9950113831527988,279,120,2,401
22505,bright,main,20220221,4,0.9955968513438368,299,92,6,397
22505,bright,main,20220221,5,0.9945440145795184,316,96,4,416
22505,bright,main,20220221,6,0.991962918044041,331,101,2,434
22505,bright,main,20220221,7,0.9939715958792898,257,117,2,376
22505,bright,main,20220221,8,0.9916658839555405,245,172,4,421
22505,bright,main,20220221,9,0.9931847476034275,267,167,2,436
22335,bright,main,20220221,0,0.991095185878288,262,145,8,415
22335,bright,main,20220221,1,0.9899335099251959,234,151,4,389
22335,bright,main,20220221,2,0.9885615738167346,313,103,6,422
22335,bright,main,20220221,3,0.991800499755072,272,116,3,391
22335,bright,main,20220221,4,0.9930963475546002,267,117,2,386
22335,bright,main,20220221,5,0.9927117443582986,290,105,8,403
22335,bright,main,20220221,6,0.9938037045536591,326,90,2,418
22335,bright,main,20220221,7,0.9909318187650936,234,120,5,359
22335,bright,main,20220221,8,0.993548060778306,263,132,7,402
22335,bright,main,20220221,9,0.9948552894129282,303,108,6,417
20339,bright,main,20220221,0,0.9862900929057552,340,77,4,421
20339,bright,main,20220221,1,0.9879236856397084,291,82,6,379
20339,bright,main,20220221,2,0.9936037970156661,319,86,4,409
20339,bright,main,20220221,3,0.9849284187631128,277,89,5,371
20339,bright,main,20220221,4,0.9903581582602281,309,68,5,382
20339,bright,main,20220221,5,0.9931094734291482,336,58,3,397
20339,bright,main,20220221,6,0.9941660593000808,340,69,4,413
20339,bright,main,20220221,7,0.9891285984638181,289,52,7,348
20339,bright,main,20220221,8,0.9945488167824851,299,92,3,394
20339,bright,main,20220221,9,0.9923218364595067,312,97,4,413
20326,bright,main,20220221,0,0.9964582922816795,345,76,3,424
20326,bright,main,20220221,1,0.9924579445850535,310,69,6,385
20326,bright,main,20220221,2,0.993898768156245,370,53,4,427
20326,bright,main,20220221,3,0.9930075020335488,343,40,7,390
20326,bright,main,20220221,4,0.9862079348308312,302,64,9,375
20326,bright,main,20220221,5,0.9936488523785596,318,74,8,400
20326,bright,main,20220221,6,0.9942251895434744,354,60,4,418
20326,bright,main,20220221,7,0.9848310865100879,306,52,1,359
20326,bright,main,20220221,8,0.9888559588083192,324,71,4,399
20326,bright,main,20220221,9,0.994987096522633,355,56,2,413
20321,bright,main,20220221,0,0.9937118925422496,343,79,5,427
20321,bright,main,20220221,1,0.988362537224785,279,98,3,380
20321,bright,main,20220221,2,0.9914645856361931,340,71,7,418
20321,bright,main,20220221,3,0.9932991619340358,323,52,3,378
20321,bright,main,20220221,4,0.9946221671285139,314,54,7,375
20321,bright,main,20220221,5,0.9911517984378121,338,51,4,393
20321,bright,main,20220221,6,0.9886847385980448,338,67,2,407
20321,bright,main,20220221,7,0.9929332844514575,280,67,0,347
20321,bright,main,20220221,8,0.9854721461150386,326,68,2,396
20321,bright,main,20220221,9,0.9870235056882507,367,51,4,422
20332,bright,main,20220221,0,0.9930680863196416,370,51,3,424
20332,bright,main,20220221,1,0.9938428613273309,338,46,0,384
20332,bright,main,20220221,2,0.9902680555948324,355,61,4,420
20332,bright,main,20220221,3,0.98914898626116,322,50,5,377
20332,bright,main,20220221,4,0.9877914608924432,318,61,2,381
20332,bright,main,20220221,5,0.9909008119501082,321,77,2,400
20332,bright,main,20220221,6,0.9914308077992953,340,64,1,405
20332,bright,main,20220221,7,0.9923433937583725,305,46,7,358
20332,bright,main,20220221,8,0.988805467963259,327,62,8,397
20332,bright,main,20220221,9,0.994198107107355,336,71,4,411
23073,bright,main,20220221,0,0.9920190262923054,246,198,3,447
23073,bright,main,20220221,1,0.9889317953816357,255,152,1,408
23073,bright,main,20220221,2,0.9926230592699437,232,202,2,436
23073,bright,main,20220221,3,0.9902498084117762,176,229,0,405
23073,bright,main,20220221,4,0.9924548509226472,154,245,2,401
23073,bright,main,20220221,5,0.9876249175448458,123,294,1,418
23073,bright,main,20220221,6,0.9934375852808772,108,322,3,433
23073,bright,main,20220221,7,0.994465729667299,114,262,2,378
23073,bright,main,20220221,8,0.9921787428337107,142,283,3,428
23073,bright,main,20220221,9,0.995411544310769,171,266,1,438
20316,bright,main,20220221,0,0.9962325331645248,365,60,4,429
20316,bright,main,20220221,1,0.9896953366328032,327,49,7,383
20316,bright,main,20220221,2,0.9927324049610513,318,94,7,419
20316,bright,main,20220221,3,0.9971931072113914,266,107,5,378
20316,bright,main,20220221,4,0.9953561186199427,273,96,9,378
20316,bright,main,20220221,5,0.9937927192309988,332,60,2,394
20316,bright,main,20220221,6,0.9895724862095534,355,56,7,418
20316,bright,main,20220221,7,0.9881745140284495,292,56,6,354
20316,bright,main,20220221,8,0.9928305611266064,327,67,7,401
20316,bright,main,20220221,9,0.9879441105654045,348,70,6,424
9978,dark,main,20220221,0,0.9861246431604445,291,15,87,393
9978,dark,main,20220221,1,0.9921989049531473,244,19,83,346
9978,dark,main,20220221,2,0.9896086612990956,269,12,111,392
9978,dark,main,20220221,3,0.9942652584137862,279,12,72,363
9978,dark,main,20220221,4,0.9875887582578604,297,12,54,363
9978,dark,main,20220221,5,0.9956481084568218,307,13,58,378
9978,dark,main,20220221,6,0.9955423365543464,307,11,67,385
9978,dark,main,20220221,7,0.9912934262869241,282,12,40,334
9978,dark,main,20220221,8,0.994714812780136,297,13,65,375
9978,dark,main,20220221,9,0.9852084939063906,296,13,84,393
25878,bright,main,20220221,0,0.9922574492746175,337,90,5,432
25878,bright,main,20220221,1,0.9915449807212235,317,72,5,394
25878,bright,main,20220221,2,0.9941412276461548,326,91,1,418
25878,bright,main,20220221,3,0.9952814784390727,243,127,5,375
25878,bright,main,20220221,4,0.9886881060232565,230,144,4,378
25878,bright,main,20220221,5,0.991881833371255,284,110,4,398
25878,bright,main,20220221,6,0.986938787613683,291,113,10,414
25878,bright,main,20220221,7,0.9957902683093023,277,71,2,350
25878,bright,main,20220221,8,0.994541242495673,277,122,2,401
25878,bright,main,20220221,9,0.994106057069004,275,130,7,412
8454,dark,main,20220221,0,0.9910162314766151,327,13,69,409
8454,dark,main,20220221,1,0.99252603677718,285,13,66,364
8454,dark,main,20220221,2,0.9951121266697656,304,16,72,392
8454,dark,main,20220221,3,0.989897688193838,271,18,76,365
8454,dark,main,20220221,4,0.9932781557317465,283,13,74,370
8454,dark,main,20220221,5,0.9970667606643795,314,12,49,375
8454,dark,main,20220221,6,0.9907604738665825,323,14,58,395
8454,dark,main,20220221,7,0.98848072740438,261,19,56,336
8454,dark,main,20220221,8,0.9872920360308292,325,12,50,387
8454,dark,main,20220221,9,0.9923191150227302,311,11,63,385
22926,bright,main,20220221,0,0.9935160697133599,336,99,2,437
22926,bright,main,20220221,1,0.9854788359905022,315,75,2,392
22926,bright,main,20220221,2,0.989861660669734,365,62,7,434
22926,bright,main,20220221,3,0.9908705947137031,313,81,2,396
22926,bright,main,20220221,4,0.9914516851386251,305,82,2,389
22926,bright,main,20220221,5,0.9901782351259161,329,81,1,411
22926,bright,main,20220221,6,0.9872491388744887,357,65,5,427
22926,bright,main,20220221,7,0.988364089146656,298,70,2,370
22926,bright,main,20220221,8,0.9895689059241038,338,75,2,415
22926,bright,main,20220221,9,0.993893716256982,325,99,5,429
23399,bright,main,20220221,0,0.9950070486433229,317,115,3,435
23399,bright,main,20220221,1,0.9908542704617883,302,94,3,399
23399,bright,main,20220221,2,0.9939789076986416,313,113,8,434
23399,bright,main,20220221,3,0.9893476150089509,272,123,3,398
23399,bright,main,20220221,4,0.9877388953211772,332,54,1,387
23399,bright,main,20220221,5,0.9936544292016616,309,89,7,405
23399,bright,main,20220221,6,0.9939574048438357,324,105,2,431
23399,bright,main,20220221,7,0.9952749653638934,305,68,1,374
23399,bright,main,20220221,8,0.9920561727982059,332,76,6,414
23399,bright,main,20220221,9,0.9931238215094362,333,96,0,429
24285,bright,main,20220221,0,0.9913634049585324,257,158,7,422
24285,bright,main,20220221,1,0.9887180946322595,231,158,4,393
24285,bright,main,20220221,2,0.9914319925192169,255,155,8,418
24285,bright,main,20220221,3,0.9928274872955097,279,98,3,380
24285,bright,main,20220221,4,0.9885208508463991,254,114,11,379
24285,bright,main,20220221,5,0.9917060068353262,259,120,4,383
24285,bright,main,20220221,6,0.9921278786781342,274,137,7,418
24285,bright,main,20220221,7,0.987503012241339,260,97,3,360
24285,bright,main,20220221,8,0.9928254969907206,263,140,0,403
24285,bright,main,20220221,9,0.9943579869937827,263,148,8,419
24300,bright,main,20220221,0,0.9949194120564686,315,99,6,420
24300,bright,main,20220221,1,0.9909605379479015,263,122,2,387
24300,bright,main,20220221,2,0.9959806835531919,272,134,8,414
24300,bright,main,20220221,3,0.993746646324512,296,86,4,386
24300,bright,main,20220221,4,0.9898098250169035,277,99,6,382
24300,bright,main,20220221,5,0.9911212534920233,287,96,8,391
24300,bright,main,20220221,6,0.9944847151151412,295,114,5,414
24300,bright,main,20220221,7,0.9871801380932397,237,110,5,352
24300,bright,main,20220221,8,0.991587778803428,296,100,8,404
24300,bright,main,20220221,9,0.9958531812547219,309,99,5,413
24310,bright,main,20220221,0,0.9919039988884352,317,94,2,413
24310,bright,main,20220221,1,0.986904229688457,276,102,6,384
24310,bright,main,20220221,2,0.9936686203655548,308,108,3,419
24310,bright,main,20220221,3,0.9885272044823256,312,73,4,389
24310,bright,main,20220221,4,0.9938305157546732,300,71,6,377
24310,bright,main,20220221,5,0.9938591120193905,309,79,9,397
24310,bright,main,20220221,6,0.9887203411078772,340,71,3,414
24310,bright,main,20220221,7,0.985013153256208,293,60,4,357
24310,bright,main,20220221,8,0.9934120932925066,328,62,6,396
24310,bright,main,20220221,9,0.9930913686077015,348,70,4,422
24524,bright,main,20220221,0,0.9826096608448184,342,87,7,436
24524,bright,main,20220221,1,0.9959436409774775,314,66,3,383
24524,bright,main,20220221,2,0.9874535347945392,313,100,4,417
24524,bright,main,20220221,3,0.9928903833344118,318,65,3,386
24524,bright,main,20220221,4,0.9903402237060792,286,88,2,376
24524,bright,main,20220221,5,0.9898109055702289,290,95,4,389
24524,bright,main,20220221,6,0.9910097368547224,317,84,3,404
24524,bright,main,20220221,7,0.9882778197196398,261,89,2,352
24524,bright,main,20220221,8,0.9884487859762222,335,73,2,410
24524,bright,main,20220221,9,0.9932944509812756,354,66,5,425
25062,bright,main,20220221,0,0.9947246135478629,357,63,6,426
25062,bright,main,20220221,1,0.9939609109082006,321,64,6,391
25062,bright,main,20220221,2,0.9947914633367705,353,58,4,415
25062,bright,main,20220221,3,0.9879571904224638,300,72,4,376
25062,bright,main,20220221,4,0.9911025479883077,295,64,6,365
25062,bright,main,20220221,5,0.9898739290118722,333,52,6,391
25062,bright,main,20220221,6,0.9893523628796527,348,62,4,414
25062,bright,main,20220221,7,0.9895765564983484,310,43,3,356
25062,bright,main,20220221,8,0.9969660749760393,348,57,4,409
25062,bright,main,20220221,9,0.9858110065643154,352,55,3,410
25872,bright,main,20220221,0,0.9929863346566324,357,65,4,426
25872,bright,main,20220221,1,0.9917561377783365,294,75,2,371
25872,bright,main,20220221,2,0.9919698101447803,314,82,4,400
25872,bright,main,20220221,3,0.9926435404865521,282,76,2,360
25872,bright,main,20220221,4,0.9929516768650751,319,62,1,382
25872,bright,main,20220221,5,0.9928957928926218,336,49,10,395
25872,bright,main,20220221,6,0.98992714669323,349,55,5,409
25872,bright,main,20220221,7,0.991553451469072,309,45,3,357
25872,bright,main,20220221,8,0.9963770938077043,334,56,5,395
25872,bright,main,20220221,9,0.9941473241804938,355,53,5,413
25871,bright,main,20220221,0,0.9947005866382426,343,73,4,420
25871,bright,main,20220221,1,0.9954636928039662,297,68,5,370
25871,bright,main,20220221,2,0.99625574101456,319,80,7,406
25871,bright,main,20220221,3,0.9918899664372218,338,45,5,388
25871,bright,main,20220221,4,0.9868306285433575,314,58,6,378
25871,bright,main,20220221,5,0.9892182419956065,332,54,8,394
25871,bright,main,20220221,6,0.98895453136344,355,50,5,410
25871,bright,main,20220221,7,0.9958324781523206,302,54,2,358
25871,bright,main,20220221,8,0.9924178723283233,352,44,4,400
25871,bright,main,20220221,9,0.9875027846159717,324,79,3,406
20350,bright,main,20220221,0,0.9884703810658946,333,77,6,416
20350,bright,main,20220221,1,0.9923458296607954,325,60,3,388
20350,bright,main,20220221,2,0.994177722011899,333,75,6,414
20350,bright,main,20220221,3,0.9902609974550496,314,59,5,378
20350,bright,main,20220221,4,0.9925121421517268,315,67,2,384
20350,bright,main,20220221,5,0.9918381456516584,307,73,6,386
20350,bright,main,20220221,6,0.9938476903455378,291,101,9,401
20350,bright,main,20220221,7,0.9898826826563888,247,90,3,340
20350,bright,main,20220221,8,0.9925117584164443,294,88,5,387
20350,bright,main,20220221,9,0.9934938509858378,313,83,4,400
26056,bright,main,20220221,0,0.9928466181329352,352,93,3,448
26056,bright,main,20220221,1,0.9794111086572066,313,84,5,402
26056,bright,main,20220221,2,0.99250935716333,282,156,3,441
26056,bright,main,20220221,3,0.9928425664274528,235,160,5,400
26056,bright,main,20220221,4,0.9943211060695555,295,105,1,401
26056,bright,main,20220221,5,0.9904686793658606,275,138,4,417
26056,bright,main,20220221,6,0.9935346163275011,297,132,2,431
26056,bright,main,20220221,7,0.9946874404997654,259,115,1,375
26056,bright,main,20220221,8,0.9906123382735558,329,90,3,422
26056,bright,main,20220221,9,0.9848254241991025,333,98,4,435
6918,dark,main,20220221,0,0.987204853635141,201,13,56,270
6918,dark,main,20220221,1,0.9775034794570019,194,10,55,259
6918,dark,main,20220221,2,0.9899575393742472,195,14,60,269
6918,dark,main,20220221,3,0.9940335762742886,218,12,46,276
6918,dark,main,20220221,4,0.9918320918574508,209,9,32,250
6918,dark,main,20220221,5,0.9931478702395479,221,10,38,269
6918,dark,main,20220221,6,0.9891877110206323,233,12,32,277
6918,dark,main,20220221,7,0.9841471865676351,180,12,46,238
6918,dark,main,20220221,8,0.9921223975108734,225,11,43,279
6918,dark,main,20220221,9,0.9841888424558098,216,12,57,285
40992,backup,main,20220221,0,0.9920155488628739,6,377,2,385
40992,backup,main,20220221,1,0.990185101066232,2,352,1,355
40992,backup,main,20220221,2,0.9933282389565582,2,388,0,390
40992,backup,main,20220221,3,0.9922433299857154,2,341,1,344
40992,backup,main,20220221,4,0.9884731902528927,7,351,1,359
40992,backup,main,20220221,5,0.9905843098131978,0,358,0,358
40992,backup,main,20220221,6,0.9865284263765693,4,348,2,354
40992,backup,main,20220221,7,0.9907933835393924,4,328,1,333
40992,backup,main,20220221,8,0.9866074186434708,6,347,1,354
40992,backup,main,20220221,9,0.9912855319840619,4,367,1,372
24297,bright,main,20220221,0,0.9829673521657735,295,107,5,407
24297,bright,main,20220221,1,0.9956130590694034,275,98,5,378
24297,bright,main,20220221,2,0.9930009677425894,250,150,6,406
24297,bright,main,20220221,3,0.9886183683246067,272,105,1,378
24297,bright,main,20220221,4,0.9950557407531921,249,121,3,373
24297,bright,main,20220221,5,0.9924063697025288,332,63,4,399
24297,bright,main,20220221,6,0.9926608626835323,346,67,3,416
24297,bright,main,20220221,7,0.9850166533266639,289,67,4,360
24297,bright,main,20220221,8,0.9902142255365317,284,107,7,398
24297,bright,main,20220221,9,0.9948530251874592,332,67,3,402
42735,backup,main,20220221,0,0.9894233205414424,1,403,1,405
42735,backup,main,20220221,1,0.9917770029760031,3,365,1,369
42735,backup,main,20220221,2,0.9929017081781084,7,390,0,397
42735,backup,main,20220221,3,0.9896754702628636,6,362,0,368
42735,backup,main,20220221,4,0.9940524893621238,3,360,0,363
42735,backup,main,20220221,5,0.9930906173481623,2,377,0,379
42735,backup,main,20220221,6,0.9957314058973598,0,384,1,385
42735,backup,main,20220221,7,0.9923995193541951,3,336,0,339
42735,backup,main,20220221,8,0.993000395600993,3,384,3,390
42735,backup,main,20220221,9,0.9899704271819392,6,404,1,411
25907,bright,main,20220221,0,0.9935515481385498,342,79,1,422
25907,bright,main,20220221,1,0.9903068904398346,316,67,5,388
25907,bright,main,20220221,2,0.9951382816035458,325,87,6,418
25907,bright,main,20220221,3,0.9928077891948391,305,72,4,381
25907,bright,main,20220221,4,0.9924659281037734,240,131,2,373
25907,bright,main,20220221,5,0.9963679979978547,233,145,8,386
25907,bright,main,20220221,6,0.9938033648525818,280,116,6,402
25907,bright,main,20220221,7,0.9903254488639984,268,85,1,354
25907,bright,main,20220221,8,0.9928928538115849,318,72,6,396
25907,bright,main,20220221,9,0.9934875902464873,323,94,3,420
26071,bright,main,20220221,0,0.9962026741015758,214,224,4,442
26071,bright,main,20220221,1,0.9916708898687076,219,182,3,404
26071,bright,main,20220221,2,0.9911456915715383,237,140,5,382
26071,bright,main,20220221,3,0.9903985304902743,280,121,2,403
26071,bright,main,20220221,4,0.987616547385265,328,62,6,396
26071,bright,main,20220221,5,0.9946876667002242,344,72,5,421
26071,bright,main,20220221,6,0.9919704587250303,351,78,3,432
26071,bright,main,20220221,7,0.9867542878893725,292,84,2,378
26071,bright,main,20220221,8,0.9934694827050934,313,106,3,422
26071,bright,main,20220221,9,0.9931128267727308,298,138,2,438
23050,bright,main,20220225,0,0.9929544920252388,292,139,3,434
23050,bright,main,20220225,1,0.9920573668326186,266,124,7,397
23050,bright,main,20220225,2,0.9921190168844749,285,136,6,427
23050,bright,main,20220225,3,0.9855393389365407,262,132,8,402
23050,bright,main,20220225,4,0.9910860878107487,218,171,3,392
23050,bright,main,20220225,5,0.9918901118667537,180,232,4,416
23050,bright,main,20220225,6,0.9929832103173939,111,311,4,426
23050,bright,main,20220225,7,0.9926088394951522,147,225,1,373
23050,bright,main,20220225,8,0.991224632291974,190,217,5,412
23050,bright,main,20220225,9,0.9941145683085006,240,185,6,431
23048,bright,main,20220225,0,0.9906013778731229,287,150,6,443
23048,bright,main,20220225,1,0.9929962173351459,281,115,6,402
23048,bright,main,20220225,2,0.9917302316970329,290,135,4,429
23048,bright,main,20220225,3,0.987903916428196,251,142,1,394
23048,bright,main,20220225,4,0.9878672968442422,309,85,3,397
23048,bright,main,20220225,5,0.9897918480377835,294,115,4,413
23048,bright,main,20220225,6,0.9949071189654703,295,131,3,429
23048,bright,main,20220225,7,0.9891649809296887,244,121,6,371
23048,bright,main,20220225,8,0.9953364555759762,293,120,4,417
23048,bright,main,20220225,9,0.9950348980973734,328,101,2,431
11925,dark,main,20220225,0,0.9932727048292532,311,23,67,401
11925,dark,main,20220225,1,0.9902078589870051,310,13,33,356
11925,dark,main,20220225,2,0.9901210147946053,316,13,48,377
11925,dark,main,20220225,3,0.990840486672741,291,15,46,352
11925,dark,main,20220225,4,0.9907835508458825,279,17,39,335
11925,dark,main,20220225,5,0.9949936284814087,298,16,43,357
11925,dark,main,20220225,6,0.9959367835315477,305,16,50,371
11925,dark,main,20220225,7,0.9879482178417787,271,13,36,320
11925,dark,main,20220225,8,0.9918401073368407,293,16,39,348
11925,dark,main,20220225,9,0.9932893245404885,301,15,62,378
11924,dark,main,20220225,0,0.9933843281065385,323,18,39,380
11924,dark,main,20220225,1,0.9919354022993672,282,14,41,337
11924,dark,main,20220225,2,0.9938234620947558,326,17,39,382
11924,dark,main,20220225,3,0.9906326270747503,295,16,38,349
11924,dark,main,20220225,4,0.9912838363415184,298,13,29,340
11924,dark,main,20220225,5,0.9914493598669476,295,11,52,358
11924,dark,main,20220225,6,0.9944138849252478,311,15,42,368
11924,dark,main,20220225,7,0.9869572568640216,275,16,33,324
11924,dark,main,20220225,8,0.9883658820050553,313,17,36,366
11924,dark,main,20220225,9,0.9887607571166472,310,16,43,369
10858,dark,main,20220225,0,0.9865753835791504,334,12,36,382
10858,dark,main,20220225,1,0.9875732904242983,297,11,28,336
10858,dark,main,20220225,2,0.9923464684894773,317,17,41,375
10858,dark,main,20220225,3,0.9921543532404828,306,19,35,360
10858,dark,main,20220225,4,0.991475010234084,287,14,49,350
10858,dark,main,20220225,5,0.9942890752963964,301,14,43,358
10858,dark,main,20220225,6,0.9899283586170632,291,17,43,351
10858,dark,main,20220225,7,0.9855618499891018,277,16,27,320
10858,dark,main,20220225,8,0.9927787326194906,315,16,43,374
10858,dark,main,20220225,9,0.9918596552397668,335,14,33,382
1591,dark,main,20220225,0,0.9859074950677238,320,13,38,371
1591,dark,main,20220225,1,0.994435424017416,279,13,49,341
1591,dark,main,20220225,2,0.9946590842380835,319,14,43,376
1591,dark,main,20220225,3,0.9899478195806549,286,15,38,339
1591,dark,main,20220225,4,0.9815709697366723,283,17,32,332
1591,dark,main,20220225,5,0.9947154705847119,295,13,38,346
1591,dark,main,20220225,6,0.9938608875111832,315,13,43,371
1591,dark,main,20220225,7,0.9891240815471786,289,18,24,331
1591,dark,main,20220225,8,0.9922960574406673,316,14,32,362
1591,dark,main,20220225,9,0.9830721319865028,320,14,36,370
6193,dark,main,20220225,0,0.9888954699780033,334,11,49,394
6193,dark,main,20220225,1,0.9897983019248531,284,18,52,354
6193,dark,main,20220225,2,0.9881757496772561,308,12,65,385
6193,dark,main,20220225,3,0.9873851888625451,258,11,68,337
6193,dark,main,20220225,4,0.9936911767174331,279,16,60,355
6193,dark,main,20220225,5,0.9908597579094929,282,16,58,356
6193,dark,main,20220225,6,0.9909617676492813,312,12,56,380
6193,dark,main,20220225,7,0.9876659442011609,270,13,42,325
6193,dark,main,20220225,8,0.9888669245616382,308,11,47,366
6193,dark,main,20220225,9,0.9953633213472493,320,13,41,374
8919,dark,main,20220225,0,0.989387689391918,301,15,78,394
8919,dark,main,20220225,1,0.996272499054211,258,23,55,336
8919,dark,main,20220225,2,0.989286000726921,291,18,58,367
8919,dark,main,20220225,3,0.9933961413675737,279,15,54,348
8919,dark,main,20220225,4,0.9947242476446181,280,17,49,346
8919,dark,main,20220225,5,0.9949262144428715,278,25,47,350
8919,dark,main,20220225,6,0.9893845023071558,284,12,79,375
8919,dark,main,20220225,7,0.9851141913983925,236,14,54,304
8919,dark,main,20220225,8,0.9911775551749157,281,17,51,349
8919,dark,main,20220225,9,0.9891961939978304,286,14,71,371
7734,dark,main,20220225,0,0.9943712158780569,305,13,48,366
7734,dark,main,20220225,1,0.9857454958223015,287,14,38,339
7734,dark,main,20220225,2,0.9929274265133728,303,15,38,356
7734,dark,main,20220225,3,0.9919666905478387,300,12,38,350
7734,dark,main,20220225,4,0.9844118057773946,277,13,45,335
7734,dark,main,20220225,5,0.9910484018437062,314,14,43,371
7734,dark,main,20220225,6,0.995231249691586,298,16,48,362
7734,dark,main,20220225,7,0.9875578790624406,277,13,45,335
7734,dark,main,20220225,8,0.9924783683580819,303,15,48,366
7734,dark,main,20220225,9,0.9943766092151298,303,16,57,376
11911,dark,main,20220225,0,0.9892645519970922,256,17,51,324
11911,dark,main,20220225,1,0.992076367121005,268,18,36,322
11911,dark,main,20220225,2,0.9930354177562792,309,24,44,377
11911,dark,main,20220225,3,0.9931688540214901,290,16,34,340
11911,dark,main,20220225,4,0.9910847075463569,270,19,52,341
11911,dark,main,20220225,5,0.9930047756362658,303,13,51,367
11911,dark,main,20220225,6,0.993912165500684,332,14,48,394
11911,dark,main,20220225,7,0.9871035966386215,280,16,35,331
11911,dark,main,20220225,8,0.9890952655756649,260,24,39,323
11911,dark,main,20220225,9,0.9945416987100144,271,19,48,338
9310,dark,main,20220225,0,0.9907591941987619,332,16,46,394
9310,dark,main,20220225,1,0.9952540503867184,278,12,60,350
9310,dark,main,20220225,2,0.9914900669594995,321,13,52,386
9310,dark,main,20220225,3,0.9933479409758307,311,10,35,356
9310,dark,main,20220225,4,0.9908598581999951,317,10,34,361
9310,dark,main,20220225,5,0.9917730573827428,291,22,46,359
9310,dark,main,20220225,6,0.9923912885493728,341,13,38,392
9310,dark,main,20220225,7,0.9922672974662025,273,12,39,324
9310,dark,main,20220225,8,0.9762515489527471,303,13,61,377
9310,dark,main,20220225,9,0.9939676241445855,320,16,58,394
7084,dark,main,20220225,0,0.9906013587034992,295,11,57,363
7084,dark,main,20220225,1,0.9903213300366398,307,12,44,363
7084,dark,main,20220225,2,0.9945005418298145,300,15,67,382
7084,dark,main,20220225,3,0.9889660444462212,283,18,51,352
7084,dark,main,20220225,4,0.9933758766873251,291,15,45,351
7084,dark,main,20220225,5,0.9892411057864345,288,18,44,350
7084,dark,main,20220225,6,0.9967891862871969,306,21,39,366
7084,dark,main,20220225,7,0.9943495790984622,270,17,36,323
7084,dark,main,20220225,8,0.994934565411037,294,18,45,357
7084,dark,main,20220225,9,0.992776383019279,319,17,45,381
24797,bright,main,20220225,0,0.990106050567383,230,206,5,441
24797,bright,main,20220225,1,0.98628852413619,233,169,3,405
24797,bright,main,20220225,2,0.9921362951924375,215,213,7,435
24797,bright,main,20220225,3,0.9933342671459658,189,210,2,401
24797,bright,main,20220225,4,0.9906536024305926,191,205,1,397
24797,bright,main,20220225,5,0.9921190613046823,229,187,3,419
24797,bright,main,20220225,6,0.9927434138184105,274,155,1,430
24797,bright,main,20220225,7,0.9951264257395133,247,127,4,378
24797,bright,main,20220225,8,0.9942313287215458,253,166,5,424
24797,bright,main,20220225,9,0.9879773527079494,269,157,6,432
8934,dark,main,20220225,0,0.9891269469298004,305,12,36,353
8934,dark,main,20220225,1,0.9944132821074191,249,18,39,306
8934,dark,main,20220225,2,0.9870506318338784,296,15,36,347
8934,dark,main,20220225,3,0.991928908965112,301,10,30,341
8934,dark,main,20220225,4,0.9873321092965217,283,17,46,346
8934,dark,main,20220225,5,0.9924278277829797,287,14,64,365
8934,dark,main,20220225,6,0.9918753519583448,267,15,76,358
8934,dark,main,20220225,7,0.9883358235534916,254,12,45,311
8934,dark,main,20220225,8,0.9909470786828617,273,12,55,340
8934,dark,main,20220225,9,0.9927517243520962,284,11,52,347
6290,dark,main,20220225,0,0.9936457138479772,249,34,96,379
6290,dark,main,20220225,1,0.9920705890391746,286,13,56,355
6290,dark,main,20220225,2,0.989094649385195,326,15,44,385
6290,dark,main,20220225,3,0.9876800536419729,286,12,56,354
6290,dark,main,20220225,4,0.9895596115653943,289,12,50,351
6290,dark,main,20220225,5,0.9887357622589416,296,14,47,357
6290,dark,main,20220225,6,0.989007299681293,298,12,59,369
6290,dark,main,20220225,7,0.9939925997376411,279,15,28,322
6290,dark,main,20220225,8,0.9928006840358129,274,13,61,348
6290,dark,main,20220225,9,0.9909232210222985,313,14,57,384
5646,dark,main,20220225,0,0.9894049015631594,326,17,36,379
5646,dark,main,20220225,1,0.9906724127230802,294,19,34,347
5646,dark,main,20220225,2,0.9880337281348678,325,22,33,380
5646,dark,main,20220225,3,0.9928653310709366,302,17,34,353
5646,dark,main,20220225,4,0.9874408075982909,283,13,40,336
5646,dark,main,20220225,5,0.9906333186908067,300,13,48,361
5646,dark,main,20220225,6,0.9898947892310273,306,12,41,359
5646,dark,main,20220225,7,0.9899919759178828,258,11,46,315
5646,dark,main,20220225,8,0.9925595313586475,308,16,35,359
5646,dark,main,20220225,9,0.9960922766882581,305,17,41,363
5502,dark,main,20220225,0,0.9910801930794281,325,14,37,376
5502,dark,main,20220225,1,0.994654350836137,283,16,43,342
5502,dark,main,20220225,2,0.9857984654686576,313,19,48,380
5502,dark,main,20220225,3,0.9914294148269008,295,17,42,354
5502,dark,main,20220225,4,0.9880867310131858,291,14,38,343
5502,dark,main,20220225,5,0.991953637198479,307,18,38,363
5502,dark,main,20220225,6,0.9933021003714132,298,14,59,371
5502,dark,main,20220225,7,0.9856326097740409,245,13,47,305
5502,dark,main,20220225,8,0.9858012263380284,317,12,46,375
5502,dark,main,20220225,9,0.9899406625044234,318,18,42,378
5639,dark,main,20220225,0,0.9882542051718133,319,16,33,368
5639,dark,main,20220225,1,0.9869136573240515,298,11,48,357
5639,dark,main,20220225,2,0.9913217930159978,325,20,34,379
5639,dark,main,20220225,3,0.9898274892101573,289,14,35,338
5639,dark,main,20220225,4,0.9852886743899879,279,19,44,342
5639,dark,main,20220225,5,0.9951278941933221,315,14,28,357
5639,dark,main,20220225,6,0.9949435540020176,327,11,42,380
5639,dark,main,20220225,7,0.990914586277665,246,12,53,311
5639,dark,main,20220225,8,0.9834787604667441,296,14,48,358
5639,dark,main,20220225,9,0.9912510048619954,326,17,39,382
11927,dark,main,20220225,0,0.9885335698608688,299,20,56,375
11927,dark,main,20220225,1,0.9873677364905348,277,21,46,344
11927,dark,main,20220225,2,0.9904671013679972,291,18,73,382
11927,dark,main,20220225,3,0.9924878420041626,302,14,56,372
11927,dark,main,20220225,4,0.9929309321686108,281,18,50,349
11927,dark,main,20220225,5,0.9903809903589744,305,16,42,363
11927,dark,main,20220225,6,0.9897666010897865,284,15,55,354
11927,dark,main,20220225,7,0.9861451821284007,255,14,43,312
11927,dark,main,20220225,8,0.9955913421947615,311,15,33,359
11927,dark,main,20220225,9,0.9963386248342596,282,23,50,355
5260,dark,main,20220225,0,0.9919496467588754,299,12,52,363
5260,dark,main,20220225,1,0.9937789392590001,288,14,53,355
5260,dark,main,20220225,2,0.9911413483259834,292,14,48,354
5260,dark,main,20220225,3,0.9933889168547538,250,12,82,344
5260,dark,main,20220225,4,0.9881700128293108,257,13,54,324
5260,dark,main,20220225,5,0.984124147713249,266,11,71,348
5260,dark,main,20220225,6,0.9922345214437748,299,11,41,351
5260,dark,main,20220225,7,0.9902820914474473,252,15,42,309
5260,dark,main,20220225,8,0.9919738862441162,301,12,45,358
5260,dark,main,20220225,9,0.9910482161781099,299,15,41,355
4225,dark,main,20220225,0,0.9920924841374553,287,17,61,365
4225,dark,main,20220225,1,0.9909485916113916,273,17,45,335
4225,dark,main,20220225,2,0.9882057441358886,312,12,48,372
4225,dark,main,20220225,3,0.9909712864803519,266,16,51,333
4225,dark,main,20220225,4,0.988125743327857,259,17,63,339
4225,dark,main,20220225,5,0.9963940257981574,286,13,58,357
4225,dark,main,20220225,6,0.9905068502087988,279,26,56,361
4225,dark,main,20220225,7,0.9894907737019266,264,16,46,326
4225,dark,main,20220225,8,0.9920527829548795,267,25,62,354
4225,dark,main,20220225,9,0.994005800870365,280,18,55,353
2687,dark,main,20220225,0,0.9955601838784999,318,12,37,367
2687,dark,main,20220225,1,0.9939184269912577,267,13,43,323
2687,dark,main,20220225,2,0.9923758001067258,311,14,31,356
2687,dark,main,20220225,3,0.9886759991106996,266,15,46,327
2687,dark,main,20220225,4,0.993854585558724,233,17,73,323
2687,dark,main,20220225,5,0.993169497543374,246,14,68,328
2687,dark,main,20220225,6,0.9916243719355623,282,15,56,353
2687,dark,main,20220225,7,0.9886685254492085,263,16,38,317
2687,dark,main,20220225,8,0.991502613830941,300,13,37,350
2687,dark,main,20220225,9,0.9955253497818646,288,12,51,351
3688,dark,main,20220225,0,0.9937867548939798,291,15,74,380
3688,dark,main,20220225,1,0.9936935293152139,294,15,41,350
3688,dark,main,20220225,2,0.9962938919517518,305,22,53,380
3688,dark,main,20220225,3,0.9919753104352377,282,13,44,339
3688,dark,main,20220225,4,0.9891093766174356,302,11,44,357
3688,dark,main,20220225,5,0.9902957306571614,292,11,61,364
3688,dark,main,20220225,6,0.9935083032621093,308,12,48,368
3688,dark,main,20220225,7,0.9898057883453912,254,11,36,301
3688,dark,main,20220225,8,0.9939105508981335,305,12,52,369
3688,dark,main,20220225,9,0.9889020143909686,323,11,50,384
4414,dark,main,20220225,0,0.9938152141416727,283,12,100,395
4414,dark,main,20220225,1,0.9923654613745524,284,23,56,363
4414,dark,main,20220225,2,0.9875119066089997,304,15,66,385
4414,dark,main,20220225,3,0.9917370469846394,293,12,36,341
4414,dark,main,20220225,4,0.9946478587879716,287,15,44,346
4414,dark,main,20220225,5,0.9936103783339578,294,16,48,358
4414,dark,main,20220225,6,0.9949657769610034,301,14,34,349
4414,dark,main,20220225,7,0.9932034240070483,259,15,47,321
4414,dark,main,20220225,8,0.9909495998224064,296,12,51,359
4414,dark,main,20220225,9,0.9931766666409505,306,14,65,385
2532,dark,main,20220225,0,0.9933253675120158,316,20,53,389
2532,dark,main,20220225,1,0.9884109759019917,285,22,37,344
2532,dark,main,20220225,2,0.9933319776427803,314,24,34,372
2532,dark,main,20220225,3,0.9881519939316903,274,24,51,349
2532,dark,main,20220225,4,0.9954192005394177,291,20,37,348
2532,dark,main,20220225,5,0.9897664600881565,303,20,38,361
2532,dark,main,20220225,6,0.9918702201187944,323,18,41,382
2532,dark,main,20220225,7,0.9921430380348341,253,27,36,316
2532,dark,main,20220225,8,0.9910843764011195,286,30,46,362
2532,dark,main,20220225,9,0.9932606518427379,325,20,38,383
2369,dark,main,20220225,0,0.9858962862915466,307,20,47,374
2369,dark,main,20220225,1,0.9892015897238009,303,23,31,357
2369,dark,main,20220225,2,0.9905303263844647,298,16,48,362
2369,dark,main,20220225,3,0.986552727352672,289,19,36,344
2369,dark,main,20220225,4,0.9814177314885677,276,27,38,341
2369,dark,main,20220225,5,0.9922547377920414,303,25,26,354
2369,dark,main,20220225,6,0.9891510809818699,319,17,42,378
2369,dark,main,20220225,7,0.9910296186096414,259,11,49,319
2369,dark,main,20220225,8,0.9942728593351278,310,16,46,372
2369,dark,main,20220225,9,0.9913208431716701,320,22,38,380
3949,dark,main,20220225,0,0.9937816383223541,306,20,48,374
3949,dark,main,20220225,1,0.9944117595058525,287,24,36,347
3949,dark,main,20220225,2,0.9936775575428033,307,17,52,376
3949,dark,main,20220225,3,0.9919734771003083,286,23,35,344
3949,dark,main,20220225,4,0.9911456582779173,281,14,39,334
3949,dark,main,20220225,5,0.9868002682822273,317,18,37,372
3949,dark,main,20220225,6,0.9882300250337642,310,19,38,367
3949,dark,main,20220225,7,0.9933697667276604,242,16,51,309
3949,dark,main,20220225,8,0.9884677001836423,299,15,36,350
3949,dark,main,20220225,9,0.9922674505388595,311,21,38,370
3697,dark,main,20220225,0,0.9948327291308217,310,11,49,370
3697,dark,main,20220225,1,0.9913164682260698,295,13,33,341
3697,dark,main,20220225,2,0.9883187409021373,321,11,32,364
3697,dark,main,20220225,3,0.986029447425743,298,11,39,348
3697,dark,main,20220225,4,0.9904373375210821,276,19,47,342
3697,dark,main,20220225,5,0.9886212772717639,291,20,47,358
3697,dark,main,20220225,6,0.9872404270869756,325,17,41,383
3697,dark,main,20220225,7,0.9909144721945596,263,14,47,324
3697,dark,main,20220225,8,0.9934157495452502,300,12,45,357
3697,dark,main,20220225,9,0.9885559233940399,298,15,58,371
11489,dark,main,20220225,0,0.9959927161014445,322,13,41,376
11489,dark,main,20220225,1,0.9884537932833031,302,12,31,345
11489,dark,main,20220225,2,0.993212197239693,316,14,48,378
11489,dark,main,20220225,3,0.9868140952060672,297,11,44,352
11489,dark,main,20220225,4,0.9972828646999299,283,12,45,340
11489,dark,main,20220225,5,0.9977178849339488,314,14,35,363
11489,dark,main,20220225,6,0.9936223091583725,322,12,38,372
11489,dark,main,20220225,7,0.9913496369871982,261,11,38,310
11489,dark,main,20220225,8,0.9952621415695478,300,12,55,367
11489,dark,main,20220225,9,0.987925705271122,323,12,43,378
3014,dark,main,20220225,0,0.9947345184834034,334,12,45,391
3014,dark,main,20220225,1,0.9884882986910589,290,15,36,341
3014,dark,main,20220225,2,0.9920725540183065,333,18,37,388
3014,dark,main,20220225,3,0.9948006266696369,302,15,33,350
3014,dark,main,20220225,4,0.9914048113557553,276,13,55,344
3014,dark,main,20220225,5,0.9846794135862937,289,11,52,352
3014,dark,main,20220225,6,0.9917370620055681,311,14,45,370
3014,dark,main,20220225,7,0.979690587421633,264,13,52,329
3014,dark,main,20220225,8,0.9882274506359958,294,21,46,361
3014,dark,main,20220225,9,0.9962855357823109,310,15,48,373
2517,dark,main,20220226,0,0.9876171506907174,329,14,38,381
2517,dark,main,20220226,1,0.9885245158279994,295,15,44,354
2517,dark,main,20220226,2,0.9943559752197907,321,14,48,383
2517,dark,main,20220226,3,0.9900196467500858,306,16,34,356
2517,dark,main,20220226,4,0.9951811540957558,278,15,47,340
2517,dark,main,20220226,5,0.9930220695856393,308,13,50,371
2517,dark,main,20220226,6,0.9948068609982236,304,15,61,380
2517,dark,main,20220226,7,0.9910104362740547,271,13,55,339
2517,dark,main,20220226,8,0.9952519302676393,289,15,54,358
2517,dark,main,20220226,9,0.9938711986189236,292,17,54,363
3150,dark,main,20220226,0,0.9963747070334835,303,15,55,373
3150,dark,main,20220226,1,0.9847001728315473,293,14,49,356
3150,dark,main,20220226,2,0.9920824701534642,315,25,56,396
3150,dark,main,20220226,3,0.993452118178469,288,15,53,356
3150,dark,main,20220226,4,0.9886309456235826,288,14,44,346
3150,dark,main,20220226,5,0.9976680832048286,301,11,41,353
3150,dark,main,20220226,6,0.9924658215366453,299,14,51,364
3150,dark,main,20220226,7,0.9911721506639888,270,12,44,326
3150,dark,main,20220226,8,0.9856677353174966,292,15,65,372
3150,dark,main,20220226,9,0.9927027463431449,293,14,73,380
3012,dark,main,20220226,0,0.9877634227008211,305,17,67,389
3012,dark,main,20220226,1,0.9915010374359547,299,15,48,362
3012,dark,main,20220226,2,0.9832163596551846,290,14,68,372
3012,dark,main,20220226,3,0.9894471199617817,271,15,73,359
3012,dark,main,20220226,4,0.9927830626189142,250,15,75,340
3012,dark,main,20220226,5,0.9814667882223547,276,14,73,363
3012,dark,main,20220226,6,0.9910387038838848,275,14,95,384
3012,dark,main,20220226,7,0.9826749339137034,238,12,73,323
3012,dark,main,20220226,8,0.98867622704487,263,17,86,366
3012,dark,main,20220226,9,0.9903630496020298,309,12,49,370
2513,dark,main,20220226,0,0.9864329760729077,310,14,55,379
2513,dark,main,20220226,1,0.9903017485301294,284,14,52,350
2513,dark,main,20220226,2,0.9884800594528936,310,16,55,381
2513,dark,main,20220226,3,0.9850261610347278,300,11,55,366
2513,dark,main,20220226,4,0.9945257534617983,286,14,53,353
2513,dark,main,20220226,5,0.9941432053792554,298,12,55,365
2513,dark,main,20220226,6,0.9943229858982433,287,14,72,373
2513,dark,main,20220226,7,0.994008221140312,274,15,41,330
2513,dark,main,20220226,8,0.9962575432170818,306,12,62,380
2513,dark,main,20220226,9,0.9859022425682901,324,13,41,378
3934,dark,main,20220226,0,0.9901246479489203,334,12,54,400
3934,dark,main,20220226,1,0.9959925222013526,292,17,49,358
3934,dark,main,20220226,2,0.9913966466778055,331,13,50,394
3934,dark,main,20220226,3,0.9899510459027496,291,10,45,346
3934,dark,main,20220226,4,0.9916045336631819,297,14,39,350
3934,dark,main,20220226,5,0.994558505439031,305,11,44,360
3934,dark,main,20220226,6,0.9922094758971693,330,14,47,391
3934,dark,main,20220226,7,0.9889610733635572,259,16,60,335
3934,dark,main,20220226,8,0.992627776242333,319,17,45,381
3934,dark,main,20220226,9,0.9919482572738944,328,14,44,386
3692,dark,main,20220226,0,0.9947967497071706,295,13,48,356
3692,dark,main,20220226,1,0.9842184942457117,251,22,65,338
3692,dark,main,20220226,2,0.989098070476375,289,14,78,381
3692,dark,main,20220226,3,0.9951363012702223,236,17,86,339
3692,dark,main,20220226,4,0.9917288421608964,241,16,85,342
3692,dark,main,20220226,5,0.984559245361878,247,22,84,353
3692,dark,main,20220226,6,0.9925136188473185,257,21,105,383
3692,dark,main,20220226,7,0.9949766702025472,215,18,87,320
3692,dark,main,20220226,8,0.9845585615786799,277,19,55,351
3692,dark,main,20220226,9,0.9950654969839433,312,13,61,386
1500,dark,main,20220226,0,0.9962379786482426,308,17,71,396
1500,dark,main,20220226,1,0.99498285960598,274,12,45,331
1500,dark,main,20220226,2,0.9951068120939779,306,13,49,368
1500,dark,main,20220226,3,0.9906805990394753,289,17,55,361
1500,dark,main,20220226,4,0.9906213815762536,259,14,70,343
1500,dark,main,20220226,5,0.9919748042265214,287,14,64,365
1500,dark,main,20220226,6,0.9913348677073163,284,12,82,378
1500,dark,main,20220226,7,0.9884192170135279,242,14,85,341
1500,dark,main,20220226,8,0.9932475518302404,263,17,97,377
1500,dark,main,20220226,9,0.9912974730175829,288,16,88,392
2384,dark,main,20220226,0,0.9899450980391518,316,22,45,383
2384,dark,main,20220226,1,0.984731517467674,289,23,42,354
2384,dark,main,20220226,2,0.9931480559968376,315,31,32,378
2384,dark,main,20220226,3,0.9922092749296638,281,19,42,342
2384,dark,main,20220226,4,0.9933424007996536,287,17,47,351
2384,dark,main,20220226,5,0.9926690528967421,293,13,54,360
2384,dark,main,20220226,6,0.9914047467105292,307,15,52,374
2384,dark,main,20220226,7,0.9931869894354189,274,14,42,330
2384,dark,main,20220226,8,0.994409548758769,309,25,39,373
2384,dark,main,20220226,9,0.9873568231076864,310,13,51,374
2689,dark,main,20220226,0,0.994051160387834,320,12,42,374
2689,dark,main,20220226,1,0.9875794832676985,297,10,34,341
2689,dark,main,20220226,2,0.9912055190386148,307,16,49,372
2689,dark,main,20220226,3,0.9907502863387193,280,11,33,324
2689,dark,main,20220226,4,0.9946479260240567,284,13,32,329
2689,dark,main,20220226,5,0.9851559108254446,300,15,30,345
2689,dark,main,20220226,6,0.9896619600510478,286,15,51,352
2689,dark,main,20220226,7,0.9885051792337449,260,13,35,308
2689,dark,main,20220226,8,0.9915705593579683,287,17,44,348
2689,dark,main,20220226,9,0.9961511560614481,317,15,49,381
4245,dark,main,20220226,0,0.9933326704246086,311,15,37,363
4245,dark,main,20220226,1,0.9923933827119543,242,16,56,314
4245,dark,main,20220226,2,0.9850347754712633,283,12,60,355
4245,dark,main,20220226,3,0.9803508939558483,277,15,44,336
4245,dark,main,20220226,4,0.9913024821727858,255,21,48,324
4245,dark,main,20220226,5,0.9916386163690302,282,15,49,346
4245,dark,main,20220226,6,0.9862743958110194,302,13,36,351
4245,dark,main,20220226,7,0.9917323147405162,257,12,32,301
4245,dark,main,20220226,8,0.9865965164955117,281,14,33,328
4245,dark,main,20220226,9,0.9956005890842498,278,18,62,358
2139,dark,main,20220226,0,0.9958479996093063,331,12,45,388
2139,dark,main,20220226,1,0.9856117463278965,299,16,36,351
2139,dark,main,20220226,2,0.9883972477259888,328,14,42,384
2139,dark,main,20220226,3,0.9903995020518583,303,12,39,354
2139,dark,main,20220226,4,0.9866823364675147,283,13,44,340
2139,dark,main,20220226,5,0.988929138511484,273,20,73,366
2139,dark,main,20220226,6,0.9909630027429572,278,15,80,373
2139,dark,main,20220226,7,0.9916242047002247,270,15,53,338
2139,dark,main,20220226,8,0.9907018131845884,303,13,44,360
2139,dark,main,20220226,9,0.9932769020804704,296,15,62,373
4410,dark,main,20220226,0,0.9952012185738491,309,11,72,392
4410,dark,main,20220226,1,0.9885925878123428,279,13,50,342
4410,dark,main,20220226,2,0.9915869714512319,314,13,47,374
4410,dark,main,20220226,3,0.9897065033238999,301,13,42,356
4410,dark,main,20220226,4,0.9944231176536014,278,12,45,335
4410,dark,main,20220226,5,0.9945005451131622,287,21,50,358
4410,dark,main,20220226,6,0.9924921105892767,313,17,30,360
4410,dark,main,20220226,7,0.994762266742468,291,17,22,330
4410,dark,main,20220226,8,0.9924900227000673,325,12,26,363
4410,dark,main,20220226,9,0.9903961546020157,333,13,42,388
3977,dark,main,20220226,0,0.9841284761958892,300,13,69,382
3977,dark,main,20220226,1,0.9936402627228479,292,11,47,350
3977,dark,main,20220226,2,0.9869485343004383,324,13,34,371
3977,dark,main,20220226,3,0.9905455858487258,287,15,55,357
3977,dark,main,20220226,4,0.989742147727099,294,15,49,358
3977,dark,main,20220226,5,0.991056473889707,286,12,73,371
3977,dark,main,20220226,6,0.9923120407568977,258,22,101,381
3977,dark,main,20220226,7,0.9860901933549783,270,12,45,327
3977,dark,main,20220226,8,0.9923412723771483,299,15,52,366
3977,dark,main,20220226,9,0.9915877173587417,296,19,66,381
10189,dark,main,20220226,0,0.9919400365252821,283,20,85,388
10189,dark,main,20220226,1,0.9923248249277161,264,12,79,355
10189,dark,main,20220226,2,0.9929427923692883,292,15,85,392
10189,dark,main,20220226,3,0.988150320670487,281,21,53,355
10189,dark,main,20220226,4,0.9834802716538769,265,16,70,351
10189,dark,main,20220226,5,0.9912760140639307,279,20,70,369
10189,dark,main,20220226,6,0.9893508789472545,311,16,59,386
10189,dark,main,20220226,7,0.9922879859072522,276,15,45,336
10189,dark,main,20220226,8,0.989693115848348,262,20,92,374
10189,dark,main,20220226,9,0.992249217658815,297,14,82,393
8644,dark,main,20220226,0,0.9900790165239436,325,16,32,373
8644,dark,main,20220226,1,0.9896514948829975,288,14,41,343
8644,dark,main,20220226,2,0.9877369957282608,340,13,30,383
8644,dark,main,20220226,3,0.9892903002955951,297,16,45,358
8644,dark,main,20220226,4,0.9959947865572968,277,12,53,342
8644,dark,main,20220226,5,0.9906734904075625,297,12,61,370
8644,dark,main,20220226,6,0.996469517312879,302,14,69,385
8644,dark,main,20220226,7,0.982790440834435,279,11,48,338
8644,dark,main,20220226,8,0.991880583075073,308,12,51,371
8644,dark,main,20220226,9,0.9897952732142622,325,11,30,366
9247,dark,main,20220226,0,0.9899719652360617,307,15,62,384
9247,dark,main,20220226,1,0.9831218876985602,284,13,51,348
9247,dark,main,20220226,2,0.9898522657161012,291,13,86,390
9247,dark,main,20220226,3,0.9962192678391011,255,15,75,345
9247,dark,main,20220226,4,0.9914659346494687,262,17,82,361
9247,dark,main,20220226,5,0.9857314509655171,261,18,91,370
9247,dark,main,20220226,6,0.991533860269996,303,12,63,378
9247,dark,main,20220226,7,0.993494560702675,283,11,44,338
9247,dark,main,20220226,8,0.9926916612178959,325,13,42,380
9247,dark,main,20220226,9,0.9933370356491567,303,11,67,381
11918,dark,main,20220226,0,0.9868057000366979,315,18,55,388
11918,dark,main,20220226,1,0.9897991016394602,288,15,43,346
11918,dark,main,20220226,2,0.9941674100026565,344,13,33,390
11918,dark,main,20220226,3,0.9882660175439915,301,11,37,349
11918,dark,main,20220226,4,0.9902678965489012,291,11,48,350
11918,dark,main,20220226,5,0.9907982361823476,293,14,61,368
11918,dark,main,20220226,6,0.9940693745996536,298,13,60,371
11918,dark,main,20220226,7,0.992426168914429,267,13,50,330
11918,dark,main,20220226,8,0.9940872707134397,308,15,54,377
11918,dark,main,20220226,9,0.990603927754957,312,15,58,385
1484,dark,main,20220226,0,0.9944066475168988,318,15,49,382
1484,dark,main,20220226,1,0.9978801362531028,301,11,49,361
1484,dark,main,20220226,2,0.9908361256922508,332,11,51,394
1484,dark,main,20220226,3,0.9891583646377047,279,14,67,360
1484,dark,main,20220226,4,0.9888336516890748,266,9,75,350
1484,dark,main,20220226,5,0.9894217660048863,307,16,46,369
1484,dark,main,20220226,6,0.9961787043265314,310,13,72,395
1484,dark,main,20220226,7,0.9959493829586941,273,11,48,332
1484,dark,main,20220226,8,0.9904515520168444,297,16,65,378
1484,dark,main,20220226,9,0.9931526636315727,306,14,52,372
11488,dark,main,20220226,0,0.9894061410588185,314,15,61,390
11488,dark,main,20220226,1,0.9912605991773348,269,17,50,336
11488,dark,main,20220226,2,0.9926829849448094,309,15,53,377
11488,dark,main,20220226,3,0.9878207495258878,268,15,66,349
11488,dark,main,20220226,4,0.9876146375345745,264,10,67,341
11488,dark,main,20220226,5,0.9867055256243411,229,20,104,353
11488,dark,main,20220226,6,0.992625625300483,261,20,87,368
11488,dark,main,20220226,7,0.988941594071377,237,13,61,311
11488,dark,main,20220226,8,0.9905454272463696,292,15,61,368
11488,dark,main,20220226,9,0.9879098699902762,321,12,35,368
23051,bright,main,20220226,0,0.9965965690558836,284,151,3,438
23051,bright,main,20220226,1,0.99205592213713,285,107,3,395
23051,bright,main,20220226,2,0.9911645970326634,348,82,2,432
23051,bright,main,20220226,3,0.9959028145266254,272,127,0,399
23051,bright,main,20220226,4,0.9930414587756264,275,118,3,396
23051,bright,main,20220226,5,0.9969479002359383,300,111,5,416
23051,bright,main,20220226,6,0.9875763448062127,254,167,5,426
23051,bright,main,20220226,7,0.9945211515419573,185,190,1,376
23051,bright,main,20220226,8,0.9935236112576813,206,199,2,407
23051,bright,main,20220226,9,0.9939603907159217,250,171,5,426
24829,bright,main,20220226,0,0.9922061750113764,203,231,7,441
24829,bright,main,20220226,1,0.995327107848646,229,161,4,394
24829,bright,main,20220226,2,0.9929033997219591,268,154,3,425
24829,bright,main,20220226,3,0.9946635172871223,305,79,1,385
24829,bright,main,20220226,4,0.9928798731401153,277,114,3,394
24829,bright,main,20220226,5,0.9921574465227511,262,147,1,410
24829,bright,main,20220226,6,0.9960836172101364,256,155,7,418
24829,bright,main,20220226,7,0.987746863057069,226,132,4,362
24829,bright,main,20220226,8,0.9943043711896873,234,175,5,414
24829,bright,main,20220226,9,0.9962187436243491,206,216,3,425
5791,dark,main,20220226,0,0.9908625581030603,270,26,40,336
5791,dark,main,20220226,1,0.9903010009378596,241,15,51,307
5791,dark,main,20220226,2,0.9874522894336819,239,18,95,352
5791,dark,main,20220226,3,0.988282944617328,249,15,52,316
5791,dark,main,20220226,4,0.9878129895469492,254,13,61,328
5791,dark,main,20220226,5,0.9932014056375602,246,18,56,320
5791,dark,main,20220226,6,0.9909005128941683,267,15,72,354
5791,dark,main,20220226,7,0.9871045249390862,218,18,62,298
5791,dark,main,20220226,8,0.9898356333410181,289,19,48,356
5791,dark,main,20220226,9,0.9912086946836599,263,19,46,328
11943,dark,main,20220226,0,0.9896116401821301,315,11,33,359
11943,dark,main,20220226,1,0.9836804636562442,289,15,38,342
11943,dark,main,20220226,2,0.9877234837283633,285,23,36,344
11943,dark,main,20220226,3,0.9885302337284504,274,26,28,328
11943,dark,main,20220226,4,0.9923638896411305,258,17,35,310
11943,dark,main,20220226,5,0.9935696844176418,292,14,31,337
11943,dark,main,20220226,6,0.992579266530891,294,15,44,353
11943,dark,main,20220226,7,0.9908880929138372,259,13,32,304
11943,dark,main,20220226,8,0.9961131653547312,296,13,32,341
11943,dark,main,20220226,9,0.9884740259203441,298,14,36,348
5242,dark,main,20220226,0,0.9945391851974622,274,19,87,380
5242,dark,main,20220226,1,0.9925258728629313,249,17,80,346
5242,dark,main,20220226,2,0.9921947169677124,233,31,97,361
5242,dark,main,20220226,3,0.9889056463478066,247,23,76,346
5242,dark,main,20220226,4,0.9940789614182969,232,22,88,342
5242,dark,main,20220226,5,0.9939078138307887,249,22,77,348
5242,dark,main,20220226,6,0.9850696425999536,254,19,77,350
5242,dark,main,20220226,7,0.9920316161636004,252,15,47,314
5242,dark,main,20220226,8,0.9968739391949131,268,16,76,360
5242,dark,main,20220226,9,0.9916547480610237,273,19,79,371
4223,dark,main,20220226,0,0.9907713635553788,279,14,60,353
4223,dark,main,20220226,1,0.9909114716908266,242,25,59,326
4223,dark,main,20220226,2,0.9862301204758794,271,12,71,354
4223,dark,main,20220226,3,0.9857656574465133,244,19,56,319
4223,dark,main,20220226,4,0.9881865484789931,227,18,72,317
4223,dark,main,20220226,5,0.9930270220008918,261,19,60,340
4223,dark,main,20220226,6,0.9852667052138765,284,20,58,362
4223,dark,main,20220226,7,0.9898839410259392,254,15,44,313
4223,dark,main,20220226,8,0.9906969932388715,250,15,65,330
4223,dark,main,20220226,9,0.9832219551195563,279,17,49,345
41273,backup,main,20220227,0,0.9836398498808043,9,440,0,449
41273,backup,main,20220227,1,0.9946661553189547,7,402,0,409
41273,backup,main,20220227,2,0.995386025769042,11,434,0,445
41273,backup,main,20220227,3,0.9894143031812721,11,396,0,407
41273,backup,main,20220227,4,0.9931382053543426,24,398,0,422
41273,backup,main,20220227,5,0.9930969709522992,44,392,0,436
41273,backup,main,20220227,6,0.9945068823439931,19,417,0,436
41273,backup,main,20220227,7,0.9940267293669925,29,359,0,388
41273,backup,main,20220227,8,0.9904283346532252,21,407,0,428
41273,backup,main,20220227,9,0.9945581182941167,14,425,0,439
41108,backup,main,20220227,0,0.9939866186263369,7,372,0,379
41108,backup,main,20220227,1,0.9911292823045609,4,334,0,338
41108,backup,main,20220227,2,0.9935986126332803,4,362,0,366
41108,backup,main,20220227,3,0.9899519953781192,3,335,1,339
41108,backup,main,20220227,4,0.9890754325849253,2,328,2,332
41108,backup,main,20220227,5,0.9928456266225544,5,351,1,357
41108,backup,main,20220227,6,0.992549455097253,3,354,0,357
41108,backup,main,20220227,7,0.9918691824560663,5,308,4,317
41108,backup,main,20220227,8,0.9900067748745807,2,354,1,357
41108,backup,main,20220227,9,0.99327828286379,4,370,1,375
41159,backup,main,20220227,0,0.9921751136524122,5,381,1,387
41159,backup,main,20220227,1,0.9913032236961309,4,332,2,338
41159,backup,main,20220227,2,0.9895009773350675,1,361,0,362
41159,backup,main,20220227,3,0.995141746085879,4,323,2,329
41159,backup,main,20220227,4,0.9841897452021596,2,318,2,322
41159,backup,main,20220227,5,0.9941108906318321,4,336,1,341
41159,backup,main,20220227,6,0.9947606373739096,2,353,2,357
41159,backup,main,20220227,7,0.9937988647956595,6,306,0,312
41159,backup,main,20220227,8,0.990870569077178,1,354,4,359
41159,backup,main,20220227,9,0.9926911432453054,3,364,1,368
41239,backup,main,20220227,0,0.9948909964963597,55,394,0,449
41239,backup,main,20220227,1,0.9932450468327471,58,349,0,407
41239,backup,main,20220227,2,0.9868406875953502,71,373,1,445
41239,backup,main,20220227,3,0.9930627201022568,49,358,0,407
41239,backup,main,20220227,4,0.9920706253536749,55,367,0,422
41239,backup,main,20220227,5,0.9968924090627409,68,369,0,437
41239,backup,main,20220227,6,0.9938325722319308,74,361,2,437
41239,backup,main,20220227,7,0.989084809494941,48,340,0,388
41239,backup,main,20220227,8,0.9888972606789611,54,375,0,429
41239,backup,main,20220227,9,0.9917706833752368,63,378,0,441
41252,backup,main,20220227,0,0.9953823308183543,8,441,0,449
41252,backup,main,20220227,1,0.9936606408055507,6,402,0,408
41252,backup,main,20220227,2,0.9935968897737302,1,443,0,444
41252,backup,main,20220227,3,0.9887540959836252,5,400,0,405
41252,backup,main,20220227,4,0.9948842576628371,2,401,0,403
41252,backup,main,20220227,5,0.9938631067144662,1,422,0,423
41252,backup,main,20220227,6,0.9920210938446589,2,434,0,436
41252,backup,main,20220227,7,0.996364042715237,3,377,0,380
41252,backup,main,20220227,8,0.9928352809834813,1,427,0,428
41252,backup,main,20220227,9,0.9925869715878298,7,434,0,441
41484,backup,main,20220227,0,0.9965123810146213,85,363,0,448
41484,backup,main,20220227,1,0.9901821681728736,80,312,0,392
41484,backup,main,20220227,2,0.9949258008775549,90,354,0,444
41484,backup,main,20220227,3,0.9912743909236521,17,384,0,401
41484,backup,main,20220227,4,0.9905756958717886,10,387,0,397
41484,backup,main,20220227,5,0.9919811391258262,11,407,0,418
41484,backup,main,20220227,6,0.9945592987182054,13,420,0,433
41484,backup,main,20220227,7,0.9902360027347215,5,373,0,378
41484,backup,main,20220227,8,0.9934268997781612,6,423,0,429
41484,backup,main,20220227,9,0.9889872136755306,31,401,0,432
40530,backup,main,20220227,0,0.9935236892717818,4,412,1,417
40530,backup,main,20220227,1,0.99250965466737,4,377,1,382
40530,backup,main,20220227,2,0.9879988616871259,6,401,0,407
40530,backup,main,20220227,3,0.9965210267350655,4,364,0,368
40530,backup,main,20220227,4,0.989246360063922,15,351,0,366
40530,backup,main,20220227,5,0.9902797703534774,3,370,0,373
40530,backup,main,20220227,6,0.9882855752107244,3,393,0,396
40530,backup,main,20220227,7,0.9927455121080294,12,337,0,349
40530,backup,main,20220227,8,0.9924076202772489,30,355,0,385
40530,backup,main,20220227,9,0.9912366543069502,6,393,1,400
43033,backup,main,20220227,0,0.9914038677883613,3,435,0,438
43033,backup,main,20220227,1,0.9937243742736162,3,391,0,394
43033,backup,main,20220227,2,0.9928550784956518,3,426,0,429
43033,backup,main,20220227,3,0.9915944937712057,3,395,0,398
43033,backup,main,20220227,4,0.991904479704195,2,393,0,395
43033,backup,main,20220227,5,0.9924860357297327,3,403,2,408
43033,backup,main,20220227,6,0.9941745600386269,2,423,0,425
43033,backup,main,20220227,7,0.9918928107376966,3,366,0,369
43033,backup,main,20220227,8,0.9928607411813203,1,411,0,412
43033,backup,main,20220227,9,0.9941341251609624,6,422,0,428
43035,backup,main,20220227,0,0.9891220106557833,0,443,0,443
43035,backup,main,20220227,1,0.992751510186059,1,397,0,398
43035,backup,main,20220227,2,0.9957947537150152,2,437,0,439
43035,backup,main,20220227,3,0.9898455287873689,5,392,0,397
43035,backup,main,20220227,4,0.9914042966266089,0,395,0,395
43035,backup,main,20220227,5,0.9897459070474182,0,407,1,408
43035,backup,main,20220227,6,0.9934352111292168,3,423,3,429
43035,backup,main,20220227,7,0.9946648984960657,5,367,1,373
43035,backup,main,20220227,8,0.9950532374668112,1,415,0,416
43035,backup,main,20220227,9,0.9915669800469884,2,425,1,428
43059,backup,main,20220227,0,0.9959953213606214,4,386,1,391
43059,backup,main,20220227,1,0.9913290749365553,0,363,0,363
43059,backup,main,20220227,2,0.9925490364550879,8,389,0,397
43059,backup,main,20220227,3,0.9819943817828357,2,364,1,367
43059,backup,main,20220227,4,0.9881067505926217,4,351,0,355
43059,backup,main,20220227,5,0.9903629600058925,3,375,0,378
43059,backup,main,20220227,6,0.9956382529876686,1,381,0,382
43059,backup,main,20220227,7,0.9869765732205411,2,331,1,334
43059,backup,main,20220227,8,0.9909690346105395,6,362,2,370
43059,backup,main,20220227,9,0.9917893161040867,2,388,1,391
43025,backup,main,20220227,0,0.9918698430861314,6,419,1,426
43025,backup,main,20220227,1,0.9970431804120508,3,384,0,387
43025,backup,main,20220227,2,0.995810269539154,7,420,0,427
43025,backup,main,20220227,3,0.9896218212827446,3,374,1,378
43025,backup,main,20220227,4,0.9839319844668248,2,368,1,371
43025,backup,main,20220227,5,0.9941198681953496,2,392,0,394
43025,backup,main,20220227,6,0.9970771758098335,5,409,0,414
43025,backup,main,20220227,7,0.987179442441802,1,353,0,354
43025,backup,main,20220227,8,0.9912182990867039,3,397,0,400
43025,backup,main,20220227,9,0.985604397142672,3,411,1,415
40575,backup,main,20220227,0,0.9918979267547922,3,369,1,373
40575,backup,main,20220227,1,0.9946586469218944,3,349,1,353
40575,backup,main,20220227,2,0.9939404432756692,2,364,1,367
40575,backup,main,20220227,3,0.9887337812791198,2,173,0,175
40575,backup,main,20220227,4,0.9815109143489521,3,339,2,344
40575,backup,main,20220227,5,0.9822663584674929,5,360,1,366
40575,backup,main,20220227,6,0.9900251973905303,3,369,0,372
40575,backup,main,20220227,7,0.9857768660437031,1,316,2,319
40575,backup,main,20220227,8,0.9917851015181275,3,369,0,372
40575,backup,main,20220227,9,0.9921646856521537,7,363,0,370
40240,backup,main,20220227,0,0.9919472393619444,11,426,1,438
40240,backup,main,20220227,1,0.9922512438213303,5,388,0,393
40240,backup,main,20220227,2,0.9911974265260053,9,423,1,433
40240,backup,main,20220227,3,0.9891748953593915,5,393,0,398
40240,backup,main,20220227,4,0.9841290652569137,2,394,0,396
40240,backup,main,20220227,5,0.9929261490089057,7,404,0,411
40240,backup,main,20220227,6,0.9959041069323701,3,426,0,429
40240,backup,main,20220227,7,0.9841244387693796,9,366,0,375
40240,backup,main,20220227,8,0.9924340067742801,3,415,0,418
40240,backup,main,20220227,9,0.9964973657076107,5,423,0,428
41243,backup,main,20220227,0,0.9932854310722845,19,425,0,444
41243,backup,main,20220227,1,0.9949056845899364,21,369,0,390
41243,backup,main,20220227,2,0.9968452874448638,33,409,0,442
41243,backup,main,20220227,3,0.9904085800876197,13,388,0,401
41243,backup,main,20220227,4,0.9949193862185405,48,346,0,394
41243,backup,main,20220227,5,0.9891559261455657,39,375,0,414
41243,backup,main,20220227,6,0.9880217256992783,55,376,0,431
41243,backup,main,20220227,7,0.9905942969199595,49,322,0,371
41243,backup,main,20220227,8,0.9940411395992029,65,358,0,423
41243,backup,main,20220227,9,0.9935718427305504,40,382,1,423
40237,backup,main,20220227,0,0.9926293975839418,4,424,0,428
40237,backup,main,20220227,1,0.9792248735112428,2,386,0,388
40237,backup,main,20220227,2,0.992768129243877,4,418,0,422
40237,backup,main,20220227,3,0.9934789800484626,13,370,1,384
40237,backup,main,20220227,4,0.9892872748299855,0,369,1,370
40237,backup,main,20220227,5,0.9935147039527112,1,399,0,400
40237,backup,main,20220227,6,0.989121813322641,8,405,1,414
40237,backup,main,20220227,7,0.9875712581169291,7,363,0,370
40237,backup,main,20220227,8,0.995166490400995,3,392,2,397
40237,backup,main,20220227,9,0.9900797491177483,3,413,0,416
40236,backup,main,20220227,0,0.9952463263279837,2,440,0,442
40236,backup,main,20220227,1,0.9901753381078178,1,391,0,392
40236,backup,main,20220227,2,0.9910815486857445,3,426,1,430
40236,backup,main,20220227,3,0.9873848185328199,9,376,0,385
40236,backup,main,20220227,4,0.9842609984457664,2,381,1,384
40236,backup,main,20220227,5,0.9930756750522485,2,405,0,407
40236,backup,main,20220227,6,0.9962155919026402,2,416,1,419
40236,backup,main,20220227,7,0.9923135085561477,1,366,0,367
40236,backup,main,20220227,8,0.9853392451856464,2,413,0,415
40236,backup,main,20220227,9,0.9960128878649278,3,420,0,423
26067,bright,main,20220227,0,0.9936045358307714,329,101,3,433
26067,bright,main,20220227,1,0.9936210698260625,266,140,2,408
26067,bright,main,20220227,2,0.9933821609858945,252,180,4,436
26067,bright,main,20220227,3,0.9903495601740424,226,175,3,404
26067,bright,main,20220227,4,0.9966346011668873,253,143,5,401
26067,bright,main,20220227,5,0.9961814500036135,320,91,3,414
26067,bright,main,20220227,6,0.9918157110890935,336,89,3,428
26067,bright,main,20220227,7,0.9950907820628263,287,84,4,375
26067,bright,main,20220227,8,0.9939376173752434,282,140,3,425
26067,bright,main,20220227,9,0.9937532055245474,275,163,1,439
24675,bright,main,20220227,0,0.9896567211595881,280,151,3,434
24675,bright,main,20220227,1,0.9937427085252281,276,121,3,400
24675,bright,main,20220227,2,0.9911570391168131,226,195,9,430
24675,bright,main,20220227,3,0.9940899104159531,247,150,1,398
24675,bright,main,20220227,4,0.9863936601058849,158,225,2,385
24675,bright,main,20220227,5,0.9907322903923751,152,240,5,397
24675,bright,main,20220227,6,0.992695799921935,162,250,7,419
24675,bright,main,20220227,7,0.9948716888758546,165,196,9,370
24675,bright,main,20220227,8,0.9933542279712554,252,156,6,414
24675,bright,main,20220227,9,0.9942249480871361,288,129,4,421
22028,bright,main,20220227,0,0.9888990852580654,324,111,2,437
22028,bright,main,20220227,1,0.9925441160581528,304,88,5,397
22028,bright,main,20220227,2,0.9926611871635086,316,105,7,428
22028,bright,main,20220227,3,0.9883230883341525,222,160,5,387
22028,bright,main,20220227,4,0.993520822420015,202,172,4,378
22028,bright,main,20220227,5,0.9885729112885745,269,134,4,407
22028,bright,main,20220227,6,0.9957082713074846,333,87,3,423
22028,bright,main,20220227,7,0.9885471481852344,285,81,4,370
22028,bright,main,20220227,8,0.9954184407921929,280,129,4,413
22028,bright,main,20220227,9,0.9948490933633777,314,105,3,422
21567,bright,main,20220227,0,0.9943698410910028,245,194,4,443
21567,bright,main,20220227,1,0.9889839312307618,192,206,4,402
21567,bright,main,20220227,2,0.9949477470824262,253,187,0,440
21567,bright,main,20220227,3,0.991611113252101,200,201,3,404
21567,bright,main,20220227,4,0.9940856052385201,186,207,3,396
21567,bright,main,20220227,5,0.9895018986546539,202,215,3,420
21567,bright,main,20220227,6,0.9933266639080857,222,207,4,433
21567,bright,main,20220227,7,0.9896081943749345,188,187,2,377
21567,bright,main,20220227,8,0.9952440706643543,239,182,3,424
21567,bright,main,20220227,9,0.9945103771773772,236,199,4,439
21532,bright,main,20220227,0,0.988243550366176,361,77,3,441
21532,bright,main,20220227,1,0.9889664319616943,290,113,0,403
21532,bright,main,20220227,2,0.9944468338975418,272,161,3,436
21532,bright,main,20220227,3,0.9951523649999365,210,194,1,405
21532,bright,main,20220227,4,0.9849660305100938,167,229,4,400
21532,bright,main,20220227,5,0.9903787119375922,228,182,3,413
21532,bright,main,20220227,6,0.9923157544614187,219,210,4,433
21532,bright,main,20220227,7,0.9838115001671596,216,155,1,372
21532,bright,main,20220227,8,0.995626390935583,293,131,3,427
21532,bright,main,20220227,9,0.9926588212351399,324,104,6,434
20269,bright,main,20220227,0,0.9915265655654844,268,161,8,437
20269,bright,main,20220227,1,0.9946913711457914,202,187,3,392
20269,bright,main,20220227,2,0.9932565190798105,173,249,6,428
20269,bright,main,20220227,3,0.9883140438038567,129,244,2,375
20269,bright,main,20220227,4,0.9921609244040726,188,196,8,392
20269,bright,main,20220227,5,0.9957509575244843,192,201,6,399
20269,bright,main,20220227,6,0.9950589793837675,192,224,4,420
20269,bright,main,20220227,7,0.9917530101997083,199,164,6,369
20269,bright,main,20220227,8,0.9934211036850702,276,125,4,405
20269,bright,main,20220227,9,0.9888219895045013,247,170,6,423
40238,backup,main,20220227,0,0.9921098183659309,9,421,1,431
40238,backup,main,20220227,1,0.9945226068653712,8,381,1,390
40238,backup,main,20220227,2,0.9839554275462332,4,425,1,430
40238,backup,main,20220227,3,0.9852464376691075,10,383,0,393
40238,backup,main,20220227,4,0.9932781987626492,2,393,0,395
40238,backup,main,20220227,5,0.9931962944149845,4,402,1,407
40238,backup,main,20220227,6,0.9886127912407201,6,419,0,425
40238,backup,main,20220227,7,0.9927907547373033,7,361,1,369
40238,backup,main,20220227,8,0.9937012240134689,3,410,1,414
40238,backup,main,20220227,9,0.9947421836289428,4,418,1,423
23079,bright,main,20220227,0,0.9979531654598779,285,140,10,435
23079,bright,main,20220227,1,0.9885961090242026,212,180,3,395
23079,bright,main,20220227,2,0.9955652144149542,201,225,7,433
23079,bright,main,20220227,3,0.9940914668632971,211,172,6,389
23079,bright,main,20220227,4,0.9918496233778654,215,171,4,390
23079,bright,main,20220227,5,0.9924853784731493,200,197,6,403
23079,bright,main,20220227,6,0.9926511941763605,258,158,5,421
23079,bright,main,20220227,7,0.9865338699085253,172,192,4,368
23079,bright,main,20220227,8,0.9923404208420175,241,168,2,411
23079,bright,main,20220227,9,0.9914064844286496,243,183,4,430
4079,dark,main,20220228,0,0.992981993736548,315,15,36,366
4079,dark,main,20220228,1,0.9950931987272249,306,13,39,358
4079,dark,main,20220228,2,0.9938146985308454,322,17,40,379
4079,dark,main,20220228,3,0.9853628444813213,285,14,48,347
4079,dark,main,20220228,4,0.992239208053822,291,12,39,342
4079,dark,main,20220228,5,0.9946928594921659,298,10,52,360
4079,dark,main,20220228,6,0.9789216107539561,317,17,50,384
4079,dark,main,20220228,7,0.9918373971573815,271,14,35,320
4079,dark,main,20220228,8,0.9919387535070555,306,11,42,359
4079,dark,main,20220228,9,0.9904679460271615,323,15,36,374
1268,dark,main,20220228,0,0.9861108060571069,328,16,47,391
1268,dark,main,20220228,1,0.9884424622651482,284,13,40,337
1268,dark,main,20220228,2,0.9931255900702669,328,11,34,373
1268,dark,main,20220228,3,0.9951644523803537,298,16,28,342
1268,dark,main,20220228,4,0.9924399488958693,298,19,23,340
1268,dark,main,20220228,5,0.9876950129187564,307,18,26,351
1268,dark,main,20220228,6,0.9920828037014426,312,16,32,360
1268,dark,main,20220228,7,0.983257899471149,273,12,35,320
1268,dark,main,20220228,8,0.9923771218016991,314,11,37,362
1268,dark,main,20220228,9,0.9904223376227629,307,11,39,357
2126,dark,main,20220228,0,0.9850297247070433,318,16,30,364
2126,dark,main,20220228,1,0.993172623030581,289,9,36,334
2126,dark,main,20220228,2,0.9956080350282736,298,16,37,351
2126,dark,main,20220228,3,0.9869413655181375,279,14,42,335
2126,dark,main,20220228,4,0.992167765988882,266,14,44,324
2126,dark,main,20220228,5,0.9928769669857173,289,13,58,360
2126,dark,main,20220228,6,0.9913588321580183,312,12,46,370
2126,dark,main,20220228,7,0.9922231727111236,256,16,49,321
2126,dark,main,20220228,8,0.9868459294539248,289,14,53,356
2126,dark,main,20220228,9,0.9920056200149514,324,16,46,386
2143,dark,main,20220228,0,0.9912258242155881,319,11,38,368
2143,dark,main,20220228,1,0.9933065943180266,284,15,47,346
2143,dark,main,20220228,2,0.9924797884667572,317,14,49,380
2143,dark,main,20220228,3,0.9881379829012621,273,13,53,339
2143,dark,main,20220228,4,0.9868396660360932,262,10,57,329
2143,dark,main,20220228,5,0.9905925121709053,294,11,46,351
2143,dark,main,20220228,6,0.9902733294777157,305,15,52,372
2143,dark,main,20220228,7,0.9923931133724272,259,12,48,319
2143,dark,main,20220228,8,0.9903662713656453,304,12,41,357
2143,dark,main,20220228,9,0.990965871885177,313,13,47,373
2366,dark,main,20220228,0,0.9892685603414924,301,25,35,361
2366,dark,main,20220228,1,0.9949443035544954,281,24,35,340
2366,dark,main,20220228,2,0.9885848025458439,301,25,46,372
2366,dark,main,20220228,3,0.9958419422848565,287,24,32,343
2366,dark,main,20220228,4,0.9924693724541889,280,15,51,346
2366,dark,main,20220228,5,0.9911851230230134,315,14,37,366
2366,dark,main,20220228,6,0.996598357898371,292,15,61,368
2366,dark,main,20220228,7,0.9908631745423373,266,12,49,327
2366,dark,main,20220228,8,0.9923370584073445,285,16,58,359
2366,dark,main,20220228,9,0.992617339744358,283,24,50,357
2367,dark,main,20220228,0,0.9949390794280961,321,13,48,382
2367,dark,main,20220228,1,0.992975489723001,283,23,34,340
2367,dark,main,20220228,2,0.9911288452756846,314,24,43,381
2367,dark,main,20220228,3,0.9852264441244261,293,29,40,362
2367,dark,main,20220228,4,0.990859272004271,284,14,51,349
2367,dark,main,20220228,5,0.9909197960640681,303,16,43,362
2367,dark,main,20220228,6,0.9898769534102255,297,16,51,364
2367,dark,main,20220228,7,0.9899423579711163,276,17,41,334
2367,dark,main,20220228,8,0.9961979869098676,307,14,48,369
2367,dark,main,20220228,9,0.9921769508332673,318,26,32,376
4092,dark,main,20220228,0,0.9923109241815192,330,16,38,384
4092,dark,main,20220228,1,0.9904418209581453,292,15,36,343
4092,dark,main,20220228,2,0.9877602032955236,318,18,41,377
4092,dark,main,20220228,3,0.9935365982205692,296,16,38,350
4092,dark,main,20220228,4,0.9875059320754228,269,19,49,337
4092,dark,main,20220228,5,0.9875247827239931,303,22,40,365
4092,dark,main,20220228,6,0.9891981955915604,303,20,37,360
4092,dark,main,20220228,7,0.9900630159231886,262,16,35,313
4092,dark,main,20220228,8,0.9868491500751093,296,25,38,359
4092,dark,main,20220228,9,0.9951737215264126,316,20,37,373
5654,dark,main,20220228,0,0.9957321141324929,306,23,36,365
5654,dark,main,20220228,1,0.9927806211454416,295,17,33,345
5654,dark,main,20220228,2,0.9950062873798411,312,30,50,392
5654,dark,main,20220228,3,0.9888579825150716,308,14,26,348
5654,dark,main,20220228,4,0.9940261427574736,281,22,43,346
5654,dark,main,20220228,5,0.9947720413751268,304,25,34,363
5654,dark,main,20220228,6,0.9934658682806486,321,15,39,375
5654,dark,main,20220228,7,0.9893459263482952,247,17,42,306
5654,dark,main,20220228,8,0.9911013155875684,291,19,48,358
5654,dark,main,20220228,9,0.9834570427232839,313,15,42,370
4226,dark,main,20220228,0,0.9905001398955482,293,19,46,358
4226,dark,main,20220228,1,0.9942050159389819,274,13,39,326
4226,dark,main,20220228,2,0.9958730736680851,282,14,46,342
4226,dark,main,20220228,3,0.9897915506670597,283,14,46,343
4226,dark,main,20220228,4,0.989255270559485,275,20,46,341
4226,dark,main,20220228,5,0.9932784879134673,273,14,64,351
4226,dark,main,20220228,6,0.99017428365621,287,19,43,349
4226,dark,main,20220228,7,0.9866506831328132,228,19,55,302
4226,dark,main,20220228,8,0.9931771525703204,284,16,55,355
4226,dark,main,20220228,9,0.9912561339173108,304,15,48,367
4254,dark,main,20220228,0,0.9939928032750978,278,13,61,352
4254,dark,main,20220228,1,0.9837313818930576,270,18,56,344
4254,dark,main,20220228,2,0.990269476927557,305,17,48,370
4254,dark,main,20220228,3,0.9892357024132078,278,12,30,320
4254,dark,main,20220228,4,0.9939580676411656,259,17,40,316
4254,dark,main,20220228,5,0.9934350952862359,289,16,35,340
4254,dark,main,20220228,6,0.9916360952439033,290,16,45,351
4254,dark,main,20220228,7,0.9954015498337482,260,13,34,307
4254,dark,main,20220228,8,0.9858573690421518,305,14,36,355
4254,dark,main,20220228,9,0.994483206373327,299,12,45,356
4720,dark,main,20220228,0,0.9933574964260027,316,12,53,381
4720,dark,main,20220228,1,0.991282798413325,281,15,53,349
4720,dark,main,20220228,2,0.9961927061104129,308,16,40,364
4720,dark,main,20220228,3,0.9949133689351334,277,15,53,345
4720,dark,main,20220228,4,0.9912144889802811,286,12,52,350
4720,dark,main,20220228,5,0.9963241450289624,298,10,41,349
4720,dark,main,20220228,6,0.9886169002201171,295,18,38,351
4720,dark,main,20220228,7,0.9924950579420838,267,12,29,308
4720,dark,main,20220228,8,0.9930747948703237,301,13,32,346
4720,dark,main,20220228,9,0.9915053424047087,311,20,38,369
5641,dark,main,20220228,0,0.9929289318615444,311,25,44,380
5641,dark,main,20220228,1,0.9905329704338662,286,20,37,343
5641,dark,main,20220228,2,0.9972477400124383,325,18,39,382
5641,dark,main,20220228,3,0.9889959834540054,274,13,56,343
5641,dark,main,20220228,4,0.9874476096724064,291,11,47,349
5641,dark,main,20220228,5,0.9907140135574812,302,14,43,359
5641,dark,main,20220228,6,0.9914840781821265,313,14,33,360
5641,dark,main,20220228,7,0.9884469317069271,276,13,28,317
5641,dark,main,20220228,8,0.9927188226134206,324,15,29,368
5641,dark,main,20220228,9,0.9910480072116866,305,18,51,374
5787,dark,main,20220228,0,0.9946744587601984,309,12,26,347
5787,dark,main,20220228,1,0.9954809539880319,289,13,36,338
5787,dark,main,20220228,2,0.9915054447779923,285,18,46,349
5787,dark,main,20220228,3,0.9886984562836457,270,18,32,320
5787,dark,main,20220228,4,0.9901614691118485,276,16,29,321
5787,dark,main,20220228,5,0.988758695664303,279,14,40,333
5787,dark,main,20220228,6,0.9871993400560456,301,15,45,361
5787,dark,main,20220228,7,0.9958360708317935,261,13,33,307
5787,dark,main,20220228,8,0.9915955468207213,290,13,33,336
5787,dark,main,20220228,9,0.9958977913835816,283,14,33,330
5673,dark,main,20220228,0,0.9858888892108536,325,12,37,374
5673,dark,main,20220228,1,0.996050906513532,312,12,37,361
5673,dark,main,20220228,2,0.992341521908652,321,13,37,371
5673,dark,main,20220228,3,0.9965061527277013,287,13,34,334
5673,dark,main,20220228,4,0.9941062067990686,280,12,44,336
5673,dark,main,20220228,5,0.9922349658568467,317,12,45,374
5673,dark,main,20220228,6,0.9937367123335777,308,14,58,380
5673,dark,main,20220228,7,0.9860311182512781,283,16,31,330
5673,dark,main,20220228,8,0.9925084260021241,324,15,33,372
5673,dark,main,20220228,9,0.996049301089012,326,14,31,371
5698,dark,main,20220228,0,0.989627919644551,319,13,26,358
5698,dark,main,20220228,1,0.9884099857517715,297,14,25,336
5698,dark,main,20220228,2,0.990403784270216,334,15,34,383
5698,dark,main,20220228,3,0.9915435444585058,302,15,34,351
5698,dark,main,20220228,4,0.991612989018706,282,13,41,336
5698,dark,main,20220228,5,0.9941326878735914,300,11,43,354
5698,dark,main,20220228,6,0.9864435499564422,305,10,56,371
5698,dark,main,20220228,7,0.9955165938941165,269,11,50,330
5698,dark,main,20220228,8,0.9891526892715726,304,11,51,366
5698,dark,main,20220228,9,0.9953531412060859,341,15,33,389
4115,dark,main,20220228,0,0.991029043231993,307,14,47,368
4115,dark,main,20220228,1,0.9893635223703187,278,12,44,334
4115,dark,main,20220228,2,0.9903403354566479,326,19,42,387
4115,dark,main,20220228,3,0.992659547557128,260,21,57,338
4115,dark,main,20220228,4,0.9915923796090127,281,21,39,341
4115,dark,main,20220228,5,0.9882296196598532,246,15,49,310
4115,dark,main,20220228,6,0.9885912210154691,286,23,45,354
4115,dark,main,20220228,7,0.9859707029056023,245,17,61,323
4115,dark,main,20220228,8,0.992994938271989,283,15,61,359
4115,dark,main,20220228,9,0.9926941231490588,318,16,49,383
5792,dark,main,20220228,0,0.9946333483474419,207,12,59,278
5792,dark,main,20220228,1,0.9833786408793289,226,18,49,293
5792,dark,main,20220228,2,0.9937338789751198,229,30,72,331
5792,dark,main,20220228,3,0.9905631724138978,235,19,44,298
5792,dark,main,20220228,4,0.9877243344454056,250,12,50,312
5792,dark,main,20220228,5,0.9863907545284084,243,19,47,309
5792,dark,main,20220228,6,0.9953486203749234,253,19,55,327
5792,dark,main,20220228,7,0.9941532586176441,203,13,56,272
5792,dark,main,20220228,8,0.9930422312656477,227,18,45,290
5792,dark,main,20220228,9,0.9872512016107401,224,15,59,298
10821,dark,main,20220228,0,0.9879573234257976,309,13,63,385
10821,dark,main,20220228,1,0.9876515488433666,260,17,79,356
10821,dark,main,20220228,2,0.9930197069315194,321,13,54,388
10821,dark,main,20220228,3,0.9946756441023984,301,14,34,349
10821,dark,main,20220228,4,0.9917288672848507,286,16,32,334
10821,dark,main,20220228,5,0.9891972305069487,301,17,40,358
10821,dark,main,20220228,6,0.9893427210126291,321,12,33,366
10821,dark,main,20220228,7,0.986064967042184,263,16,34,313
10821,dark,main,20220228,8,0.9840726740238092,307,15,37,359
10821,dark,main,20220228,9,0.9943709490181325,313,12,53,378
9942,dark,main,20220228,0,0.9929354831017683,324,14,45,383
9942,dark,main,20220228,1,0.9914712995234783,295,11,44,350
9942,dark,main,20220228,2,0.9924419935803572,304,16,60,380
9942,dark,main,20220228,3,0.9953492874595842,296,12,49,357
9942,dark,main,20220228,4,0.9826426312293239,292,8,47,347
9942,dark,main,20220228,5,0.9896707207096135,310,11,39,360
9942,dark,main,20220228,6,0.9849063082532353,296,16,46,358
9942,dark,main,20220228,7,0.9944163435710862,272,14,36,322
9942,dark,main,20220228,8,0.987638813558174,298,17,43,358
9942,dark,main,20220228,9,0.98517306024864,316,15,49,380
23235,bright,main,20220228,0,0.9931061444141557,303,128,3,434
23235,bright,main,20220228,1,0.9919756470383716,254,139,3,396
23235,bright,main,20220228,2,0.9940277311763093,260,181,0,441
23235,bright,main,20220228,3,0.985759996924814,181,217,2,400
23235,bright,main,20220228,4,0.99295126403602,165,224,2,391
23235,bright,main,20220228,5,0.9920050316307998,160,252,1,413
23235,bright,main,20220228,6,0.9911283871711938,205,220,4,429
23235,bright,main,20220228,7,0.9902278094271174,188,179,1,368
23235,bright,main,20220228,8,0.9882166053262551,180,233,2,415
23235,bright,main,20220228,9,0.9951631121270978,251,174,6,431
1005,dark,main,20220228,0,0.9917390543357202,302,15,49,366
1005,dark,main,20220228,1,0.9909179760195231,278,14,36,328
1005,dark,main,20220228,2,0.9959124508926134,291,13,54,358
1005,dark,main,20220228,3,0.9903209006076895,281,16,53,350
1005,dark,main,20220228,4,0.9877986135944363,261,15,65,341
1005,dark,main,20220228,5,0.9896283706532109,270,19,69,358
1005,dark,main,20220228,6,0.9956777053742503,262,22,69,353
1005,dark,main,20220228,7,0.989139747322214,266,10,40,316
1005,dark,main,20220228,8,0.9910255776052721,284,16,42,342
1005,dark,main,20220228,9,0.9869259750738998,325,14,35,374
7225,dark,main,20220228,0,0.9959495561313132,322,23,37,382
7225,dark,main,20220228,1,0.9940241827022388,283,16,41,340
7225,dark,main,20220228,2,0.9907515147365392,307,15,42,364
7225,dark,main,20220228,3,0.994580962032493,303,18,30,351
7225,dark,main,20220228,4,0.987683327743023,281,14,41,336
7225,dark,main,20220228,5,0.9921587037815888,307,25,30,362
7225,dark,main,20220228,6,0.995354071140056,309,22,30,361
7225,dark,main,20220228,7,0.988936075287818,287,17,21,325
7225,dark,main,20220228,8,0.9892478581423256,292,16,42,350
7225,dark,main,20220228,9,0.9896494359307992,298,12,40,350
7706,dark,main,20220228,0,0.9918604579860554,336,17,22,375
7706,dark,main,20220228,1,0.9910283056570958,320,12,31,363
7706,dark,main,20220228,2,0.9886714759055428,319,14,44,377
7706,dark,main,20220228,3,0.9910126820331016,304,11,45,360
7706,dark,main,20220228,4,0.9887440669732085,278,15,39,332
7706,dark,main,20220228,5,0.9932892607275513,312,12,40,364
7706,dark,main,20220228,6,0.9853192077037436,324,10,30,364
7706,dark,main,20220228,7,0.9915321039909606,277,18,22,317
7706,dark,main,20220228,8,0.9917638330448868,303,16,36,355
7706,dark,main,20220228,9,0.9916851962178328,342,15,24,381
8818,dark,main,20220228,0,0.9904627432513168,281,36,41,358
8818,dark,main,20220228,1,0.9908749635109999,288,22,36,346
8818,dark,main,20220228,2,0.9901884864232378,314,22,41,377
8818,dark,main,20220228,3,0.988897640146178,293,18,47,358
8818,dark,main,20220228,4,0.9931458356243577,270,17,45,332
8818,dark,main,20220228,5,0.9903627711735611,297,15,40,352
8818,dark,main,20220228,6,0.9874205455059077,297,37,42,376
8818,dark,main,20220228,7,0.9925844527153014,279,18,36,333
8818,dark,main,20220228,8,0.991649199149862,315,23,43,381
8818,dark,main,20220228,9,0.995393451079868,292,22,53,367
8915,dark,main,20220228,0,0.9961261204562543,274,14,75,363
8915,dark,main,20220228,1,0.9780903517835313,281,17,38,336
8915,dark,main,20220228,2,0.9932635211738071,270,16,69,355
8915,dark,main,20220228,3,0.9885823435309481,259,20,53,332
8915,dark,main,20220228,4,0.9870018837088801,273,15,48,336
8915,dark,main,20220228,5,0.9953305604224165,286,16,64,366
8915,dark,main,20220228,6,0.995471165593104,283,18,65,366
8915,dark,main,20220228,7,0.9881464465728669,247,26,40,313
8915,dark,main,20220228,8,0.9942089929361381,279,21,59,359
8915,dark,main,20220228,9,0.9889782895436918,257,16,79,352
8943,dark,main,20220228,0,0.993580599598824,303,14,53,370
8943,dark,main,20220228,1,0.9912088309787274,275,15,43,333
8943,dark,main,20220228,2,0.9932266257568483,276,15,80,371
8943,dark,main,20220228,3,0.991842686608257,281,12,45,338
8943,dark,main,20220228,4,0.9902472079977186,265,11,40,316
8943,dark,main,20220228,5,0.9943076603963109,290,13,40,343
8943,dark,main,20220228,6,0.9946665238729707,286,14,33,333
8943,dark,main,20220228,7,0.9921247967224297,270,18,20,308
8943,dark,main,20220228,8,0.9937929328241366,302,13,28,343
8943,dark,main,20220228,9,0.9933494157796537,317,12,46,375
9930,dark,main,20220228,0,0.9858314302604945,297,20,45,362
9930,dark,main,20220228,1,0.9862723960831674,279,18,33,330
9930,dark,main,20220228,2,0.9912621393751344,294,15,55,364
9930,dark,main,20220228,3,0.9906761901173473,263,15,45,323
9930,dark,main,20220228,4,0.9872550856656143,259,14,54,327
9930,dark,main,20220228,5,0.9858053558361599,270,17,52,339
9930,dark,main,20220228,6,0.991884111145253,301,11,46,358
9930,dark,main,20220228,7,0.9918876951820635,251,16,39,306
9930,dark,main,20220228,8,0.9818494554377204,288,17,53,358
9930,dark,main,20220228,9,0.9864094441378678,296,13,46,355
7065,dark,main,20220228,0,0.9910078026050234,317,14,51,382
7065,dark,main,20220228,1,0.9891998475981184,299,15,39,353
7065,dark,main,20220228,2,0.9927549657377773,308,14,54,376
7065,dark,main,20220228,3,0.9900944393821541,287,18,61,366
7065,dark,main,20220228,4,0.9942734078670991,265,19,64,348
7065,dark,main,20220228,5,0.9881530242526169,306,16,59,381
7065,dark,main,20220228,6,0.9896216990658383,304,13,40,357
7065,dark,main,20220228,7,0.9833971830325882,292,13,35,340
7065,dark,main,20220228,8,0.9912502444926055,310,22,53,385
7065,dark,main,20220228,9,0.9868974746623999,303,16,39,358
9941,dark,main,20220228,0,0.9947039627642436,302,20,58,380
9941,dark,main,20220228,1,0.9939954170459635,281,11,40,332
9941,dark,main,20220228,2,0.9941822632122617,337,12,41,390
9941,dark,main,20220228,3,0.9893893959429251,298,11,32,341
9941,dark,main,20220228,4,0.9833785538983038,298,15,30,343
9941,dark,main,20220228,5,0.9940397042370187,315,14,36,365
9941,dark,main,20220228,6,0.9901056756614206,304,13,48,365
9941,dark,main,20220228,7,0.987489576302288,260,14,41,315
9941,dark,main,20220228,8,0.9957543540409909,302,15,65,382
9941,dark,main,20220228,9,0.9964033849091589,324,14,48,386
10813,dark,main,20220228,0,0.9967078580264865,325,14,40,379
10813,dark,main,20220228,1,0.9898867384510754,297,16,36,349
10813,dark,main,20220228,2,0.9923402531485919,352,11,29,392
10813,dark,main,20220228,3,0.9920648403048786,294,14,38,346
10813,dark,main,20220228,4,0.9894338090785009,294,15,30,339
10813,dark,main,20220228,5,0.9923371722661257,283,12,50,345
10813,dark,main,20220228,6,0.9899589677173253,332,18,29,379
10813,dark,main,20220228,7,0.9900949638470485,275,14,37,326
10813,dark,main,20220228,8,0.9907217004969003,316,16,36,368
10813,dark,main,20220228,9,0.9896606716030636,322,14,49,385
10861,dark,main,20220228,0,0.9938309243099348,298,14,66,378
10861,dark,main,20220228,1,0.99264134810698,280,10,51,341
10861,dark,main,20220228,2,0.9966674933635098,323,10,48,381
10861,dark,main,20220228,3,0.9869072575937567,301,12,42,355
10861,dark,main,20220228,4,0.9925946216733282,289,11,54,354
10861,dark,main,20220228,5,0.9904671092459221,278,11,77,366
10861,dark,main,20220228,6,0.9872841569441904,302,14,56,372
10861,dark,main,20220228,7,0.9929009727109095,265,13,45,323
10861,dark,main,20220228,8,0.9870436626632316,283,13,59,355
10861,dark,main,20220228,9,0.9971269225090845,315,12,55,382
11909,dark,main,20220228,0,0.9908677513838564,304,20,37,361
11909,dark,main,20220228,1,0.9920011892406205,298,12,36,346
11909,dark,main,20220228,2,0.991871721315388,321,16,45,382
11909,dark,main,20220228,3,0.9952635860577274,297,17,34,348
11909,dark,main,20220228,4,0.9912123888394504,311,11,23,345
11909,dark,main,20220228,5,0.992979155213645,325,13,31,369
11909,dark,main,20220228,6,0.9930232464869,326,13,37,376
11909,dark,main,20220228,7,0.989296909123057,274,14,33,321
11909,dark,main,20220228,8,0.9931243505410462,299,20,47,366
11909,dark,main,20220228,9,0.9884723246817347,296,14,44,354
11926,dark,main,20220228,0,0.9862580766191404,311,16,49,376
11926,dark,main,20220228,1,0.9891334630859601,309,14,31,354
11926,dark,main,20220228,2,0.9905432339152986,329,17,29,375
11926,dark,main,20220228,3,0.9945976307954456,281,19,41,341
11926,dark,main,20220228,4,0.9866577606533754,289,16,41,346
11926,dark,main,20220228,5,0.9941695807435946,315,16,42,373
11926,dark,main,20220228,6,0.9890021521968919,314,15,40,369
11926,dark,main,20220228,7,0.9945480451745232,274,19,40,333
11926,dark,main,20220228,8,0.9894742627329942,289,12,60,361
11926,dark,main,20220228,9,0.9914444792758871,302,14,65,381
23233,bright,main,20220228,0,0.9939668914273586,288,151,5,444
23233,bright,main,20220228,1,0.9903548538001025,242,161,0,403
23233,bright,main,20220228,2,0.9882919732758977,251,186,4,441
23233,bright,main,20220228,3,0.9957031842022727,248,150,5,403
23233,bright,main,20220228,4,0.9938268311497075,156,232,5,393
23233,bright,main,20220228,5,0.991066934372721,138,273,5,416
23233,bright,main,20220228,6,0.9927688015042057,176,248,3,427
23233,bright,main,20220228,7,0.9855661856041373,157,214,3,374
23233,bright,main,20220228,8,0.9916748411740017,182,240,3,425
23233,bright,main,20220228,9,0.9921081891571711,227,205,3,435
5793,dark,main,20220228,0,0.9825020878117814,232,16,42,290
5793,dark,main,20220228,1,0.9914243161592113,224,16,40,280
5793,dark,main,20220228,2,0.990156853616454,239,24,44,307
5793,dark,main,20220228,3,0.9918079385751403,211,11,47,269
5793,dark,main,20220228,4,0.9871479145116084,217,13,57,287
5793,dark,main,20220228,5,0.9909580642702082,241,13,63,317
5793,dark,main,20220228,6,0.9894814097490975,227,16,49,292
5793,dark,main,20220228,7,0.9843405341552481,207,23,49,279
5793,dark,main,20220228,8,0.9824725560217688,223,13,44,280
5793,dark,main,20220228,9,0.9887636282179382,234,21,43,298
24610,bright,main,20220228,0,0.9905554662035441,336,100,1,437
24610,bright,main,20220228,1,0.9913445567023139,230,170,2,402
24610,bright,main,20220228,2,0.994594308653687,241,190,4,435
24610,bright,main,20220228,3,0.9856636728787764,217,175,5,397
24610,bright,main,20220228,4,0.9931362039154629,230,160,5,395
24610,bright,main,20220228,5,0.9925594437512936,172,238,6,416
24610,bright,main,20220228,6,0.9896315181503542,195,231,5,431
24610,bright,main,20220228,7,0.9913503776408658,196,172,4,372
24610,bright,main,20220228,8,0.993433813007665,253,167,3,423
24610,bright,main,20220228,9,0.9898551046169272,240,186,3,429
