TILEID,PROGRAM,SURVEY,PETALID,H,N_GAL,N_STAR,N_QSO,N_GOOD_Z
21184,bright,main,0,0.986339274807899,364,56,4,424
21184,bright,main,1,0.9943514117172828,325,55,2,382
21184,bright,main,2,0.9876833537727443,375,42,3,420
21184,bright,main,3,0.9924941246273916,333,43,1,377
21184,bright,main,4,0.9914749433437152,339,49,3,391
21184,bright,main,5,0.9900655533107818,364,34,2,400
21184,bright,main,6,0.9930614789123742,329,32,2,363
21184,bright,main,7,0.9888986943339283,283,58,0,341
21184,bright,main,8,0.9939996162495803,327,68,2,397
21184,bright,main,9,0.9958330344760437,332,70,3,405
21202,bright,main,0,0.993420463530659,335,79,0,414
21202,bright,main,1,0.9912774034098942,330,61,3,394
21202,bright,main,2,0.9946638137860788,351,61,3,415
21202,bright,main,3,0.9908455403893395,311,67,1,379
21202,bright,main,4,0.9913983264711222,312,65,5,382
21202,bright,main,5,0.9921798119223445,331,60,1,392
21202,bright,main,6,0.9873418920237305,294,57,3,354
21202,bright,main,7,0.9907453175485786,278,64,2,344
21202,bright,main,8,0.9942082541779715,365,47,3,415
21202,bright,main,9,0.9935695367140248,337,65,7,409
21196,bright,main,0,0.9854944207623539,280,116,4,400
21196,bright,main,1,0.9836780493845121,149,29,3,181
21196,bright,main,2,0.9927738274817296,348,53,4,405
21196,bright,main,3,0.9945531428921615,274,84,2,360
21196,bright,main,4,0.9930762459173205,329,52,3,384
21196,bright,main,5,0.9949853640324992,318,70,1,389
21196,bright,main,6,0.9884031090465054,304,51,4,359
21196,bright,main,7,0.996574090598602,295,51,3,349
21196,bright,main,8,0.9881861614532486,356,51,5,412
21196,bright,main,9,0.9962276307897207,300,92,3,395
1404,dark,main,0,0.993479963740401,256,34,86,376
1404,dark,main,1,0.99194201594641,237,35,88,360
1404,dark,main,2,0.992497906908451,249,46,82,377
1404,dark,main,3,0.991989683182334,221,32,87,340
1404,dark,main,4,0.9941367951523735,237,30,79,346
1404,dark,main,5,0.9856940447409713,238,30,86,354
1404,dark,main,6,0.9916112897153678,207,42,73,322
1404,dark,main,7,0.9922234879717204,221,36,67,324
1404,dark,main,8,0.992663001410554,235,36,92,363
1404,dark,main,9,0.9913138284078846,248,36,91,375
20240,bright,main,0,0.9947012057151419,359,75,2,436
20240,bright,main,1,0.9928487284448247,299,76,7,382
20240,bright,main,2,0.9929507371483003,340,79,3,422
20240,bright,main,3,0.9929849045515303,297,89,0,386
20240,bright,main,4,0.9919346832644855,298,88,3,389
20240,bright,main,5,0.9915561987321159,322,72,4,398
20240,bright,main,6,0.9925731585939812,309,61,4,374
20240,bright,main,7,0.994159370827409,295,57,6,358
20240,bright,main,8,0.9935997571202748,353,62,3,418
20240,bright,main,9,0.9921872479435911,373,47,6,426
1751,dark,main,0,0.9871705922758287,264,21,92,377
1751,dark,main,1,0.9921445843825517,248,23,75,346
1751,dark,main,2,0.9897849733528331,271,16,89,376
1751,dark,main,3,0.9926896491508588,264,18,81,363
1751,dark,main,4,0.9949271306979655,254,25,80,359
1751,dark,main,5,0.9903276137180439,260,21,86,367
1751,dark,main,6,0.9881249250339195,214,23,92,329
1751,dark,main,7,0.9928346365097355,217,17,84,318
1751,dark,main,8,0.9948862236517257,259,22,84,365
1751,dark,main,9,0.99251785425206,280,21,72,373
2175,dark,main,0,0.9919415497707121,278,15,97,390
2175,dark,main,1,0.9961815020018657,246,13,94,353
2175,dark,main,2,0.9915445295702623,264,12,122,398
2175,dark,main,3,0.9928991894690067,273,12,80,365
2175,dark,main,4,0.9945254252940603,264,15,85,364
2175,dark,main,5,0.9887859423200352,290,18,66,374
2175,dark,main,6,0.9958995059239485,249,14,75,338
2175,dark,main,7,0.9921799069328786,266,11,66,343
2175,dark,main,8,0.9909127554045659,245,17,105,367
2175,dark,main,9,0.990683022578509,280,11,101,392
1750,dark,main,0,0.994283103431242,287,23,79,389
1750,dark,main,1,0.9948092988285221,242,13,79,334
1750,dark,main,2,0.9911582891236963,251,29,68,348
1750,dark,main,3,0.9927319162331916,225,31,92,348
1750,dark,main,4,0.9914696579739884,247,13,98,358
1750,dark,main,5,0.9962978145676405,244,30,79,353
1750,dark,main,6,0.9849824710537548,216,30,67,313
1750,dark,main,7,0.9900210598008268,238,22,66,326
1750,dark,main,8,0.9954623712867049,270,23,81,374
1750,dark,main,9,0.9890477462290866,278,21,78,377
20654,bright,main,0,0.9816266837314943,345,68,2,415
20654,bright,main,1,0.9816266837314943,345,68,2,415
20654,bright,main,2,0.9903098630407969,371,42,2,415
20654,bright,main,3,0.9946479209074707,310,64,0,374
20654,bright,main,4,0.9918189317700034,329,45,2,376
20654,bright,main,5,0.9893680819229528,308,66,2,376
20654,bright,main,6,0.9907787685042513,308,46,6,360
20654,bright,main,7,0.9865619206534679,266,60,1,327
20654,bright,main,8,0.9924877663672983,336,54,4,394
20654,bright,main,9,0.992536311929868,355,50,4,409
20257,bright,main,0,0.9904677829786929,336,82,1,419
20257,bright,main,1,0.9916211924368331,293,85,2,380
20257,bright,main,2,0.9941983150064131,384,34,0,418
20257,bright,main,3,0.9966908946291377,340,48,4,392
20257,bright,main,4,0.9916775470046535,338,54,4,396
20257,bright,main,5,0.9910584865915952,330,64,4,398
20257,bright,main,6,0.992255478852841,290,61,1,352
20257,bright,main,7,0.9876554466388867,252,91,3,346
20257,bright,main,8,0.9932802710183348,312,100,4,416
20257,bright,main,9,0.9883371016766405,368,53,4,425
20377,bright,main,0,0.979973883480059,354,50,6,410
20377,bright,main,1,0.9837409409959715,334,41,0,375
20377,bright,main,2,0.9898573475023262,322,61,1,384
20377,bright,main,3,0.9925843348227378,298,63,2,363
20377,bright,main,4,0.9922270217503667,309,55,5,369
20377,bright,main,5,0.991755759518118,340,46,5,391
20377,bright,main,6,0.9952674965713493,292,51,4,347
20377,bright,main,7,0.9921682210915129,316,27,4,347
20377,bright,main,8,0.9914069749193712,348,57,1,406
20377,bright,main,9,0.9924463642260418,346,60,1,407
1433,dark,main,0,0.9913620266270229,233,70,62,365
1433,dark,main,1,0.9850913795872926,203,60,78,341
1433,dark,main,2,0.9855091244870624,217,77,87,381
1433,dark,main,3,0.989059300709069,227,46,72,345
1433,dark,main,4,0.9903504196248333,216,57,78,351
1433,dark,main,5,0.9960446381005195,239,48,77,364
1433,dark,main,6,0.9929266534696161,175,50,71,296
1433,dark,main,7,0.9897816362313391,146,89,53,288
1433,dark,main,8,0.9883395793569736,168,95,44,307
1433,dark,main,9,0.9778422674773317,149,54,27,230
20923,bright,main,0,0.994082660695413,366,73,2,441
20923,bright,main,1,0.9927084331112822,318,79,4,401
20923,bright,main,2,0.9919962718261686,353,75,1,429
20923,bright,main,3,0.9940960267483171,304,91,5,400
20923,bright,main,4,0.994264287758761,287,112,4,403
20923,bright,main,5,0.9949443379725356,338,68,3,409
20923,bright,main,6,0.9900045348609688,300,65,4,369
20923,bright,main,7,0.9894053413354582,318,46,1,365
20923,bright,main,8,0.9956949375249627,371,54,2,427
20923,bright,main,9,0.9894350877565262,373,61,5,439
21162,bright,main,0,0.9918680741185415,336,80,3,419
21162,bright,main,1,0.9925422178532801,315,54,4,373
21162,bright,main,2,0.992920381195633,338,67,6,411
21162,bright,main,3,0.9840440376651236,311,52,6,369
21162,bright,main,4,0.9889772170878179,318,63,3,384
21162,bright,main,5,0.9876001629281027,299,76,7,382
21162,bright,main,6,0.9885737389799596,249,83,5,337
21162,bright,main,7,0.9959642503929341,249,86,1,336
21162,bright,main,8,0.9951905257430833,283,101,0,384
21162,bright,main,9,0.9933696900091961,330,70,2,402
21181,bright,main,0,0.9912981934611306,373,45,3,421
21181,bright,main,1,0.9902983994561322,333,37,3,373
21181,bright,main,2,0.9930903398930928,368,44,3,415
21181,bright,main,3,0.9922097513191989,302,52,3,357
21181,bright,main,4,0.9949739148937401,335,47,1,383
21181,bright,main,5,0.9959834092550116,362,40,2,404
21181,bright,main,6,0.9926962611372887,300,52,5,357
21181,bright,main,7,0.9950330207500678,295,42,1,338
21181,bright,main,8,0.9958616787726322,368,44,0,412
21181,bright,main,9,0.9941967654973822,360,42,4,406
2196,dark,main,0,0.9948884737346307,301,15,77,393
2196,dark,main,1,0.9888046591589275,261,16,75,352
2196,dark,main,2,0.9939370950152359,283,14,90,387
2196,dark,main,3,0.9918635911886409,273,14,76,363
2196,dark,main,4,0.9921883334600842,276,17,74,367
2196,dark,main,5,0.9902074518279769,255,15,88,358
2196,dark,main,6,0.9884876730372015,250,14,64,328
2196,dark,main,7,0.9926325499896553,218,12,92,322
2196,dark,main,8,0.992691606862022,290,18,68,376
2196,dark,main,9,0.9939336989017763,278,18,86,382
1762,dark,main,0,0.9875739800450246,288,26,78,392
1762,dark,main,1,0.9877967075885888,255,24,82,361
1762,dark,main,2,0.9942061306956764,255,34,96,385
1762,dark,main,3,0.9850760669279833,229,37,80,346
1762,dark,main,4,0.9932085066992234,262,25,82,369
1762,dark,main,5,0.990126777727447,198,111,53,362
1762,dark,main,6,0.9884564271489995,226,28,65,319
1762,dark,main,7,0.9928085128901042,224,25,76,325
1762,dark,main,8,0.9941076969359631,263,18,93,374
1762,dark,main,9,0.9942371139529084,271,19,83,373
20888,bright,main,0,0.9920290522141223,313,113,4,430
20888,bright,main,1,0.9908236288692952,283,116,1,400
20888,bright,main,2,0.9961070434814991,344,84,0,428
20888,bright,main,3,0.9930267897146586,295,97,5,397
20888,bright,main,4,0.9973860205542,311,87,7,405
20888,bright,main,5,0.9869883979750936,299,102,2,403
20888,bright,main,6,0.9930495268386987,250,108,4,362
20888,bright,main,7,0.993767583386404,261,94,2,357
20888,bright,main,8,0.9941544483796867,326,92,4,422
20888,bright,main,9,0.9906144653412587,325,94,3,422
1765,dark,main,0,0.9942488251258796,281,18,88,387
1765,dark,main,1,0.9976212737237893,255,16,81,352
1765,dark,main,2,0.992991991312783,277,23,87,387
1765,dark,main,3,0.9804373803715707,253,15,76,344
1765,dark,main,4,0.9957049161571658,245,19,85,349
1765,dark,main,5,0.9928521181002156,242,17,92,351
1765,dark,main,6,0.9861788819503072,240,14,61,315
1765,dark,main,7,0.9749761073698464,223,15,84,322
1765,dark,main,8,0.9913742258587526,254,17,86,357
1765,dark,main,9,0.9922181678575935,260,14,111,385
1912,dark,main,0,0.9928284763512818,248,32,97,377
1912,dark,main,1,0.9959352103375069,231,32,84,347
1912,dark,main,2,0.9937387552335455,257,43,86,386
1912,dark,main,3,0.9915454715207511,241,25,78,344
1912,dark,main,4,0.9908759436538321,243,20,92,355
1912,dark,main,5,0.9925249320681961,245,34,74,353
1912,dark,main,6,0.9834469828195213,213,24,66,303
1912,dark,main,7,0.9907472167009935,228,26,63,317
1912,dark,main,8,0.9891231029132423,255,26,93,374
1912,dark,main,9,0.9921171693659442,244,41,84,369
1737,dark,main,0,0.9891093248139519,267,21,97,385
1737,dark,main,1,0.9909987316502942,250,15,92,357
1737,dark,main,2,0.9793703381448616,269,18,82,369
1737,dark,main,3,0.9908877590520844,249,19,72,340
1737,dark,main,4,0.9873036519160349,227,25,83,335
1737,dark,main,5,0.9923775366111606,252,21,61,334
1737,dark,main,6,0.9878643988190614,225,19,73,317
1737,dark,main,7,0.9939670863614657,235,20,81,336
1737,dark,main,8,0.987414971760818,257,15,94,366
1737,dark,main,9,0.9894165552856529,275,19,87,381
1241,dark,main,0,0.9930707981481409,246,15,118,379
1241,dark,main,1,0.9919319759385125,232,21,100,353
1241,dark,main,2,0.9918876906203067,282,17,82,381
1241,dark,main,3,0.9939500652991252,262,15,79,356
1241,dark,main,4,0.9893949520948883,245,16,93,354
1241,dark,main,5,0.990938280083228,255,11,91,357
1241,dark,main,6,0.9917455180482091,242,15,72,329
1241,dark,main,7,0.990222698640966,239,18,67,324
1241,dark,main,8,0.9919097027029298,263,15,98,376
1241,dark,main,9,0.9959135047052036,265,16,100,381
2161,dark,main,0,0.9912991665325811,282,13,91,386
2161,dark,main,1,0.9895189664689055,253,13,82,348
2161,dark,main,2,0.9923096442608559,262,14,96,372
2161,dark,main,3,0.9913392206737942,262,16,94,372
2161,dark,main,4,0.992275076198522,260,15,92,367
2161,dark,main,5,0.9912843590601462,252,14,91,357
2161,dark,main,6,0.9819681394590398,243,12,71,326
2161,dark,main,7,0.9913809158072585,237,15,77,329
2161,dark,main,8,0.993314223107139,259,19,93,371
2161,dark,main,9,0.994051108717925,266,15,97,378
20914,bright,main,0,0.9958459581403579,337,95,4,436
20914,bright,main,1,0.994752092477664,314,84,5,403
20914,bright,main,2,0.9889272104127138,336,90,5,431
20914,bright,main,3,0.9949573338550751,334,63,5,402
20914,bright,main,4,0.9876386331517218,319,85,3,407
20914,bright,main,5,0.9882554523669056,278,116,7,401
20914,bright,main,6,0.9952699064538669,246,113,3,362
20914,bright,main,7,0.9941215499099855,275,91,2,368
20914,bright,main,8,0.9951896299665528,315,108,3,426
20914,bright,main,9,0.9896288920365236,333,99,5,437
2173,dark,main,0,0.9825942753387028,305,13,84,402
2173,dark,main,1,0.9863987585948011,266,16,76,358
2173,dark,main,2,0.9948804955782579,288,16,82,386
2173,dark,main,3,0.9939685085135149,256,14,89,359
2173,dark,main,4,0.9933946141396005,267,15,85,367
2173,dark,main,5,0.9968906764936324,253,13,82,348
2173,dark,main,6,0.9859672203820972,219,12,89,320
2173,dark,main,7,0.9953252502825912,238,13,77,328
2173,dark,main,8,0.9952900870743482,266,13,85,364
2173,dark,main,9,0.9926861226217065,305,13,84,402
2181,dark,main,0,0.9925333620296994,290,19,95,404
2181,dark,main,1,0.9927677149237344,259,14,83,356
2181,dark,main,2,0.9943177761297745,284,13,93,390
2181,dark,main,3,0.9888238025364009,258,11,77,346
2181,dark,main,4,0.9952190426020258,287,12,61,360
2181,dark,main,5,0.9913876387633732,258,21,80,359
2181,dark,main,6,0.9918301132028372,239,13,72,324
2181,dark,main,7,0.9926328067244389,231,14,79,324
2181,dark,main,8,0.9874097442690882,267,13,85,365
2181,dark,main,9,0.9876849163340673,282,15,78,375
1240,dark,main,0,0.9929099659069535,295,16,74,385
1240,dark,main,1,0.9925775332769083,249,13,85,347
1240,dark,main,2,0.9876761980453974,273,21,96,390
1240,dark,main,3,0.977002582171983,253,15,77,345
1240,dark,main,4,0.9877655135020768,267,20,77,364
1240,dark,main,5,0.996080784881661,271,19,82,372
1240,dark,main,6,0.9887153740916397,232,19,77,328
1240,dark,main,7,0.982652041048936,227,20,75,322
1240,dark,main,8,0.9867681756415332,271,23,85,379
1240,dark,main,9,0.980986799337903,281,15,96,392
2172,dark,main,0,0.9930242962416344,297,13,89,399
2172,dark,main,1,0.9910310946373609,259,14,94,367
2172,dark,main,2,0.9947174318493243,272,20,98,390
2172,dark,main,3,0.991329180140134,271,15,69,355
2172,dark,main,4,0.9949529053383098,276,15,85,376
2172,dark,main,5,0.984353628634082,248,14,86,348
2172,dark,main,6,0.9899253920300646,230,14,69,313
2172,dark,main,7,0.9909333356042982,224,14,82,320
2172,dark,main,8,0.9929133592871845,267,19,88,374
2172,dark,main,9,0.9949980288689845,289,11,92,392
20776,bright,main,0,0.9944178226152629,372,55,4,431
20776,bright,main,1,0.9866283656139745,334,50,4,388
20776,bright,main,2,0.9938732068056806,354,63,5,422
20776,bright,main,3,0.9848271898202223,323,63,4,390
20776,bright,main,4,0.9922845848909867,339,53,6,398
20776,bright,main,5,0.9923527218133584,324,63,5,392
20776,bright,main,6,0.9858373296754076,289,64,2,355
20776,bright,main,7,0.9902766060029005,304,48,5,357
20776,bright,main,8,0.9892943985059498,336,73,5,414
20776,bright,main,9,0.9929961671231173,379,48,5,432
1918,dark,main,0,0.990950247294972,266,22,95,383
1918,dark,main,1,0.9905588880254207,254,33,69,356
1918,dark,main,2,0.986359819349418,257,33,91,381
1918,dark,main,3,0.9922239783345733,233,29,73,335
1918,dark,main,4,0.993351759598884,257,22,78,357
1918,dark,main,5,0.98920599803194,228,26,90,344
1918,dark,main,6,0.9871451629012796,208,19,81,308
1918,dark,main,7,0.9928270212265404,213,31,70,314
1918,dark,main,8,0.9890269398954851,238,32,85,355
1918,dark,main,9,0.9946107253651363,252,33,90,375
1738,dark,main,0,0.9931829379856552,269,17,104,390
1738,dark,main,1,0.9910408727675122,242,16,98,356
1738,dark,main,2,0.994239017103647,259,23,95,377
1738,dark,main,3,0.9922140023522915,258,14,83,355
1738,dark,main,4,0.9924826213128704,242,18,98,358
1738,dark,main,5,0.9913980091993365,243,20,87,350
1738,dark,main,6,0.9828676988965804,228,16,68,312
1738,dark,main,7,0.9929083566257793,260,21,54,335
1738,dark,main,8,0.9934783548293885,267,21,91,379
1738,dark,main,9,0.9904116049282363,266,21,90,377
21161,bright,main,0,0.9925842978956017,331,82,3,416
21161,bright,main,1,0.9862961975892583,297,69,4,370
21161,bright,main,2,0.9884636805170598,331,57,4,392
21161,bright,main,3,0.9848515578272131,275,73,2,350
21161,bright,main,4,0.9961644372160393,314,57,5,376
21161,bright,main,5,0.9895225683004463,315,63,3,381
21161,bright,main,6,0.9916806767117469,298,46,3,347
21161,bright,main,7,0.9937095823235036,300,39,7,346
21161,bright,main,8,0.9918388930654256,355,44,6,405
21161,bright,main,9,0.9905742859798019,348,51,3,402
1749,dark,main,0,0.9952914995496185,266,18,91,375
1749,dark,main,1,0.9821500280615452,246,14,79,339
1749,dark,main,2,0.9936873221768286,260,25,99,384
1749,dark,main,3,0.984901038931244,240,22,83,345
1749,dark,main,4,0.9929249125717159,255,13,78,346
1749,dark,main,5,0.99198082610822,243,19,79,341
1749,dark,main,6,0.9883861926392329,231,16,75,322
1749,dark,main,7,0.9887926465826433,230,18,76,324
1749,dark,main,8,0.992167947340877,259,18,97,374
1749,dark,main,9,0.9926411089548466,271,18,100,389
2160,dark,main,0,0.9909095748202613,284,14,83,381
2160,dark,main,1,0.98879758423691,229,14,87,330
2160,dark,main,2,0.9939162033270587,258,13,69,340
2160,dark,main,3,0.9921216390717265,224,12,94,330
2160,dark,main,4,0.9881287734451655,257,12,89,358
2160,dark,main,5,0.9935673312252503,253,21,76,350
2160,dark,main,6,0.9942992893379192,237,14,75,326
2160,dark,main,7,0.9865258329651245,229,12,80,321
2160,dark,main,8,0.9885134945120956,294,12,78,384
2160,dark,main,9,0.9918626184374706,253,18,95,366
21169,bright,main,0,0.995052857309385,370,54,6,430
21169,bright,main,1,0.992694688562164,332,47,7,386
21169,bright,main,2,0.989201728141722,354,48,2,404
21169,bright,main,3,0.9915424479158412,319,40,4,363
21169,bright,main,4,0.9784054500768111,330,48,5,383
21169,bright,main,5,0.9885753167692424,318,62,4,384
21169,bright,main,6,0.9788674379718604,194,41,0,235
21169,bright,main,7,0.9935985904246702,280,40,3,323
21169,bright,main,8,0.9955239542618152,332,66,2,400
21169,bright,main,9,0.9858634261880209,337,63,1,401
2184,dark,main,0,0.9934974653402372,284,14,82,380
2184,dark,main,1,0.9925662986466315,236,14,101,351
2184,dark,main,2,0.9923517115129449,293,16,76,385
2184,dark,main,3,0.9873443648159105,234,17,89,340
2184,dark,main,4,0.9913896911661157,265,14,87,366
2184,dark,main,5,0.9939284549575267,256,18,79,353
2184,dark,main,6,0.9883945459458232,184,8,52,244
2184,dark,main,7,0.9935464363027957,203,15,80,298
2184,dark,main,8,0.9801370011842375,222,11,93,326
2184,dark,main,9,0.9901159768759251,266,15,90,371
2220,dark,main,0,0.9894203327301355,272,14,99,385
2220,dark,main,1,0.9934214369644251,258,17,86,361
2220,dark,main,2,0.9943544414121338,294,19,81,394
2220,dark,main,3,0.9847737418984995,222,13,68,303
2220,dark,main,4,0.9910179388655518,263,12,80,355
2220,dark,main,5,0.988610664681163,293,14,68,375
2220,dark,main,6,0.9948069036457805,228,15,82,325
2220,dark,main,7,0.9953452918795368,235,13,71,319
2220,dark,main,8,0.9864646397962507,280,19,88,387
2220,dark,main,9,0.9946784324517218,287,19,83,389
2195,dark,main,0,0.9963384604185447,269,16,103,388
2195,dark,main,1,0.989317539606338,246,13,93,352
2195,dark,main,2,0.9935140531569934,286,17,76,379
2195,dark,main,3,0.9931555452900827,251,16,72,339
2195,dark,main,4,0.9914465351949066,254,15,90,359
2195,dark,main,5,0.992031071669223,272,19,66,357
2195,dark,main,6,0.9873497717575527,243,12,71,326
2195,dark,main,7,0.9782152482705353,228,14,76,318
2195,dark,main,8,0.9952404821679641,276,15,92,383
2195,dark,main,9,0.9951920693945747,288,16,85,389
1243,dark,main,0,0.9914757840254238,281,19,92,392
1243,dark,main,1,0.9938825075228219,238,14,99,351
1243,dark,main,2,0.9930093834908309,273,22,84,379
1243,dark,main,3,0.9908164130931842,249,17,75,341
1243,dark,main,4,0.9853623102571035,212,15,64,291
1243,dark,main,5,0.9790602596401758,205,11,56,272
1243,dark,main,6,0.9940739903822107,214,20,80,314
1243,dark,main,7,0.9775483985961477,215,17,70,302
1243,dark,main,8,0.9925689868164682,240,28,94,362
1243,dark,main,9,0.9945743404282491,257,17,90,364
21156,bright,main,0,0.9896189560696832,369,48,3,420
21156,bright,main,1,0.9917311793830967,305,52,1,358
21156,bright,main,2,0.9881503435244918,341,57,6,404
21156,bright,main,3,0.9930877578334666,316,52,4,372
21156,bright,main,4,0.9958938165650215,351,41,4,396
21156,bright,main,5,0.9960493013635179,333,46,6,385
21156,bright,main,6,0.982217198170919,289,57,6,352
21156,bright,main,7,0.9955204566760298,285,40,3,328
21156,bright,main,8,0.9941901149577388,299,79,7,385
21156,bright,main,9,0.993959202272575,299,80,8,387
21219,bright,main,0,0.9845952371939799,293,48,3,344
21219,bright,main,1,0.9935086917588655,288,74,7,369
21219,bright,main,2,0.9929153005521721,342,49,3,394
21219,bright,main,3,0.9933855362501353,297,55,1,353
21219,bright,main,4,0.9892748349576336,329,40,6,375
21219,bright,main,5,0.9871448319029824,333,56,3,392
21219,bright,main,6,0.994092638400316,303,39,0,342
21219,bright,main,7,0.9873771699473702,282,50,2,334
21219,bright,main,8,0.993019152925176,289,86,0,375
21219,bright,main,9,0.9882680678316561,279,96,3,378
2156,dark,main,0,0.9959251178319899,285,11,95,391
2156,dark,main,1,0.9862083940603438,250,13,93,356
2156,dark,main,2,0.9925337855346757,292,15,83,390
2156,dark,main,3,0.9925607819747225,248,16,89,353
2156,dark,main,4,0.9932244722981,257,12,87,356
2156,dark,main,5,0.9898542458080792,249,10,77,336
2156,dark,main,6,0.9899488534948375,206,11,83,300
2156,dark,main,7,0.9946564442316967,239,17,61,317
2156,dark,main,8,0.9935170604182061,261,23,102,386
2156,dark,main,9,0.9903917889733546,283,17,96,396
2202,dark,main,0,0.9949304087921894,296,12,85,393
2202,dark,main,1,0.9904621837943092,251,11,91,353
2202,dark,main,2,0.9937520251933808,278,18,94,390
2202,dark,main,3,0.9885488468984243,228,17,115,360
2202,dark,main,4,0.9901326250134861,266,13,87,366
2202,dark,main,5,0.9919100707340824,255,16,97,368
2202,dark,main,6,0.9897422588567685,241,14,74,329
2202,dark,main,7,0.9928771291198674,229,15,71,315
2202,dark,main,8,0.9901648477962295,300,11,68,379
2202,dark,main,9,0.9926936834717458,288,16,80,384
1791,dark,main,0,0.9913831889800679,269,16,105,390
1791,dark,main,1,0.9938280052846703,255,16,93,364
1791,dark,main,2,0.9913748003485182,278,14,87,379
1791,dark,main,3,0.9906546127466765,234,13,103,350
1791,dark,main,4,0.9912289653702301,267,15,83,365
1791,dark,main,5,0.9907624058770342,255,18,87,360
1791,dark,main,6,0.9919165653614134,245,13,59,317
1791,dark,main,7,0.9879668397098403,222,14,79,315
1791,dark,main,8,0.9910457116988273,277,14,91,382
1791,dark,main,9,0.9926487382596523,288,13,90,391
1776,dark,main,0,0.9958380530944821,303,12,81,396
1776,dark,main,1,0.9897562745084266,260,14,67,341
1776,dark,main,2,0.9901946248168878,269,17,98,384
1776,dark,main,3,0.9921931670385788,259,13,84,356
1776,dark,main,4,0.9921387810104162,256,21,89,366
1776,dark,main,5,0.9967508980356156,269,12,82,363
1776,dark,main,6,0.9930806841018706,221,17,85,323
1776,dark,main,7,0.9923893116779313,235,17,61,313
1776,dark,main,8,0.9893047575768381,271,14,94,379
1776,dark,main,9,0.9901477204255884,291,21,74,386
21175,bright,main,0,0.9948312937423415,338,68,1,407
21175,bright,main,1,0.9937499659258047,283,68,3,354
21175,bright,main,2,0.9957118267202076,345,52,4,401
21175,bright,main,3,0.9926501244113578,307,51,2,360
21175,bright,main,4,0.9891064996747033,322,45,7,374
21175,bright,main,5,0.9924664107361733,298,63,5,366
21175,bright,main,6,0.9898630081273172,284,57,4,345
21175,bright,main,7,0.9914195941329594,289,49,3,341
21175,bright,main,8,0.9945114486718277,330,51,5,386
21175,bright,main,9,0.9925528656336612,316,72,3,391
1257,dark,main,0,0.987802045562151,266,23,91,380
1257,dark,main,1,0.9899956631563377,272,16,78,366
1257,dark,main,2,0.9894781114867336,291,17,80,388
1257,dark,main,3,0.9944542713198365,254,13,88,355
1257,dark,main,4,0.9874394741866598,231,14,105,350
1257,dark,main,5,0.9883073359200959,260,12,87,359
1257,dark,main,6,0.9818601596039709,214,15,65,294
1257,dark,main,7,0.9923693726446312,229,19,67,315
1257,dark,main,8,0.9942279579782444,276,16,80,372
1257,dark,main,9,0.9930333827077521,263,18,97,378
2187,dark,main,0,0.9880371870473016,274,12,108,394
2187,dark,main,1,0.9864827163465886,241,15,89,345
2187,dark,main,2,0.993273572465158,276,13,98,387
2187,dark,main,3,0.9922773012789982,247,16,85,348
2187,dark,main,4,0.9909765708654951,267,12,84,363
2187,dark,main,5,0.9918960210998566,255,12,94,361
2187,dark,main,6,0.996608514668689,229,18,60,307
2187,dark,main,7,0.9890512972730744,231,14,73,318
2187,dark,main,8,0.9939964430710935,276,17,77,370
2187,dark,main,9,0.9882912121085761,266,11,107,384
20274,bright,main,0,0.9926170358524985,382,59,3,444
20274,bright,main,1,0.9897364072941341,324,59,6,389
20274,bright,main,2,0.9911782660679331,366,55,5,426
20274,bright,main,3,0.9862182475501207,322,56,1,379
20274,bright,main,4,0.9954899078705345,344,53,2,399
20274,bright,main,5,0.9958427026125317,365,43,2,410
20274,bright,main,6,0.993793403656848,315,49,3,367
20274,bright,main,7,0.9950690638016996,300,50,4,354
20274,bright,main,8,0.9928050821595163,343,69,1,413
20274,bright,main,9,0.9907000965398279,345,79,2,426
1406,dark,main,0,0.9907008993349777,257,37,76,370
1406,dark,main,1,0.992841969000994,241,38,77,356
1406,dark,main,2,0.9942369418232585,259,29,96,384
1406,dark,main,3,0.9912386887780517,233,30,88,351
1406,dark,main,4,0.9905454786743784,165,31,44,240
1406,dark,main,5,0.9917484104852923,237,33,82,352
1406,dark,main,6,0.9948596195853573,220,30,70,320
1406,dark,main,7,0.9964067285585746,205,42,69,316
1406,dark,main,8,0.9936052261272168,248,36,83,367
1406,dark,main,9,0.9929369260456361,263,43,86,392
1391,dark,main,0,0.9962085480521016,262,48,75,385
1391,dark,main,1,0.9902837953349547,226,41,82,349
1391,dark,main,2,0.9892449491415917,251,40,89,380
1391,dark,main,3,0.9898096592075923,215,44,84,343
1391,dark,main,4,0.9891188112949735,157,37,49,243
1391,dark,main,5,0.9916270368292533,250,39,63,352
1391,dark,main,6,0.9945102888443335,195,35,78,308
1391,dark,main,7,0.9893726117664683,204,37,69,310
1391,dark,main,8,0.9884230781141973,230,46,79,355
1391,dark,main,9,0.9928393009833866,253,40,80,373
1130,dark,main,0,0.9912837963637375,282,25,82,389
1130,dark,main,1,0.9944251741498267,264,19,65,348
1130,dark,main,2,0.9952415250826443,264,19,93,376
1130,dark,main,3,0.9895835977897994,238,22,81,341
1130,dark,main,4,0.9843653133251563,189,16,42,247
1130,dark,main,5,0.9931690386401424,248,20,100,368
1130,dark,main,6,0.9873388660695674,212,32,85,329
1130,dark,main,7,0.989015276257611,204,24,92,320
1130,dark,main,8,0.9938881390113381,244,39,71,354
1130,dark,main,9,0.9897731297060751,258,30,73,361
1392,dark,main,0,0.9906152409233823,235,73,63,371
1392,dark,main,1,0.9915234493184245,221,50,66,337
1392,dark,main,2,0.9881001240468646,234,52,88,374
1392,dark,main,3,0.9949547539628233,193,59,59,311
1392,dark,main,4,0.9811684880955649,111,42,42,195
1392,dark,main,5,0.9901084803429958,207,64,84,355
1392,dark,main,6,0.9868487911490594,202,53,58,313
1392,dark,main,7,0.9885041692513039,232,46,50,328
1392,dark,main,8,0.9933269533847505,224,50,80,354
1392,dark,main,9,0.9906829655459662,240,63,73,376
1106,dark,main,0,0.9903643233647103,257,20,77,354
1106,dark,main,1,0.9909534178423622,218,14,79,311
1106,dark,main,2,0.9946974396205311,241,20,74,335
1106,dark,main,3,0.9917594420889716,228,15,76,319
1106,dark,main,4,0.9886384653925044,155,12,58,225
1106,dark,main,5,0.995926656953122,233,17,89,339
1106,dark,main,6,0.9945741621651583,200,20,70,290
1106,dark,main,7,0.9947542842278934,203,26,66,295
1106,dark,main,8,0.9929757273534217,231,28,70,329
1106,dark,main,9,0.9783656979198075,228,28,87,343
1412,dark,main,0,0.9885964619419574,250,45,84,379
1412,dark,main,1,0.9884471835504681,230,42,76,348
1412,dark,main,2,0.9943686135412996,244,48,74,366
1412,dark,main,3,0.9909402130938545,226,42,77,345
1412,dark,main,4,0.9740865923561322,153,37,53,243
1412,dark,main,5,0.9966078527727918,231,56,72,359
1412,dark,main,6,0.9882916735173253,190,45,71,306
1412,dark,main,7,0.9910887702895832,195,40,70,305
1412,dark,main,8,0.9903384455291109,228,47,88,363
1412,dark,main,9,0.991751923867213,236,52,77,365
1429,dark,main,0,0.986215336181031,234,58,66,358
1429,dark,main,1,0.9929092631833246,191,57,85,333
1429,dark,main,2,0.9921842632310088,230,47,80,357
1429,dark,main,3,0.993615568240172,231,42,74,347
1429,dark,main,4,0.987861937325524,198,56,81,335
1429,dark,main,5,0.9930573986875181,207,68,71,346
1429,dark,main,6,0.9889561878929919,205,42,53,300
1429,dark,main,7,0.9908035596789194,193,43,63,299
1429,dark,main,8,0.9937158079809302,221,52,80,353
1429,dark,main,9,0.9918528551980657,247,80,52,379
20587,bright,main,0,0.993436059339972,345,80,4,429
20587,bright,main,1,0.9959510186136361,303,76,6,385
20587,bright,main,2,0.9967684831346323,338,71,5,414
20587,bright,main,3,0.9968011919859243,286,95,3,384
20587,bright,main,4,0.9910234915554343,210,59,2,271
20587,bright,main,5,0.9909476481613599,342,58,8,408
20587,bright,main,6,0.9911148444437075,289,63,3,355
20587,bright,main,7,0.9906963668865248,266,80,2,348
20587,bright,main,8,0.9898937087231497,315,98,4,417
20587,bright,main,9,0.9932093350533037,341,77,3,421
20574,bright,main,0,0.9913780064990846,374,55,4,433
20574,bright,main,1,0.9834421622656279,333,63,2,398
20574,bright,main,2,0.9928199550387949,346,68,4,418
20574,bright,main,3,0.9904583852674544,297,78,4,379
20574,bright,main,4,0.9890529482283228,211,50,1,262
20574,bright,main,5,0.9886331182630692,332,64,3,399
20574,bright,main,6,0.9922007397426854,275,83,5,363
20574,bright,main,7,0.9826655942665914,274,70,3,347
20574,bright,main,8,0.9959530437440691,337,78,3,418
20574,bright,main,9,0.9947064740915537,357,67,1,425
20575,bright,main,0,0.9904558036479443,362,62,3,427
20575,bright,main,1,0.9938885681543562,316,66,6,388
20575,bright,main,2,0.9956631995967872,358,65,3,426
20575,bright,main,3,0.9937604111892884,329,58,2,389
20575,bright,main,4,0.9807251454665241,216,50,3,269
20575,bright,main,5,0.9899254791091798,342,59,3,404
20575,bright,main,6,0.9902456620010928,288,67,6,361
20575,bright,main,7,0.9957653718406284,295,56,1,352
20575,bright,main,8,0.9929151235891547,354,60,6,420
20575,bright,main,9,0.9960237178698976,348,67,5,420
1000,dark,main,0,0.9924210606795631,259,20,91,370
1000,dark,main,1,0.9934337623439495,235,23,83,341
1000,dark,main,2,0.9900402790288921,253,24,96,373
1000,dark,main,3,0.9972737947881692,219,26,96,341
1000,dark,main,4,0.9827472762415042,171,13,56,240
1000,dark,main,5,0.9856893684643638,259,24,83,366
1000,dark,main,6,0.9915420453494519,216,24,78,318
1000,dark,main,7,0.9851957977818022,224,23,69,316
1000,dark,main,8,0.9932502002149058,236,26,87,349
1000,dark,main,9,0.9864318652272461,231,44,71,346
20576,bright,main,0,0.9940564586132259,329,97,0,426
20576,bright,main,1,0.9933299169961575,325,62,3,390
20576,bright,main,2,0.9953316825191785,336,77,4,417
20576,bright,main,3,0.9904000182962213,324,63,3,390
20576,bright,main,4,0.99179846155096,194,75,2,271
20576,bright,main,5,0.988613249660959,306,74,8,388
20576,bright,main,6,0.9915912683974651,306,49,3,358
20576,bright,main,7,0.9945874981624472,295,50,7,352
20576,bright,main,8,0.9945999252151362,334,70,3,407
20576,bright,main,9,0.9947635097036154,372,50,2,424
20572,bright,main,0,0.9865555389115497,356,64,6,426
20572,bright,main,1,0.993657014145528,325,61,2,388
20572,bright,main,2,0.9941283234071017,367,57,1,425
20572,bright,main,3,0.9942420012255951,322,72,0,394
20572,bright,main,4,0.9901926073683972,223,46,1,270
20572,bright,main,5,0.9945903016459838,338,57,6,401
20572,bright,main,6,0.9895832780542073,293,65,3,361
20572,bright,main,7,0.9899610475593392,306,44,7,357
20572,bright,main,8,0.9936137197692811,345,64,6,415
20572,bright,main,9,0.993536241059721,341,66,5,412
1413,dark,main,0,0.9952050868643696,225,53,88,366
1413,dark,main,1,0.9856544356109457,210,44,85,339
1413,dark,main,2,0.9946923236767251,216,59,88,363
1413,dark,main,3,0.9935186822325317,233,41,82,356
1413,dark,main,4,0.9894770141796017,168,29,52,249
1413,dark,main,5,0.99373061885727,241,31,86,358
1413,dark,main,6,0.9843079504346713,186,42,84,312
1413,dark,main,7,0.9940511106483161,216,39,68,323
1413,dark,main,8,0.9939859143712835,245,41,87,373
1413,dark,main,9,0.9841574563196144,220,51,64,335
1090,dark,main,0,0.9960356062511471,273,26,88,387
1090,dark,main,1,0.9911912855051653,235,17,86,338
1090,dark,main,2,0.9949711508074147,281,16,80,377
1090,dark,main,3,0.9895935929991356,245,16,98,359
1090,dark,main,4,0.9902351727309907,164,7,61,232
1090,dark,main,5,0.9917724531454616,218,23,98,339
1090,dark,main,6,0.9808202895115754,212,23,80,315
1090,dark,main,7,0.9899537890736456,233,20,64,317
1090,dark,main,8,0.9912821139670445,247,27,97,371
1090,dark,main,9,0.9927263246954591,257,26,90,373
1081,dark,main,0,0.9909348511897895,247,25,87,359
1081,dark,main,1,0.991830006769921,243,20,70,333
1081,dark,main,2,0.9900798247268686,256,29,71,356
1081,dark,main,3,0.9911875089751936,231,22,71,324
1081,dark,main,4,0.9884291627340277,169,14,46,229
1081,dark,main,5,0.9855199354950889,231,19,84,334
1081,dark,main,6,0.9918572894294957,217,19,74,310
1081,dark,main,7,0.9815150085234199,213,25,62,300
1081,dark,main,8,0.9924967842587069,234,17,89,340
1081,dark,main,9,0.9908859953321211,260,23,75,358
1586,dark,main,0,0.9899815946543588,187,18,69,274
1586,dark,main,1,0.9797630821666201,193,23,69,285
1586,dark,main,2,0.9908727875712698,289,17,92,398
1586,dark,main,3,0.9896030872925615,261,18,72,351
1586,dark,main,4,0.9849597787692191,164,18,56,238
1586,dark,main,5,0.993138851873464,259,20,91,370
1586,dark,main,6,0.9878790297957109,220,16,75,311
1586,dark,main,7,0.9933278181927666,216,19,82,317
1586,dark,main,8,0.9890392483399595,267,19,81,367
1586,dark,main,9,0.9843560242861991,234,24,86,344
20090,bright,main,0,0.9896365763048407,353,80,5,438
20090,bright,main,1,0.9912563331959973,319,74,2,395
20090,bright,main,2,0.9929595045234321,359,66,2,427
20090,bright,main,3,0.9948464687245792,317,71,4,392
20090,bright,main,4,0.9885745115025033,214,52,3,269
20090,bright,main,5,0.9940561040955711,335,74,4,413
20090,bright,main,6,0.9765169202980059,288,79,1,368
20090,bright,main,7,0.9858990633312378,274,83,1,358
20090,bright,main,8,0.9977773699434692,339,78,6,423
20090,bright,main,9,0.9947413583850799,363,66,4,433
1573,dark,main,0,0.9931309005969623,270,22,101,393
1573,dark,main,1,0.989099980270854,253,23,68,344
1573,dark,main,2,0.9941537973144632,285,19,82,386
1573,dark,main,3,0.9950266342849258,217,20,105,342
1573,dark,main,4,0.9886550584730746,158,9,75,242
1573,dark,main,5,0.9947224491036106,255,19,84,358
1573,dark,main,6,0.9890998981956582,235,18,72,325
1573,dark,main,7,0.9906066674727655,246,18,70,334
1573,dark,main,8,0.9911296800293095,242,22,94,358
1573,dark,main,9,0.991032272940729,286,17,82,385
1405,dark,main,0,0.993748931157471,262,31,81,374
1405,dark,main,1,0.989030459692542,219,32,81,332
1405,dark,main,2,0.9935706572771108,255,26,91,372
1405,dark,main,3,0.9874836685259464,260,34,60,354
1405,dark,main,4,0.9908083789932833,175,17,53,245
1405,dark,main,5,0.9917491432182188,235,30,88,353
1405,dark,main,6,0.9928982725626888,223,26,80,329
1405,dark,main,7,0.9976082954019718,235,20,71,326
1405,dark,main,8,0.9911407039884472,258,30,82,370
1405,dark,main,9,0.993084099823894,238,30,101,369
1098,dark,main,0,0.9911767228442272,232,29,78,339
1098,dark,main,1,0.9929006243047958,224,40,73,337
1098,dark,main,2,0.9968508871675832,253,25,82,360
1098,dark,main,3,0.9908597454043745,252,27,77,356
1098,dark,main,4,0.9939084414184125,242,25,79,346
1098,dark,main,5,0.9862187654964413,259,24,81,364
1098,dark,main,6,0.9872220651318173,219,31,67,317
1098,dark,main,7,0.9878022527714455,216,22,82,320
1098,dark,main,8,0.9900241608753136,246,29,79,354
1098,dark,main,9,0.9940406014905864,235,35,89,359
1432,dark,main,0,0.9958327283709094,262,31,86,379
1432,dark,main,1,0.9895621168240233,258,25,66,349
1432,dark,main,2,0.9926425119443426,249,29,93,371
1432,dark,main,3,0.989076953359204,248,24,77,349
1432,dark,main,4,0.9891963663574131,245,27,79,351
1432,dark,main,5,0.9872763774354285,251,29,83,363
1432,dark,main,6,0.9940463631009518,228,27,58,313
1432,dark,main,7,0.9934988637070613,229,21,69,319
1432,dark,main,8,0.9880102172440136,258,22,71,351
1432,dark,main,9,0.9884636082615037,255,23,96,374
20586,bright,main,0,0.9931430663268684,240,63,1,304
20586,bright,main,1,0.9900620928346224,261,65,0,326
20586,bright,main,2,0.9968764921220024,338,84,4,426
20586,bright,main,3,0.9901775766870737,266,110,3,379
20586,bright,main,4,0.9920492946934654,289,89,7,385
20586,bright,main,5,0.9949850955250872,306,90,4,400
20586,bright,main,6,0.9955308576576406,277,85,1,363
20586,bright,main,7,0.9955962905501361,260,87,4,351
20586,bright,main,8,0.9904382438197334,338,76,3,417
20586,bright,main,9,0.9926375741725467,315,82,1,398
20083,bright,main,0,0.992577930008669,315,114,9,438
20083,bright,main,1,0.9873643732647069,300,93,2,395
20083,bright,main,2,0.9952495496116037,337,83,4,424
20083,bright,main,3,0.9943990956920428,305,84,4,393
20083,bright,main,4,0.9887791008154171,305,84,8,397
20083,bright,main,5,0.9919450105018617,339,59,10,408
20083,bright,main,6,0.9800249044867828,306,55,1,362
20083,bright,main,7,0.9952777822987483,300,53,5,358
20083,bright,main,8,0.9941304084685537,362,52,2,416
20083,bright,main,9,0.9914160089626899,333,91,4,428
1080,dark,main,0,0.9956771348875045,247,21,83,351
1080,dark,main,1,0.9879773722952361,223,17,90,330
1080,dark,main,2,0.9833746851356204,222,23,79,324
1080,dark,main,3,0.990199836646174,192,22,101,315
1080,dark,main,4,0.9850012282960373,213,16,75,304
1080,dark,main,5,0.9859745830277634,233,19,85,337
1080,dark,main,6,0.989595476958567,191,19,65,275
1080,dark,main,7,0.9935631714884288,200,23,72,295
1080,dark,main,8,0.9909110621695094,247,20,88,355
1080,dark,main,9,0.9897079962583359,239,16,95,350
1252,dark,main,0,0.9924265321980931,268,23,84,375
1252,dark,main,1,0.9917637046387697,222,23,98,343
1252,dark,main,2,0.996311265012271,260,23,81,364
1252,dark,main,3,0.9938732053328884,244,20,82,346
1252,dark,main,4,0.9850578109116737,247,20,69,336
1252,dark,main,5,0.9934100883128483,243,21,90,354
1252,dark,main,6,0.9948994364734874,211,29,72,312
1252,dark,main,7,0.9937905895455235,226,21,78,325
1252,dark,main,8,0.9911647015461237,263,27,77,367
1252,dark,main,9,0.9916549263784681,259,29,85,373
20089,bright,main,0,0.9969721958381795,239,80,2,321
20089,bright,main,1,0.986329225713291,287,79,3,369
20089,bright,main,2,0.9885575966208586,354,72,4,430
20089,bright,main,3,0.992818499923182,321,69,6,396
20089,bright,main,4,0.990904635399341,326,73,2,401
20089,bright,main,5,0.982951029299452,337,72,5,414
20089,bright,main,6,0.9926433738542104,303,67,1,371
20089,bright,main,7,0.9939162014361084,304,59,4,367
20089,bright,main,8,0.992263169586588,325,88,1,414
20089,bright,main,9,0.9932513717144102,337,88,4,429
20581,bright,main,0,0.9874528378649994,383,44,2,429
20581,bright,main,1,0.9889616714365739,343,48,4,395
20581,bright,main,2,0.9933000643557404,332,81,1,414
20581,bright,main,3,0.9927227671828575,313,70,4,387
20581,bright,main,4,0.9966559300755722,328,66,2,396
20581,bright,main,5,0.9895573743573124,350,46,5,401
20581,bright,main,6,0.9919646929774317,309,52,5,366
20581,bright,main,7,0.9916232725705617,287,62,1,350
20581,bright,main,8,0.9928561742156854,354,48,2,404
20581,bright,main,9,0.9950878996560664,376,44,3,423
20585,bright,main,0,0.9903642006389701,358,74,1,433
20585,bright,main,1,0.9950528561013856,341,55,1,397
20585,bright,main,2,0.9972232914642196,356,61,7,424
20585,bright,main,3,0.9894305444575734,329,58,5,392
20585,bright,main,4,0.9910761495864655,341,57,4,402
20585,bright,main,5,0.9938619589104728,362,46,5,413
20585,bright,main,6,0.9934246006959929,291,67,5,363
20585,bright,main,7,0.9942278494784508,271,85,4,360
20585,bright,main,8,0.9943130455952202,311,95,7,413
20585,bright,main,9,0.9929233174897416,331,88,5,424
1588,dark,main,0,0.9922131952402058,230,41,87,358
1588,dark,main,1,0.9862867644045581,245,21,95,361
1588,dark,main,2,0.9887462646474942,260,30,83,373
1588,dark,main,3,0.9862548539036464,215,21,97,333
1588,dark,main,4,0.9905756984195986,252,16,79,347
1588,dark,main,5,0.9906973391895239,242,16,95,353
1588,dark,main,6,0.992302979400139,220,32,73,325
1588,dark,main,7,0.9897002920664327,220,18,85,323
1588,dark,main,8,0.9914750090801744,272,19,76,367
1588,dark,main,9,0.9919995582762042,263,24,98,385
20573,bright,main,0,0.9955697005249148,364,66,5,435
20573,bright,main,1,0.9948561326718248,342,47,6,395
20573,bright,main,2,0.9968863687408223,339,72,6,417
20573,bright,main,3,0.9919115174426988,327,57,8,392
20573,bright,main,4,0.9905980733515201,325,69,3,397
20573,bright,main,5,0.9860332597421549,336,60,4,400
20573,bright,main,6,0.9881699646865516,341,29,1,371
20573,bright,main,7,0.9945254132919736,288,61,5,354
20573,bright,main,8,0.992724183896045,348,60,6,414
20573,bright,main,9,0.9923734532638142,351,66,0,417
20582,bright,main,0,0.9925998327032522,367,56,8,431
20582,bright,main,1,0.987318580026615,300,86,2,388
20582,bright,main,2,0.9941627666573014,364,56,5,425
20582,bright,main,3,0.9927160202361675,332,56,3,391
20582,bright,main,4,0.9924130756417348,312,80,2,394
20582,bright,main,5,0.9922308302141448,343,58,2,403
20582,bright,main,6,0.9899599302991439,301,57,3,361
20582,bright,main,7,0.9942959555840705,326,37,4,367
20582,bright,main,8,0.9921950981327137,362,51,4,417
20582,bright,main,9,0.9892489757154975,324,89,5,418
1766,dark,main,0,0.9884684311322975,289,14,88,391
1766,dark,main,1,0.9930314064325283,255,13,92,360
1766,dark,main,2,0.9928969077326869,272,24,76,372
1766,dark,main,3,0.9908546433550838,273,13,68,354
1766,dark,main,4,0.9971743994443653,260,18,85,363
1766,dark,main,5,0.9883575882802418,276,15,70,361
1766,dark,main,6,0.9927254221646137,240,13,76,329
1766,dark,main,7,0.9852757012158337,230,16,73,319
1766,dark,main,8,0.9899103921325669,274,15,98,387
1766,dark,main,9,0.9920493658042011,249,17,101,367
20004,bright,main,0,0.9926149125245096,341,81,3,425
20004,bright,main,1,0.9950429495657926,302,69,3,374
20004,bright,main,2,0.9895255031757016,328,83,2,413
20004,bright,main,3,0.9921852529134779,306,65,10,381
20004,bright,main,4,0.99347013038074,308,73,2,383
20004,bright,main,5,0.9860583885124856,323,66,5,394
20004,bright,main,6,0.9883777777443447,285,66,3,354
20004,bright,main,7,0.9878925229921975,275,68,3,346
20004,bright,main,8,0.9900311104457726,350,59,2,411
20004,bright,main,9,0.9869245782461631,320,88,4,412
1901,dark,main,0,0.9922530974100823,281,22,86,389
1901,dark,main,1,0.992089882945474,239,23,84,346
1901,dark,main,2,0.9829291665700811,264,21,97,382
1901,dark,main,3,0.9953398684789674,252,23,77,352
1901,dark,main,4,0.984489916469688,246,18,86,350
1901,dark,main,5,0.9854155062904988,275,21,73,369
1901,dark,main,6,0.9875106648998998,215,25,72,312
1901,dark,main,7,0.9824732036380004,187,18,44,249
1901,dark,main,8,0.9917680365174206,265,21,84,370
1901,dark,main,9,0.9960384176337936,279,21,65,365
1740,dark,main,0,0.9928773990226523,301,18,84,403
1740,dark,main,1,0.9919342207740978,257,16,90,363
1740,dark,main,2,0.994364007998054,271,14,91,376
1740,dark,main,3,0.9919055068821375,245,20,96,361
1740,dark,main,4,0.9898658391320025,244,17,98,359
1740,dark,main,5,0.9943198761857737,257,18,90,365
1740,dark,main,6,0.9851589003711639,229,16,76,321
1740,dark,main,7,0.9875126813397294,180,13,66,259
1740,dark,main,8,0.9877652086007088,275,18,89,382
1740,dark,main,9,0.9916173744937495,281,18,92,391
20791,bright,main,0,0.9914691886617607,327,90,4,421
20791,bright,main,1,0.9912245672617159,314,63,4,381
20791,bright,main,2,0.9914590984496833,365,52,5,422
20791,bright,main,3,0.9962384884621315,326,58,3,387
20791,bright,main,4,0.9862993093343554,329,59,8,396
20791,bright,main,5,0.9943775969232806,290,91,6,387
20791,bright,main,6,0.9919381893222609,287,62,1,350
20791,bright,main,7,0.9829895559229626,291,53,2,346
20791,bright,main,8,0.9961169615450972,355,50,5,410
20791,bright,main,9,0.9899216210383452,368,50,5,423
20641,bright,main,0,0.9939015044853314,354,68,4,426
20641,bright,main,1,0.9933192192914563,300,70,3,373
20641,bright,main,2,0.9913835572616397,331,58,3,392
20641,bright,main,3,0.9932856719890822,335,48,3,386
20641,bright,main,4,0.992366704979782,322,63,4,389
20641,bright,main,5,0.9868746914774785,324,66,3,393
20641,bright,main,6,0.9930798668049473,296,53,2,351
20641,bright,main,7,0.9914670189211521,291,46,2,339
20641,bright,main,8,0.992602116801443,369,49,2,420
20641,bright,main,9,0.9949592145477298,352,53,5,410
1757,dark,main,0,0.9916716772702338,282,23,85,390
1757,dark,main,1,0.9929808677980161,243,27,89,359
1757,dark,main,2,0.9920693055437825,273,23,82,378
1757,dark,main,3,0.9945583274241304,244,24,96,364
1757,dark,main,4,0.9845840192815882,253,17,87,357
1757,dark,main,5,0.9891256134855052,247,15,94,356
1757,dark,main,6,0.9877069480703266,233,17,86,336
1757,dark,main,7,0.9866714552508267,172,20,63,255
1757,dark,main,8,0.9844166742358321,274,22,79,375
1757,dark,main,9,0.9949592873908105,280,25,76,381
1727,dark,main,0,0.9914212026874575,272,28,87,387
1727,dark,main,1,0.9873437522336844,247,17,93,357
1727,dark,main,2,0.9957150549114595,293,17,79,389
1727,dark,main,3,0.9933685897072524,248,22,87,357
1727,dark,main,4,0.9946565528757672,260,17,87,364
1727,dark,main,5,0.9855405127110428,248,17,101,366
1727,dark,main,6,0.9906631713100543,250,15,68,333
1727,dark,main,7,0.9909360775469446,219,18,83,320
1727,dark,main,8,0.982687732155456,252,14,106,372
1727,dark,main,9,0.9961806825539284,267,16,83,366
20109,bright,main,0,0.990194279445059,378,60,2,440
20109,bright,main,1,0.9935489386277466,313,72,5,390
20109,bright,main,2,0.9946718458644909,303,116,2,421
20109,bright,main,3,0.978033502614791,302,89,2,393
20109,bright,main,4,0.9941437496745112,312,84,1,397
20109,bright,main,5,0.9898782397558443,350,55,6,411
20109,bright,main,6,0.9915671489162057,310,50,4,364
20109,bright,main,7,0.9923037965843333,302,55,2,359
20109,bright,main,8,0.9910205613471929,355,58,2,415
20109,bright,main,9,0.9873187162647987,353,65,4,422
1790,dark,main,0,0.992895059920553,280,19,81,380
1790,dark,main,1,0.9951766848985262,253,22,71,346
1790,dark,main,2,0.9904320970740966,282,22,73,377
1790,dark,main,3,0.9886328819844803,243,19,82,344
1790,dark,main,4,0.9891993035192672,260,19,73,352
1790,dark,main,5,0.9925539670870186,241,21,89,351
1790,dark,main,6,0.9906519051378522,235,15,73,323
1790,dark,main,7,0.9820380115749984,179,18,63,260
1790,dark,main,8,0.9855949328288216,223,34,84,341
1790,dark,main,9,0.9894850226068236,256,23,85,364
2204,dark,main,0,0.9885646928965462,290,13,97,400
2204,dark,main,1,0.9899779086114615,267,10,83,360
2204,dark,main,2,0.9924093606278181,279,17,83,379
2204,dark,main,3,0.9945152255169608,273,15,77,365
2204,dark,main,4,0.9883185912733712,260,14,90,364
2204,dark,main,5,0.9927280124204191,278,12,88,378
2204,dark,main,6,0.9930356696939929,255,17,68,340
2204,dark,main,7,0.9755786394134833,237,16,72,325
2204,dark,main,8,0.984509136855506,273,12,92,377
2204,dark,main,9,0.9906418449463608,301,16,83,400
1773,dark,main,0,0.9951686617521306,291,16,89,396
1773,dark,main,1,0.9871613615845635,247,13,93,353
1773,dark,main,2,0.9924199943817854,276,23,87,386
1773,dark,main,3,0.9896441990495325,255,16,80,351
1773,dark,main,4,0.9936335054583185,254,12,90,356
1773,dark,main,5,0.9919203575205658,253,14,101,368
1773,dark,main,6,0.9829852309761972,225,22,77,324
1773,dark,main,7,0.9938284585363195,219,13,79,311
1773,dark,main,8,0.9932056295861921,268,13,87,368
1773,dark,main,9,0.9917342084489316,280,12,88,380
20646,bright,main,0,0.994099836358057,343,63,5,411
20646,bright,main,1,0.9902389174511682,294,71,6,371
20646,bright,main,2,0.9904903972730572,347,53,5,405
20646,bright,main,3,0.9851739733942498,296,66,3,365
20646,bright,main,4,0.9869280131411429,346,43,3,392
20646,bright,main,5,0.9926081603173137,316,64,1,381
20646,bright,main,6,0.9900897900722513,309,42,1,352
20646,bright,main,7,0.9883080483586093,276,66,6,348
20646,bright,main,8,0.9958429446119148,349,62,4,415
20646,bright,main,9,0.9932716860282783,353,46,7,406
21204,bright,main,0,0.9926899845830771,360,56,4,420
21204,bright,main,1,0.9939328434856368,311,66,7,384
21204,bright,main,2,0.9923367858433689,340,57,5,402
21204,bright,main,3,0.9920202369387641,299,72,2,373
21204,bright,main,4,0.9931670500985135,313,72,5,390
21204,bright,main,5,0.991835902834348,310,72,2,384
21204,bright,main,6,0.9924274494140458,286,64,2,352
21204,bright,main,7,0.9897919635702368,271,68,8,347
21204,bright,main,8,0.9900297288139572,317,76,4,397
21204,bright,main,9,0.9927438257800328,370,46,2,418
1734,dark,main,0,0.9909196607783112,274,22,100,396
1734,dark,main,1,0.9861175830987081,266,15,83,364
1734,dark,main,2,0.9881500702798275,269,21,91,381
1734,dark,main,3,0.9833450840545892,266,15,77,358
1734,dark,main,4,0.9814070722637558,269,15,77,361
1734,dark,main,5,0.9933949447801024,237,30,102,369
1734,dark,main,6,0.988528749008707,228,16,94,338
1734,dark,main,7,0.9974834622762389,244,16,69,329
1734,dark,main,8,0.9959048997784806,272,18,84,374
1734,dark,main,9,0.9903544474945378,259,20,101,380
20588,bright,main,0,0.9922767129323602,321,109,5,435
20588,bright,main,1,0.9933598674420304,298,94,2,394
20588,bright,main,2,0.9886116089690491,294,114,3,411
20588,bright,main,3,0.9926759153413732,283,103,0,386
20588,bright,main,4,0.9925806807500693,343,59,1,403
20588,bright,main,5,0.9948327166599595,346,55,2,403
20588,bright,main,6,0.9979732074431091,288,68,5,361
20588,bright,main,7,0.9933462878112496,263,88,2,353
20588,bright,main,8,0.9913792904372947,335,75,1,411
20588,bright,main,9,0.988937952253768,317,92,8,417
21220,bright,main,0,0.991716200336364,356,66,5,427
21220,bright,main,1,0.9903805023575087,345,38,3,386
21220,bright,main,2,0.9934055856033867,339,61,8,408
21220,bright,main,3,0.9903361908662061,308,65,2,375
21220,bright,main,4,0.9925365682455448,322,68,1,391
21220,bright,main,5,0.995978995965056,346,62,2,410
21220,bright,main,6,0.9951070391872197,315,40,2,357
21220,bright,main,7,0.9901290117380371,275,68,6,349
21220,bright,main,8,0.996930229362183,358,51,1,410
21220,bright,main,9,0.9938339643312665,347,64,3,414
1739,dark,main,0,0.9857744700545554,286,16,91,393
1739,dark,main,1,0.9876732680479318,241,27,80,348
1739,dark,main,2,0.9916832956603353,267,17,90,374
1739,dark,main,3,0.9929387129612012,251,19,78,348
1739,dark,main,4,0.9890277799682967,268,21,76,365
1739,dark,main,5,0.9929988509127025,262,21,79,362
1739,dark,main,6,0.9967732496196983,218,18,82,318
1739,dark,main,7,0.9881664491378648,197,17,51,265
1739,dark,main,8,0.983894915439807,281,16,81,378
1739,dark,main,9,0.9900683024091701,284,17,90,391
1895,dark,main,0,0.9936259353767253,263,26,82,371
1895,dark,main,1,0.9914830765923808,233,18,83,334
1895,dark,main,2,0.9948921039657935,247,21,93,361
1895,dark,main,3,0.9936454986131059,237,35,73,345
1895,dark,main,4,0.9925744323549761,234,24,93,351
1895,dark,main,5,0.9917098749329188,255,22,78,355
1895,dark,main,6,0.9933827068904019,233,17,66,316
1895,dark,main,7,0.9878925584803611,176,19,59,254
1895,dark,main,8,0.9894691432079612,257,32,91,380
1895,dark,main,9,0.9937204209480791,268,28,93,389
1731,dark,main,0,0.9947933729412233,279,21,80,380
1731,dark,main,1,0.9857356495244254,260,21,75,356
1731,dark,main,2,0.9877534072841194,266,16,100,382
1731,dark,main,3,0.9939962798765152,245,24,84,353
1731,dark,main,4,0.9882302155131866,242,18,98,358
1731,dark,main,5,0.9941169359516324,261,21,85,367
1731,dark,main,6,0.9946343849635634,229,20,73,322
1731,dark,main,7,0.9906903642073528,171,16,66,253
1731,dark,main,8,0.9890267486169213,258,20,92,370
1731,dark,main,9,0.9910684687430178,272,18,95,385
20765,bright,main,0,0.9933412031060255,381,55,2,438
20765,bright,main,1,0.9932146537110182,350,45,3,398
20765,bright,main,2,0.9928901353318466,353,64,3,420
20765,bright,main,3,0.985995420026985,324,64,3,391
20765,bright,main,4,0.9923131137195182,325,64,5,394
20765,bright,main,5,0.9870664555222782,361,40,6,407
20765,bright,main,6,0.9925578341318779,317,44,4,365
20765,bright,main,7,0.988782870258105,294,59,3,356
20765,bright,main,8,0.9834469579676524,330,79,2,411
20765,bright,main,9,0.9932274416406387,354,67,2,423
1728,dark,main,0,0.9949557356483906,276,15,95,386
1728,dark,main,1,0.9898552639578034,230,28,100,358
1728,dark,main,2,0.9888306752152479,260,15,98,373
1728,dark,main,3,0.9913936215402369,269,16,76,361
1728,dark,main,4,0.9914984338515731,260,14,89,363
1728,dark,main,5,0.992792723829449,254,17,95,366
1728,dark,main,6,0.9951951567533,242,15,73,330
1728,dark,main,7,0.9917297080163177,239,19,69,327
1728,dark,main,8,0.9819380050233175,263,19,96,378
1728,dark,main,9,0.9942743523523037,258,19,85,362
1759,dark,main,0,0.996049945845563,289,18,76,383
1759,dark,main,1,0.9937184392954694,262,18,80,360
1759,dark,main,2,0.994287921898038,267,20,91,378
1759,dark,main,3,0.9932464125640204,253,23,85,361
1759,dark,main,4,0.9902783778112568,244,27,87,358
1759,dark,main,5,0.9924651111798704,274,16,85,375
1759,dark,main,6,0.985508074103771,238,14,79,331
1759,dark,main,7,0.9910093471317191,172,22,61,255
1759,dark,main,8,0.9915616484716371,259,26,83,368
1759,dark,main,9,0.9939200033854859,267,24,84,375
1741,dark,main,0,0.9930329698571614,286,21,82,389
1741,dark,main,1,0.9872382454621622,263,17,80,360
1741,dark,main,2,0.9910544644460483,231,35,87,353
1741,dark,main,3,0.9849994920990088,243,23,89,355
1741,dark,main,4,0.9842759924840571,254,23,91,368
1741,dark,main,5,0.9876018378181407,238,22,99,359
1741,dark,main,6,0.9956175741650835,211,17,83,311
1741,dark,main,7,0.9900652595146191,184,16,57,257
1741,dark,main,8,0.9876366872751149,240,21,98,359
1741,dark,main,9,0.9957007566665255,281,19,87,387
21206,bright,main,0,0.990677875486026,363,52,3,418
21206,bright,main,1,0.9896016391485285,351,39,4,394
21206,bright,main,2,0.9847243050078139,329,74,2,405
21206,bright,main,3,0.9906524873888162,314,61,5,380
21206,bright,main,4,0.9941267635458588,324,54,5,383
21206,bright,main,5,0.9951213788565917,331,58,2,391
21206,bright,main,6,0.9932588137409805,297,53,5,355
21206,bright,main,7,0.9944210671638152,296,54,1,351
21206,bright,main,8,0.9867755102615755,322,73,3,398
21206,bright,main,9,0.9908136345452506,359,56,5,420
1928,dark,main,0,0.9900986521820853,279,21,81,381
1928,dark,main,1,0.9912317402058686,229,16,97,342
1928,dark,main,2,0.9828634501678207,259,36,78,373
1928,dark,main,3,0.9912066054046804,261,22,74,357
1928,dark,main,4,0.9939816482832592,206,21,59,286
1928,dark,main,5,0.9937974850368892,244,20,84,348
1928,dark,main,6,0.9791617614237386,208,22,81,311
1928,dark,main,7,0.9885968759183592,202,23,72,297
1928,dark,main,8,0.9869830252792706,264,28,82,374
1928,dark,main,9,0.9889516187483479,247,22,87,356
20212,bright,main,0,0.9930424586172566,346,90,5,441
20212,bright,main,1,0.9901967413321611,309,89,2,400
20212,bright,main,2,0.9928070914495316,328,101,2,431
20212,bright,main,3,0.9942319495539785,259,137,2,398
20212,bright,main,4,0.9927769878596698,297,58,2,357
20212,bright,main,5,0.9854676672912325,310,80,4,394
20212,bright,main,6,0.9885247000916704,287,82,1,370
20212,bright,main,7,0.9894073708659841,281,73,3,357
20212,bright,main,8,0.990973186650745,297,118,3,418
20212,bright,main,9,0.9902500627723039,309,114,7,430
20779,bright,main,0,0.9925899681348009,361,61,1,423
20779,bright,main,1,0.9933951359361849,316,65,0,381
20779,bright,main,2,0.9958091193770985,328,78,4,410
20779,bright,main,3,0.9844215141248218,315,60,6,381
20779,bright,main,4,0.9865812180364093,293,39,2,334
20779,bright,main,5,0.9916995073895724,314,66,5,385
20779,bright,main,6,0.9943555868708965,282,72,1,355
20779,bright,main,7,0.9920203957552078,285,59,0,344
20779,bright,main,8,0.9898881196156158,334,63,5,402
20779,bright,main,9,0.9976961759255728,343,66,5,414
20775,bright,main,0,0.9896860330248606,382,45,6,433
20775,bright,main,1,0.987465363646338,333,53,4,390
20775,bright,main,2,0.9961713246587303,351,61,5,417
20775,bright,main,3,0.9935600343356193,304,70,3,377
20775,bright,main,4,0.9951151718944701,246,77,1,324
20775,bright,main,5,0.9916971515483851,311,72,4,387
20775,bright,main,6,0.9944796153028267,273,76,3,352
20775,bright,main,7,0.9898305221520195,258,72,2,332
20775,bright,main,8,0.9924501146757798,360,53,4,417
20775,bright,main,9,0.9936687038148666,376,42,7,425
20768,bright,main,0,0.9954820689101799,342,81,5,428
20768,bright,main,1,0.9894857793939672,327,59,4,390
20768,bright,main,2,0.9954904541995914,347,66,3,416
20768,bright,main,3,0.9893676389964053,285,86,5,376
20768,bright,main,4,0.9870003250583123,272,65,1,338
20768,bright,main,5,0.9917052676575802,339,65,1,405
20768,bright,main,6,0.9897572548666517,270,84,4,358
20768,bright,main,7,0.9875819864169005,254,85,4,343
20768,bright,main,8,0.9887191164065249,343,57,4,404
20768,bright,main,9,0.9957294897975787,354,58,0,412
20405,bright,main,0,0.9927064523705631,341,94,8,443
20405,bright,main,1,0.9928381049424928,304,91,7,402
20405,bright,main,2,0.9975571982714372,341,89,5,435
20405,bright,main,3,0.9856677522565633,303,92,3,398
20405,bright,main,4,0.9872667767739708,267,78,6,351
20405,bright,main,5,0.9906892375843421,323,86,5,414
20405,bright,main,6,0.9926950522325959,282,91,1,374
20405,bright,main,7,0.9916092468085436,275,86,1,362
20405,bright,main,8,0.9932043588516063,340,83,5,428
20405,bright,main,9,0.9933832141882005,336,94,5,435
1735,dark,main,0,0.9968377749684246,289,18,85,392
1735,dark,main,1,0.9948375023592464,262,15,87,364
1735,dark,main,2,0.9945732036593912,272,18,91,381
1735,dark,main,3,0.988971517524799,267,14,86,367
1735,dark,main,4,0.9857954929604091,237,17,70,324
1735,dark,main,5,0.992353215286149,267,16,94,377
1735,dark,main,6,0.98461237635133,221,20,89,330
1735,dark,main,7,0.9863056952046453,229,16,73,318
1735,dark,main,8,0.9898441250001558,287,26,79,392
1735,dark,main,9,0.9892202234723403,283,20,79,382
21167,bright,main,0,0.9879772675733044,322,83,1,406
21167,bright,main,1,0.9900496946314788,317,49,3,369
21167,bright,main,2,0.9882718727533126,311,84,3,398
21167,bright,main,3,0.988380936137876,281,76,4,361
21167,bright,main,4,0.9913635578019048,259,75,1,335
21167,bright,main,5,0.9941308805111421,293,76,6,375
21167,bright,main,6,0.9889499474198418,303,52,3,358
21167,bright,main,7,0.9911434013328457,273,63,3,339
21167,bright,main,8,0.9897559923843827,318,77,3,398
21167,bright,main,9,0.9937562381535514,335,73,4,412
20911,bright,main,0,0.9938942114788225,342,99,2,443
20911,bright,main,1,0.9908098216184288,349,51,4,404
20911,bright,main,2,0.9899503119293668,352,79,4,435
20911,bright,main,3,0.9933879636430037,316,77,5,398
20911,bright,main,4,0.9952815358959866,302,49,0,351
20911,bright,main,5,0.9924968075972133,340,71,3,414
20911,bright,main,6,0.9921108883163897,295,64,2,361
20911,bright,main,7,0.9904376090590701,264,83,1,348
20911,bright,main,8,0.9914629070288051,344,75,4,423
20911,bright,main,9,0.9929847510776697,356,75,2,433
20918,bright,main,0,0.9955444781370282,334,106,3,443
20918,bright,main,1,0.9932241792460639,302,98,4,404
20918,bright,main,2,0.9900612169136604,355,72,6,433
20918,bright,main,3,0.9895290809687083,299,94,5,398
20918,bright,main,4,0.9876749385869745,288,61,4,353
20918,bright,main,5,0.9923589238740272,338,71,4,413
20918,bright,main,6,0.9948982309492403,287,79,5,371
20918,bright,main,7,0.9899595567844989,299,61,2,362
20918,bright,main,8,0.9921739168585089,367,58,3,428
20918,bright,main,9,0.9939797002112337,332,103,4,439
21194,bright,main,0,0.9965256534268728,334,69,8,411
21194,bright,main,1,0.9879745804280078,307,71,3,381
21194,bright,main,2,0.9929671073882693,352,52,4,408
21194,bright,main,3,0.995367493124989,308,68,3,379
21194,bright,main,4,0.9880638074285648,279,52,5,336
21194,bright,main,5,0.9937494043271384,326,63,2,391
21194,bright,main,6,0.9907938417486423,314,39,5,358
21194,bright,main,7,0.9872604824474253,256,70,4,330
21194,bright,main,8,0.9934888708595875,328,74,2,404
21194,bright,main,9,0.9941949278375483,323,75,3,401
1927,dark,main,0,0.9933051384631245,273,31,85,389
1927,dark,main,1,0.9935417719346252,223,29,76,328
1927,dark,main,2,0.991003379317465,245,21,105,371
1927,dark,main,3,0.9930257331875382,263,22,75,360
1927,dark,main,4,0.9813551467692062,208,34,74,316
1927,dark,main,5,0.9923650156057294,258,16,84,358
1927,dark,main,6,0.9892843192563783,234,23,63,320
1927,dark,main,7,0.9905926291685243,223,31,62,316
1927,dark,main,8,0.9849796992050543,268,25,80,373
1927,dark,main,9,0.9758319010300027,134,9,46,189
21180,bright,main,0,0.9943306194894972,338,74,6,418
21180,bright,main,1,0.9916627612310301,310,60,6,376
21180,bright,main,2,0.990048364244584,314,69,6,389
21180,bright,main,3,0.9884226132014449,295,69,0,364
21180,bright,main,4,0.9855581196506569,275,48,5,328
21180,bright,main,5,0.9950963378402975,341,44,8,393
21180,bright,main,6,0.9915471727115658,279,63,4,346
21180,bright,main,7,0.9938688500859622,288,47,1,336
21180,bright,main,8,0.9958471640549208,341,52,5,398
21180,bright,main,9,0.9921253192110663,352,54,3,409
20199,bright,main,0,0.9922934196161485,370,60,4,434
20199,bright,main,1,0.9937245119089746,316,66,6,388
20199,bright,main,2,0.9960530762313204,347,74,4,425
20199,bright,main,3,0.9954463934544237,308,78,2,388
20199,bright,main,4,0.996293246610536,272,65,5,342
20199,bright,main,5,0.9958330264161634,326,68,5,399
20199,bright,main,6,0.9910550150149798,300,54,8,362
20199,bright,main,7,0.991850290155295,277,73,3,353
20199,bright,main,8,0.9935569300001853,326,83,5,414
20199,bright,main,9,0.9905679338744681,317,97,7,421
1913,dark,main,0,0.9890795715209251,255,35,97,387
1913,dark,main,1,0.9889333007171096,253,23,74,350
1913,dark,main,2,0.9947280698446034,249,33,94,376
1913,dark,main,3,0.9940807300908138,237,32,79,348
1913,dark,main,4,0.9910033957264557,218,18,62,298
1913,dark,main,5,0.9922670056648095,236,36,92,364
1913,dark,main,6,0.9962778805799463,215,31,57,303
1913,dark,main,7,0.9927974833573926,204,33,70,307
1913,dark,main,8,0.993374947919563,262,32,70,364
1913,dark,main,9,0.9857640145802549,242,35,88,365
20655,bright,main,0,0.9923295102568148,307,86,3,396
20655,bright,main,1,0.99065869944437,296,72,6,374
20655,bright,main,2,0.9917326333885428,323,62,2,387
20655,bright,main,3,0.9931590991435642,326,50,2,378
20655,bright,main,4,0.9931590991435642,326,50,2,378
20655,bright,main,5,0.9925724873884246,314,69,2,385
20655,bright,main,6,0.9887476570490507,290,51,5,346
20655,bright,main,7,0.9903271311891534,266,60,4,330
20655,bright,main,8,0.9952757747380108,349,57,3,409
20655,bright,main,9,0.994172792455048,328,66,3,397
20750,bright,main,0,0.9920150467857692,359,76,3,438
20750,bright,main,1,0.9933487502054741,317,74,5,396
20750,bright,main,2,0.9892855381010931,347,75,4,426
20750,bright,main,3,0.9947960914673589,309,83,3,395
20750,bright,main,4,0.9888333644448025,287,65,1,353
20750,bright,main,5,0.9921457483722813,332,70,4,406
20750,bright,main,6,0.9904713780748119,306,65,0,371
20750,bright,main,7,0.9905841658396553,286,68,3,357
20750,bright,main,8,0.9890757460603975,345,76,5,426
20750,bright,main,9,0.992322295506697,334,96,3,433
21071,bright,main,0,0.9914323794300218,338,86,4,428
21071,bright,main,1,0.9891705049840811,313,87,2,402
21071,bright,main,2,0.9898050447991558,324,103,2,429
21071,bright,main,3,0.9918102975220566,291,109,3,403
21071,bright,main,4,0.9929844496581658,337,62,3,402
21071,bright,main,5,0.9928886045063551,304,106,4,414
21071,bright,main,6,0.989184989036875,280,92,3,375
21071,bright,main,7,0.9901159888740995,269,97,3,369
21071,bright,main,8,0.9915581247570712,303,122,5,430
21071,bright,main,9,0.9934795608284824,336,85,3,424
1911,dark,main,0,0.9958665749603725,271,30,84,385
1911,dark,main,1,0.993092450960256,229,24,81,334
1911,dark,main,2,0.9918322603191888,255,35,85,375
1911,dark,main,3,0.9916746492894289,218,23,93,334
1911,dark,main,4,0.9854397400981769,209,23,73,305
1911,dark,main,5,0.9903635006590671,263,18,66,347
1911,dark,main,6,0.9867857743127049,215,33,74,322
1911,dark,main,7,0.9914722592366266,213,23,76,312
1911,dark,main,8,0.9835407890199849,271,21,95,387
1911,dark,main,9,0.9962859979719092,253,29,94,376
20427,bright,main,0,0.9947720901556744,324,101,7,432
20427,bright,main,1,0.9900232876555678,301,96,6,403
20427,bright,main,2,0.9916336476161631,293,125,7,425
20427,bright,main,3,0.9961131818299923,271,128,1,400
20427,bright,main,4,0.9900170287735223,283,74,4,361
20427,bright,main,5,0.9918726077616317,317,79,7,403
20427,bright,main,6,0.9901905778735345,263,98,4,365
20427,bright,main,7,0.9930014478941999,264,94,3,361
20427,bright,main,8,0.9909305036074163,322,91,5,418
20427,bright,main,9,0.9905469126449793,300,130,4,434
20774,bright,main,0,0.9942168350944942,353,59,4,416
20774,bright,main,1,0.9874260380375303,325,56,7,388
20774,bright,main,2,0.988986944439065,333,79,4,416
20774,bright,main,3,0.9892262398758992,324,53,5,382
20774,bright,main,4,0.9915103269064919,295,46,4,345
20774,bright,main,5,0.9917287150984758,350,36,7,393
20774,bright,main,6,0.9917287150984758,350,36,7,393
20774,bright,main,7,0.991849289016207,279,62,6,347
20774,bright,main,8,0.9872947985367079,343,58,6,407
20774,bright,main,9,0.9904313528254726,320,77,3,400
20235,bright,main,0,0.9935239800390744,342,87,3,432
20235,bright,main,1,0.9943514549552729,280,112,3,395
20235,bright,main,2,0.9913933439782413,300,116,4,420
20235,bright,main,3,0.9929883355190925,300,89,8,397
20235,bright,main,4,0.9894087091681124,271,78,6,355
20235,bright,main,5,0.9933072130072748,353,50,1,404
20235,bright,main,6,0.9923367561739805,303,58,4,365
20235,bright,main,7,0.9932403032791173,291,63,2,356
20235,bright,main,8,0.9949528118982233,310,108,6,424
20235,bright,main,9,0.9965165384606334,350,76,0,426
20430,bright,main,0,0.9965376583870542,345,92,2,439
20430,bright,main,1,0.9927370666878866,255,117,4,376
20430,bright,main,2,0.9927897320434173,311,119,2,432
20430,bright,main,3,0.9940398016355037,291,109,2,402
20430,bright,main,4,0.9929410704188948,281,81,5,367
20430,bright,main,5,0.9890219217035262,326,80,4,410
20430,bright,main,6,0.9812265111048284,285,78,1,364
20430,bright,main,7,0.9908634112577464,266,91,1,358
20430,bright,main,8,0.9910984620519909,353,73,1,427
20430,bright,main,9,0.9887209909397955,361,72,1,434
20418,bright,main,0,0.9961195254405533,345,95,3,443
20418,bright,main,1,0.9913696822356116,330,70,4,404
20418,bright,main,2,0.9894387964271474,338,96,3,437
20418,bright,main,3,0.9903674048347317,308,80,5,393
20418,bright,main,4,0.9930270795449517,281,79,3,363
20418,bright,main,5,0.9928324522510182,323,85,4,412
20418,bright,main,6,0.9958133680177922,286,82,1,369
20418,bright,main,7,0.9921100170732927,253,101,2,356
20418,bright,main,8,0.9890475268006035,331,97,2,430
20418,bright,main,9,0.9943338759312863,339,96,0,435
20766,bright,main,0,0.9918881178208911,340,84,5,429
20766,bright,main,1,0.9958521566426267,277,97,4,378
20766,bright,main,2,0.9901515929198463,298,96,3,397
20766,bright,main,3,0.9953840312423434,282,87,2,371
20766,bright,main,4,0.9906039846950256,267,78,3,348
20766,bright,main,5,0.996817306967087,318,69,2,389
20766,bright,main,6,0.990466825313779,260,85,5,350
20766,bright,main,7,0.9904672054032082,243,91,1,335
20766,bright,main,8,0.9922773079007353,343,66,6,415
20766,bright,main,9,0.9964962724923628,328,89,3,420
1427,dark,main,0,0.9835397931881698,222,68,73,363
1427,dark,main,1,0.9892108699664693,217,57,72,346
1427,dark,main,2,0.9925629421328269,231,47,90,368
1427,dark,main,3,0.9923769924096209,190,56,81,327
1427,dark,main,4,0.9799875714999822,227,36,59,322
1427,dark,main,5,0.9952495382512059,201,53,84,338
1427,dark,main,6,0.9925249898877234,185,55,65,305
1427,dark,main,7,0.9897789306936033,179,51,61,291
1427,dark,main,8,0.9903548059118444,226,67,62,355
1427,dark,main,9,0.9913561143617964,234,62,67,363
20425,bright,main,0,0.9939838766565304,340,88,3,431
20425,bright,main,1,0.9953409102227925,289,100,6,395
20425,bright,main,2,0.9877321573929774,239,81,3,323
20425,bright,main,3,0.9941954321671508,281,111,2,394
20425,bright,main,4,0.9914967840032091,261,98,4,363
20425,bright,main,5,0.9926812713900054,312,94,1,407
20425,bright,main,6,0.9919607630677838,289,77,4,370
20425,bright,main,7,0.9835895929933691,293,67,2,362
20425,bright,main,8,0.9868098965855894,331,80,4,415
20425,bright,main,9,0.9859385007333545,323,99,2,424
20835,bright,main,0,0.9946108095645891,327,109,3,439
20835,bright,main,1,0.9873681426394703,283,107,7,397
20835,bright,main,2,0.9965398434083843,322,97,7,426
20835,bright,main,3,0.9895246546476031,287,111,2,400
20835,bright,main,4,0.9934046710409861,271,85,4,360
20835,bright,main,5,0.9903727893124211,307,105,2,414
20835,bright,main,6,0.9899564728400821,268,102,2,372
20835,bright,main,7,0.9862202148020678,255,102,0,357
20835,bright,main,8,0.994685280860444,294,122,7,423
20835,bright,main,9,0.9877871653354415,316,110,4,430
21190,bright,main,0,0.9781582476272341,367,54,4,425
21190,bright,main,1,0.9917711232955011,325,46,1,372
21190,bright,main,2,0.9930158019879842,355,50,4,409
21190,bright,main,3,0.9958879814308789,323,50,1,374
21190,bright,main,4,0.9903041441412923,273,45,4,322
21190,bright,main,5,0.9966583712059842,351,39,7,397
21190,bright,main,6,0.9915732568617777,297,49,3,349
21190,bright,main,7,0.9936872993525757,289,42,3,334
21190,bright,main,8,0.9944394574123397,342,55,1,398
21190,bright,main,9,0.992933749370423,318,58,7,383
20930,bright,main,0,0.996269881059391,319,110,4,433
20930,bright,main,1,0.9958547581342622,300,106,1,407
20930,bright,main,2,0.9940288120942516,311,121,3,435
20930,bright,main,3,0.9952478456512399,343,58,2,403
20930,bright,main,4,0.9904702656243447,286,75,2,363
20930,bright,main,5,0.9869753462763262,343,69,3,415
20930,bright,main,6,0.9900422279641767,279,91,1,371
20930,bright,main,7,0.9915867116861672,276,84,0,360
20930,bright,main,8,0.9808147320686108,326,87,6,419
20930,bright,main,9,0.9931756381049244,337,83,3,423
20243,bright,main,0,0.9934157438188547,341,93,3,437
20243,bright,main,1,0.9928884496873203,301,86,6,393
20243,bright,main,2,0.9955491609413247,316,103,2,421
20243,bright,main,3,0.9937092690112945,311,75,3,389
20243,bright,main,4,0.9882185128036797,295,53,3,351
20243,bright,main,5,0.9938342241765671,346,63,2,411
20243,bright,main,6,0.9960210952422367,296,59,3,358
20243,bright,main,7,0.9924953577221299,286,54,4,344
20243,bright,main,8,0.9950294514215967,320,89,1,410
20243,bright,main,9,0.9932243050118873,307,111,6,424
20773,bright,main,0,0.9943878227478365,337,86,2,425
20773,bright,main,1,0.9934891939274084,292,82,3,377
20773,bright,main,2,0.9932064961371985,317,79,8,404
20773,bright,main,3,0.9890236736473953,318,52,0,370
20773,bright,main,4,0.9892286914455303,303,44,5,352
20773,bright,main,5,0.9928566954539001,341,54,7,402
20773,bright,main,6,0.9914605275100198,308,47,3,358
20773,bright,main,7,0.9897644118161223,293,47,4,344
20773,bright,main,8,0.9932876371210709,296,105,2,403
20773,bright,main,9,0.9973993226831035,340,74,7,421
20393,bright,main,0,0.987923025134044,301,131,3,435
20393,bright,main,1,0.9896052796726124,284,118,4,406
20393,bright,main,2,0.9946806733548387,299,128,4,431
20393,bright,main,3,0.996140196367867,291,105,4,400
20393,bright,main,4,0.9925652737220619,263,113,7,383
20393,bright,main,5,0.9959501148425932,305,106,2,413
20393,bright,main,6,0.9926367868284357,293,77,2,372
20393,bright,main,7,0.9900087978913702,247,106,3,356
20393,bright,main,8,0.9906529089757595,303,113,3,419
20393,bright,main,9,0.9908957143240426,283,136,5,424
20253,bright,main,0,0.9914842690854464,362,76,3,441
20253,bright,main,1,0.992178057314154,300,96,3,399
20253,bright,main,2,0.991857356322703,323,103,5,431
20253,bright,main,3,0.9923018101229166,337,63,0,400
20253,bright,main,4,0.989058055093557,299,76,3,378
20253,bright,main,5,0.9956974630238309,299,106,3,408
20253,bright,main,6,0.9863121335632251,267,96,2,365
20253,bright,main,7,0.9868709487349356,266,82,5,353
20253,bright,main,8,0.9864839184596805,353,65,4,422
20253,bright,main,9,0.9897516965103632,361,67,3,431
20915,bright,main,0,0.9933683640636333,338,92,5,435
20915,bright,main,1,0.9940940200938753,313,82,4,399
20915,bright,main,2,0.9928460272783022,361,63,2,426
20915,bright,main,3,0.9892096494127904,315,86,2,403
20915,bright,main,4,0.9882294360022993,311,70,4,385
20915,bright,main,5,0.9902201521621137,331,82,3,416
20915,bright,main,6,0.9926108174602748,295,77,1,373
20915,bright,main,7,0.9936575712099653,260,97,2,359
20915,bright,main,8,0.9942080025418932,344,71,4,419
20915,bright,main,9,0.9936492148101493,312,117,6,435
20254,bright,main,0,0.9952098577788198,360,74,2,436
20254,bright,main,1,0.9930695155271373,332,64,3,399
20254,bright,main,2,0.9923482636690764,351,73,5,429
20254,bright,main,3,0.9973218862927674,348,47,4,399
20254,bright,main,4,0.9908233632039138,327,52,3,382
20254,bright,main,5,0.9954604302289644,318,81,7,406
20254,bright,main,6,0.9856520599369641,315,53,3,371
20254,bright,main,7,0.9870158934269005,270,74,4,348
20254,bright,main,8,0.9942054921435757,333,83,4,420
20254,bright,main,9,0.9955480834472465,325,103,4,432
20424,bright,main,0,0.9927053571293328,342,89,2,433
20424,bright,main,1,0.9948818642244187,307,95,5,407
20424,bright,main,2,0.9904620554780307,324,100,7,431
20424,bright,main,3,0.9884100556787466,300,100,1,401
20424,bright,main,4,0.9860136559994587,284,90,3,377
20424,bright,main,5,0.9965658854684942,293,118,4,415
20424,bright,main,6,0.9889360162219021,288,81,3,372
20424,bright,main,7,0.9874508114698041,273,85,3,361
20424,bright,main,8,0.9944068672931171,355,58,1,414
20424,bright,main,9,0.9936628880200475,354,78,2,434
20909,bright,main,0,0.9945901264417168,342,85,3,430
20909,bright,main,1,0.9943223674466988,364,40,3,407
20909,bright,main,2,0.9919480584796244,348,76,7,431
20909,bright,main,3,0.9865093668556738,307,89,4,400
20909,bright,main,4,0.9877887564256844,291,82,7,380
20909,bright,main,5,0.9914212042362154,316,96,3,415
20909,bright,main,6,0.9939086201175857,284,88,2,374
20909,bright,main,7,0.9922783360760126,266,86,6,358
20909,bright,main,8,0.9941402767993329,298,98,1,397
20909,bright,main,9,0.9917525456082313,313,112,9,434
20738,bright,main,0,0.989815160486637,370,59,6,435
20738,bright,main,1,0.996321152578265,340,57,5,402
20738,bright,main,2,0.9912457532512894,345,74,5,424
20738,bright,main,3,0.9949275406619101,311,72,5,388
20738,bright,main,4,0.9943232537616282,294,76,4,374
20738,bright,main,5,0.9916501505572455,341,57,10,408
20738,bright,main,6,0.9911023751728724,294,69,3,366
20738,bright,main,7,0.9869873413094368,294,62,2,358
20738,bright,main,8,0.9930915031570617,361,60,2,423
20738,bright,main,9,0.9939578409049096,381,42,5,428
20882,bright,main,0,0.9942227786346085,320,114,2,436
20882,bright,main,1,0.9930505637880762,277,125,2,404
20882,bright,main,2,0.9861867402876441,326,107,0,433
20882,bright,main,3,0.9953177963209648,273,128,2,403
20882,bright,main,4,0.9905347935242257,277,105,2,384
20882,bright,main,5,0.992924157192337,297,113,7,417
20882,bright,main,6,0.9908028365180758,262,105,3,370
20882,bright,main,7,0.9926033905291622,260,99,2,361
20882,bright,main,8,0.9902747801871221,298,125,4,427
20882,bright,main,9,0.9907554840101416,337,86,2,425
20428,bright,main,0,0.9953363893869153,319,110,2,431
20428,bright,main,1,0.9937232185945335,280,118,3,401
20428,bright,main,2,0.9937354962806624,318,105,6,429
20428,bright,main,3,0.9882801302608593,318,77,8,403
20428,bright,main,4,0.9919781895126886,319,55,5,379
20428,bright,main,5,0.9919036622671029,291,95,3,389
20428,bright,main,6,0.9948586851700479,259,93,3,355
20428,bright,main,7,0.9873421837954253,262,99,2,363
20428,bright,main,8,0.9978291091073901,284,141,4,429
20428,bright,main,9,0.9928064140194918,305,122,1,428
20847,bright,main,0,0.9878427766407243,336,94,7,437
20847,bright,main,1,0.991535772529448,290,103,5,398
20847,bright,main,2,0.9970758491127598,301,121,6,428
20847,bright,main,3,0.9923921577652468,275,125,1,401
20847,bright,main,4,0.989420727030703,281,94,6,381
20847,bright,main,5,0.994372511348483,322,89,3,414
20847,bright,main,6,0.991149424565167,277,93,5,375
20847,bright,main,7,0.9859014891478919,248,111,2,361
20847,bright,main,8,0.9919131346016655,327,94,5,426
20847,bright,main,9,0.9962136957311621,312,115,3,430
20385,bright,main,0,0.9941960357264786,324,114,3,441
20385,bright,main,1,0.9886351092306936,317,83,6,406
20385,bright,main,2,0.9933735054020809,351,78,5,434
20385,bright,main,3,0.9886546475236467,291,104,7,402
20385,bright,main,4,0.9861641844121037,282,100,3,385
20385,bright,main,5,0.9947479327638534,302,106,4,412
20385,bright,main,6,0.992344208943868,238,139,0,377
20385,bright,main,7,0.9913243030888619,232,127,2,361
20385,bright,main,8,0.9967878973420011,291,130,3,424
20385,bright,main,9,0.9914062221590709,328,103,2,433
20836,bright,main,0,0.9910832057825085,345,93,0,438
20836,bright,main,1,0.9867178401576386,288,112,3,403
20836,bright,main,2,0.995206174372421,349,79,3,431
20836,bright,main,3,0.9911625612836258,293,110,0,403
20836,bright,main,4,0.9934268308744506,311,69,4,384
20836,bright,main,5,0.9955873025205427,328,85,2,415
20836,bright,main,6,0.9908813661773294,301,62,3,366
20836,bright,main,7,0.9935693655732486,261,99,2,362
20836,bright,main,8,0.9907750117848,304,121,5,430
20836,bright,main,9,0.9931485749719973,331,95,9,435
1774,dark,main,0,0.9913625772336196,294,14,79,387
1774,dark,main,1,0.993123518658395,262,12,85,359
1774,dark,main,2,0.9909559703935608,272,15,89,376
1774,dark,main,3,0.9941500957551411,257,12,76,345
1774,dark,main,4,0.9896267006251034,261,12,84,357
1774,dark,main,5,0.9908385017955451,275,13,81,369
1774,dark,main,6,0.9899131634451626,244,12,72,328
1774,dark,main,7,0.9904812204544958,236,13,77,326
1774,dark,main,8,0.9939618079807289,247,14,100,361
1774,dark,main,9,0.992604360166551,278,17,83,378
2162,dark,main,0,0.9920322578006917,304,11,71,386
2162,dark,main,1,0.9910711401828131,246,15,98,359
2162,dark,main,2,0.9935885158578984,273,12,96,381
2162,dark,main,3,0.9855969122178337,246,18,91,355
2162,dark,main,4,0.9956290972971603,257,11,87,355
2162,dark,main,5,0.9908077517837276,280,14,71,365
2162,dark,main,6,0.9859887881043801,237,13,86,336
2162,dark,main,7,0.9868332027422158,223,14,78,315
2162,dark,main,8,0.9824663442355881,269,12,86,367
2162,dark,main,9,0.9920343514182816,289,13,92,394
1007,dark,main,0,0.9918155288450727,289,16,88,393
1007,dark,main,1,0.9883550324340737,256,18,68,342
1007,dark,main,2,0.9940054612948693,288,12,96,396
1007,dark,main,3,0.9904530064202544,257,20,85,362
1007,dark,main,4,0.9847437208927078,281,12,78,371
1007,dark,main,5,0.983405382144321,254,14,96,364
1007,dark,main,6,0.9941613644347016,223,16,87,326
1007,dark,main,7,0.9960241106819125,239,14,80,333
1007,dark,main,8,0.9967428025300332,290,21,80,391
1007,dark,main,9,0.9925506780450818,288,15,80,383
21173,bright,main,0,0.9938085196058543,342,69,4,415
21173,bright,main,1,0.9873954384205287,306,58,6,370
21173,bright,main,2,0.9858969063597897,344,50,1,395
21173,bright,main,3,0.9913124700526162,312,57,1,370
21173,bright,main,4,0.983609594107,318,53,6,377
21173,bright,main,5,0.9798169369842736,316,64,4,384
21173,bright,main,6,0.9917930071739124,286,57,6,349
21173,bright,main,7,0.9831247908161258,281,59,4,344
21173,bright,main,8,0.9900349336047023,333,59,2,394
21173,bright,main,9,0.9887039649843734,360,44,2,406
1646,dark,main,0,0.9904108192786355,274,19,95,388
1646,dark,main,1,0.9867779127980355,249,11,105,365
1646,dark,main,2,0.9944151613058781,283,12,101,396
1646,dark,main,3,0.9932195279039876,263,13,88,364
1646,dark,main,4,0.9923199677644349,277,16,74,367
1646,dark,main,5,0.9892782389864759,277,15,82,374
1646,dark,main,6,0.9851768220003178,247,10,79,336
1646,dark,main,7,0.9919787085620856,249,13,69,331
1646,dark,main,8,0.990275992852366,286,14,88,388
1646,dark,main,9,0.9891506513514807,273,14,86,373
1578,dark,main,0,0.9977215584625215,282,17,91,390
1578,dark,main,1,0.9950945092314837,221,19,104,344
1578,dark,main,2,0.9945282623566679,287,13,79,379
1578,dark,main,3,0.9937001562066878,270,21,73,364
1578,dark,main,4,0.9792200025089943,269,14,77,360
1578,dark,main,5,0.9907262070720437,263,21,96,380
1578,dark,main,6,0.9857220160804614,223,17,84,324
1578,dark,main,7,0.9848800346257102,232,13,71,316
1578,dark,main,8,0.9941225788728713,256,20,101,377
1578,dark,main,9,0.9932233265621703,262,16,98,376
80977,dark,special,0,0.9915872430962458,257,20,86,363
80977,dark,special,1,0.9903327966861621,240,17,87,344
80977,dark,special,2,0.9918558246947641,268,19,82,369
80977,dark,special,3,0.992851955162181,242,21,93,356
80977,dark,special,4,0.98988545225884,243,21,87,351
80977,dark,special,5,0.996161569563436,244,24,87,355
80977,dark,special,6,0.9928881372002427,220,21,75,316
80977,dark,special,7,0.9959449657125992,206,23,81,310
80977,dark,special,8,0.9905109477763732,228,20,105,353
80977,dark,special,9,0.985340686294401,257,19,87,363
1590,dark,main,0,0.9883627059722356,279,17,95,391
1590,dark,main,1,0.9946559900535522,240,24,81,345
1590,dark,main,2,0.9858440376903278,282,13,80,375
1590,dark,main,3,0.9901277465600965,247,17,88,352
1590,dark,main,4,0.9911346541013724,244,17,83,344
1590,dark,main,5,0.9928240492531611,268,24,84,376
1590,dark,main,6,0.9928432072326298,219,17,88,324
1590,dark,main,7,0.98870656728207,220,18,71,309
1590,dark,main,8,0.99299426963546,247,17,112,376
1590,dark,main,9,0.9918280331926607,249,23,107,379
1930,dark,main,0,0.9856750651054788,230,52,86,368
1930,dark,main,1,0.9945473914681242,220,42,82,344
1930,dark,main,2,0.9865900044971632,237,40,81,358
1930,dark,main,3,0.9939537487022047,226,40,64,330
1930,dark,main,4,0.9928785713748556,216,44,94,354
1930,dark,main,5,0.9935015426990744,233,47,84,364
1930,dark,main,6,0.9902594845962805,211,51,56,318
1930,dark,main,7,0.9901048370057108,200,46,61,307
1930,dark,main,8,0.9929926450868933,243,62,54,359
1930,dark,main,9,0.9947492712190577,243,55,74,372
1256,dark,main,0,0.9957882902671638,267,21,91,379
1256,dark,main,1,0.9945188365337558,246,22,88,356
1256,dark,main,2,0.9926353483748332,266,22,104,392
1256,dark,main,3,0.9923400019157066,263,16,65,344
1256,dark,main,4,0.9892994707267321,261,17,81,359
1256,dark,main,5,0.9889344369773043,240,21,111,372
1256,dark,main,6,0.9923634037775827,225,17,74,316
1256,dark,main,7,0.9940514284101893,239,22,72,333
1256,dark,main,8,0.9806096929939057,269,18,84,371
1256,dark,main,9,0.9893046356265722,251,20,91,362
20433,bright,main,0,0.9895624347221245,292,130,4,426
20433,bright,main,1,0.9934234427171847,261,139,5,405
20433,bright,main,2,0.993758580556961,341,92,2,435
20433,bright,main,3,0.9938340704901133,265,130,8,403
20433,bright,main,4,0.9955798880608377,268,140,3,411
20433,bright,main,5,0.9933837400117098,290,124,3,417
20433,bright,main,6,0.9950541716645986,224,149,4,377
20433,bright,main,7,0.9884538997690357,197,166,5,368
20433,bright,main,8,0.995266651829656,240,138,1,379
20433,bright,main,9,0.9858611357147526,175,93,3,271
20884,bright,main,0,0.9965226809449528,358,73,0,431
20884,bright,main,1,0.9912390751846301,303,98,2,403
20884,bright,main,2,0.9908006973113662,334,95,4,433
20884,bright,main,3,0.9899464990772497,325,74,2,401
20884,bright,main,4,0.9952748827900704,300,101,2,403
20884,bright,main,5,0.9934015856724159,308,98,6,412
20884,bright,main,6,0.9946947372895936,307,62,4,373
20884,bright,main,7,0.9935556124378732,286,83,2,371
20884,bright,main,8,0.9968921234442241,337,89,2,428
20884,bright,main,9,0.9918474170682945,332,89,10,431
20504,bright,main,0,0.9928003212963644,333,107,4,444
20504,bright,main,1,0.9949702184852384,302,101,2,405
20504,bright,main,2,0.991134176143767,344,88,0,432
20504,bright,main,3,0.9931215736226433,329,67,5,401
20504,bright,main,4,0.9928979343940104,346,60,4,410
20504,bright,main,5,0.9946015745796802,342,68,4,414
20504,bright,main,6,0.9902645247142651,312,51,4,367
20504,bright,main,7,0.993836964329505,290,76,3,369
20504,bright,main,8,0.9958456100593964,347,76,2,425
20504,bright,main,9,0.9934830901197488,338,79,6,423
20887,bright,main,0,0.9924533036720116,307,124,5,436
20887,bright,main,1,0.9861361539734326,322,79,2,403
20887,bright,main,2,0.9908718334331004,311,109,2,422
20887,bright,main,3,0.9952512835657293,296,99,3,398
20887,bright,main,4,0.9927964051986732,313,91,2,406
20887,bright,main,5,0.9929628636621685,292,121,4,417
20887,bright,main,6,0.9887533259065203,268,105,1,374
20887,bright,main,7,0.9960967784109296,262,102,5,369
20887,bright,main,8,0.9934070186436722,311,108,8,427
20887,bright,main,9,0.9928697088773342,296,135,3,434
1089,dark,main,0,0.9897324041290749,190,22,51,263
1089,dark,main,1,0.9921819274580507,239,19,74,332
1089,dark,main,2,0.9901469079104466,220,33,99,352
1089,dark,main,3,0.9891866052872968,245,18,69,332
1089,dark,main,4,0.9868486360032734,243,14,79,336
1089,dark,main,5,0.9947186267145163,245,23,72,340
1089,dark,main,6,0.985403562779707,220,20,74,314
1089,dark,main,7,0.9923903352495846,220,19,65,304
1089,dark,main,8,0.9964894626735268,235,29,91,355
1089,dark,main,9,0.98513888616858,238,24,85,347
1096,dark,main,0,0.9942997222418485,230,23,100,353
1096,dark,main,1,0.9948450748118198,238,15,79,332
1096,dark,main,2,0.9924776669445727,235,35,92,362
1096,dark,main,3,0.9880837304234545,236,20,83,339
1096,dark,main,4,0.9902696320521602,227,22,101,350
1096,dark,main,5,0.9939109481789611,231,23,90,344
1096,dark,main,6,0.9904379748532798,217,26,57,300
1096,dark,main,7,0.9812529587314954,202,18,94,314
1096,dark,main,8,0.9923845340294241,246,22,96,364
1096,dark,main,9,0.9905999563852604,245,24,81,350
20916,bright,main,0,0.9930637116418556,357,78,3,438
20916,bright,main,1,0.993060786406998,289,108,4,401
20916,bright,main,2,0.9932278062986988,334,93,8,435
20916,bright,main,3,0.9910969013545532,315,88,2,405
20916,bright,main,4,0.9938718067095094,325,78,5,408
20916,bright,main,5,0.9903836369882993,315,98,0,413
20916,bright,main,6,0.9854200144539146,279,93,3,375
20916,bright,main,7,0.9957865253417105,285,79,7,371
20916,bright,main,8,0.9924540270232692,363,51,4,418
20916,bright,main,9,0.9943556302187603,347,78,4,429
20422,bright,main,0,0.9888541170618499,320,115,2,437
20422,bright,main,1,0.9858069672039997,308,95,1,404
20422,bright,main,2,0.9928316578142703,339,84,3,426
20422,bright,main,3,0.9918696955539233,320,82,2,404
20422,bright,main,4,0.9913772111029134,333,78,3,414
20422,bright,main,5,0.9910299377224844,320,89,5,414
20422,bright,main,6,0.9918886095813273,279,92,3,374
20422,bright,main,7,0.9846137583530398,277,84,6,367
20422,bright,main,8,0.9922251933367809,329,92,2,423
20422,bright,main,9,0.9923782461403127,313,114,3,430
1085,dark,main,0,0.9929651571746504,237,19,75,331
1085,dark,main,1,0.9895443884079602,202,23,82,307
1085,dark,main,2,0.9841553900676558,214,28,91,333
1085,dark,main,3,0.993846142880962,200,26,83,309
1085,dark,main,4,0.9918404270135791,218,24,95,337
1085,dark,main,5,0.9906359018392855,235,21,91,347
1085,dark,main,6,0.9925338087281355,190,24,78,292
1085,dark,main,7,0.9944402027057694,195,29,72,296
1085,dark,main,8,0.9924051674094344,218,33,87,338
1085,dark,main,9,0.9880136781182712,242,25,78,345
1212,dark,main,0,0.9913652980225943,269,22,92,383
1212,dark,main,1,0.9956568979371215,267,23,77,367
1212,dark,main,2,0.987480001036483,294,17,75,386
1212,dark,main,3,0.9836258780080486,250,18,94,362
1212,dark,main,4,0.9899884764658758,246,23,95,364
1212,dark,main,5,0.9931115738205789,235,26,80,341
1212,dark,main,6,0.9841366970582164,217,20,76,313
1212,dark,main,7,0.9906375177465638,214,25,83,322
1212,dark,main,8,0.9909230055806575,241,25,78,344
1212,dark,main,9,0.9925227406567414,259,28,75,362
20502,bright,main,0,0.989256611589968,373,63,4,440
20502,bright,main,1,0.9878436209562423,315,85,3,403
20502,bright,main,2,0.9923266410398577,332,91,5,428
20502,bright,main,3,0.9950044892617301,297,92,5,394
20502,bright,main,4,0.9937030383674437,312,95,2,409
20502,bright,main,5,0.9913646367495788,322,82,7,411
20502,bright,main,6,0.9922346193346596,271,92,3,366
20502,bright,main,7,0.9942393932756213,267,98,2,367
20502,bright,main,8,0.9874130069754733,309,113,2,424
20502,bright,main,9,0.9935495945465821,353,77,3,433
1430,dark,main,0,0.9932962279593497,226,59,79,364
1430,dark,main,1,0.9921005302735122,192,73,51,316
1430,dark,main,2,0.9839991813272545,236,39,91,366
1430,dark,main,3,0.9883477694160168,218,43,83,344
1430,dark,main,4,0.9807174241975347,226,40,83,349
1430,dark,main,5,0.9881183257756966,240,39,87,366
1430,dark,main,6,0.9942767029328479,214,34,76,324
1430,dark,main,7,0.994194171892131,216,44,60,320
1430,dark,main,8,0.9948129498344537,245,54,69,368
1430,dark,main,9,0.9856323764180899,219,61,76,356
20589,bright,main,0,0.9881090667772379,347,74,1,422
20589,bright,main,1,0.9941599745334416,304,80,7,391
20589,bright,main,2,0.9923031432289222,331,72,7,410
20589,bright,main,3,0.9924405562507193,303,77,3,383
20589,bright,main,4,0.9963955735324997,335,54,5,394
20589,bright,main,5,0.9904513576488405,344,53,2,399
20589,bright,main,6,0.9939168416518991,303,60,2,365
20589,bright,main,7,0.9938198107359562,283,68,5,356
20589,bright,main,8,0.9945381785785975,341,75,2,418
20589,bright,main,9,0.993185750187737,357,62,2,421
1403,dark,main,0,0.9948242847658589,259,20,100,379
1403,dark,main,1,0.9953280928980547,228,23,96,347
1403,dark,main,2,0.9929710746915086,259,21,94,374
1403,dark,main,3,0.9761735154832945,239,20,83,342
1403,dark,main,4,0.9854855391238595,248,22,76,346
1403,dark,main,5,0.9954411046561771,257,28,66,351
1403,dark,main,6,0.9903687105683172,215,20,87,322
1403,dark,main,7,0.9921639736524095,228,33,58,319
1403,dark,main,8,0.9921456029178041,262,32,80,374
1403,dark,main,9,0.9903182791988174,276,21,67,364
1213,dark,main,0,0.9853202949497188,289,23,81,393
1213,dark,main,1,0.9899708091999015,260,20,74,354
1213,dark,main,2,0.9918764434933285,272,21,83,376
1213,dark,main,3,0.9905586027023228,260,22,78,360
1213,dark,main,4,0.9933781003008338,252,20,83,355
1213,dark,main,5,0.9886037279857642,237,33,74,344
1213,dark,main,6,0.9895413878130325,231,23,73,327
1213,dark,main,7,0.9864971046837114,228,22,77,327
1213,dark,main,8,0.9907439272411004,254,20,92,366
1213,dark,main,9,0.99141090273644,266,12,82,360
1416,dark,main,0,0.9914364378114747,263,22,87,372
1416,dark,main,1,0.9937814786259429,218,27,102,347
1416,dark,main,2,0.9861719276796364,269,24,82,375
1416,dark,main,3,0.9865827123355388,239,29,86,354
1416,dark,main,4,0.9900658833528655,242,25,86,353
1416,dark,main,5,0.989439741468676,255,23,83,361
1416,dark,main,6,0.9934789971694743,196,22,91,309
1416,dark,main,7,0.9922097055280581,204,17,80,301
1416,dark,main,8,0.9921295494193153,258,29,93,380
1416,dark,main,9,0.9946586356786993,253,28,90,371
1402,dark,main,0,0.9949389047962423,265,34,81,380
1402,dark,main,1,0.9959262698339114,240,29,71,340
1402,dark,main,2,0.9914708078692755,232,47,88,367
1402,dark,main,3,0.9893147364422058,247,36,71,354
1402,dark,main,4,0.9932872650336351,239,38,74,351
1402,dark,main,5,0.9895525309212919,245,29,73,347
1402,dark,main,6,0.9922492745956923,211,33,79,323
1402,dark,main,7,0.9918640841016757,215,39,70,324
1402,dark,main,8,0.9923533167931191,244,48,79,371
1402,dark,main,9,0.9916759253090803,246,39,95,380
1210,dark,main,0,0.9935103358649167,262,29,88,379
1210,dark,main,1,0.9913986281840661,251,16,81,348
1210,dark,main,2,0.9935047561693129,260,18,107,385
1210,dark,main,3,0.9932426818446837,238,19,84,341
1210,dark,main,4,0.9834621031099472,139,16,59,214
1210,dark,main,5,0.9877067573693982,265,22,78,365
1210,dark,main,6,0.992618243111427,233,19,74,326
1210,dark,main,7,0.983842089613879,221,20,76,317
1210,dark,main,8,0.9932007942571083,234,26,111,371
1210,dark,main,9,0.990363147126667,246,24,96,366
20584,bright,main,0,0.9907970694500059,384,51,1,436
20584,bright,main,1,0.9890991399751238,137,17,1,155
20584,bright,main,2,0.9930630575461958,350,64,4,418
20584,bright,main,3,0.9943347754949565,327,54,3,384
20584,bright,main,4,0.9937923323061006,324,64,6,394
20584,bright,main,5,0.9910538042632463,336,63,4,403
20584,bright,main,6,0.9937884126388284,292,63,4,359
20584,bright,main,7,0.991304595654178,313,48,3,364
20584,bright,main,8,0.9911835020910236,343,73,2,418
20584,bright,main,9,0.9914146148092662,373,46,1,420
1099,dark,main,0,0.9895037257716884,267,24,75,366
1099,dark,main,1,0.9912561369007463,258,21,66,345
1099,dark,main,2,0.9932917846094667,271,24,81,376
1099,dark,main,3,0.9890772085626511,230,17,99,346
1099,dark,main,4,0.9962373967887348,247,17,90,354
1099,dark,main,5,0.9917677230915936,238,17,96,351
1099,dark,main,6,0.9912022996205235,222,25,68,315
1099,dark,main,7,0.9893781222147173,241,17,68,326
1099,dark,main,8,0.9923792178686008,244,21,107,372
1099,dark,main,9,0.9904715640414251,251,21,83,355
1107,dark,main,0,0.9898522412721029,231,15,99,345
1107,dark,main,1,0.989266120765972,215,21,64,300
1107,dark,main,2,0.9934108523311738,239,22,82,343
1107,dark,main,3,0.9874287755145501,208,26,66,300
1107,dark,main,4,0.9917206357051237,213,16,81,310
1107,dark,main,5,0.982549702927808,231,19,65,315
1107,dark,main,6,0.9925609216106328,198,15,81,294
1107,dark,main,7,0.994515549580911,186,29,63,278
1107,dark,main,8,0.985050380030283,222,22,79,323
1107,dark,main,9,0.9884434385970132,241,24,79,344
1224,dark,main,0,0.9939995029450909,274,14,100,388
1224,dark,main,1,0.9946046008667558,261,25,72,358
1224,dark,main,2,0.9908243898929285,272,21,85,378
1224,dark,main,3,0.9929140577748224,233,25,86,344
1224,dark,main,4,0.9961014766069137,272,22,81,375
1224,dark,main,5,0.9940555075017157,252,28,84,364
1224,dark,main,6,0.9895430791304558,239,17,70,326
1224,dark,main,7,0.9887247632020335,233,16,73,322
1224,dark,main,8,0.9905870978348837,253,21,90,364
1224,dark,main,9,0.9900578878036501,275,21,88,384
20110,bright,main,0,0.9967114611577291,355,69,4,428
20110,bright,main,1,0.9908486395262694,306,84,4,394
20110,bright,main,2,0.992773472984406,339,79,5,423
20110,bright,main,3,0.9961950690495829,306,75,3,384
20110,bright,main,4,0.9945401397715063,337,62,3,402
20110,bright,main,5,0.9886475124361893,335,65,4,404
20110,bright,main,6,0.9823476043947083,286,72,4,362
20110,bright,main,7,0.9916989573737407,274,79,3,356
20110,bright,main,8,0.9944905423551387,327,82,4,413
20110,bright,main,9,0.9871529599422341,327,88,2,417
20080,bright,main,0,0.9958226713519438,294,143,4,441
20080,bright,main,1,0.9942766784120349,313,85,3,401
20080,bright,main,2,0.9975855674393825,307,109,9,425
20080,bright,main,3,0.9936109700929779,271,114,3,388
20080,bright,main,4,0.9919350547471382,280,118,2,400
20080,bright,main,5,0.9884379887119,297,106,2,405
20080,bright,main,6,0.9906504176142242,259,101,4,364
20080,bright,main,7,0.9961455541625428,264,104,2,370
20080,bright,main,8,0.9930494211418435,326,94,3,423
20080,bright,main,9,0.9919210071830158,331,99,3,433
1084,dark,main,0,0.9877646392563473,228,18,94,340
1084,dark,main,1,0.9941904870506801,223,26,70,319
1084,dark,main,2,0.9930632964754981,231,24,75,330
1084,dark,main,3,0.9833996099328558,200,22,73,295
1084,dark,main,4,0.9883702899233036,212,20,86,318
1084,dark,main,5,0.9893804607653315,231,18,81,330
1084,dark,main,6,0.9862054098730829,177,21,89,287
1084,dark,main,7,0.9800822325759799,211,16,58,285
1084,dark,main,8,0.9825459541853678,220,20,98,338
1084,dark,main,9,0.9895077758051002,221,21,76,318
1109,dark,main,0,0.9960561721510369,280,16,111,407
1109,dark,main,1,0.9854002781486997,240,26,81,347
1109,dark,main,2,0.98810297028478,282,15,70,367
1109,dark,main,3,0.990519688536455,232,24,79,335
1109,dark,main,4,0.9910495204377423,226,21,101,348
1109,dark,main,5,0.9916416923234125,277,19,83,379
1109,dark,main,6,0.9906235712724947,234,20,72,326
1109,dark,main,7,0.9876965160905407,242,18,53,313
1109,dark,main,8,0.9881534951987094,252,20,84,356
1109,dark,main,9,0.9853153216065621,244,25,86,355
1091,dark,main,0,0.9926018281615826,286,17,67,370
1091,dark,main,1,0.9910035951012457,224,21,100,345
1091,dark,main,2,0.9893936275516267,234,15,83,332
1091,dark,main,3,0.9859486925200613,240,17,77,334
1091,dark,main,4,0.9927456286112281,234,15,86,335
1091,dark,main,5,0.9838524125196627,118,8,48,174
1091,dark,main,6,0.9941405790686016,221,22,70,313
1091,dark,main,7,0.9908660298021853,228,16,66,310
1091,dark,main,8,0.9829260743376379,238,24,84,346
1091,dark,main,9,0.9957162276289158,255,20,85,360
1425,dark,main,0,0.9867481747740114,231,67,74,372
1425,dark,main,1,0.9911003815541235,224,53,66,343
1425,dark,main,2,0.9966878705911372,251,45,85,381
1425,dark,main,3,0.9933412943406367,202,60,77,339
1425,dark,main,4,0.9891293528196501,209,71,51,331
1425,dark,main,5,0.9888384715201965,204,66,81,351
1425,dark,main,6,0.9918465617323388,197,62,58,317
1425,dark,main,7,0.9845423958772642,200,56,59,315
1425,dark,main,8,0.9928947436579556,191,80,75,346
1425,dark,main,9,0.9926954661208743,230,54,72,356
1088,dark,main,0,0.9892689699211471,257,17,64,338
1088,dark,main,1,0.9948269450077396,224,22,82,328
1088,dark,main,2,0.9909069110884889,241,21,81,343
1088,dark,main,3,0.9953214147269209,211,19,94,324
1088,dark,main,4,0.9914183252298937,242,19,76,337
1088,dark,main,5,0.9931286778763316,218,17,90,325
1088,dark,main,6,0.9928962432462434,201,18,78,297
1088,dark,main,7,0.9857911828064979,201,16,75,292
1088,dark,main,8,0.9941958366530618,237,22,85,344
1088,dark,main,9,0.9885252489449041,241,21,84,346
1888,dark,main,0,0.9927603005199495,227,54,73,354
1888,dark,main,1,0.9940678914296034,207,55,77,339
1888,dark,main,2,0.9845431202213226,223,60,82,365
1888,dark,main,3,0.9930330584173555,228,35,82,345
1888,dark,main,4,0.9865638421361171,225,45,75,345
1888,dark,main,5,0.9860790243769393,227,65,70,362
1888,dark,main,6,0.9883451903864972,197,47,79,323
1888,dark,main,7,0.9914572751640472,192,72,45,309
1888,dark,main,8,0.9915810321747232,239,51,74,364
1888,dark,main,9,0.9941489804214546,231,63,77,371
20592,bright,main,0,0.9909468992906103,367,58,4,429
20592,bright,main,1,0.9914864321511627,337,44,10,391
20592,bright,main,2,0.9959429363558018,367,48,8,423
20592,bright,main,3,0.9950979757951958,338,43,4,385
20592,bright,main,4,0.986574739199622,317,71,4,392
20592,bright,main,5,0.994753141692581,361,45,2,408
20592,bright,main,6,0.9948606143325329,340,29,0,369
20592,bright,main,7,0.989245605358765,316,43,3,362
20592,bright,main,8,0.9902259366177213,340,71,5,416
20592,bright,main,9,0.9904671712192108,347,81,2,430
1390,dark,main,0,0.9872157164845252,260,35,74,369
1390,dark,main,1,0.988520369591866,245,31,67,343
1390,dark,main,2,0.9961146486552015,278,19,93,390
1390,dark,main,3,0.9870418279524025,246,23,80,349
1390,dark,main,4,0.9949903417207864,223,26,84,333
1390,dark,main,5,0.9898182340736394,240,25,93,358
1390,dark,main,6,0.9770194668154794,128,24,53,205
1390,dark,main,7,0.9833463463206165,202,38,71,311
1390,dark,main,8,0.9899630353588894,209,45,93,347
1390,dark,main,9,0.9933228445070104,248,43,87,378
1411,dark,main,0,0.9940289600719289,264,39,74,377
1411,dark,main,1,0.9947804473561754,219,42,88,349
1411,dark,main,2,0.9935578710140042,264,53,66,383
1411,dark,main,3,0.9888188209803407,254,29,77,360
1411,dark,main,4,0.9891942412682659,222,36,83,341
1411,dark,main,5,0.9933060058998263,230,37,77,344
1411,dark,main,6,0.9736603587370273,136,23,29,188
1411,dark,main,7,0.9823571552706777,196,52,71,319
1411,dark,main,8,0.9909873765897722,240,47,72,359
1411,dark,main,9,0.9930784350272903,244,54,73,371
2072,dark,main,0,0.9876682341054963,267,31,89,387
2072,dark,main,1,0.988833969735225,237,26,80,343
2072,dark,main,2,0.9832471721005727,252,26,79,357
2072,dark,main,3,0.9890509999864076,243,30,71,344
2072,dark,main,4,0.9890352312740589,257,23,83,363
2072,dark,main,5,0.9873388031816583,248,24,79,351
2072,dark,main,6,0.9856703940263828,155,20,36,211
2072,dark,main,7,0.9895116409797513,214,35,62,311
2072,dark,main,8,0.985411962881337,242,42,71,355
2072,dark,main,9,0.9937376972293087,265,40,63,368
1207,dark,main,0,0.9904713336425053,277,13,92,382
1207,dark,main,1,0.9888042477720678,257,16,76,349
1207,dark,main,2,0.9950610307188926,252,21,103,376
1207,dark,main,3,0.9917721098997814,254,14,70,338
1207,dark,main,4,0.9921999003602532,251,14,80,345
1207,dark,main,5,0.9933709053140015,263,16,88,367
1207,dark,main,6,0.992759699191261,222,18,80,320
1207,dark,main,7,0.994829067152247,251,17,64,332
1207,dark,main,8,0.996028182351751,265,20,90,375
1207,dark,main,9,0.988368048172558,265,20,69,354
1424,dark,main,0,0.9932524178428195,225,57,82,364
1424,dark,main,1,0.9924553928178184,224,51,74,349
1424,dark,main,2,0.994791409589918,240,59,79,378
1424,dark,main,3,0.9906887193795003,237,45,62,344
1424,dark,main,4,0.994614647848654,246,58,57,361
1424,dark,main,5,0.9931983739413903,227,55,82,364
1424,dark,main,6,0.9907845825300331,124,27,44,195
1424,dark,main,7,0.9944532075551402,204,41,73,318
1424,dark,main,8,0.9952418914352577,229,62,83,374
1424,dark,main,9,0.9917036216090946,252,48,74,374
1399,dark,main,0,0.9955248370608955,240,35,94,369
1399,dark,main,1,0.9820065421947548,233,32,77,342
1399,dark,main,2,0.993781039308017,242,48,79,369
1399,dark,main,3,0.9882639356350356,245,30,68,343
1399,dark,main,4,0.9892036050948292,217,28,105,350
1399,dark,main,5,0.9900643489904472,217,31,94,342
1399,dark,main,6,0.9816618148684555,138,21,33,192
1399,dark,main,7,0.9945505128392426,223,30,72,325
1399,dark,main,8,0.9958453288010546,249,31,74,354
1399,dark,main,9,0.9947243162740576,232,29,99,360
20222,bright,main,0,0.9932372009708793,346,83,4,433
20222,bright,main,1,0.9942242007632294,307,87,4,398
20222,bright,main,2,0.9918989217971714,332,93,1,426
20222,bright,main,3,0.9927376845679585,300,88,4,392
20222,bright,main,4,0.9953986983235016,314,88,3,405
20222,bright,main,5,0.9922187189147211,328,78,4,410
20222,bright,main,6,0.9886276126621324,254,112,0,366
20222,bright,main,7,0.9866339114535241,271,84,2,357
20222,bright,main,8,0.988666821529728,351,72,1,424
20222,bright,main,9,0.9940311650755603,350,72,7,429
1915,dark,main,0,0.9847610952089906,236,52,78,366
1915,dark,main,1,0.9910205906714715,225,40,69,334
1915,dark,main,2,0.9963766737397959,247,43,81,371
1915,dark,main,3,0.9921465932143682,241,38,75,354
1915,dark,main,4,0.9898913350911217,235,37,89,361
1915,dark,main,5,0.9892295323703918,234,52,85,371
1915,dark,main,6,0.9891387717977362,129,26,45,200
1915,dark,main,7,0.992737912824559,158,67,84,309
1915,dark,main,8,0.9958510371404986,213,58,70,341
1915,dark,main,9,0.9863314306303589,238,67,68,373
20088,bright,main,0,0.9927049618564642,306,116,6,428
20088,bright,main,1,0.993229925264186,258,120,5,383
20088,bright,main,2,0.9930165461365554,327,90,2,419
20088,bright,main,3,0.989157777681291,312,72,5,389
20088,bright,main,4,0.9904801181857661,296,99,3,398
20088,bright,main,5,0.9831035209579321,322,79,3,404
20088,bright,main,6,0.9880885167392537,275,91,3,369
20088,bright,main,7,0.9922042470912619,277,74,1,352
20088,bright,main,8,0.9869127879975286,312,106,4,422
20088,bright,main,9,0.9948595608036519,263,146,4,413
20117,bright,main,0,0.9937556089038025,356,75,7,438
20117,bright,main,1,0.9948241000968896,312,78,0,390
20117,bright,main,2,0.9902681878866375,351,79,2,432
20117,bright,main,3,0.983204104298288,332,58,0,390
20117,bright,main,4,0.9914677283174208,337,62,3,402
20117,bright,main,5,0.9948364037866855,330,72,2,404
20117,bright,main,6,0.9955359005209817,287,73,6,366
20117,bright,main,7,0.9939481273885968,282,76,1,359
20117,bright,main,8,0.9948984111051811,327,80,5,412
20117,bright,main,9,0.9913457910674063,322,96,1,419
20119,bright,main,0,0.9930090422791217,353,74,6,433
20119,bright,main,1,0.9927094493493619,335,48,7,390
20119,bright,main,2,0.9905555151359955,346,70,1,417
20119,bright,main,3,0.9901103776117205,316,68,2,386
20119,bright,main,4,0.9850546744313721,336,64,4,404
20119,bright,main,5,0.9901749840452032,320,75,2,397
20119,bright,main,6,0.9867843938717696,288,71,2,361
20119,bright,main,7,0.9951183361681761,302,51,2,355
20119,bright,main,8,0.9961801033206772,336,74,6,416
20119,bright,main,9,0.9965251633645676,356,59,6,421
1401,dark,main,0,0.9970996607560653,283,22,79,384
1401,dark,main,1,0.9882583187924531,235,29,85,349
1401,dark,main,2,0.9936308890016895,271,33,73,377
1401,dark,main,3,0.9881475965273402,239,23,84,346
1401,dark,main,4,0.993303798320253,249,32,80,361
1401,dark,main,5,0.9954920215748033,265,22,71,358
1401,dark,main,6,0.9914085659516896,215,29,80,324
1401,dark,main,7,0.988509254772638,211,30,71,312
1401,dark,main,8,0.9911385209425043,249,30,92,371
1401,dark,main,9,0.9927186995335627,254,30,78,362
1082,dark,main,0,0.9933692254317279,246,19,91,356
1082,dark,main,1,0.9938414045206339,228,18,82,328
1082,dark,main,2,0.9908629950679897,242,19,84,345
1082,dark,main,3,0.9892877460801631,238,20,76,334
1082,dark,main,4,0.9922064664278152,248,12,80,340
1082,dark,main,5,0.9915139571586543,260,19,67,346
1082,dark,main,6,0.99359098066528,196,15,85,296
1082,dark,main,7,0.9879871350339818,213,23,68,304
1082,dark,main,8,0.9873202209666876,213,38,85,336
1082,dark,main,9,0.9961697805626297,233,38,79,350
1909,dark,main,0,0.9914755184633737,242,44,73,359
1909,dark,main,1,0.9863503295221854,212,63,71,346
1909,dark,main,2,0.9922378381636425,237,50,79,366
1909,dark,main,3,0.9915660328434404,232,37,74,343
1909,dark,main,4,0.990398861613721,220,58,72,350
1909,dark,main,5,0.9926031091579237,226,50,79,355
1909,dark,main,6,0.9916457176495498,188,40,83,311
1909,dark,main,7,0.9944141136447328,185,57,70,312
1909,dark,main,8,0.9919212233628306,214,51,78,343
1909,dark,main,9,0.9904606154038532,240,46,77,363
21090,bright,main,0,0.9932607310963888,357,62,4,423
21090,bright,main,1,0.994122524677299,339,54,5,398
21090,bright,main,2,0.9937100401359377,329,81,1,411
21090,bright,main,3,0.9962672742966586,320,56,5,381
21090,bright,main,4,0.9898835490016528,339,51,3,393
21090,bright,main,5,0.9915443344975003,336,55,5,396
21090,bright,main,6,0.9929232256396897,281,68,1,350
21090,bright,main,7,0.9880610942295822,283,60,1,344
21090,bright,main,8,0.9940899997022274,326,74,4,404
21090,bright,main,9,0.9849854874994747,323,79,6,408
1428,dark,main,0,0.9902855175864839,255,55,61,371
1428,dark,main,1,0.9897330878925475,227,36,97,360
1428,dark,main,2,0.9946676403565915,242,42,86,370
1428,dark,main,3,0.9866325255026487,219,50,76,345
1428,dark,main,4,0.9924531764078088,252,39,77,368
1428,dark,main,5,0.9900940602236472,240,43,77,360
1428,dark,main,6,0.9822747829379984,196,38,75,309
1428,dark,main,7,0.9868426238094461,199,32,83,314
1428,dark,main,8,0.9915310379915855,237,54,65,356
1428,dark,main,9,0.9877397969703047,228,44,86,358
20108,bright,main,0,0.9967279543813438,364,74,0,438
20108,bright,main,1,0.99400677661776,337,59,3,399
20108,bright,main,2,0.9932084527785903,323,99,2,424
20108,bright,main,3,0.9948870375975691,294,94,3,391
20108,bright,main,4,0.9957071648732619,315,82,4,401
20108,bright,main,5,0.99632207448516,310,88,2,400
20108,bright,main,6,0.990199224703349,277,79,2,358
20108,bright,main,7,0.9869157839762192,251,101,2,354
20108,bright,main,8,0.994080019404336,344,74,2,420
20108,bright,main,9,0.9960228163697247,343,83,1,427
20087,bright,main,0,0.9903024581069437,356,72,4,432
20087,bright,main,1,0.9827650442572673,305,86,3,394
20087,bright,main,2,0.9920328108736852,321,97,3,421
20087,bright,main,3,0.9935680233798841,323,63,6,392
20087,bright,main,4,0.9946370797158332,323,74,3,400
20087,bright,main,5,0.993746084901553,325,72,5,402
20087,bright,main,6,0.9896353865459876,328,36,2,366
20087,bright,main,7,0.9917952498798263,299,56,5,360
20087,bright,main,8,0.9929544621296849,336,79,4,419
20087,bright,main,9,0.9950085971468836,357,62,4,423
1211,dark,main,0,0.9914241337738561,268,22,93,383
1211,dark,main,1,0.9895160923085909,251,14,96,361
1211,dark,main,2,0.993475397934605,274,18,79,371
1211,dark,main,3,0.9899627756006841,264,23,70,357
1211,dark,main,4,0.9955115573070897,233,21,88,342
1211,dark,main,5,0.9899714164571001,254,18,85,357
1211,dark,main,6,0.9906375008521827,215,25,80,320
1211,dark,main,7,0.9930620093634429,222,18,79,319
1211,dark,main,8,0.9887019996351194,262,20,86,368
1211,dark,main,9,0.9892952912824448,270,26,84,380
1414,dark,main,0,0.9955385887671261,248,47,75,370
1414,dark,main,1,0.9919204583476577,217,53,79,349
1414,dark,main,2,0.9845258217098081,232,48,80,360
1414,dark,main,3,0.9893043427565968,213,42,74,329
1414,dark,main,4,0.9940686122641416,225,46,81,352
1414,dark,main,5,0.9858013316316312,223,42,75,340
1414,dark,main,6,0.9902468921336466,208,38,79,325
1414,dark,main,7,0.9896338306659174,196,35,76,307
1414,dark,main,8,0.9956968629583045,242,45,68,355
1414,dark,main,9,0.9856617217147545,232,44,93,369
1094,dark,main,0,0.9928572159963583,248,20,91,359
1094,dark,main,1,0.9910735438211554,237,18,64,319
1094,dark,main,2,0.9897854765015133,244,20,102,366
1094,dark,main,3,0.9871982035862829,221,26,81,328
1094,dark,main,4,0.9904997421378625,224,17,85,326
1094,dark,main,5,0.9927254835193565,231,25,88,344
1094,dark,main,6,0.9859819822440694,200,20,77,297
1094,dark,main,7,0.9903727799309878,201,18,77,296
1094,dark,main,8,0.9923737682884908,250,23,79,352
1094,dark,main,9,0.9866691856189256,259,17,77,353
1415,dark,main,0,0.9928641822067047,267,24,92,383
1415,dark,main,1,0.9917304844994759,243,27,84,354
1415,dark,main,2,0.9906743589561677,256,30,95,381
1415,dark,main,3,0.9939372777987768,251,30,72,353
1415,dark,main,4,0.9922710800613934,233,24,83,340
1415,dark,main,5,0.9925242185831153,252,20,93,365
1415,dark,main,6,0.9846949367232037,215,20,82,317
1415,dark,main,7,0.9864304781699637,219,26,71,316
1415,dark,main,8,0.9947118617234981,252,27,91,370
1415,dark,main,9,0.9898512251333519,272,24,90,386
1386,dark,main,0,0.9931486525359784,242,34,89,365
1386,dark,main,1,0.9927655669389753,215,40,84,339
1386,dark,main,2,0.9920942537836149,236,53,79,368
1386,dark,main,3,0.9866089903954662,235,29,78,342
1386,dark,main,4,0.98408704079422,210,46,88,344
1386,dark,main,5,0.9899538188889399,219,39,89,347
1386,dark,main,6,0.9902891110493315,231,32,62,325
1386,dark,main,7,0.9833699245660066,215,38,70,323
1386,dark,main,8,0.9919687222740904,217,59,71,347
1386,dark,main,9,0.9907628453888035,233,50,88,371
1208,dark,main,0,0.987767926604371,266,24,92,382
1208,dark,main,1,0.9890354884931775,254,23,78,355
1208,dark,main,2,0.985908528438462,271,18,84,373
1208,dark,main,3,0.9928830081621169,237,17,102,356
1208,dark,main,4,0.9967590103696156,244,17,104,365
1208,dark,main,5,0.99198988589022,231,19,106,356
1208,dark,main,6,0.9856897755673439,218,16,94,328
1208,dark,main,7,0.991325191167053,229,22,83,334
1208,dark,main,8,0.9930778368754613,277,24,75,376
1208,dark,main,9,0.9953504425279149,254,21,100,375
1220,dark,main,0,0.991184217247623,285,23,75,383
1220,dark,main,1,0.9912173529649982,232,26,89,347
1220,dark,main,2,0.9901317194106287,287,25,77,389
1220,dark,main,3,0.9877589985697848,238,26,84,348
1220,dark,main,4,0.9898142650560025,250,27,83,360
1220,dark,main,5,0.9950363124537757,253,25,84,362
1220,dark,main,6,0.9944400754844862,231,17,79,327
1220,dark,main,7,0.9875890620763468,218,25,65,308
1220,dark,main,8,0.9944251546031246,249,19,88,356
1220,dark,main,9,0.9943792356260847,254,43,73,370
1206,dark,main,0,0.9954063274734792,269,15,103,387
1206,dark,main,1,0.9907881333173036,240,16,87,343
1206,dark,main,2,0.9840363782512664,272,15,92,379
1206,dark,main,3,0.9955975368888876,232,17,95,344
1206,dark,main,4,0.9895434497651815,237,11,81,329
1206,dark,main,5,0.9876453241293288,276,16,73,365
1206,dark,main,6,0.9954588133572685,218,18,78,314
1206,dark,main,7,0.9895169110573033,221,40,55,316
1206,dark,main,8,0.9931759680262272,268,16,81,365
1206,dark,main,9,0.9882138742308142,268,17,95,380
20102,bright,main,0,0.9858881422814517,375,50,6,431
20102,bright,main,1,0.9893438706017723,319,77,3,399
20102,bright,main,2,0.9897053767556172,390,41,5,436
20102,bright,main,3,0.9934077500626413,334,59,1,394
20102,bright,main,4,0.9899989923013102,337,58,1,396
20102,bright,main,5,0.9915323872397906,317,83,3,403
20102,bright,main,6,0.9878508316078224,286,79,1,366
20102,bright,main,7,0.9947810128929674,284,74,2,360
20102,bright,main,8,0.9908280038150215,361,57,2,420
20102,bright,main,9,0.9939595709173021,360,59,5,424
20124,bright,main,0,0.9940694570407358,341,83,6,430
20124,bright,main,1,0.9833277995045829,324,58,3,385
20124,bright,main,2,0.9915565997450887,339,69,0,408
20124,bright,main,3,0.9885837831206337,286,97,2,385
20124,bright,main,4,0.9942293453249219,332,57,4,393
20124,bright,main,5,0.9926132434818257,327,70,4,401
20124,bright,main,6,0.9914948341800859,275,78,6,359
20124,bright,main,7,0.9917340987333964,270,78,3,351
20124,bright,main,8,0.990987962717356,298,105,6,409
20124,bright,main,9,0.9830678326401663,343,71,4,418
1198,dark,main,0,0.9898748010399668,266,18,90,374
1198,dark,main,1,0.9936575960624083,256,20,86,362
1198,dark,main,2,0.9916660346177802,287,19,79,385
1198,dark,main,3,0.9880117836529694,243,15,97,355
1198,dark,main,4,0.9947106091619115,244,16,82,342
1198,dark,main,5,0.9887977478999053,261,13,85,359
1198,dark,main,6,0.9911231095822829,205,22,90,317
1198,dark,main,7,0.9925964984269209,227,14,78,319
1198,dark,main,8,0.988753343218606,268,17,91,376
1198,dark,main,9,0.9844099252746661,292,16,82,390
1196,dark,main,0,0.9930121157833863,277,19,101,397
1196,dark,main,1,0.9912818806697101,244,18,89,351
1196,dark,main,2,0.9956872454804343,263,23,103,389
1196,dark,main,3,0.98920081433404,249,25,77,351
1196,dark,main,4,0.990017576124379,269,18,75,362
1196,dark,main,5,0.9917013835069342,258,15,86,359
1196,dark,main,6,0.9881284188318574,231,12,71,314
1196,dark,main,7,0.9946489401453311,235,11,75,321
1196,dark,main,8,0.9904293481566149,249,27,94,370
1196,dark,main,9,0.9912204988647757,283,15,77,375
20118,bright,main,0,0.992211518931723,368,64,3,435
20118,bright,main,1,0.9952531333407904,299,83,7,389
20118,bright,main,2,0.9942988042238968,335,81,2,418
20118,bright,main,3,0.9928519863594957,296,78,8,382
20118,bright,main,4,0.9890837435467187,310,78,2,390
20118,bright,main,5,0.9925205629761987,328,68,3,399
20118,bright,main,6,0.9860970219571821,268,81,4,353
20118,bright,main,7,0.9946632450213491,281,72,3,356
20118,bright,main,8,0.9858850112067447,315,84,7,406
20118,bright,main,9,0.9940052727756867,381,44,6,431
1199,dark,main,0,0.9957542147003796,276,17,96,389
1199,dark,main,1,0.9896970558883688,246,16,89,351
1199,dark,main,2,0.9909537454850489,269,17,98,384
1199,dark,main,3,0.9885415641285311,246,16,82,344
1199,dark,main,4,0.9901361538673488,242,17,86,345
1199,dark,main,5,0.9878999812448755,246,18,91,355
1199,dark,main,6,0.992087380035413,215,24,86,325
1199,dark,main,7,0.9866494747021846,222,17,87,326
1199,dark,main,8,0.9872747602269045,257,18,96,371
1199,dark,main,9,0.993892914546528,247,22,93,362
20104,bright,main,0,0.9908546878564954,361,72,4,437
20104,bright,main,1,0.9925864664315857,309,72,5,386
20104,bright,main,2,0.9950380003962042,357,61,1,419
20104,bright,main,3,0.9881682135975037,307,76,2,385
20104,bright,main,4,0.9883804269568693,323,68,6,397
20104,bright,main,5,0.9901553095980928,334,68,2,404
20104,bright,main,6,0.9846812341181361,310,51,3,364
20104,bright,main,7,0.9933014417088464,310,49,4,363
20104,bright,main,8,0.9917828688991468,370,55,3,428
20104,bright,main,9,0.9925146849517528,366,48,4,418
1124,dark,main,0,0.9887332346737925,279,16,91,386
1124,dark,main,1,0.996179706087443,250,15,71,336
1124,dark,main,2,0.996193361334832,252,42,68,362
1124,dark,main,3,0.9878758859373813,227,17,88,332
1124,dark,main,4,0.9881586385590126,237,16,92,345
1124,dark,main,5,0.9842180419724708,229,14,105,348
1124,dark,main,6,0.98010642557635,203,16,89,308
1124,dark,main,7,0.9847567340083639,197,20,74,291
1124,dark,main,8,0.9918367209587433,246,19,99,364
1124,dark,main,9,0.9903890340633559,274,15,80,369
1120,dark,main,0,0.9885631169585241,288,28,82,398
1120,dark,main,1,0.9886872378408594,273,18,82,373
1120,dark,main,2,0.9952279886854676,291,15,82,388
1120,dark,main,3,0.9942304125912845,261,19,70,350
1120,dark,main,4,0.9915781229213987,249,26,92,367
1120,dark,main,5,0.9835384056151846,254,21,93,368
1120,dark,main,6,0.9824454131746356,245,20,81,346
1120,dark,main,7,0.9923287085410908,233,19,81,333
1120,dark,main,8,0.9916369742856057,270,18,92,380
1120,dark,main,9,0.9852081552531003,280,28,81,389
1197,dark,main,0,0.9883831300843434,253,30,89,372
1197,dark,main,1,0.9873846249484275,233,15,102,350
1197,dark,main,2,0.9937563328587314,280,21,86,387
1197,dark,main,3,0.9948777532249734,256,15,78,349
1197,dark,main,4,0.9907594408359632,250,17,85,352
1197,dark,main,5,0.990062898234296,252,17,91,360
1197,dark,main,6,0.9918237151746082,224,21,75,320
1197,dark,main,7,0.9938764535913045,235,14,76,325
1197,dark,main,8,0.9925691526216935,246,27,87,360
1197,dark,main,9,0.9958561248236153,276,13,88,377
1105,dark,main,0,0.9924396548968395,258,29,77,364
1105,dark,main,1,0.986215514874087,200,32,82,314
1105,dark,main,2,0.986791246825627,231,41,82,354
1105,dark,main,3,0.9906958437957718,218,22,69,309
1105,dark,main,4,0.9893691824028021,220,24,71,315
1105,dark,main,5,0.9881276965960432,230,31,77,338
1105,dark,main,6,0.9894308795946956,213,21,69,303
1105,dark,main,7,0.9886970201309194,211,23,73,307
1105,dark,main,8,0.9917646027026109,234,31,78,343
1105,dark,main,9,0.9891695506578135,224,31,83,338
1102,dark,main,0,0.9884285404817063,293,16,84,393
1102,dark,main,1,0.9875024200830009,240,24,80,344
1102,dark,main,2,0.9885382722645291,302,17,81,400
1102,dark,main,3,0.9903742473504396,251,20,100,371
1102,dark,main,4,0.9940358674605501,256,23,94,373
1102,dark,main,5,0.9899497824431488,231,21,100,352
1102,dark,main,6,0.9922568717041114,237,19,88,344
1102,dark,main,7,0.9883362910926985,250,17,63,330
1102,dark,main,8,0.9961871932658496,256,21,103,380
1102,dark,main,9,0.988158545316365,271,22,101,394
20120,bright,main,0,0.9930739118178312,377,60,2,439
20120,bright,main,1,0.9954926350057632,327,59,6,392
20120,bright,main,2,0.9934865688884419,352,67,4,423
20120,bright,main,3,0.993194957684971,305,91,3,399
20120,bright,main,4,0.9877438194580838,346,59,3,408
20120,bright,main,5,0.9923389296575121,317,82,3,402
20120,bright,main,6,0.9930073349483189,306,56,4,366
20120,bright,main,7,0.992916564854803,298,60,3,361
20120,bright,main,8,0.9945193720159595,354,62,8,424
20120,bright,main,9,0.9905388762040533,376,45,5,426
20130,bright,main,0,0.9910062822891733,352,86,3,441
20130,bright,main,1,0.994621416961083,303,94,9,406
20130,bright,main,2,0.9929129931226067,338,94,3,435
20130,bright,main,3,0.9911301983597648,312,84,5,401
20130,bright,main,4,0.9928117034348045,344,62,6,412
20130,bright,main,5,0.9915045341128946,329,82,2,413
20130,bright,main,6,0.9891007172515485,295,72,4,371
20130,bright,main,7,0.9849938419719255,287,72,6,365
20130,bright,main,8,0.9932896100352518,351,72,4,427
20130,bright,main,9,0.9929643028417866,353,80,4,437
1083,dark,main,0,0.9929543328068033,262,18,82,362
1083,dark,main,1,0.99123478398755,237,29,70,336
1083,dark,main,2,0.9921764636691126,256,22,87,365
1083,dark,main,3,0.9854129619482102,237,18,87,342
1083,dark,main,4,0.9780075321461676,212,24,94,330
1083,dark,main,5,0.9933222180652022,224,14,88,326
1083,dark,main,6,0.9907920801343899,231,15,58,304
1083,dark,main,7,0.9869476085890774,223,23,61,307
1083,dark,main,8,0.9896571847201048,241,29,82,352
1083,dark,main,9,0.9889057394435401,254,17,103,374
1205,dark,main,0,0.9938132661388168,266,19,107,392
1205,dark,main,1,0.9909857112243776,252,14,86,352
1205,dark,main,2,0.9836025335534049,275,17,81,373
1205,dark,main,3,0.9916166821855299,236,16,88,340
1205,dark,main,4,0.9944763695873482,270,16,60,346
1205,dark,main,5,0.9879567600763274,245,22,89,356
1205,dark,main,6,0.989958095922649,228,16,79,323
1205,dark,main,7,0.9769023677657508,222,16,87,325
1205,dark,main,8,0.992511790440103,260,20,91,371
1205,dark,main,9,0.9913117670536713,281,21,95,397
1223,dark,main,0,0.9896485382581439,284,18,75,377
1223,dark,main,1,0.9929986970551161,266,20,74,360
1223,dark,main,2,0.9961869835688282,274,27,76,377
1223,dark,main,3,0.9901404432726966,248,16,99,363
1223,dark,main,4,0.9926430986177928,224,19,113,356
1223,dark,main,5,0.9900982793182246,250,14,100,364
1223,dark,main,6,0.9901513036693794,226,13,72,311
1223,dark,main,7,0.9904561315703091,238,15,65,318
1223,dark,main,8,0.9906552112890484,268,15,96,379
1223,dark,main,9,0.9938986660216114,274,13,99,386
1385,dark,main,0,0.9929335047024307,241,35,84,360
1385,dark,main,1,0.9817844808865367,235,30,92,357
1385,dark,main,2,0.9882951084578986,263,28,67,358
1385,dark,main,3,0.9908968280500727,242,32,77,351
1385,dark,main,4,0.9921538284056696,211,32,91,334
1385,dark,main,5,0.9909051549074763,232,35,78,345
1385,dark,main,6,0.9912536342797093,198,36,69,303
1385,dark,main,7,0.9905249190275442,208,31,66,305
1385,dark,main,8,0.987039200325785,261,33,70,364
1385,dark,main,9,0.9910930523405634,245,23,80,348
1248,dark,main,0,0.9944282160430182,257,41,84,382
1248,dark,main,1,0.9923922935889745,257,22,75,354
1248,dark,main,2,0.9879355406405937,257,16,93,366
1248,dark,main,3,0.992887575859241,238,27,85,350
1248,dark,main,4,0.9915538249497006,231,27,89,347
1248,dark,main,5,0.9895468946540036,265,21,80,366
1248,dark,main,6,0.9812164524869958,221,20,74,315
1248,dark,main,7,0.9915734356168177,222,19,79,320
1248,dark,main,8,0.992444872114727,259,20,87,366
1248,dark,main,9,0.98741351122592,261,18,86,365
20133,bright,main,0,0.990688483259918,359,75,5,439
20133,bright,main,1,0.993675590423355,328,57,6,391
20133,bright,main,2,0.9947239774087719,370,54,4,428
20133,bright,main,3,0.9884962370798889,325,55,3,383
20133,bright,main,4,0.9956136998907648,343,47,4,394
20133,bright,main,5,0.9949195555910766,338,63,3,404
20133,bright,main,6,0.9892500641002232,295,52,3,350
20133,bright,main,7,0.9869304878050447,294,54,2,350
20133,bright,main,8,0.9958330986548269,324,85,2,411
20133,bright,main,9,0.9949408161783517,337,74,6,417
1417,dark,main,0,0.991927392154641,259,24,91,374
1417,dark,main,1,0.9943380422191076,232,31,88,351
1417,dark,main,2,0.9964665123767965,268,27,84,379
1417,dark,main,3,0.9920965434524172,242,25,92,359
1417,dark,main,4,0.9811149993069753,247,22,91,360
1417,dark,main,5,0.9950809541041442,261,24,87,372
1417,dark,main,6,0.9928220248438682,208,28,73,309
1417,dark,main,7,0.9886280511660505,217,24,80,321
1417,dark,main,8,0.9876152458420447,243,32,100,375
1417,dark,main,9,0.994103379717388,253,36,78,367
1393,dark,main,0,0.9883438985139689,253,51,77,381
1393,dark,main,1,0.9940322086397929,227,57,78,362
1393,dark,main,2,0.9961554424274579,257,40,80,377
1393,dark,main,3,0.9928241016276633,241,40,87,368
1393,dark,main,4,0.9898492597375989,239,56,71,366
1393,dark,main,5,0.9922966562124259,205,81,82,368
1393,dark,main,6,0.9843495603381512,201,38,84,323
1393,dark,main,7,0.9851239382069966,215,53,61,329
1393,dark,main,8,0.9949862850145975,232,59,71,362
1393,dark,main,9,0.9884122646306762,219,54,95,368
20005,bright,main,0,0.9924171715434678,337,85,3,425
20005,bright,main,1,0.9925551441712214,332,55,4,391
20005,bright,main,2,0.9910972832829292,345,69,2,416
20005,bright,main,3,0.9950376165480563,318,60,2,380
20005,bright,main,4,0.997188180620394,315,71,2,388
20005,bright,main,5,0.9917934552768863,333,64,4,401
20005,bright,main,6,0.9934550207432751,290,70,3,363
20005,bright,main,7,0.9884620775044389,297,57,1,355
20005,bright,main,8,0.985767991266639,315,84,1,400
20005,bright,main,9,0.9904533981738983,350,69,2,421
1422,dark,main,0,0.9897764873234632,261,40,68,369
1422,dark,main,1,0.9868474842677174,232,42,75,349
1422,dark,main,2,0.9948354515510565,248,38,80,366
1422,dark,main,3,0.9901908109595381,230,43,69,342
1422,dark,main,4,0.9914615579483063,225,40,85,350
1422,dark,main,5,0.9867810298293453,203,45,102,350
1422,dark,main,6,0.9874438909611456,237,28,68,333
1422,dark,main,7,0.9839590705798069,216,29,79,324
1422,dark,main,8,0.9943004694230227,224,56,80,360
1422,dark,main,9,0.993222484624406,251,38,86,375
1251,dark,main,0,0.9873496865794535,275,24,87,386
1251,dark,main,1,0.9832703128432998,238,19,93,350
1251,dark,main,2,0.9903378943394366,274,18,89,381
1251,dark,main,3,0.9907880464078261,233,26,89,348
1251,dark,main,4,0.99314166732311,259,19,82,360
1251,dark,main,5,0.9910081072857744,270,16,67,353
1251,dark,main,6,0.9915470876674256,205,23,83,311
1251,dark,main,7,0.9899246780239173,235,21,75,331
1251,dark,main,8,0.9903986011651471,268,19,89,376
1251,dark,main,9,0.9949638289585437,252,16,102,370
1833,dark,main,0,0.9873549444992852,245,37,90,372
1833,dark,main,1,0.9936391027870671,216,36,67,319
1833,dark,main,2,0.9928710458229734,241,36,77,354
1833,dark,main,3,0.9895392050642945,235,26,59,320
1833,dark,main,4,0.9860205585878039,230,33,79,342
1833,dark,main,5,0.9945418079072947,234,36,66,336
1833,dark,main,6,0.9894787027026617,197,41,56,294
1833,dark,main,7,0.9783222397076405,187,40,73,300
1833,dark,main,8,0.9920269707181909,233,44,81,358
1833,dark,main,9,0.9901535680576424,232,37,80,349
1400,dark,main,0,0.9890023186996253,253,23,107,383
1400,dark,main,1,0.9891796017969334,253,26,71,350
1400,dark,main,2,0.991507467474106,272,31,82,385
1400,dark,main,3,0.978336013973133,224,36,85,345
1400,dark,main,4,0.9934257742865298,227,28,87,342
1400,dark,main,5,0.9893356062931532,222,29,88,339
1400,dark,main,6,0.9950348485099337,217,31,69,317
1400,dark,main,7,0.9890802612522355,222,26,65,313
1400,dark,main,8,0.9874881124372326,249,28,94,371
1400,dark,main,9,0.9907007084952033,257,30,88,375
21117,bright,main,0,0.9931130735821896,332,89,5,426
21117,bright,main,1,0.9911024314171969,317,61,8,386
21117,bright,main,2,0.9956470926036814,337,79,1,417
21117,bright,main,3,0.9884514095301947,317,62,3,382
21117,bright,main,4,0.9959110779526098,304,77,3,384
21117,bright,main,5,0.9891189055844627,331,59,4,394
21117,bright,main,6,0.9879805629464453,283,74,3,360
21117,bright,main,7,0.9867042684071964,279,60,3,342
21117,bright,main,8,0.9925371897673518,307,90,6,403
21117,bright,main,9,0.9952104982812334,346,63,4,413
1108,dark,main,0,0.9911366534835625,269,15,91,375
1108,dark,main,1,0.985270061688981,258,21,67,346
1108,dark,main,2,0.9881917113902219,261,15,73,349
1108,dark,main,3,0.9919281467553688,215,29,84,328
1108,dark,main,4,0.9903225948291693,263,20,77,360
1108,dark,main,5,0.9857246389428537,227,18,99,344
1108,dark,main,6,0.9957237310352314,200,24,75,299
1108,dark,main,7,0.9834091636463794,209,16,84,309
1108,dark,main,8,0.9933883914163548,250,20,77,347
1108,dark,main,9,0.9941230721246304,272,18,76,366
1103,dark,main,0,0.9934024744623977,241,20,96,357
1103,dark,main,1,0.994991760006428,233,17,87,337
1103,dark,main,2,0.9825272695833102,267,17,88,372
1103,dark,main,3,0.9958192659834296,233,23,79,335
1103,dark,main,4,0.9941778274232348,238,21,91,350
1103,dark,main,5,0.9884698587618814,246,22,70,338
1103,dark,main,6,0.9851810307773915,214,21,86,321
1103,dark,main,7,0.9966663141867583,191,19,84,294
1103,dark,main,8,0.9912898283385011,251,25,90,366
1103,dark,main,9,0.991909227780719,253,23,91,367
1086,dark,main,0,0.9959442770323731,238,23,94,355
1086,dark,main,1,0.9918690596402407,234,13,90,337
1086,dark,main,2,0.9936206443227795,235,24,101,360
1086,dark,main,3,0.9906021210573928,236,14,80,330
1086,dark,main,4,0.9948221054609393,241,19,80,340
1086,dark,main,5,0.9878713125717348,238,19,98,355
1086,dark,main,6,0.9915375838760988,219,17,80,316
1086,dark,main,7,0.9880392469118331,226,20,71,317
1086,dark,main,8,0.9907184086476315,238,12,112,362
1086,dark,main,9,0.9948306577681035,261,22,71,354
1087,dark,main,0,0.9907478593243115,249,20,87,356
1087,dark,main,1,0.994306352092958,231,18,72,321
1087,dark,main,2,0.9929585569843197,252,20,85,357
1087,dark,main,3,0.9871789987021582,237,13,77,327
1087,dark,main,4,0.9895200742938068,235,21,82,338
1087,dark,main,5,0.9960990960690885,209,14,109,332
1087,dark,main,6,0.9924861690144084,206,20,76,302
1087,dark,main,7,0.9821070362325611,206,23,73,302
1087,dark,main,8,0.9854645142488061,228,22,98,348
1087,dark,main,9,0.985261544342797,247,21,81,349
1209,dark,main,0,0.9894978058468376,265,15,108,388
1209,dark,main,1,0.9918598257171418,240,24,87,351
1209,dark,main,2,0.9959465790061716,271,17,91,379
1209,dark,main,3,0.9949356272005534,228,24,94,346
1209,dark,main,4,0.9932796418461209,228,18,98,344
1209,dark,main,5,0.9861297001120708,253,14,94,361
1209,dark,main,6,0.9909255640748327,216,22,87,325
1209,dark,main,7,0.990301827602141,226,18,74,318
1209,dark,main,8,0.9882480172492945,243,26,86,355
1209,dark,main,9,0.9896995789260203,268,26,92,386
1398,dark,main,0,0.9901668525313819,254,32,88,374
1398,dark,main,1,0.9891272290018827,215,34,83,332
1398,dark,main,2,0.9914580504997358,230,54,71,355
1398,dark,main,3,0.9930089319688494,219,42,74,335
1398,dark,main,4,0.9938672183314656,221,34,75,330
1398,dark,main,5,0.9922206882312931,235,36,87,358
1398,dark,main,6,0.9944583533363986,205,35,72,312
1398,dark,main,7,0.9920575253219772,193,48,74,315
1398,dark,main,8,0.994476663710806,252,38,77,367
1398,dark,main,9,0.9907829590201431,225,47,71,343
1389,dark,main,0,0.9879797332522263,256,39,80,375
1389,dark,main,1,0.9941283535023887,223,39,82,344
1389,dark,main,2,0.9799802914264237,232,40,93,365
1389,dark,main,3,0.9927967831426582,255,31,65,351
1389,dark,main,4,0.9903830283019788,201,55,83,339
1389,dark,main,5,0.9934042745528965,222,37,79,338
1389,dark,main,6,0.9906763360537004,208,32,62,302
1389,dark,main,7,0.9866942979522829,196,40,65,301
1389,dark,main,8,0.9885447416588823,203,31,97,331
1389,dark,main,9,0.9912028115636351,255,34,85,374
1092,dark,main,0,0.9923838700849056,247,21,99,367
1092,dark,main,1,0.9884985879990986,210,20,81,311
1092,dark,main,2,0.9945461407499965,220,35,89,344
1092,dark,main,3,0.9902587842533767,223,20,87,330
1092,dark,main,4,0.9845621582359989,225,23,79,327
1092,dark,main,5,0.9874056813176354,241,16,98,355
1092,dark,main,6,0.9917432813546312,219,14,81,314
1092,dark,main,7,0.9931265283815132,212,16,84,312
1092,dark,main,8,0.9889191499276134,256,27,78,361
1092,dark,main,9,0.9848127495550539,247,20,78,345
1193,dark,main,0,0.9922871926432573,275,26,89,390
1193,dark,main,1,0.992585680343006,245,12,93,350
1193,dark,main,2,0.9929179964380485,276,18,89,383
1193,dark,main,3,0.9944472332302003,253,26,71,350
1193,dark,main,4,0.9879313619635749,259,17,87,363
1193,dark,main,5,0.9878111155232844,259,14,84,357
1193,dark,main,6,0.9869235874785564,218,16,82,316
1193,dark,main,7,0.9935847558452936,233,15,76,324
1193,dark,main,8,0.9926644793873065,261,15,90,366
1193,dark,main,9,0.9885666920473403,278,19,95,392
21088,bright,main,0,0.9911422907745386,347,67,5,419
21088,bright,main,1,0.9889829043437185,313,53,5,371
21088,bright,main,2,0.9953813460992789,350,54,5,409
21088,bright,main,3,0.9873358499582794,334,47,4,385
21088,bright,main,4,0.9846867143883044,331,52,3,386
21088,bright,main,5,0.9890154917500498,330,65,3,398
21088,bright,main,6,0.986707747616854,288,61,3,352
21088,bright,main,7,0.9833406701900548,294,52,3,349
21088,bright,main,8,0.9919850819727655,351,60,4,415
21088,bright,main,9,0.9941370918034955,363,53,7,423
20105,bright,main,0,0.9927094192525521,341,92,5,438
20105,bright,main,1,0.9939533865859699,325,73,6,404
20105,bright,main,2,0.9921964553660331,364,60,2,426
20105,bright,main,3,0.9852991083174993,322,75,3,400
20105,bright,main,4,0.9919460978427915,323,83,3,409
20105,bright,main,5,0.9912921108964503,308,101,4,413
20105,bright,main,6,0.992127286349725,290,80,6,376
20105,bright,main,7,0.9927674272110225,288,81,0,369
20105,bright,main,8,0.9921396523156134,343,82,0,425
20105,bright,main,9,0.9937722403270256,328,103,0,431
20121,bright,main,0,0.9938097986054716,374,54,3,431
20121,bright,main,1,0.9926935053159351,343,50,3,396
20121,bright,main,2,0.9899101968365952,328,77,6,411
20121,bright,main,3,0.9922335199088114,287,86,1,374
20121,bright,main,4,0.9946083404584151,310,80,3,393
20121,bright,main,5,0.9933236925235519,327,69,3,399
20121,bright,main,6,0.9908771759701654,321,41,3,365
20121,bright,main,7,0.9876926761747782,283,61,4,348
20121,bright,main,8,0.9955454849538724,356,55,3,414
20121,bright,main,9,0.9916107918964507,330,80,5,415
1095,dark,main,0,0.9945586904487573,249,27,91,367
1095,dark,main,1,0.9935179034653021,267,16,64,347
1095,dark,main,2,0.9933841642238673,253,22,86,361
1095,dark,main,3,0.9947103644344275,236,22,82,340
1095,dark,main,4,0.992495212543425,259,16,66,341
1095,dark,main,5,0.9853433851848845,256,17,69,342
1095,dark,main,6,0.9925113970180526,223,15,81,319
1095,dark,main,7,0.9839667017589491,226,16,74,316
1095,dark,main,8,0.9934110409774913,213,34,94,341
1095,dark,main,9,0.9903615521787354,248,22,82,352
20252,bright,main,0,0.9925151730296861,324,116,2,442
20252,bright,main,1,0.9888140742472635,305,97,4,406
20252,bright,main,2,0.9894570591451314,339,95,1,435
20252,bright,main,3,0.9928075327492438,301,99,2,402
20252,bright,main,4,0.992706726457316,297,107,3,407
20252,bright,main,5,0.992446737791226,312,99,2,413
20252,bright,main,6,0.9942716791586372,270,97,0,367
20252,bright,main,7,0.9832822976956835,269,100,2,371
20252,bright,main,8,0.9910940473146072,354,72,2,428
20252,bright,main,9,0.9928776091272955,340,89,8,437
1110,dark,main,0,0.9898698268169988,250,18,92,360
1110,dark,main,1,0.9943937296855587,240,16,80,336
1110,dark,main,2,0.9955468636346545,260,14,81,355
1110,dark,main,3,0.9850352492975258,248,15,79,342
1110,dark,main,4,0.9884036248312065,237,17,78,332
1110,dark,main,5,0.9920622881992992,236,15,86,337
1110,dark,main,6,0.9850823964577176,197,20,80,297
1110,dark,main,7,0.994644337839603,197,20,74,291
1110,dark,main,8,0.9861988443254126,211,21,88,320
1110,dark,main,9,0.9921706538010896,262,21,76,359
21127,bright,main,0,0.9891587172228913,386,44,3,433
21127,bright,main,1,0.990629281476325,280,102,1,383
21127,bright,main,2,0.9925481032450898,272,121,3,396
21127,bright,main,3,0.9920196269049047,290,80,5,375
21127,bright,main,4,0.9949930487579809,318,69,4,391
21127,bright,main,5,0.9908498749812116,319,79,3,401
21127,bright,main,6,0.9890299954202667,311,47,2,360
21127,bright,main,7,0.995716899328564,316,41,4,361
21127,bright,main,8,0.9881944229396273,364,54,1,419
21127,bright,main,9,0.9891038070790451,347,66,6,419
21128,bright,main,0,0.9946966358939926,326,85,8,419
21128,bright,main,1,0.9906290098371554,361,34,0,395
21128,bright,main,2,0.9887764158732565,366,44,5,415
21128,bright,main,3,0.9931069611029405,338,46,5,389
21128,bright,main,4,0.9923968116629817,365,37,0,402
21128,bright,main,5,0.9941226646641015,325,59,7,391
21128,bright,main,6,0.9858608520696855,297,64,0,361
21128,bright,main,7,0.9889779492733238,273,75,3,351
21128,bright,main,8,0.9889557083452907,331,71,3,405
21128,bright,main,9,0.9944567959282211,314,89,2,405
1418,dark,main,0,0.9921775914973239,274,24,84,382
1418,dark,main,1,0.9938147620398173,274,20,75,369
1418,dark,main,2,0.9909936758076658,254,38,92,384
1418,dark,main,3,0.9901724918377035,234,27,87,348
1418,dark,main,4,0.9915823079674339,257,25,81,363
1418,dark,main,5,0.9793648851345264,263,29,69,361
1418,dark,main,6,0.9951786591250059,230,21,79,330
1418,dark,main,7,0.992747219127037,246,25,61,332
1418,dark,main,8,0.9901681351282234,252,21,97,370
1418,dark,main,9,0.9843035267281043,263,19,88,370
20079,bright,main,0,0.9895910075876571,270,82,3,355
20079,bright,main,1,0.991872368456982,277,117,10,404
20079,bright,main,2,0.9868271571650025,326,94,6,426
20079,bright,main,3,0.990031938281244,298,100,6,404
20079,bright,main,4,0.9889233444322763,270,137,3,410
20079,bright,main,5,0.9945873972807349,292,120,2,414
20079,bright,main,6,0.9953887306768828,298,74,2,374
20079,bright,main,7,0.9879715783892666,209,80,2,291
20079,bright,main,8,0.9894293013007335,339,84,3,426
20079,bright,main,9,0.989172348041982,329,98,4,431
2163,dark,main,0,0.9944300178062956,302,13,80,395
2163,dark,main,1,0.9887933714380602,244,13,101,358
2163,dark,main,2,0.9926070043317272,275,16,100,391
2163,dark,main,3,0.9934269838352485,260,17,70,347
2163,dark,main,4,0.9929665011792274,272,13,81,366
2163,dark,main,5,0.9915715711626518,271,13,96,380
2163,dark,main,6,0.9864111913817668,223,12,94,329
2163,dark,main,7,0.9919823591749146,229,22,79,330
2163,dark,main,8,0.9956023409639413,272,15,80,367
2163,dark,main,9,0.9863311409648551,288,12,88,388
20111,bright,main,0,0.990645799816167,323,106,0,429
20111,bright,main,1,0.9937819573766415,251,127,6,384
20111,bright,main,2,0.9894309654365506,312,100,2,414
20111,bright,main,3,0.991464043009184,330,60,4,394
20111,bright,main,4,0.9894080638861317,336,62,1,399
20111,bright,main,5,0.9885742765144107,320,73,7,400
20111,bright,main,6,0.9937964976003839,321,41,5,367
20111,bright,main,7,0.9903558542593016,282,77,1,360
20111,bright,main,8,0.9930935018746753,330,74,5,409
20111,bright,main,9,0.9928542748536874,304,112,3,419
1910,dark,main,0,0.9927534492290195,241,36,92,369
1910,dark,main,1,0.9918587295594853,208,45,87,340
1910,dark,main,2,0.9921101321054675,232,42,80,354
1910,dark,main,3,0.9924838192639571,223,34,87,344
1910,dark,main,4,0.9889385771482871,226,36,86,348
1910,dark,main,5,0.9932835002309017,260,30,75,365
1910,dark,main,6,0.9860372955247646,195,34,75,304
1910,dark,main,7,0.988849977072079,199,37,67,303
1910,dark,main,8,0.9948365221593011,247,37,82,366
1910,dark,main,9,0.9790833485170186,240,34,96,370
1117,dark,main,0,0.9913725644742384,266,21,90,377
1117,dark,main,1,0.9875151646330367,207,17,92,316
1117,dark,main,2,0.9902776030843136,245,24,92,361
1117,dark,main,3,0.9883042504546562,252,18,64,334
1117,dark,main,4,0.9935164267266717,235,13,91,339
1117,dark,main,5,0.9941486929880333,229,15,85,329
1117,dark,main,6,0.9963888776742288,218,16,78,312
1117,dark,main,7,0.9919327018108651,219,14,83,316
1117,dark,main,8,0.9882562362492912,239,19,84,342
1117,dark,main,9,0.9933729030496191,261,17,80,358
2203,dark,main,0,0.9871613308089745,282,15,83,380
2203,dark,main,1,0.994646482214957,255,16,83,354
2203,dark,main,2,0.99673708540355,270,18,87,375
2203,dark,main,3,0.9948231953136444,254,16,73,343
2203,dark,main,4,0.9883588791535145,264,20,84,368
2203,dark,main,5,0.9923640781160268,272,17,86,375
2203,dark,main,6,0.9850102840373068,226,38,52,316
2203,dark,main,7,0.9891366669362952,212,19,92,323
2203,dark,main,8,0.9905685909229736,274,15,89,378
2203,dark,main,9,0.9914720649969891,271,17,94,382
1882,dark,main,0,0.9820480354514494,251,45,78,374
1882,dark,main,1,0.992676537359824,240,35,71,346
1882,dark,main,2,0.9905363776785373,267,35,79,381
1882,dark,main,3,0.9812448364775856,226,36,78,340
1882,dark,main,4,0.995641260896699,220,39,74,333
1882,dark,main,5,0.9897327019065741,253,43,62,358
1882,dark,main,6,0.9911678309258061,206,39,73,318
1882,dark,main,7,0.9907593944944604,220,29,68,317
1882,dark,main,8,0.9946281256334157,247,48,80,375
1882,dark,main,9,0.9924450181445026,265,47,64,376
21195,bright,main,0,0.9940340191329735,322,81,3,406
21195,bright,main,1,0.9964733638237824,303,71,2,376
21195,bright,main,2,0.991500673960888,337,61,7,405
21195,bright,main,3,0.9920149042111941,317,55,3,375
21195,bright,main,4,0.980843695661056,328,47,9,384
21195,bright,main,5,0.9925541991627422,315,69,2,386
21195,bright,main,6,0.9872252398047243,281,59,8,348
21195,bright,main,7,0.9837709383637552,273,72,0,345
21195,bright,main,8,0.9890048601177238,328,63,5,396
21195,bright,main,9,0.9906878622696614,333,74,3,410
2197,dark,main,0,0.9921909024568945,289,15,95,399
2197,dark,main,1,0.9882377343292092,246,17,86,349
2197,dark,main,2,0.9919960438507139,258,19,97,374
2197,dark,main,3,0.9942179191869943,252,14,88,354
2197,dark,main,4,0.9885066302306519,247,19,99,365
2197,dark,main,5,0.9901986398130461,247,15,100,362
2197,dark,main,6,0.9844861373018363,236,13,81,330
2197,dark,main,7,0.9807574267146408,242,15,80,337
2197,dark,main,8,0.9917449689562975,284,15,92,391
2197,dark,main,9,0.9914861804362487,282,13,87,382
20112,bright,main,0,0.9960275926869365,358,62,6,426
20112,bright,main,1,0.9902566982711797,342,52,4,398
20112,bright,main,2,0.9941760266489013,373,49,2,424
20112,bright,main,3,0.9932084248176916,328,60,2,390
20112,bright,main,4,0.9943182757557012,342,54,4,400
20112,bright,main,5,0.9941968183746169,308,83,2,393
20112,bright,main,6,0.9870362279493325,269,72,2,343
20112,bright,main,7,0.9888336803180982,275,78,0,353
20112,bright,main,8,0.9959061129307347,343,76,2,421
20112,bright,main,9,0.9946980673066865,372,48,5,425
1239,dark,main,0,0.9895494417979878,273,16,93,382
1239,dark,main,1,0.9917889985837914,256,17,81,354
1239,dark,main,2,0.9905603794160087,262,19,93,374
1239,dark,main,3,0.9943553376742638,259,16,85,360
1239,dark,main,4,0.9922202612021421,267,19,80,366
1239,dark,main,5,0.9906008537506834,271,17,75,363
1239,dark,main,6,0.991716402830671,231,17,69,317
1239,dark,main,7,0.9954535276175775,229,21,77,327
1239,dark,main,8,0.993565759923485,281,18,83,382
1239,dark,main,9,0.9936972453574777,263,22,73,358
1222,dark,main,0,0.996123378963322,283,23,85,391
1222,dark,main,1,0.9854416899177184,252,19,81,352
1222,dark,main,2,0.9952745191198893,258,18,97,373
1222,dark,main,3,0.989690251572471,247,23,84,354
1222,dark,main,4,0.9812994496412191,243,17,78,338
1222,dark,main,5,0.9889907281540644,246,19,83,348
1222,dark,main,6,0.9905680221200631,234,14,75,323
1222,dark,main,7,0.9873713556895825,226,19,76,321
1222,dark,main,8,0.9923721579707991,280,20,77,377
1222,dark,main,9,0.9909296033163927,261,25,87,373
1230,dark,main,0,0.9941035824662795,295,16,78,389
1230,dark,main,1,0.9884430605787786,263,15,75,353
1230,dark,main,2,0.9844759016173958,259,12,92,363
1230,dark,main,3,0.9942937654194953,270,14,72,356
1230,dark,main,4,0.9896772872788163,242,21,94,357
1230,dark,main,5,0.9936310511824802,268,15,95,378
1230,dark,main,6,0.99468603293548,217,18,91,326
1230,dark,main,7,0.9923425887962545,227,17,86,330
1230,dark,main,8,0.992253066632117,271,15,71,357
1230,dark,main,9,0.9936560195645265,296,18,73,387
1246,dark,main,0,0.9936513213007141,275,14,81,370
1246,dark,main,1,0.9907710427708767,226,17,100,343
1246,dark,main,2,0.9859396707750419,274,26,87,387
1246,dark,main,3,0.9955429110642151,246,15,82,343
1246,dark,main,4,0.9931757871167182,250,16,76,342
1246,dark,main,5,0.9952849822746253,237,26,84,347
1246,dark,main,6,0.9872373699649045,240,15,64,319
1246,dark,main,7,0.9917269991527629,228,20,74,322
1246,dark,main,8,0.9946253090579205,255,18,86,359
1246,dark,main,9,0.9915297242175128,255,23,89,367
1394,dark,main,0,0.992703969988463,261,27,85,373
1394,dark,main,1,0.9891067831571893,228,33,86,347
1394,dark,main,2,0.9914820372876255,259,43,82,384
1394,dark,main,3,0.9934943985245458,242,39,70,351
1394,dark,main,4,0.9922355140554933,245,20,91,356
1394,dark,main,5,0.9905545609689022,262,29,69,360
1394,dark,main,6,0.9912405108051638,214,19,86,319
1394,dark,main,7,0.9644999457407231,93,18,39,150
1394,dark,main,8,0.9888636130898025,238,29,97,364
1394,dark,main,9,0.9883791493809713,245,29,87,361
1395,dark,main,0,0.9891174010619809,275,32,76,383
1395,dark,main,1,0.9922258541249845,230,44,77,351
1395,dark,main,2,0.9916895619343811,252,44,82,378
1395,dark,main,3,0.9954927291135194,249,29,72,350
1395,dark,main,4,0.9953545784187735,229,37,89,355
1395,dark,main,5,0.9941855063701518,240,31,82,353
1395,dark,main,6,0.9894555009435604,229,27,69,325
1395,dark,main,7,0.9915631888792524,220,40,57,317
1395,dark,main,8,0.9917034350184267,247,41,76,364
1395,dark,main,9,0.9932621574622192,242,43,85,370
1387,dark,main,0,0.9915855455927843,244,42,80,366
1387,dark,main,1,0.9884268527603166,242,31,63,336
1387,dark,main,2,0.9927244835530411,262,34,84,380
1387,dark,main,3,0.9939910655182479,241,28,78,347
1387,dark,main,4,0.9942418991713311,241,34,83,358
1387,dark,main,5,0.9901271664482227,241,27,85,353
1387,dark,main,6,0.9933165807131191,209,29,90,328
1387,dark,main,7,0.9920828426606818,228,34,69,331
1387,dark,main,8,0.9876002464801242,221,46,94,361
1387,dark,main,9,0.9936416485516577,252,39,71,362
1242,dark,main,0,0.9917736355026634,289,19,90,398
1242,dark,main,1,0.9923422861147957,256,15,88,359
1242,dark,main,2,0.9935165847681894,269,13,83,365
1242,dark,main,3,0.9945995555094388,245,11,93,349
1242,dark,main,4,0.9960538958494469,255,14,95,364
1242,dark,main,5,0.9962188985693234,248,17,100,365
1242,dark,main,6,0.9904487944997268,214,12,97,323
1242,dark,main,7,0.9944179931191549,224,16,83,323
1242,dark,main,8,0.9906614882874746,261,21,93,375
1242,dark,main,9,0.9904083156718735,279,16,86,381
1423,dark,main,0,0.9951775052337116,244,44,72,360
1423,dark,main,1,0.9905870653341929,230,38,75,343
1423,dark,main,2,0.9888913836548097,256,36,79,371
1423,dark,main,3,0.9873912094891389,243,39,79,361
1423,dark,main,4,0.9917944618819845,224,38,82,344
1423,dark,main,5,0.9935051432873692,258,22,78,358
1423,dark,main,6,0.9864373269730259,229,28,64,321
1423,dark,main,7,0.9922973314298277,214,33,70,317
1423,dark,main,8,0.9932865396026082,275,31,75,381
1423,dark,main,9,0.9918488226461117,224,46,89,359
1407,dark,main,0,0.9829238453710816,261,34,86,381
1407,dark,main,1,0.9927852171340886,257,21,70,348
1407,dark,main,2,0.986735291123357,276,20,81,377
1407,dark,main,3,0.9858200255749523,243,27,79,349
1407,dark,main,4,0.9928486352689321,236,25,89,350
1407,dark,main,5,0.9848202848501472,239,31,86,356
1407,dark,main,6,0.981230826485386,201,28,76,305
1407,dark,main,7,0.9886477482481792,209,33,77,319
1407,dark,main,8,0.9904850328837249,244,24,104,372
1407,dark,main,9,0.9869197412003073,259,30,77,366
21089,bright,main,0,0.9884421649710872,323,86,5,414
21089,bright,main,1,0.9870389665497518,319,63,2,384
21089,bright,main,2,0.9957141073287407,322,73,5,400
21089,bright,main,3,0.9964874410794962,329,53,5,387
21089,bright,main,4,0.9922734670162259,330,62,6,398
21089,bright,main,5,0.9931399287249281,327,69,3,399
21089,bright,main,6,0.986202598326485,261,84,3,348
21089,bright,main,7,0.9915552216218183,277,68,2,347
21089,bright,main,8,0.994924055139541,330,76,4,410
21089,bright,main,9,0.9911516554179012,348,60,1,409
1200,dark,main,0,0.9919019060184413,287,12,88,387
1200,dark,main,1,0.9962073699053876,254,16,78,348
1200,dark,main,2,0.9914090349187434,272,19,90,381
1200,dark,main,3,0.9935645022116578,253,14,85,352
1200,dark,main,4,0.9947695360078913,270,20,71,361
1200,dark,main,5,0.9907754690130881,234,15,108,357
1200,dark,main,6,0.9860523577683376,219,16,74,309
1200,dark,main,7,0.9826194744310058,229,13,82,324
1200,dark,main,8,0.9960511905076244,280,16,81,377
1200,dark,main,9,0.9938289484331226,285,12,70,367
1219,dark,main,0,0.9942755168306775,284,21,84,389
1219,dark,main,1,0.9916657197558653,251,22,83,356
1219,dark,main,2,0.9878599102012644,240,41,96,377
1219,dark,main,3,0.9905253312009145,249,16,84,349
1219,dark,main,4,0.9903597926749518,248,15,100,363
1219,dark,main,5,0.9890972881586084,270,15,80,365
1219,dark,main,6,0.9849587360662422,209,24,87,320
1219,dark,main,7,0.9829089033307599,219,19,83,321
1219,dark,main,8,0.9807058256107422,283,18,80,381
1219,dark,main,9,0.9913471148148117,259,21,98,378
21197,bright,main,0,0.9954220391537206,352,68,3,423
21197,bright,main,1,0.9909624526441028,300,73,6,379
21197,bright,main,2,0.99252490955007,331,69,3,403
21197,bright,main,3,0.9943233714623523,293,76,4,373
21197,bright,main,4,0.995761920736423,317,69,1,387
21197,bright,main,5,0.985564092388749,315,65,2,382
21197,bright,main,6,0.9870075073392897,294,62,3,359
21197,bright,main,7,0.9890811646913364,278,67,3,348
21197,bright,main,8,0.9958319226411263,301,92,3,396
21197,bright,main,9,0.9926629550889213,310,85,3,398
21163,bright,main,0,0.9838936429574141,348,62,6,416
21163,bright,main,1,0.9943844973851288,300,70,7,377
21163,bright,main,2,0.9911455907655282,329,68,4,401
21163,bright,main,3,0.9909648378343818,282,75,6,363
21163,bright,main,4,0.9949042722038367,335,52,1,388
21163,bright,main,5,0.9884807608293372,306,75,4,385
21163,bright,main,6,0.9925970080776403,279,63,2,344
21163,bright,main,7,0.988705701936217,297,49,5,351
21163,bright,main,8,0.9957612864378681,354,49,2,405
21163,bright,main,9,0.9915233118392183,339,61,8,408
20077,bright,main,0,0.9929687336558346,362,68,2,432
20077,bright,main,1,0.9933849933136125,306,91,4,401
20077,bright,main,2,0.9938420967021323,338,86,0,424
20077,bright,main,3,0.9914155279693336,304,99,3,406
20077,bright,main,4,0.9918104655242435,315,99,0,414
20077,bright,main,5,0.9938134097009549,335,72,3,410
20077,bright,main,6,0.986669956377706,297,72,5,374
20077,bright,main,7,0.9920011878154213,283,82,3,368
20077,bright,main,8,0.990936237644823,314,109,6,429
20077,bright,main,9,0.9925192095846278,332,95,2,429
20076,bright,main,0,0.9966491265267631,340,97,6,443
20076,bright,main,1,0.9916233274398878,326,78,3,407
20076,bright,main,2,0.993403245482924,354,68,2,424
20076,bright,main,3,0.9940637313416207,313,88,4,405
20076,bright,main,4,0.9920529388970906,283,122,8,413
20076,bright,main,5,0.9930245114441195,295,107,4,406
20076,bright,main,6,0.9915395885690568,264,102,4,370
20076,bright,main,7,0.9904491744106059,284,80,6,370
20076,bright,main,8,0.9920104796395505,304,123,4,431
20076,bright,main,9,0.9955316358343425,295,136,2,433
1097,dark,main,0,0.9864095203799429,275,19,85,379
1097,dark,main,1,0.9932855905236342,244,16,79,339
1097,dark,main,2,0.993873714153719,252,19,96,367
1097,dark,main,3,0.9913332592717896,232,18,85,335
1097,dark,main,4,0.9961629399957086,241,24,89,354
1097,dark,main,5,0.9866275882139576,240,18,79,337
1097,dark,main,6,0.9864958312619969,223,19,78,320
1097,dark,main,7,0.994539184515666,192,30,83,305
1097,dark,main,8,0.9942868443182785,238,22,95,355
1097,dark,main,9,0.9858038007518845,232,36,87,355
1923,dark,main,0,0.9906395361695355,283,19,88,390
1923,dark,main,1,0.9918315688102611,238,24,86,348
1923,dark,main,2,0.9908996339514866,258,25,82,365
1923,dark,main,3,0.9930603127517192,246,23,84,353
1923,dark,main,4,0.9923182645876865,254,20,90,364
1923,dark,main,5,0.9906016957690191,241,24,88,353
1923,dark,main,6,0.9892981241553677,215,23,74,312
1923,dark,main,7,0.991372901271852,223,26,82,331
1923,dark,main,8,0.9951207298503829,241,27,106,374
1923,dark,main,9,0.9880906494512924,255,23,85,363
1887,dark,main,0,0.9904073246701504,243,40,87,370
1887,dark,main,1,0.9922504653318485,219,37,77,333
1887,dark,main,2,0.9934037001809483,259,28,78,365
1887,dark,main,3,0.9924200562703415,246,36,70,352
1887,dark,main,4,0.9914551923837924,234,35,80,349
1887,dark,main,5,0.9883656047358229,218,32,84,334
1887,dark,main,6,0.9852798985962099,195,40,71,306
1887,dark,main,7,0.9896182572767922,211,46,51,308
1887,dark,main,8,0.9937244324041313,225,47,95,367
1887,dark,main,9,0.990029032718763,229,56,89,374
1903,dark,main,0,0.9914513438589712,271,27,78,376
1903,dark,main,1,0.9861395699569964,225,26,80,331
1903,dark,main,2,0.9898354397331484,265,29,76,370
1903,dark,main,3,0.9916292299916644,230,33,76,339
1903,dark,main,4,0.9870139791535493,248,33,69,350
1903,dark,main,5,0.9877315093786904,229,25,81,335
1903,dark,main,6,0.9936641744335447,206,16,83,305
1903,dark,main,7,0.9872698100570717,226,26,66,318
1903,dark,main,8,0.9878128189271704,265,25,82,372
1903,dark,main,9,0.9943567661335913,265,25,81,371
1258,dark,main,0,0.9940268249855466,277,18,104,399
1258,dark,main,1,0.9927581662543314,246,27,81,354
1258,dark,main,2,0.9916125358819297,265,26,83,374
1258,dark,main,3,0.9917378696374554,261,18,72,351
1258,dark,main,4,0.9753884346154132,252,22,93,367
1258,dark,main,5,0.9921948108952234,238,26,78,342
1258,dark,main,6,0.9925996423880159,216,29,66,311
1258,dark,main,7,0.990374164580115,216,19,81,316
1258,dark,main,8,0.9927213858555739,293,14,85,392
1258,dark,main,9,0.9932465307088844,273,18,85,376
20096,bright,main,0,0.991935154691593,323,111,3,437
20096,bright,main,1,0.995292203254006,335,63,1,399
20096,bright,main,2,0.9933220139936944,370,62,0,432
20096,bright,main,3,0.9888439079641728,352,45,1,398
20096,bright,main,4,0.9956293085427927,322,88,0,410
20096,bright,main,5,0.9975745509515485,326,79,1,406
20096,bright,main,6,0.9961690564649761,275,90,1,366
20096,bright,main,7,0.9865008134555336,274,85,3,362
20096,bright,main,8,0.9934353810290019,322,98,4,424
20096,bright,main,9,0.9883673318393731,305,126,3,434
1421,dark,main,0,0.9929915716511775,246,28,86,360
1421,dark,main,1,0.9906757163675225,253,25,86,364
1421,dark,main,2,0.9879236426980833,232,30,104,366
1421,dark,main,3,0.9932021773476079,237,20,81,338
1421,dark,main,4,0.9893770440297506,253,21,91,365
1421,dark,main,5,0.9907055523296243,234,22,89,345
1421,dark,main,6,0.993377187800062,218,28,79,325
1421,dark,main,7,0.9897396833595897,215,33,67,315
1421,dark,main,8,0.9974085572249841,226,50,84,360
1421,dark,main,9,0.992726862250966,254,20,96,370
1884,dark,main,0,0.9928502418442584,274,40,69,383
1884,dark,main,1,0.9884863828732013,220,56,67,343
1884,dark,main,2,0.988709764990928,272,31,91,394
1884,dark,main,3,0.9924672882678228,224,44,73,341
1884,dark,main,4,0.9931547647030032,246,35,66,347
1884,dark,main,5,0.9972293599466858,232,35,85,352
1884,dark,main,6,0.9857858528373188,216,36,67,319
1884,dark,main,7,0.9927134937225631,197,45,77,319
1884,dark,main,8,0.9887316215387217,225,52,79,356
1884,dark,main,9,0.9801457549317723,237,61,73,371
20107,bright,main,0,0.9935625872546346,374,66,2,442
20107,bright,main,1,0.9946079643412044,325,73,5,403
20107,bright,main,2,0.9944652611708987,338,92,2,432
20107,bright,main,3,0.994832997072821,332,59,0,391
20107,bright,main,4,0.9944358175282103,308,93,3,404
20107,bright,main,5,0.9913165301057996,289,107,4,400
20107,bright,main,6,0.9934396637007749,280,86,3,369
20107,bright,main,7,0.9927836019937888,275,86,5,366
20107,bright,main,8,0.9886067551906129,358,69,2,429
20107,bright,main,9,0.9926473559759059,361,73,1,435
1408,dark,main,0,0.9954118269308286,266,25,84,375
1408,dark,main,1,0.9948262289101694,239,30,80,349
1408,dark,main,2,0.9953798113485343,246,36,92,374
1408,dark,main,3,0.9900457262923668,237,35,74,346
1408,dark,main,4,0.9885525309183884,242,22,97,361
1408,dark,main,5,0.9781307467490205,234,30,79,343
1408,dark,main,6,0.9903970787126135,220,25,74,319
1408,dark,main,7,0.9899223658001424,226,16,66,308
1408,dark,main,8,0.9934376758835042,246,33,90,369
1408,dark,main,9,0.9906790721149995,234,20,89,343
1396,dark,main,0,0.9935739250020589,258,35,95,388
1396,dark,main,1,0.9893205084484019,233,37,77,347
1396,dark,main,2,0.99164923653876,260,24,83,367
1396,dark,main,3,0.9925945098104116,236,33,75,344
1396,dark,main,4,0.9899087541041524,226,28,79,333
1396,dark,main,5,0.9889053523347195,220,35,92,347
1396,dark,main,6,0.9924403202148815,226,26,68,320
1396,dark,main,7,0.9949109254247649,213,27,87,327
1396,dark,main,8,0.9820714768115006,251,27,91,369
1396,dark,main,9,0.9917756853058799,246,26,78,350
1218,dark,main,0,0.9928822064411927,277,17,86,380
1218,dark,main,1,0.9864963580596263,243,15,95,353
1218,dark,main,2,0.99101305100857,255,28,90,373
1218,dark,main,3,0.9844299188915663,242,15,83,340
1218,dark,main,4,0.9920382547444285,229,20,103,352
1218,dark,main,5,0.9919662253045429,248,20,78,346
1218,dark,main,6,0.9921365426741208,233,20,66,319
1218,dark,main,7,0.9921104065694751,248,16,58,322
1218,dark,main,8,0.9911846925627252,290,22,77,389
1218,dark,main,9,0.9945170527999386,250,20,85,355
20106,bright,main,0,0.9916654363309998,374,65,2,441
20106,bright,main,1,0.9931896660176063,342,61,3,406
20106,bright,main,2,0.995534920193691,322,107,6,435
20106,bright,main,3,0.9921343969186567,305,90,3,398
20106,bright,main,4,0.9870757851480578,331,74,3,408
20106,bright,main,5,0.9897246420200935,322,78,2,402
20106,bright,main,6,0.9901212863263837,298,69,3,370
20106,bright,main,7,0.985103485743723,274,84,4,362
20106,bright,main,8,0.991613884813955,317,104,1,422
20106,bright,main,9,0.9885618837407022,350,84,4,438
1831,dark,main,0,0.9931455460637745,269,33,82,384
1831,dark,main,1,0.9878723143410526,210,49,81,340
1831,dark,main,2,0.9892935553889285,218,81,76,375
1831,dark,main,3,0.988433996776631,219,40,76,335
1831,dark,main,4,0.9955503271127777,242,26,77,345
1831,dark,main,5,0.9913020726511074,209,51,76,336
1831,dark,main,6,0.9903145051054325,227,29,78,334
1831,dark,main,7,0.9881158592853828,237,26,68,331
1831,dark,main,8,0.9919628530232882,253,29,86,368
1831,dark,main,9,0.9887619385923652,255,25,72,352
1247,dark,main,0,0.9933303612195113,272,19,99,390
1247,dark,main,1,0.9925808127912865,249,19,84,352
1247,dark,main,2,0.993526554961062,278,20,82,380
1247,dark,main,3,0.9952401068957878,264,17,72,353
1247,dark,main,4,0.9896933790148565,233,19,104,356
1247,dark,main,5,0.9911543408936966,241,32,71,344
1247,dark,main,6,0.9868177088565969,234,19,70,323
1247,dark,main,7,0.984188928602787,220,23,75,318
1247,dark,main,8,0.986471544126146,251,29,80,360
1247,dark,main,9,0.9836019428719547,279,19,83,381
1384,dark,main,0,0.9932019324015187,270,26,81,377
1384,dark,main,1,0.9892568433916596,227,30,79,336
1384,dark,main,2,0.990379798097649,251,31,83,365
1384,dark,main,3,0.9917530382546212,220,35,82,337
1384,dark,main,4,0.9907347967024877,232,34,92,358
1384,dark,main,5,0.9938402131360028,252,23,85,360
1384,dark,main,6,0.9903701066973829,234,20,73,327
1384,dark,main,7,0.9907572903520375,192,44,76,312
1384,dark,main,8,0.9798592657472266,254,32,81,367
1384,dark,main,9,0.9922675068670007,248,32,75,355
20093,bright,main,0,0.9904834879639164,306,78,2,386
20093,bright,main,1,0.9947255660914697,300,81,3,384
20093,bright,main,2,0.9955674413064164,349,81,1,431
20093,bright,main,3,0.9922405179181473,296,99,2,397
20093,bright,main,4,0.9940858786122959,257,142,3,402
20093,bright,main,5,0.9912481984645761,312,84,2,398
20093,bright,main,6,0.9913603759502077,276,89,2,367
20093,bright,main,7,0.9899183919033075,299,59,2,360
20093,bright,main,8,0.9925006527111785,335,82,4,421
20093,bright,main,9,0.9908503477854963,312,99,4,415
1388,dark,main,0,0.9958783788663564,252,27,96,375
1388,dark,main,1,0.9950111745959025,247,22,79,348
1388,dark,main,2,0.9909499729731133,242,27,110,379
1388,dark,main,3,0.9825068455181571,234,30,95,359
1388,dark,main,4,0.992979709165255,253,25,81,359
1388,dark,main,5,0.9881849711439604,232,27,85,344
1388,dark,main,6,0.9916717604095018,211,23,75,309
1388,dark,main,7,0.9909531308493787,214,20,69,303
1388,dark,main,8,0.994455533802842,260,27,85,372
1388,dark,main,9,0.9913037439162862,251,21,90,362
20085,bright,main,0,0.9914622179370001,333,103,2,438
20085,bright,main,1,0.9914134404366267,309,85,4,398
20085,bright,main,2,0.993710584441777,333,93,5,431
20085,bright,main,3,0.9935280425353386,291,101,2,394
20085,bright,main,4,0.9920539523385652,313,91,0,404
20085,bright,main,5,0.9953824994647724,295,98,3,396
20085,bright,main,6,0.9919973294648029,277,82,5,364
20085,bright,main,7,0.9931363619420469,265,95,1,361
20085,bright,main,8,0.9938285181643679,341,84,0,425
20085,bright,main,9,0.9918985789029753,354,83,0,437
20092,bright,main,0,0.9917623156040509,353,84,2,439
20092,bright,main,1,0.987860867658557,295,104,2,401
20092,bright,main,2,0.9961112075549706,323,101,6,430
20092,bright,main,3,0.9935039491919672,288,104,2,394
20092,bright,main,4,0.9964245654524784,307,93,2,402
20092,bright,main,5,0.9954774277039515,308,95,3,406
20092,bright,main,6,0.988675273309178,296,63,10,369
20092,bright,main,7,0.9818116957982875,293,74,1,368
20092,bright,main,8,0.9942068278248782,338,84,2,424
20092,bright,main,9,0.9949118771366543,241,82,0,323
20084,bright,main,0,0.9952059184355552,331,102,1,434
20084,bright,main,1,0.9907287330616434,304,91,2,397
20084,bright,main,2,0.9911918060912323,342,82,3,427
20084,bright,main,3,0.9916640600592481,300,86,2,388
20084,bright,main,4,0.9885757159544385,339,66,3,408
20084,bright,main,5,0.9845487340831838,315,84,6,405
20084,bright,main,6,0.9955315129984952,307,60,2,369
20084,bright,main,7,0.9921623458477917,299,56,3,358
20084,bright,main,8,0.9932649969669731,359,56,4,419
20084,bright,main,9,0.9870327821066804,347,78,5,430
20912,bright,main,0,0.988204614865813,371,68,4,443
20912,bright,main,1,0.9898350597385197,327,68,8,403
20912,bright,main,2,0.9936486420480237,354,77,5,436
20912,bright,main,3,0.9935890662726775,324,74,4,402
20912,bright,main,4,0.9966040738420421,333,77,3,413
20912,bright,main,5,0.9905911321344879,332,79,3,414
20912,bright,main,6,0.9919611408086914,292,72,6,370
20912,bright,main,7,0.9945139500970092,293,66,2,361
20912,bright,main,8,0.9867290987656943,348,76,4,428
20912,bright,main,9,0.9885056997212941,331,95,2,428
20091,bright,main,0,0.9892495841968503,377,60,3,440
20091,bright,main,1,0.9922874433278931,347,50,3,400
20091,bright,main,2,0.9912850062758733,355,74,2,431
20091,bright,main,3,0.9906507084103992,304,91,2,397
20091,bright,main,4,0.9924440744800881,330,72,2,404
20091,bright,main,5,0.9941110048651345,326,72,5,403
20091,bright,main,6,0.9903709160806078,271,85,6,362
20091,bright,main,7,0.9914794253060518,275,80,4,359
20091,bright,main,8,0.9930944915098717,354,68,6,428
20091,bright,main,9,0.989694179104517,363,64,0,427
20098,bright,main,0,0.9949446388621688,345,94,1,440
20098,bright,main,1,0.9931926503690912,284,115,2,401
20098,bright,main,2,0.9922298413492324,335,97,1,433
20098,bright,main,3,0.9946127630938998,295,99,4,398
20098,bright,main,4,0.9945198346667425,305,99,4,408
20098,bright,main,5,0.9919272704302574,326,84,1,411
20098,bright,main,6,0.9913834020545337,297,69,1,367
20098,bright,main,7,0.9884121229443953,290,64,9,363
20098,bright,main,8,0.9957856182324722,324,95,7,426
20098,bright,main,9,0.99447171759762,346,73,2,421
1914,dark,main,0,0.9820650847185937,256,35,72,363
1914,dark,main,1,0.9923221419469128,241,28,81,350
1914,dark,main,2,0.993569287110023,225,61,71,357
1914,dark,main,3,0.9945315208714529,235,37,79,351
1914,dark,main,4,0.9879219344473404,243,37,70,350
1914,dark,main,5,0.993934615949494,236,41,78,355
1914,dark,main,6,0.9921595775723114,210,26,77,313
1914,dark,main,7,0.9900461843314555,219,32,57,308
1914,dark,main,8,0.9960278859913331,234,36,77,347
1914,dark,main,9,0.9928568778272063,259,36,73,368
1736,dark,main,0,0.9910053893827789,252,29,100,381
1736,dark,main,1,0.9933531000974275,254,17,75,346
1736,dark,main,2,0.988312939237345,259,21,95,375
1736,dark,main,3,0.9892204745927744,224,16,99,339
1736,dark,main,4,0.9939331242932629,250,16,96,362
1736,dark,main,5,0.9915570078563868,235,14,97,346
1736,dark,main,6,0.9907789709716219,244,14,71,329
1736,dark,main,7,0.9919894772312462,223,15,74,312
1736,dark,main,8,0.9936028747073693,272,15,72,359
1736,dark,main,9,0.9902900483629594,259,24,82,365
20000,bright,main,0,0.9948139968111652,335,108,3,446
20000,bright,main,1,0.9896922569131378,297,103,4,404
20000,bright,main,2,0.9921627373640751,327,102,4,433
20000,bright,main,3,0.990138092255347,310,83,4,397
20000,bright,main,4,0.9928286321217903,300,106,3,409
20000,bright,main,5,0.9909607490861023,303,108,3,414
20000,bright,main,6,0.9894732041054828,265,103,7,375
20000,bright,main,7,0.9886515568111534,263,100,1,364
20000,bright,main,8,0.992385873885633,325,97,4,426
20000,bright,main,9,0.9901387082327755,281,138,4,423
20850,bright,main,0,0.9916799547278788,313,93,8,414
20850,bright,main,1,0.9916630921684443,285,118,3,406
20850,bright,main,2,0.9875369844246041,292,134,2,428
20850,bright,main,3,0.9953382968800127,279,123,0,402
20850,bright,main,4,0.9937218730329849,313,96,4,413
20850,bright,main,5,0.990833873997312,292,107,9,408
20850,bright,main,6,0.990718271568014,219,144,4,367
20850,bright,main,7,0.9919133802518771,279,84,3,366
20850,bright,main,8,0.9922799802374141,334,88,6,428
20850,bright,main,9,0.9930503492652502,310,118,0,428
21087,bright,main,0,0.9908834477849892,360,58,4,422
21087,bright,main,1,0.9972711748693412,327,51,4,382
21087,bright,main,2,0.9934740235923399,341,55,3,399
21087,bright,main,3,0.9914460184636131,309,68,4,381
21087,bright,main,4,0.9910125446294162,315,69,5,389
21087,bright,main,5,0.9912836774523429,302,77,9,388
21087,bright,main,6,0.98839223155683,293,59,5,357
21087,bright,main,7,0.9909737623860683,280,49,7,336
21087,bright,main,8,0.9892985738550033,349,60,4,413
21087,bright,main,9,0.9918191172770242,361,48,5,414
20094,bright,main,0,0.9915571128941701,365,70,2,437
20094,bright,main,1,0.9922968385279746,307,89,2,398
20094,bright,main,2,0.9892265889444806,324,97,10,431
20094,bright,main,3,0.9869447674222572,297,95,2,394
20094,bright,main,4,0.9919610778999621,301,103,1,405
20094,bright,main,5,0.9944875872648903,327,76,2,405
20094,bright,main,6,0.9869058847915577,317,55,3,375
20094,bright,main,7,0.9842422919987686,307,55,3,365
20094,bright,main,8,0.9928751488501735,327,93,4,424
20094,bright,main,9,0.9941832261110821,343,75,0,418
20116,bright,main,0,0.992191195181314,345,78,3,426
20116,bright,main,1,0.9960743944222241,316,69,7,392
20116,bright,main,2,0.9835630544583063,340,66,4,410
20116,bright,main,3,0.9918227199000491,315,71,4,390
20116,bright,main,4,0.9929765377467109,332,60,1,393
20116,bright,main,5,0.9841070703798307,316,76,2,394
20116,bright,main,6,0.9927571653116588,293,67,3,363
20116,bright,main,7,0.9928049177551129,276,73,2,351
20116,bright,main,8,0.9952728001290652,336,74,3,413
20116,bright,main,9,0.9905183940153816,320,98,1,419
21103,bright,main,0,0.9939684064777999,376,51,4,431
21103,bright,main,1,0.9950540773404813,341,41,5,387
21103,bright,main,2,0.9943628249437388,358,56,0,414
21103,bright,main,3,0.9935592588727088,329,47,1,377
21103,bright,main,4,0.9951652957988992,323,66,2,391
21103,bright,main,5,0.9927987561118369,355,35,6,396
21103,bright,main,6,0.9945391941041138,302,57,1,360
21103,bright,main,7,0.9938743545657284,307,46,4,357
21103,bright,main,8,0.9962834091688534,362,50,1,413
21103,bright,main,9,0.9894424472465738,361,58,4,423
20403,bright,main,0,0.9861106415645948,303,134,2,439
20403,bright,main,1,0.9905141634231389,309,92,1,402
20403,bright,main,2,0.9937556730691411,319,114,1,434
20403,bright,main,3,0.989047253560234,298,99,2,399
20403,bright,main,4,0.9899380452347316,323,82,6,411
20403,bright,main,5,0.9921198880470526,348,63,4,415
20403,bright,main,6,0.9957227458604068,320,49,4,373
20403,bright,main,7,0.9938785538979221,298,66,4,368
20403,bright,main,8,0.9949528139078301,331,91,5,427
20403,bright,main,9,0.9926189597131265,340,90,2,432
20406,bright,main,0,0.9942092198768936,316,114,5,435
20406,bright,main,1,0.9940756338817108,296,109,2,407
20406,bright,main,2,0.9923914619892799,309,116,6,431
20406,bright,main,3,0.9909257097378542,290,109,6,405
20406,bright,main,4,0.9851274145168447,301,106,5,412
20406,bright,main,5,0.994216863140197,333,80,4,417
20406,bright,main,6,0.993091317464154,275,98,2,375
20406,bright,main,7,0.9901553697124995,272,98,2,372
20406,bright,main,8,0.9927060796926037,310,114,2,426
20406,bright,main,9,0.9924068623730973,334,97,4,435
1764,dark,main,0,0.9894041046565053,263,20,100,383
1764,dark,main,1,0.9914236877480109,222,23,98,343
1764,dark,main,2,0.9918356536631837,285,23,76,384
1764,dark,main,3,0.9912912526487369,241,23,75,339
1764,dark,main,4,0.9949802031579715,247,22,87,356
1764,dark,main,5,0.991759853576605,250,19,97,366
1764,dark,main,6,0.9921978157382425,237,17,79,333
1764,dark,main,7,0.9936566004023399,239,20,70,329
1764,dark,main,8,0.9924532764026716,256,27,93,376
1764,dark,main,9,0.9904401005774595,261,21,87,369
21114,bright,main,0,0.9935462570346634,338,70,5,413
21114,bright,main,1,0.9942799954899084,306,60,6,372
21114,bright,main,2,0.9906927914217017,318,71,6,395
21114,bright,main,3,0.9891014407978035,328,44,4,376
21114,bright,main,4,0.994573076529328,306,85,2,393
21114,bright,main,5,0.9920919086707197,321,65,3,389
21114,bright,main,6,0.9939513318226448,295,52,3,350
21114,bright,main,7,0.9891169903330991,287,62,3,352
21114,bright,main,8,0.9907119618629298,344,59,4,407
21114,bright,main,9,0.9880229705421741,359,56,3,418
1834,dark,main,0,0.9922585661272146,255,39,71,365
1834,dark,main,1,0.9882803722672299,205,59,51,315
1834,dark,main,2,0.9962827157609518,232,41,87,360
1834,dark,main,3,0.9899258094388803,225,36,76,337
1834,dark,main,4,0.991318481543288,230,38,68,336
1834,dark,main,5,0.9932321790929242,253,35,58,346
1834,dark,main,6,0.9886981472351057,196,34,87,317
1834,dark,main,7,0.9882609199882392,209,33,66,308
1834,dark,main,8,0.9929389728965808,258,28,81,367
1834,dark,main,9,0.9942187105197962,237,34,74,345
1836,dark,main,0,0.9855147975715725,213,73,73,359
1836,dark,main,1,0.9882845291957042,231,51,66,348
1836,dark,main,2,0.994510984990332,244,59,66,369
1836,dark,main,3,0.9948317526053831,200,57,79,336
1836,dark,main,4,0.994904842402873,234,33,74,341
1836,dark,main,5,0.9899572356637361,230,49,73,352
1836,dark,main,6,0.9909407675528564,196,33,72,301
1836,dark,main,7,0.9886366179245994,190,44,70,304
1836,dark,main,8,0.9918149972292167,218,62,84,364
1836,dark,main,9,0.9921360384158652,266,38,78,382
1093,dark,main,0,0.9926902260070387,218,28,76,322
1093,dark,main,1,0.989968432995784,208,21,77,306
1093,dark,main,2,0.9893107908530939,232,19,87,338
1093,dark,main,3,0.9870518762638661,220,15,81,316
1093,dark,main,4,0.9923088182092462,219,21,81,321
1093,dark,main,5,0.9960066911756225,261,15,68,344
1093,dark,main,6,0.9808001453470725,203,19,73,295
1093,dark,main,7,0.99148194449884,211,33,63,307
1093,dark,main,8,0.9890469481776641,260,16,68,344
1093,dark,main,9,0.9881969214810653,231,17,90,338
1114,dark,main,0,0.9917664939475819,261,16,84,361
1114,dark,main,1,0.9934225946045324,227,19,94,340
1114,dark,main,2,0.9870397728947513,255,14,94,363
1114,dark,main,3,0.9938128938523203,231,20,96,347
1114,dark,main,4,0.99438358176308,242,22,77,341
1114,dark,main,5,0.991532456793468,241,18,93,352
1114,dark,main,6,0.9892110320905154,234,14,70,318
1114,dark,main,7,0.9819960228128243,215,20,78,313
1114,dark,main,8,0.9939994441016462,264,21,84,369
1114,dark,main,9,0.9930454895318938,241,17,105,363
1419,dark,main,0,0.9917966375474556,278,25,74,377
1419,dark,main,1,0.9921155863915015,234,33,69,336
1419,dark,main,2,0.9927929495171636,293,19,72,384
1419,dark,main,3,0.9919474586190179,250,27,77,354
1419,dark,main,4,0.9863404860233047,233,40,73,346
1419,dark,main,5,0.9932091562332415,240,28,86,354
1419,dark,main,6,0.9891314377330632,218,19,79,316
1419,dark,main,7,0.991194410764318,198,29,83,310
1419,dark,main,8,0.9881390652007676,249,28,85,362
1419,dark,main,9,0.9848225632357389,270,20,76,366
1409,dark,main,0,0.9881545220766688,285,25,70,380
1409,dark,main,1,0.9905323288647991,234,30,71,335
1409,dark,main,2,0.9822042506846081,267,25,86,378
1409,dark,main,3,0.9891564092559975,241,29,85,355
1409,dark,main,4,0.9879859340944334,248,30,83,361
1409,dark,main,5,0.9926727417954867,237,29,88,354
1409,dark,main,6,0.9895885571308395,211,28,72,311
1409,dark,main,7,0.9919632593150411,219,19,79,317
1409,dark,main,8,0.9954371053759893,249,29,91,369
1409,dark,main,9,0.9848534205812689,231,30,95,356
1832,dark,main,0,0.9889177354620861,229,45,97,371
1832,dark,main,1,0.9893484939925853,217,36,78,331
1832,dark,main,2,0.9893405129179427,253,44,63,360
1832,dark,main,3,0.9938178429012196,228,35,74,337
1832,dark,main,4,0.9923159147915429,227,47,75,349
1832,dark,main,5,0.9833097884139355,244,28,69,341
1832,dark,main,6,0.9933832463617264,186,38,75,299
1832,dark,main,7,0.9818257717715249,204,34,78,316
1832,dark,main,8,0.9931725852976666,243,35,83,361
1832,dark,main,9,0.9913486836050764,247,46,69,362
1886,dark,main,0,0.9954160387197712,255,39,80,374
1886,dark,main,1,0.9928118447367114,241,37,73,351
1886,dark,main,2,0.9892077327520259,268,32,75,375
1886,dark,main,3,0.9940826957027787,257,34,58,349
1886,dark,main,4,0.991181751045936,244,24,78,346
1886,dark,main,5,0.9938388605646156,202,54,86,342
1886,dark,main,6,0.9828016844626316,231,34,54,319
1886,dark,main,7,0.9890039681172765,216,39,65,320
1886,dark,main,8,0.9944836538616704,242,42,86,370
1886,dark,main,9,0.9828795498164296,250,43,81,374
20823,bright,main,0,0.9916066836525183,374,62,5,441
20823,bright,main,1,0.9893731955600451,319,84,5,408
20823,bright,main,2,0.9956955954576243,301,129,1,431
20823,bright,main,3,0.9907925985887076,327,70,3,400
20823,bright,main,4,0.9936162168336572,339,65,5,409
20823,bright,main,5,0.9936907226147349,353,57,3,413
20823,bright,main,6,0.9879950285761686,285,81,4,370
20823,bright,main,7,0.9919264240678037,306,53,7,366
20823,bright,main,8,0.9921593667462761,322,101,4,427
20823,bright,main,9,0.9882221991664398,370,55,3,428
1234,dark,main,0,0.9898679722886715,277,14,96,387
1234,dark,main,1,0.9921366664220879,266,19,71,356
1234,dark,main,2,0.9874033987344545,246,21,100,367
1234,dark,main,3,0.9948987933876405,258,20,74,352
1234,dark,main,4,0.9858817274268287,254,17,82,353
1234,dark,main,5,0.9936492013919698,274,16,69,359
1234,dark,main,6,0.9943794403716618,242,15,72,329
1234,dark,main,7,0.9876338556276675,222,19,89,330
1234,dark,main,8,0.992194686317109,256,16,94,366
1234,dark,main,9,0.9927393376277204,282,19,70,371
1111,dark,main,0,0.9917468155084839,253,21,80,354
1111,dark,main,1,0.9916480117747148,223,20,82,325
1111,dark,main,2,0.9912953268405829,228,21,116,365
1111,dark,main,3,0.9872044365759434,210,19,79,308
1111,dark,main,4,0.977434178425818,245,18,77,340
1111,dark,main,5,0.9930229439394564,237,19,90,346
1111,dark,main,6,0.9939372676937805,213,19,73,305
1111,dark,main,7,0.986632211103871,206,15,84,305
1111,dark,main,8,0.989869821757777,248,17,80,345
1111,dark,main,9,0.9924847053022713,234,18,94,346
1250,dark,main,0,0.9913457282677957,263,26,87,376
1250,dark,main,1,0.9932622977080674,240,23,78,341
1250,dark,main,2,0.9910287737821402,264,27,74,365
1250,dark,main,3,0.9969260887928761,261,20,72,353
1250,dark,main,4,0.9909909119629831,244,25,85,354
1250,dark,main,5,0.9877698538834685,229,28,91,348
1250,dark,main,6,0.9920020329474593,222,22,78,322
1250,dark,main,7,0.9904056066790691,224,25,79,328
1250,dark,main,8,0.9932721605245096,249,23,98,370
1250,dark,main,9,0.993985621037985,257,28,92,377
1238,dark,main,0,0.9863355500223583,286,15,78,379
1238,dark,main,1,0.9959296948131312,255,12,96,363
1238,dark,main,2,0.9936525063254189,270,30,87,387
1238,dark,main,3,0.994194425148693,228,23,88,339
1238,dark,main,4,0.9915712738456856,267,20,74,361
1238,dark,main,5,0.9883263984545566,244,18,92,354
1238,dark,main,6,0.9806267642419524,234,14,69,317
1238,dark,main,7,0.9888374736212188,230,15,77,322
1238,dark,main,8,0.9911286143176687,254,18,99,371
1238,dark,main,9,0.9952067477737244,276,14,81,371
1726,dark,main,0,0.995198456472912,265,14,92,371
1726,dark,main,1,0.9891995058529535,266,17,85,368
1726,dark,main,2,0.9949644014610995,274,28,74,376
1726,dark,main,3,0.9905203114413011,266,14,79,359
1726,dark,main,4,0.9869051714366165,231,20,97,348
1726,dark,main,5,0.9928717201468051,258,20,87,365
1726,dark,main,6,0.9936006290142145,224,20,73,317
1726,dark,main,7,0.9867119656515612,238,17,67,322
1726,dark,main,8,0.9864295470225043,262,28,77,367
1726,dark,main,9,0.994233080328347,254,23,90,367
1835,dark,main,0,0.9929474999091016,246,47,82,375
1835,dark,main,1,0.9946217902928431,198,48,77,323
1835,dark,main,2,0.9940649864200434,232,51,81,364
1835,dark,main,3,0.994689244484535,211,61,60,332
1835,dark,main,4,0.9932347353434746,220,70,54,344
1835,dark,main,5,0.9889813138768899,222,63,64,349
1835,dark,main,6,0.9867216809798288,186,40,84,310
1835,dark,main,7,0.9882276972824989,188,55,76,319
1835,dark,main,8,0.9807602989417484,216,56,76,348
1835,dark,main,9,0.9851412291766384,207,66,84,357
1221,dark,main,0,0.9959196035990973,269,14,91,374
1221,dark,main,1,0.9932252208049864,261,14,92,367
1221,dark,main,2,0.994697983382657,256,15,104,375
1221,dark,main,3,0.9931373512382344,256,19,76,351
1221,dark,main,4,0.993572931842757,231,15,104,350
1221,dark,main,5,0.9923609892934167,253,15,101,369
1221,dark,main,6,0.9888075383149845,219,13,97,329
1221,dark,main,7,0.9895868073073073,234,19,65,318
1221,dark,main,8,0.9940398022814081,263,19,92,374
1221,dark,main,9,0.9908920325768501,264,18,90,372
1397,dark,main,0,0.9950219829243137,224,27,84,335
1397,dark,main,1,0.9919167575806632,249,26,73,348
1397,dark,main,2,0.9903007471361104,260,28,90,378
1397,dark,main,3,0.9886392196159416,239,36,70,345
1397,dark,main,4,0.9908706503845985,234,23,96,353
1397,dark,main,5,0.9961188337833049,227,35,85,347
1397,dark,main,6,0.9906567782677442,227,37,58,322
1397,dark,main,7,0.9903117895253791,204,27,75,306
1397,dark,main,8,0.9892714335061155,250,44,70,364
1397,dark,main,9,0.9948327853274538,239,42,79,360
1235,dark,main,0,0.9913134928911225,273,27,70,370
1235,dark,main,1,0.9868933978902886,236,26,83,345
1235,dark,main,2,0.9877015366431642,272,19,92,383
1235,dark,main,3,0.9913713594992563,251,21,89,361
1235,dark,main,4,0.9907423166903064,247,18,83,348
1235,dark,main,5,0.9953469841281358,252,22,87,361
1235,dark,main,6,0.9896741535965409,220,30,60,310
1235,dark,main,7,0.9876191187806114,220,17,77,314
1235,dark,main,8,0.9830336166512968,261,15,93,369
1235,dark,main,9,0.9912098035570835,262,18,86,366
1236,dark,main,0,0.9921788839561418,283,17,88,388
1236,dark,main,1,0.9936220176996262,241,18,93,352
1236,dark,main,2,0.991480356134263,281,22,83,386
1236,dark,main,3,0.9932488757425911,256,15,81,352
1236,dark,main,4,0.9931173785846827,246,28,79,353
1236,dark,main,5,0.9942742772565785,258,18,88,364
1236,dark,main,6,0.9893381242485614,223,17,85,325
1236,dark,main,7,0.9924103642906227,233,17,66,316
1236,dark,main,8,0.9872612316094597,259,16,92,367
1236,dark,main,9,0.9914360322007449,259,20,102,381
1917,dark,main,0,0.9905708742210948,254,41,78,373
1917,dark,main,1,0.9851872625185006,224,40,80,344
1917,dark,main,2,0.9932201092284522,242,39,81,362
1917,dark,main,3,0.9935660829574608,215,66,71,352
1917,dark,main,4,0.9846311491964853,236,28,86,350
1917,dark,main,5,0.991980956131789,248,33,77,358
1917,dark,main,6,0.9852628662497128,229,32,68,329
1917,dark,main,7,0.9900224222227157,222,30,69,321
1917,dark,main,8,0.9891697063691627,258,44,79,381
1917,dark,main,9,0.9890282946481196,243,28,97,368
1100,dark,main,0,0.9881747953718735,265,17,83,365
1100,dark,main,1,0.9829798474558578,226,24,75,325
1100,dark,main,2,0.9921630437893982,251,29,83,363
1100,dark,main,3,0.9850891732305198,244,13,72,329
1100,dark,main,4,0.9902599819116866,256,16,69,341
1100,dark,main,5,0.994947917208226,229,29,86,344
1100,dark,main,6,0.9905414360012196,228,15,72,315
1100,dark,main,7,0.9844085366847263,205,20,91,316
1100,dark,main,8,0.9946577923362634,256,18,94,368
1100,dark,main,9,0.9946577923362634,256,18,94,368
1249,dark,main,0,0.993885127604825,268,22,87,377
1249,dark,main,1,0.9920566427747447,221,25,94,340
1249,dark,main,2,0.9939259827795316,268,23,80,371
1249,dark,main,3,0.9934453274989362,263,20,89,372
1249,dark,main,4,0.9794568246297267,234,31,83,348
1249,dark,main,5,0.9941252885195311,263,20,81,364
1249,dark,main,6,0.9864915616423511,235,22,64,321
1249,dark,main,7,0.9904695847665418,234,23,66,323
1249,dark,main,8,0.9914910387561123,269,21,90,380
1249,dark,main,9,0.9914910387561123,269,21,90,380
1134,dark,main,0,0.9909442343302309,279,21,84,384
1134,dark,main,1,0.9879811904703054,228,13,94,335
1134,dark,main,2,0.9884847430268646,243,19,86,348
1134,dark,main,3,0.9928359322942368,257,16,94,367
1134,dark,main,4,0.9890013240489802,251,18,83,352
1134,dark,main,5,0.9968633916850052,253,20,88,361
1134,dark,main,6,0.9819475985025093,215,14,77,306
1134,dark,main,7,0.9907519377965781,218,19,77,314
1134,dark,main,8,0.9929878294281733,244,21,90,355
1134,dark,main,9,0.9929878294281733,244,21,90,355
1847,dark,main,0,0.9806317823844103,251,48,65,364
1847,dark,main,1,0.9914881479126989,192,69,75,336
1847,dark,main,2,0.9836298482044925,193,59,80,332
1847,dark,main,3,0.9808459007752202,240,53,49,342
1847,dark,main,4,0.9944327043825296,203,74,65,342
1847,dark,main,5,0.9879112677621876,237,44,70,351
1847,dark,main,6,0.9866592629459202,202,42,59,303
1847,dark,main,7,0.9908990649987538,191,57,72,320
1847,dark,main,8,0.9918028204921395,227,45,71,343
1847,dark,main,9,0.9918028204921395,227,45,71,343
1420,dark,main,0,0.994850945333459,274,25,83,382
1420,dark,main,1,0.9897252521338494,241,31,73,345
1420,dark,main,2,0.9964395565572116,277,20,86,383
1420,dark,main,3,0.9960074454918889,260,15,69,344
1420,dark,main,4,0.9896294106156295,250,28,77,355
1420,dark,main,5,0.9870178651562507,256,20,87,363
1420,dark,main,6,0.9930026196326022,229,23,78,330
1420,dark,main,7,0.9894014372715328,219,24,79,322
1420,dark,main,8,0.993273356545722,255,24,88,367
1420,dark,main,9,0.993273356545722,255,24,88,367
1237,dark,main,0,0.9864743532466306,276,24,81,381
1237,dark,main,1,0.9925040306341867,254,13,90,357
1237,dark,main,2,0.9876213320538293,271,17,97,385
1237,dark,main,3,0.9906046496247695,241,15,83,339
1237,dark,main,4,0.9954566244577379,265,15,76,356
1237,dark,main,5,0.9927466525744975,254,16,90,360
1237,dark,main,6,0.9860116256643731,224,18,73,315
1237,dark,main,7,0.9920403476542838,225,13,81,319
1237,dark,main,8,0.9883868740722694,262,20,78,360
1237,dark,main,9,0.9883868740722694,262,20,78,360
1104,dark,main,0,0.9936460169167636,260,23,94,377
1104,dark,main,1,0.9871409693725222,262,21,70,353
1104,dark,main,2,0.9911893901766109,259,20,89,368
1104,dark,main,3,0.9883118297925036,243,13,78,334
1104,dark,main,4,0.9931662846245806,255,16,84,355
1104,dark,main,5,0.9898560955153869,239,19,100,358
1104,dark,main,6,0.9960821450133704,222,18,89,329
1104,dark,main,7,0.988188342870262,228,15,74,317
1104,dark,main,8,0.9953692493952533,250,12,91,353
1104,dark,main,9,0.9953692493952533,250,12,91,353
1889,dark,main,0,0.9897321510070297,250,39,91,380
1889,dark,main,1,0.9889954146928023,228,37,67,332
1889,dark,main,2,0.9935530569028065,236,38,85,359
1889,dark,main,3,0.9910429258144647,219,54,71,344
1889,dark,main,4,0.9909730443329401,244,19,86,349
1889,dark,main,5,0.9844098134285751,249,22,61,332
1889,dark,main,6,0.9952344496472725,214,26,66,306
1889,dark,main,7,0.9888720931483639,144,18,44,206
1889,dark,main,8,0.9873825723732914,200,22,80,302
1889,dark,main,9,0.9873825723732914,200,22,80,302
1431,dark,main,0,0.9928430578861552,256,31,100,387
1431,dark,main,1,0.9839979685407442,235,24,90,349
1431,dark,main,2,0.9907943262048635,256,28,92,376
1431,dark,main,3,0.9886351786287739,243,20,79,342
1431,dark,main,4,0.9933072318564372,264,23,71,358
1431,dark,main,5,0.9930233663299963,250,23,78,351
1431,dark,main,6,0.9822921374893039,205,20,90,315
1431,dark,main,7,0.994439556685201,219,28,75,322
1431,dark,main,8,0.9928473659155546,270,18,88,376
1431,dark,main,9,0.9928473659155546,270,18,88,376
20115,bright,main,0,0.9961798809969118,348,78,1,427
20115,bright,main,1,0.9924806677567152,323,59,1,383
20115,bright,main,2,0.9938535296262294,353,60,3,416
20115,bright,main,3,0.9862248821173548,319,70,1,390
20115,bright,main,4,0.995172134445354,354,37,5,396
20115,bright,main,5,0.9891315674283662,340,57,2,399
20115,bright,main,6,0.9929803313791549,266,78,3,347
20115,bright,main,7,0.9910617519720387,284,64,1,349
20115,bright,main,8,0.9959157090043137,346,59,5,410
20115,bright,main,9,0.9959157090043137,346,59,5,410
1116,dark,main,0,0.9929940081705344,274,20,84,378
1116,dark,main,1,0.9895517445349039,213,19,103,335
1116,dark,main,2,0.9916801162346237,250,23,98,371
1116,dark,main,3,0.9889422827404943,231,14,80,325
1116,dark,main,4,0.9921531781108383,247,16,85,348
1116,dark,main,5,0.9895624913151911,242,18,85,345
1116,dark,main,6,0.9946695705693303,215,20,89,324
1116,dark,main,7,0.9861207487480728,231,18,71,320
1116,dark,main,8,0.995442328535061,258,19,86,363
1116,dark,main,9,0.995442328535061,258,19,86,363
1789,dark,main,0,0.9930961806066892,270,22,101,393
1789,dark,main,1,0.9953555917355921,248,19,79,346
1789,dark,main,2,0.991934013291191,249,27,98,374
1789,dark,main,3,0.9867712364462731,223,30,89,342
1789,dark,main,4,0.987130108965858,234,23,87,344
1789,dark,main,5,0.9929471339043733,255,14,93,362
1789,dark,main,6,0.9893616299125181,219,14,85,318
1789,dark,main,7,0.9928849390466772,213,21,85,319
1789,dark,main,8,0.9936743396118426,253,23,99,375
1789,dark,main,9,0.9936743396118426,253,23,99,375
1902,dark,main,0,0.9930849755773297,267,29,82,378
1902,dark,main,1,0.9929493661182357,237,23,85,345
1902,dark,main,2,0.9908444195526032,252,31,71,354
1902,dark,main,3,0.9968075675019995,238,26,88,352
1902,dark,main,4,0.9882731080516968,253,26,77,356
1902,dark,main,5,0.990904092122981,246,22,89,357
1902,dark,main,6,0.9868161111062087,200,39,79,318
1902,dark,main,7,0.9857878187422041,212,31,58,301
1902,dark,main,8,0.9939421700191464,257,25,81,363
1902,dark,main,9,0.9939421700191464,257,25,81,363
1919,dark,main,0,0.9933535257010448,245,51,72,368
1919,dark,main,1,0.9937662589569446,230,22,81,333
1919,dark,main,2,0.9946703119128049,266,18,80,364
1919,dark,main,3,0.9867909386502585,244,26,94,364
1919,dark,main,4,0.9936854874481778,229,36,89,354
1919,dark,main,5,0.9844872250368948,243,21,82,346
1919,dark,main,6,0.9900999038392276,206,23,82,311
1919,dark,main,7,0.9888999102012153,197,50,62,309
1919,dark,main,8,0.9933092987307939,259,34,82,375
1919,dark,main,9,0.9933092987307939,259,34,82,375
20114,bright,main,0,0.992888058256362,343,82,4,429
20114,bright,main,1,0.9936773627022961,317,72,2,391
20114,bright,main,2,0.9908814505351109,364,54,6,424
20114,bright,main,3,0.9940826788171264,329,56,6,391
20114,bright,main,4,0.993422203514713,324,66,4,394
20114,bright,main,5,0.9892425082638945,339,64,3,406
20114,bright,main,6,0.9889165290360591,329,35,0,364
20114,bright,main,7,0.9870007079523692,292,62,0,354
20114,bright,main,8,0.9932860703656111,344,75,1,420
20114,bright,main,9,0.9932860703656111,344,75,1,420
1921,dark,main,0,0.9896708732718025,268,24,89,381
1921,dark,main,1,0.9832274724186966,236,22,84,342
1921,dark,main,2,0.9837076834462054,250,30,79,359
1921,dark,main,3,0.9920326567482199,239,28,82,349
1921,dark,main,4,0.9954988646336755,256,20,78,354
1921,dark,main,5,0.9855970770031502,256,21,80,357
1921,dark,main,6,0.9903026384586948,232,23,75,330
1921,dark,main,7,0.9909661543551149,228,26,67,321
1921,dark,main,8,0.9920902245604354,276,21,80,377
1921,dark,main,9,0.9920902245604354,276,21,80,377
21101,bright,main,0,0.9920509712441271,335,81,1,417
21101,bright,main,1,0.9893629629193204,333,49,4,386
21101,bright,main,2,0.9936304297182967,340,61,7,408
21101,bright,main,3,0.9911586510870471,311,64,2,377
21101,bright,main,4,0.9916840981150515,325,60,6,391
21101,bright,main,5,0.9927099552677644,324,69,2,395
21101,bright,main,6,0.9910053389245855,281,70,4,355
21101,bright,main,7,0.991806803919487,286,48,5,339
21101,bright,main,8,0.9924716536122858,365,50,2,417
21101,bright,main,9,0.9924716536122858,365,50,2,417
20818,bright,main,0,0.9913262861498566,343,92,0,435
20818,bright,main,1,0.9944977355645106,323,74,5,402
20818,bright,main,2,0.9945655981108555,332,98,3,433
20818,bright,main,3,0.9816225144379338,303,90,3,396
20818,bright,main,4,0.9856092592322985,331,74,3,408
20818,bright,main,5,0.9916250796638221,318,92,3,413
20818,bright,main,6,0.991320012584954,309,62,2,373
20818,bright,main,7,0.9884094127582513,279,85,3,367
20818,bright,main,8,0.9909752240428962,324,99,4,427
20818,bright,main,9,0.9909752240428962,324,99,4,427
1225,dark,main,0,0.9908028458932854,271,13,102,386
1225,dark,main,1,0.9940132016228668,245,17,90,352
1225,dark,main,2,0.988120124034899,257,13,111,381
1225,dark,main,3,0.9933777937790867,238,18,85,341
1225,dark,main,4,0.9934140744489046,258,15,84,357
1225,dark,main,5,0.986579559021502,259,16,95,370
1225,dark,main,6,0.9892929912109801,229,18,74,321
1225,dark,main,7,0.9925580201917868,236,15,81,332
1225,dark,main,8,0.9918281571046782,278,16,90,384
1225,dark,main,9,0.9918281571046782,278,16,90,384
1885,dark,main,0,0.9917342355785551,259,52,65,376
1885,dark,main,1,0.9910344030848399,241,34,76,351
1885,dark,main,2,0.9933003366074369,264,45,67,376
1885,dark,main,3,0.9897870719456021,237,31,67,335
1885,dark,main,4,0.9886963953534657,225,41,78,344
1885,dark,main,5,0.9949703545888078,237,40,68,345
1885,dark,main,6,0.9919489632280764,241,29,60,330
1885,dark,main,7,0.9932320484647896,218,33,62,313
1885,dark,main,8,0.9940385821310378,223,46,78,347
1885,dark,main,9,0.9940385821310378,223,46,78,347
1129,dark,main,0,0.992826549046266,260,21,94,375
1129,dark,main,1,0.984963881651768,258,19,73,350
1129,dark,main,2,0.9878013858007316,267,15,97,379
1129,dark,main,3,0.979211280033599,250,14,79,343
1129,dark,main,4,0.9834062651546719,246,22,86,354
1129,dark,main,5,0.9946585048933546,253,19,77,349
1129,dark,main,6,0.9933139448417094,226,13,80,319
1129,dark,main,7,0.9901789667803579,247,16,56,319
1129,dark,main,8,0.9951965438887418,268,19,88,375
1129,dark,main,9,0.9951965438887418,268,19,88,375
20821,bright,main,0,0.997882288348032,326,112,1,439
20821,bright,main,1,0.9811771482947829,313,85,4,402
20821,bright,main,2,0.9920671765233402,317,108,4,429
20821,bright,main,3,0.9836171570592706,291,107,2,400
20821,bright,main,4,0.9927305361001609,320,83,4,407
20821,bright,main,5,0.9963125157670812,362,48,3,413
20821,bright,main,6,0.990587773860785,298,74,5,377
20821,bright,main,7,0.9878620878388078,281,82,2,365
20821,bright,main,8,0.9903366392428814,314,106,3,423
20821,bright,main,9,0.9903366392428814,314,106,3,423
1920,dark,main,0,0.9950343159592725,270,47,78,395
1920,dark,main,1,0.9940196486765936,226,37,101,364
1920,dark,main,2,0.990727432752718,266,46,81,393
1920,dark,main,3,0.9905883593687385,223,60,82,365
1920,dark,main,4,0.9917617318488635,256,39,72,367
1920,dark,main,5,0.9952394917937247,260,38,74,372
1920,dark,main,6,0.9907938225053662,219,27,93,339
1920,dark,main,7,0.9952176645130941,205,38,81,324
1920,dark,main,8,0.9911508138962393,265,39,84,388
1920,dark,main,9,0.9925232683259236,268,30,75,373
20103,bright,main,0,0.9948789638156813,368,64,3,435
20103,bright,main,1,0.9918321714647094,330,65,2,397
20103,bright,main,2,0.9940987510390965,357,67,1,425
20103,bright,main,3,0.9902571557478498,313,65,5,383
20103,bright,main,4,0.994990357628359,339,56,3,398
20103,bright,main,5,0.9898568574216317,355,47,5,407
20103,bright,main,6,0.9925501848383134,291,68,1,360
20103,bright,main,7,0.9907032722394693,315,40,4,359
20103,bright,main,8,0.9932207818157277,339,75,4,418
20103,bright,main,9,0.9932207818157277,339,75,4,418
1924,dark,main,0,0.9874733294678233,275,26,86,387
1924,dark,main,1,0.9883264077684002,255,16,70,341
1924,dark,main,2,0.9909637017926038,276,20,79,375
1924,dark,main,3,0.9879333112189673,250,18,73,341
1924,dark,main,4,0.98880648054765,257,21,75,353
1924,dark,main,5,0.9933161610967193,237,16,92,345
1924,dark,main,6,0.9917411155890355,242,18,69,329
1924,dark,main,7,0.9873308745037993,230,16,75,321
1924,dark,main,8,0.9876176379274486,255,30,79,364
1924,dark,main,9,0.9876176379274486,255,30,79,364
1931,dark,main,0,0.9920262452620399,279,26,70,375
1931,dark,main,1,0.9869438083342038,256,30,72,358
1931,dark,main,2,0.9911317724849765,236,38,96,370
1931,dark,main,3,0.9892521421855961,232,37,81,350
1931,dark,main,4,0.9932221142599754,239,22,74,335
1931,dark,main,5,0.9916214632923865,251,32,78,361
1931,dark,main,6,0.9928421757734242,211,22,72,305
1931,dark,main,7,0.9926387995030415,236,24,59,319
1931,dark,main,8,0.9890520237552651,257,22,83,362
1931,dark,main,9,0.9890520237552651,257,22,83,362
21102,bright,main,0,0.9877030986204304,311,85,4,400
21102,bright,main,1,0.993516262245832,315,65,5,385
21102,bright,main,2,0.9922645157699236,339,66,7,412
21102,bright,main,3,0.9927749697141933,320,55,7,382
21102,bright,main,4,0.9896503470801499,327,53,1,381
21102,bright,main,5,0.9933621987363183,351,42,5,398
21102,bright,main,6,0.9965500828662928,304,50,2,356
21102,bright,main,7,0.9903202554852704,283,56,3,342
21102,bright,main,8,0.9875772808606956,340,64,0,404
21102,bright,main,9,0.9875772808606956,340,64,0,404
20081,bright,main,0,0.992731294339168,356,81,2,439
20081,bright,main,1,0.9932287392956297,345,46,7,398
20081,bright,main,2,0.9903649694533501,355,69,6,430
20081,bright,main,3,0.9898746982868772,320,65,3,388
20081,bright,main,4,0.9916173163422207,333,63,3,399
20081,bright,main,5,0.9941041063555426,321,81,3,405
20081,bright,main,6,0.9929997002077096,276,88,6,370
20081,bright,main,7,0.9929342278530293,274,83,3,360
20081,bright,main,8,0.9907271266569694,316,99,4,419
20081,bright,main,9,0.9907271266569694,316,99,4,419
20869,bright,main,0,0.9906780864679194,338,88,9,435
20869,bright,main,1,0.993376651851749,319,79,2,400
20869,bright,main,2,0.9941482131688694,320,103,3,426
20869,bright,main,3,0.9943748841451068,303,95,2,400
20869,bright,main,4,0.9900390333776491,313,92,3,408
20869,bright,main,5,0.9919980741782204,312,94,6,412
20869,bright,main,6,0.9903842316119493,275,89,5,369
20869,bright,main,7,0.99118718477184,260,92,7,359
20869,bright,main,8,0.9918216227985972,345,71,4,420
20869,bright,main,9,0.9918216227985972,345,71,4,420
1410,dark,main,0,0.9846142931111463,250,19,99,368
1410,dark,main,1,0.9897572186490554,244,27,72,343
1410,dark,main,2,0.9928480664209527,235,21,98,354
1410,dark,main,3,0.9921810139764599,249,18,78,345
1410,dark,main,4,0.9835248056131932,247,24,78,349
1410,dark,main,5,0.9924767229442804,267,16,65,348
1410,dark,main,6,0.9872759751750257,220,23,64,307
1410,dark,main,7,0.9902092669222124,215,28,62,305
1410,dark,main,8,0.9937945308485909,234,37,90,361
1410,dark,main,9,0.9937945308485909,234,37,90,361
1101,dark,main,0,0.9924632110498052,277,16,85,378
1101,dark,main,1,0.9889359723220752,254,14,85,353
1101,dark,main,2,0.9919430027311317,266,22,74,362
1101,dark,main,3,0.9882131242980227,242,16,87,345
1101,dark,main,4,0.9927655413061321,242,23,89,354
1101,dark,main,5,0.9828742270911646,256,18,83,357
1101,dark,main,6,0.9916455180328685,231,14,76,321
1101,dark,main,7,0.984967826059185,235,14,74,323
1101,dark,main,8,0.991889079974357,262,20,88,370
1101,dark,main,9,0.991889079974357,262,20,88,370
20123,bright,main,0,0.9940443049652804,367,58,3,428
20123,bright,main,1,0.9878751569043672,334,52,4,390
20123,bright,main,2,0.9904212177971072,355,61,2,418
20123,bright,main,3,0.9896911733071989,323,55,6,384
20123,bright,main,4,0.993653490560362,350,40,7,397
20123,bright,main,5,0.9944980763434101,349,48,4,401
20123,bright,main,6,0.9843016200180706,291,63,5,359
20123,bright,main,7,0.9904330522886133,279,70,2,351
20123,bright,main,8,0.9902575896262067,359,53,3,415
20123,bright,main,9,0.9902575896262067,359,53,3,415
20082,bright,main,0,0.9890685408588886,330,105,1,436
20082,bright,main,1,0.9910750750611326,322,68,1,391
20082,bright,main,2,0.9878356103053131,338,80,7,425
20082,bright,main,3,0.987141885328212,315,78,3,396
20082,bright,main,4,0.994152181091285,340,62,4,406
20082,bright,main,5,0.9912312148986335,357,47,2,406
20082,bright,main,6,0.9803219994514293,275,86,2,363
20082,bright,main,7,0.9890584376082622,280,74,1,355
20082,bright,main,8,0.9855559753191404,322,96,5,423
20082,bright,main,9,0.9855559753191404,322,96,5,423
1891,dark,main,0,0.9925585263383225,268,34,81,383
1891,dark,main,1,0.9876251994042474,247,32,73,352
1891,dark,main,2,0.9917779260130656,250,31,86,367
1891,dark,main,3,0.9878902164423553,238,30,76,344
1891,dark,main,4,0.9966540703390601,236,31,92,359
1891,dark,main,5,0.9872525799592655,239,31,80,350
1891,dark,main,6,0.9868038250247783,208,27,70,305
1891,dark,main,7,0.9872435006685598,222,28,72,322
1891,dark,main,8,0.9845493766217074,234,42,83,359
1891,dark,main,9,0.9845493766217074,234,42,83,359
1244,dark,main,0,0.9940648877730286,255,20,103,378
1244,dark,main,1,0.9844232042123147,268,15,73,356
1244,dark,main,2,0.9915380868470263,270,24,79,373
1244,dark,main,3,0.994417599124141,260,22,70,352
1244,dark,main,4,0.9858376482670931,252,17,76,345
1244,dark,main,5,0.9918070332921644,266,17,85,368
1244,dark,main,6,0.9913410344369518,227,18,84,329
1244,dark,main,7,0.9904569132900244,232,20,70,322
1244,dark,main,8,0.9882207370263981,275,21,85,381
1244,dark,main,9,0.9882207370263981,275,21,85,381
1125,dark,main,0,0.993673420428422,265,15,99,379
1125,dark,main,1,0.9934561475397672,243,15,92,350
1125,dark,main,2,0.9898018995751405,261,19,94,374
1125,dark,main,3,0.9882711821891106,248,19,83,350
1125,dark,main,4,0.9879723820505211,252,15,94,361
1125,dark,main,5,0.9858684485099676,251,18,95,364
1125,dark,main,6,0.991214740617533,242,12,70,324
1125,dark,main,7,0.9827001005470576,258,14,65,337
1125,dark,main,8,0.9870274003549235,251,12,100,363
1125,dark,main,9,0.9870274003549235,251,12,100,363
1226,dark,main,0,0.9911485802544071,276,19,90,385
1226,dark,main,1,0.9891945805097841,232,13,98,343
1226,dark,main,2,0.990852117615935,272,17,91,380
1226,dark,main,3,0.9947114699578418,249,13,82,344
1226,dark,main,4,0.9882657822563026,236,14,108,358
1226,dark,main,5,0.9898736244632634,258,12,90,360
1226,dark,main,6,0.9844554598557992,208,17,88,313
1226,dark,main,7,0.9920343796739644,219,11,94,324
1226,dark,main,8,0.9888694685229827,280,20,83,383
1226,dark,main,9,0.9888694685229827,280,20,83,383
1245,dark,main,0,0.9909475925761531,276,25,88,389
1245,dark,main,1,0.9920171946657522,243,20,82,345
1245,dark,main,2,0.9930215471786725,264,15,98,377
1245,dark,main,3,0.9940645562565358,245,20,84,349
1245,dark,main,4,0.9926177804447358,267,16,83,366
1245,dark,main,5,0.9920917880643727,235,24,88,347
1245,dark,main,6,0.9925419845401356,225,16,85,326
1245,dark,main,7,0.9925733394001179,216,21,82,319
1245,dark,main,8,0.9932689686143623,254,17,101,372
1245,dark,main,9,0.9932689686143623,254,17,101,372
1191,dark,main,0,0.9965256532918182,280,15,95,390
1191,dark,main,1,0.9883392176107695,247,22,82,351
1191,dark,main,2,0.9939959764608894,276,15,98,389
1191,dark,main,3,0.9902048800096767,245,16,83,344
1191,dark,main,4,0.9932048647952141,241,16,97,354
1191,dark,main,5,0.9931334273029325,251,15,97,363
1191,dark,main,6,0.9883465871009006,244,13,72,329
1191,dark,main,7,0.9906511012207057,230,19,81,330
1191,dark,main,8,0.9945210477702272,261,15,90,366
1191,dark,main,9,0.9945210477702272,261,15,90,366
1748,dark,main,0,0.9904288707967076,284,17,89,390
1748,dark,main,1,0.9914505650313884,255,16,87,358
1748,dark,main,2,0.9932663356956971,276,18,81,375
1748,dark,main,3,0.9886409258495048,259,16,76,351
1748,dark,main,4,0.991535119162587,262,16,80,358
1748,dark,main,5,0.9874669778734575,254,18,84,356
1748,dark,main,6,0.9943899407061294,231,29,58,318
1748,dark,main,7,0.992525478177623,237,13,64,314
1748,dark,main,8,0.9883781759848378,263,23,83,369
1748,dark,main,9,0.9883781759848378,263,23,83,369
20122,bright,main,0,0.9901772559813806,351,78,2,431
20122,bright,main,1,0.9946537751923727,344,49,3,396
20122,bright,main,2,0.9877033360414896,327,72,3,402
20122,bright,main,3,0.9960335120893592,332,51,1,384
20122,bright,main,4,0.9959171304529869,342,51,2,395
20122,bright,main,5,0.9947252447961787,327,67,5,399
20122,bright,main,6,0.9889824571260317,313,44,3,360
20122,bright,main,7,0.9880133301621373,284,60,5,349
20122,bright,main,8,0.9932132830416894,315,88,6,409
20122,bright,main,9,0.9932132830416894,315,88,6,409
1253,dark,main,0,0.9925900121542289,259,23,105,387
1253,dark,main,1,0.9892665797309412,247,20,77,344
1253,dark,main,2,0.9933523186529092,244,22,97,363
1253,dark,main,3,0.988229138877402,233,18,92,343
1253,dark,main,4,0.9904906385368324,235,19,84,338
1253,dark,main,5,0.9932480862082862,261,14,88,363
1253,dark,main,6,0.9896118253750898,231,17,77,325
1253,dark,main,7,0.9903735189355041,235,25,60,320
1253,dark,main,8,0.9924853236180363,268,19,73,360
1253,dark,main,9,0.9924853236180363,268,19,73,360
1233,dark,main,0,0.9962355199162852,287,16,84,387
1233,dark,main,1,0.9912356775496197,253,13,86,352
1233,dark,main,2,0.9901592679658539,282,15,93,390
1233,dark,main,3,0.9910693421275532,235,16,98,349
1233,dark,main,4,0.9901448946729385,270,17,86,373
1233,dark,main,5,0.9932765058885883,278,12,92,382
1233,dark,main,6,0.9897092723968737,242,12,69,323
1233,dark,main,7,0.9929790861892527,215,21,73,309
1233,dark,main,8,0.9850366116555811,270,21,82,373
1233,dark,main,9,0.9850366116555811,270,21,82,373
1822,dark,main,0,0.9876965266150415,272,33,78,383
1822,dark,main,1,0.9912051364900918,255,30,72,357
1822,dark,main,2,0.9902024555039552,254,24,86,364
1822,dark,main,3,0.9934693873020634,220,27,78,325
1822,dark,main,4,0.9949961958483021,250,31,68,349
1822,dark,main,5,0.9819791975568732,227,28,88,343
1822,dark,main,6,0.9820010323634816,200,22,90,312
1822,dark,main,7,0.9888757087264812,214,35,66,315
1822,dark,main,8,0.9883684577508525,252,37,83,372
1822,dark,main,9,0.9883684577508525,252,37,83,372
1254,dark,main,0,0.9868822549827484,274,16,92,382
1254,dark,main,1,0.9924205858879153,246,17,89,352
1254,dark,main,2,0.9915544945182736,267,22,86,375
1254,dark,main,3,0.9917436961062885,242,22,87,351
1254,dark,main,4,0.9887861911834385,252,23,78,353
1254,dark,main,5,0.9920231562694118,247,26,72,345
1254,dark,main,6,0.9852901071968866,208,24,78,310
1254,dark,main,7,0.9915628802836898,239,20,65,324
1254,dark,main,8,0.9813493425535409,257,19,89,365
1254,dark,main,9,0.9813493425535409,257,19,89,365
1761,dark,main,0,0.9930485837269318,273,25,83,381
1761,dark,main,1,0.9918195392859068,253,22,80,355
1761,dark,main,2,0.9894273781228662,255,20,92,367
1761,dark,main,3,0.9933320126313904,236,19,86,341
1761,dark,main,4,0.9868853296476205,251,21,78,350
1761,dark,main,5,0.9886757925525683,256,16,88,360
1761,dark,main,6,0.9926710293729012,227,24,77,328
1761,dark,main,7,0.9949007953348318,227,23,61,311
1761,dark,main,8,0.9945833397158294,231,35,87,353
1761,dark,main,9,0.9945833397158294,231,35,87,353
1128,dark,main,0,0.9940610439278301,274,13,88,375
1128,dark,main,1,0.9973320986071288,246,15,93,354
1128,dark,main,2,0.9936153486883477,277,14,88,379
1128,dark,main,3,0.990323291238107,249,15,85,349
1128,dark,main,4,0.9942744606512575,272,15,71,358
1128,dark,main,5,0.9824396238029949,264,12,90,366
1128,dark,main,6,0.9941300290528063,222,15,87,324
1128,dark,main,7,0.99255705354972,229,14,81,324
1128,dark,main,8,0.9899614109992373,284,18,79,381
1128,dark,main,9,0.9899614109992373,284,18,79,381
1195,dark,main,0,0.9925351659480193,288,14,75,377
1195,dark,main,1,0.9912814670413885,244,23,90,357
1195,dark,main,2,0.9888899088964915,297,16,85,398
1195,dark,main,3,0.9884865935758431,228,13,105,346
1195,dark,main,4,0.9930649108676021,254,15,95,364
1195,dark,main,5,0.9950958420738701,270,16,81,367
1195,dark,main,6,0.9884212223409363,205,17,94,316
1195,dark,main,7,0.9866268688826848,221,17,87,325
1195,dark,main,8,0.9941931559700007,257,17,102,376
1195,dark,main,9,0.9941931559700007,257,17,102,376
1232,dark,main,0,0.9871818209970327,268,14,103,385
1232,dark,main,1,0.9940080196111775,264,20,78,362
1232,dark,main,2,0.9936281158993385,292,17,80,389
1232,dark,main,3,0.9919599165280502,258,12,72,342
1232,dark,main,4,0.9774895017234971,261,11,81,353
1232,dark,main,5,0.9943244388758192,283,15,75,373
1232,dark,main,6,0.9873590672732254,225,14,71,310
1232,dark,main,7,0.9871672256228703,236,15,76,327
1232,dark,main,8,0.9920894503409015,279,15,83,377
1232,dark,main,9,0.9920894503409015,279,15,83,377
20113,bright,main,0,0.9956730031176383,329,83,2,414
20113,bright,main,1,0.9949496310793011,317,66,3,386
20113,bright,main,2,0.9928426977547816,357,63,3,423
20113,bright,main,3,0.9897212074890741,332,51,5,388
20113,bright,main,4,0.9914636237832499,335,65,0,400
20113,bright,main,5,0.99056160134134,323,68,4,395
20113,bright,main,6,0.9914691373411554,298,55,4,357
20113,bright,main,7,0.9954702260840147,306,47,4,357
20113,bright,main,8,0.9955431894515953,338,72,3,413
20113,bright,main,9,0.9955431894515953,338,72,3,413
1925,dark,main,0,0.9939118358022979,269,22,92,383
1925,dark,main,1,0.9893834312024633,263,27,70,360
1925,dark,main,2,0.988798868810103,265,30,71,366
1925,dark,main,3,0.9903687644540499,245,22,76,343
1925,dark,main,4,0.9896374583702505,265,16,84,365
1925,dark,main,5,0.9956624390901336,259,19,81,359
1925,dark,main,6,0.9915890275481616,234,23,59,316
1925,dark,main,7,0.9914011999141279,214,26,74,314
1925,dark,main,8,0.9896805681285777,239,24,97,360
1925,dark,main,9,0.9896805681285777,239,24,97,360
1899,dark,main,0,0.9908164148440963,278,29,90,397
1899,dark,main,1,0.988990110295278,250,26,82,358
1899,dark,main,2,0.9876255412406139,266,38,78,382
1899,dark,main,3,0.9880901232757122,250,28,92,370
1899,dark,main,4,0.9928166500331679,265,21,86,372
1899,dark,main,5,0.9920328896232425,257,33,80,370
1899,dark,main,6,0.9908088832673387,242,27,67,336
1899,dark,main,7,0.9930622881633955,232,31,72,335
1899,dark,main,8,0.9927294160057398,271,25,75,371
1899,dark,main,9,0.9927294160057398,271,25,75,371
1192,dark,main,0,0.9901222307752029,286,15,84,385
1192,dark,main,1,0.9924384746464138,248,16,80,344
1192,dark,main,2,0.9957360694658169,278,12,107,397
1192,dark,main,3,0.991176985698295,260,16,84,360
1192,dark,main,4,0.9959363279775242,239,19,79,337
1192,dark,main,5,0.9949138182555703,260,14,89,363
1192,dark,main,6,0.9893364723664378,241,16,76,333
1192,dark,main,7,0.982260103503782,229,18,86,333
1192,dark,main,8,0.9923178147801691,279,16,82,377
1192,dark,main,9,0.9923178147801691,279,16,82,377
1763,dark,main,0,0.9931864122609941,274,19,87,380
1763,dark,main,1,0.9865230865711648,265,22,71,358
1763,dark,main,2,0.9891344071963152,267,20,86,373
1763,dark,main,3,0.9925405051939928,251,19,93,363
1763,dark,main,4,0.9891898714798146,256,18,93,367
1763,dark,main,5,0.9886905384149689,256,16,81,353
1763,dark,main,6,0.9895660316208293,223,25,77,325
1763,dark,main,7,0.992411495609791,233,21,70,324
1763,dark,main,8,0.9884090715612573,264,19,91,374
1763,dark,main,9,0.9884090715612573,264,19,91,374
1922,dark,main,0,0.9918469243854464,268,23,82,373
1922,dark,main,1,0.9923670345426329,222,37,81,340
1922,dark,main,2,0.9951574105308805,279,19,87,385
1922,dark,main,3,0.9944754486652542,246,20,79,345
1922,dark,main,4,0.9944143788208762,253,22,82,357
1922,dark,main,5,0.9915180445788095,264,20,68,352
1922,dark,main,6,0.9906338033430973,166,111,50,327
1922,dark,main,7,0.9899289571774187,225,23,78,326
1922,dark,main,8,0.9890260468040137,248,24,97,369
1922,dark,main,9,0.9890260468040137,248,24,97,369
20100,bright,main,0,0.991076980183718,303,115,1,419
20100,bright,main,1,0.992966587008175,276,112,6,394
20100,bright,main,2,0.9944990957481087,332,86,4,422
20100,bright,main,3,0.9935964275869567,319,68,4,391
20100,bright,main,4,0.9932608177605287,305,86,5,396
20100,bright,main,5,0.992760422884097,332,66,3,401
20100,bright,main,6,0.9893456315206443,312,53,3,368
20100,bright,main,7,0.9931958369002937,292,66,3,361
20100,bright,main,8,0.9870473774500037,309,98,6,413
20100,bright,main,9,0.9870473774500037,309,98,6,413
20001,bright,main,0,0.9950958901854545,377,55,2,434
20001,bright,main,1,0.991441388526433,327,72,1,400
20001,bright,main,2,0.9957028349113793,340,90,4,434
20001,bright,main,3,0.9923279462600424,322,74,4,400
20001,bright,main,4,0.995016420284844,306,90,4,400
20001,bright,main,5,0.9894955609672152,310,92,3,405
20001,bright,main,6,0.9861593303059456,301,59,1,361
20001,bright,main,7,0.989199343589589,276,88,5,369
20001,bright,main,8,0.9965679271350043,337,83,1,421
20001,bright,main,9,0.9965679271350043,337,83,1,421
20392,bright,main,0,0.9932016081362073,328,98,8,434
20392,bright,main,1,0.9942233661595928,297,101,4,402
20392,bright,main,2,0.9922172596742556,316,109,5,430
20392,bright,main,3,0.9928266525408299,264,110,4,378
20392,bright,main,4,0.9930637454278799,287,80,6,373
20392,bright,main,5,0.9898841707763454,323,84,3,410
20392,bright,main,6,0.9971689709459707,283,81,4,368
20392,bright,main,7,0.9973206326548122,292,75,4,371
20392,bright,main,8,0.991958966416512,322,104,3,429
20392,bright,main,9,0.991958966416512,322,104,3,429
1126,dark,main,0,0.9884843708813281,271,20,96,387
1126,dark,main,1,0.9890148054840783,241,19,88,348
1126,dark,main,2,0.994807139266842,269,18,91,378
1126,dark,main,3,0.9899460400227229,255,12,97,364
1126,dark,main,4,0.9955846049113214,259,19,88,366
1126,dark,main,5,0.9930971335294633,247,23,91,361
1126,dark,main,6,0.9870835107674777,226,21,74,321
1126,dark,main,7,0.9890193453738365,238,17,73,328
1126,dark,main,8,0.9895999311573247,262,16,88,366
1126,dark,main,9,0.9895999311573247,262,16,88,366
1890,dark,main,0,0.9845103950833421,249,34,78,361
1890,dark,main,1,0.9792915174324722,251,29,73,353
1890,dark,main,2,0.9889580938034895,262,23,75,360
1890,dark,main,3,0.990731686634528,255,28,78,361
1890,dark,main,4,0.9893215885563545,226,43,78,347
1890,dark,main,5,0.9967934325436381,249,27,84,360
1890,dark,main,6,0.9874854664091073,234,24,63,321
1890,dark,main,7,0.9886668354628814,186,50,71,307
1890,dark,main,8,0.9912134515884721,230,56,81,367
1890,dark,main,9,0.9912134515884721,230,56,81,367
20386,bright,main,0,0.9958495868939956,336,96,4,436
20386,bright,main,1,0.9818982823100766,273,130,2,405
20386,bright,main,2,0.9894520183265609,301,123,9,433
20386,bright,main,3,0.9952072313009116,296,96,3,395
20386,bright,main,4,0.9925191471125309,319,93,2,414
20386,bright,main,5,0.9940396571511481,270,143,3,416
20386,bright,main,6,0.9908462974866837,277,84,5,366
20386,bright,main,7,0.9934658410153488,290,77,2,369
20386,bright,main,8,0.9947584477133875,322,105,0,427
20386,bright,main,9,0.9947584477133875,322,105,0,427
20086,bright,main,0,0.9918569917389586,371,61,2,434
20086,bright,main,1,0.996052336173739,353,39,3,395
20086,bright,main,2,0.9939640962154898,336,85,4,425
20086,bright,main,3,0.9877350793246648,332,63,2,397
20086,bright,main,4,0.9902318181146804,319,70,4,393
20086,bright,main,5,0.9925367588954475,345,58,3,406
20086,bright,main,6,0.996826213194566,295,67,1,363
20086,bright,main,7,0.9894441828563655,309,48,3,360
20086,bright,main,8,0.9865367035230578,370,49,2,421
20086,bright,main,9,0.9865367035230578,370,49,2,421
1816,dark,main,0,0.9924870796223745,268,21,94,383
1816,dark,main,1,0.9934267114831031,234,25,81,340
1816,dark,main,2,0.9850985456165584,248,31,87,366
1816,dark,main,3,0.9935621264416923,225,32,83,340
1816,dark,main,4,0.991448467934711,225,29,93,347
1816,dark,main,5,0.9875671326853365,229,24,88,341
1816,dark,main,6,0.9868216153047048,222,23,71,316
1816,dark,main,7,0.9891776597595003,204,20,91,315
1816,dark,main,8,0.9961893035720201,263,28,77,368
1816,dark,main,9,0.9961893035720201,263,28,77,368
1905,dark,main,0,0.9774149101208043,93,15,31,139
1905,dark,main,1,0.9924344412485903,229,38,84,351
1905,dark,main,2,0.9911751627159185,258,29,85,372
1905,dark,main,3,0.992617973805128,237,30,75,342
1905,dark,main,4,0.9872943138202186,220,41,82,343
1905,dark,main,5,0.9935948824100584,243,34,76,353
1905,dark,main,6,0.9881882488608913,209,28,73,310
1905,dark,main,7,0.9833288267278132,224,27,70,321
1905,dark,main,8,0.9963443385976342,246,34,85,365
1905,dark,main,9,0.9963443385976342,246,34,85,365
1900,dark,main,0,0.9895067868132452,261,24,93,378
1900,dark,main,1,0.989206498027219,234,25,80,339
1900,dark,main,2,0.9903162076262368,247,30,90,367
1900,dark,main,3,0.9942012724933146,244,20,94,358
1900,dark,main,4,0.9847886139111784,253,19,82,354
1900,dark,main,5,0.9950384418558782,249,17,89,355
1900,dark,main,6,0.9912999359643185,239,23,64,326
1900,dark,main,7,0.99082732378774,222,23,66,311
1900,dark,main,8,0.9934838168894089,258,31,84,373
1900,dark,main,9,0.9934838168894089,258,31,84,373
1848,dark,main,0,0.9897518884380674,272,33,67,372
1848,dark,main,1,0.9889956788125664,251,28,57,336
1848,dark,main,2,0.9892892872963522,270,40,64,374
1848,dark,main,3,0.9891289854682913,226,40,68,334
1848,dark,main,4,0.9879209710112568,209,41,86,336
1848,dark,main,5,0.9888099453938368,236,31,79,346
1848,dark,main,6,0.9816139660255999,205,36,66,307
1848,dark,main,7,0.991396363090424,221,27,66,314
1848,dark,main,8,0.9938188659665258,225,42,78,345
1848,dark,main,9,0.9938188659665258,225,42,78,345
20414,bright,main,0,0.9895467988344443,319,112,2,433
20414,bright,main,1,0.9909923526797351,285,113,6,404
20414,bright,main,2,0.984933216628579,327,108,2,437
20414,bright,main,3,0.9957236415378145,304,92,4,400
20414,bright,main,4,0.9934350459166911,324,86,2,412
20414,bright,main,5,0.9895374722060071,314,93,3,410
20414,bright,main,6,0.99003884664094,309,61,3,373
20414,bright,main,7,0.9862708801443824,258,86,4,348
20414,bright,main,8,0.993694161394907,300,118,3,421
20414,bright,main,9,0.993694161394907,300,118,3,421
20830,bright,main,0,0.9934289980945038,315,118,4,437
20830,bright,main,1,0.9869257191044281,299,97,3,399
20830,bright,main,2,0.9874623391324074,316,108,4,428
20830,bright,main,3,0.9936927461185219,314,79,6,399
20830,bright,main,4,0.9968427183970513,326,74,8,408
20830,bright,main,5,0.9946172190908754,322,84,5,411
20830,bright,main,6,0.9885936354459787,266,100,3,369
20830,bright,main,7,0.985262031650146,236,112,3,351
20830,bright,main,8,0.9891374937430384,345,82,0,427
20830,bright,main,9,0.9891374937430384,345,82,0,427
1893,dark,main,0,0.9848236873106345,261,29,109,399
1893,dark,main,1,0.9949128706486974,242,45,79,366
1893,dark,main,2,0.9931262970930609,295,20,88,403
1893,dark,main,3,0.9954694953605235,256,24,83,363
1893,dark,main,4,0.9824136047653754,255,25,75,355
1893,dark,main,5,0.9896999819165277,265,38,80,383
1893,dark,main,6,0.9879350406257633,210,43,80,333
1893,dark,main,7,0.9932466199448953,226,23,75,324
1893,dark,main,8,0.994555790352204,266,30,80,376
1893,dark,main,9,0.994555790352204,266,30,80,376
20256,bright,main,0,0.9873929289023219,375,60,5,440
20256,bright,main,1,0.9932026645228732,321,81,2,404
20256,bright,main,2,0.9943468483719345,346,78,5,429
20256,bright,main,3,0.9937094358916507,320,73,4,397
20256,bright,main,4,0.991018942244628,334,66,4,404
20256,bright,main,5,0.9920254327068098,371,43,3,417
20256,bright,main,6,0.9967731091701784,316,48,5,369
20256,bright,main,7,0.9898569153889025,297,47,1,345
20256,bright,main,8,0.9929822553235268,335,88,2,425
20256,bright,main,9,0.9929822553235268,335,88,2,425
1746,dark,main,0,0.9891603952319563,275,15,88,378
1746,dark,main,1,0.994290057398944,225,19,97,341
1746,dark,main,2,0.994396025781783,294,16,75,385
1746,dark,main,3,0.9858797616573626,252,22,90,364
1746,dark,main,4,0.990100435004062,258,19,77,354
1746,dark,main,5,0.9891816538685312,242,17,86,345
1746,dark,main,6,0.982395658534955,242,23,62,327
1746,dark,main,7,0.9861212730152953,203,22,73,298
1746,dark,main,8,0.9938726827183952,251,23,87,361
1746,dark,main,9,0.9938726827183952,251,23,87,361
1729,dark,main,0,0.9926254407430102,285,19,90,394
1729,dark,main,1,0.9964467197284969,254,16,94,364
1729,dark,main,2,0.9890137783276153,274,18,84,376
1729,dark,main,3,0.9906302296095016,243,22,83,348
1729,dark,main,4,0.9908577380269841,270,21,65,356
1729,dark,main,5,0.9927510671105169,243,23,95,361
1729,dark,main,6,0.9896279267101566,224,18,82,324
1729,dark,main,7,0.9922374330601843,210,21,70,301
1729,dark,main,8,0.9807096480329355,241,29,93,363
1729,dark,main,9,0.9807096480329355,241,29,93,363
20412,bright,main,0,0.9963064037730341,341,90,6,437
20412,bright,main,1,0.9919224248209241,311,90,5,406
20412,bright,main,2,0.9952614239166017,317,118,4,439
20412,bright,main,3,0.9903435358752064,323,76,5,404
20412,bright,main,4,0.9916563969856743,334,70,3,407
20412,bright,main,5,0.995485767824189,295,116,5,416
20412,bright,main,6,0.9870555755055493,266,98,6,370
20412,bright,main,7,0.9910769242381141,251,114,2,367
20412,bright,main,8,0.9942001570681185,317,103,1,421
20412,bright,main,9,0.9942001570681185,317,103,1,421
20099,bright,main,0,0.9874768451969401,372,59,4,435
20099,bright,main,1,0.9885077558505875,335,64,3,402
20099,bright,main,2,0.9952586202051255,380,55,2,437
20099,bright,main,3,0.9894568877314476,322,70,4,396
20099,bright,main,4,0.9911958394228281,332,65,2,399
20099,bright,main,5,0.9962049275778607,334,71,5,410
20099,bright,main,6,0.9890413329403418,321,49,1,371
20099,bright,main,7,0.9858261915584363,306,42,4,352
20099,bright,main,8,0.9961165137359126,345,77,3,425
20099,bright,main,9,0.9961165137359126,345,77,3,425
20844,bright,main,0,0.9954730710174375,307,132,1,440
20844,bright,main,1,0.9921216851548008,279,120,3,402
20844,bright,main,2,0.9920360244823092,280,145,1,426
20844,bright,main,3,0.9954088890980174,282,120,2,404
20844,bright,main,4,0.9908955348443061,275,134,0,409
20844,bright,main,5,0.994641147052308,304,104,5,413
20844,bright,main,6,0.9908447578707646,275,95,3,373
20844,bright,main,7,0.9857946221515987,254,96,1,351
20844,bright,main,8,0.9929165440544366,319,112,0,431
20844,bright,main,9,0.9929165440544366,319,112,0,431
1846,dark,main,0,0.9943072858400464,254,45,64,363
1846,dark,main,1,0.9861223371122766,217,40,84,341
1846,dark,main,2,0.9877671342654618,225,56,83,364
1846,dark,main,3,0.9892384319096086,235,39,68,342
1846,dark,main,4,0.9874537798954344,245,40,64,349
1846,dark,main,5,0.9880572807332665,204,49,90,343
1846,dark,main,6,0.9907158393368323,221,37,57,315
1846,dark,main,7,0.9907146570416264,214,32,58,304
1846,dark,main,8,0.9916012675094795,255,42,67,364
1846,dark,main,9,0.9916012675094795,255,42,67,364
1758,dark,main,0,0.9910719472509901,266,21,85,372
1758,dark,main,1,0.9921073221908481,236,25,82,343
1758,dark,main,2,0.9910172140221667,279,22,82,383
1758,dark,main,3,0.9856374630232833,248,17,79,344
1758,dark,main,4,0.9924544591911899,261,16,72,349
1758,dark,main,5,0.9772256292017939,262,16,81,359
1758,dark,main,6,0.9893626186522285,241,18,62,321
1758,dark,main,7,0.9936337031845838,222,24,68,314
1758,dark,main,8,0.9909763260095686,281,13,83,377
1758,dark,main,9,0.9909763260095686,281,13,83,377
20097,bright,main,0,0.9906671426260942,360,71,5,436
20097,bright,main,1,0.9946528119421684,319,70,3,392
20097,bright,main,2,0.9900042599316464,352,73,3,428
20097,bright,main,3,0.9900861057070686,325,70,4,399
20097,bright,main,4,0.9944456627520493,345,58,4,407
20097,bright,main,5,0.9956736731404158,367,41,4,412
20097,bright,main,6,0.9861624923262892,310,57,2,369
20097,bright,main,7,0.9948714472217466,289,52,4,345
20097,bright,main,8,0.9933289031635142,366,54,8,428
20097,bright,main,9,0.9933289031635142,366,54,8,428
1760,dark,main,0,0.9929882238273039,264,24,85,373
1760,dark,main,1,0.9884569085585313,257,25,60,342
1760,dark,main,2,0.991310564489231,267,22,87,376
1760,dark,main,3,0.9932758288430658,242,17,85,344
1760,dark,main,4,0.989796510886303,249,21,84,354
1760,dark,main,5,0.9923930993095439,258,19,82,359
1760,dark,main,6,0.9929264911145624,241,19,56,316
1760,dark,main,7,0.9808756539879263,220,16,74,310
1760,dark,main,8,0.9938037499847314,285,22,73,380
1760,dark,main,9,0.9938037499847314,285,22,73,380
20885,bright,main,0,0.9941310327799263,351,70,6,427
20885,bright,main,1,0.9914886644986884,294,102,7,403
20885,bright,main,2,0.9863724078819558,331,97,7,435
20885,bright,main,3,0.9931077288841886,290,106,5,401
20885,bright,main,4,0.993665239459875,328,72,7,407
20885,bright,main,5,0.9939102960462749,328,81,4,413
20885,bright,main,6,0.9919123144821115,286,83,3,372
20885,bright,main,7,0.984775459930605,287,61,3,351
20885,bright,main,8,0.9952342253365698,326,95,3,424
20885,bright,main,9,0.9952342253365698,326,95,3,424
20886,bright,main,0,0.9901511379670391,336,104,3,443
20886,bright,main,1,0.9895958775975107,300,103,3,406
20886,bright,main,2,0.9936058156269312,289,144,5,438
20886,bright,main,3,0.98760231379852,276,118,2,396
20886,bright,main,4,0.9912282237385016,310,97,2,409
20886,bright,main,5,0.9902950788566715,327,78,1,406
20886,bright,main,6,0.9890377811446404,270,99,1,370
20886,bright,main,7,0.9950394873434466,263,106,0,369
20886,bright,main,8,0.9942138622474749,331,95,2,428
20886,bright,main,9,0.9942138622474749,331,95,2,428
1892,dark,main,0,0.9929598411435198,264,38,69,371
1892,dark,main,1,0.9882659697429413,234,42,67,343
1892,dark,main,2,0.9905140546487283,246,43,75,364
1892,dark,main,3,0.9834856403554254,254,19,77,350
1892,dark,main,4,0.9887501474650461,214,23,86,323
1892,dark,main,5,0.9943591109114106,247,23,85,355
1892,dark,main,6,0.9894786754900798,216,25,76,317
1892,dark,main,7,0.9859519980536404,218,23,67,308
1892,dark,main,8,0.9956143298933161,249,26,91,366
1892,dark,main,9,0.9956143298933161,249,26,91,366
1821,dark,main,0,0.9954755517196214,286,20,84,390
1821,dark,main,1,0.9922302837642664,262,17,70,349
1821,dark,main,2,0.9937730834127141,261,25,77,363
1821,dark,main,3,0.99164850995751,220,28,81,329
1821,dark,main,4,0.9932200292355378,247,22,75,344
1821,dark,main,5,0.9893431575180839,256,18,71,345
1821,dark,main,6,0.9869352204451967,223,22,70,315
1821,dark,main,7,0.9762465386911011,190,16,54,260
1821,dark,main,8,0.9937582413578394,229,42,85,356
1821,dark,main,9,0.9937582413578394,229,42,85,356
1841,dark,main,0,0.9940353660327879,277,26,74,377
1841,dark,main,1,0.9795285186080461,213,35,88,336
1841,dark,main,2,0.9924668120283529,256,32,76,364
1841,dark,main,3,0.9899841301042664,254,25,72,351
1841,dark,main,4,0.9961850641057035,241,26,69,336
1841,dark,main,5,0.9906329101297341,252,18,79,349
1841,dark,main,6,0.9902424214379292,215,25,68,308
1841,dark,main,7,0.9913235474317734,221,28,61,310
1841,dark,main,8,0.9939338277383023,244,29,100,373
1841,dark,main,9,0.9939338277383023,244,29,100,373
20890,bright,main,0,0.9924486750027637,313,119,6,438
20890,bright,main,1,0.9894950102973045,293,106,5,404
20890,bright,main,2,0.9931982567679899,340,90,6,436
20890,bright,main,3,0.9960113529069579,301,96,2,399
20890,bright,main,4,0.9952103797066543,303,99,6,408
20890,bright,main,5,0.9864705464965844,296,109,2,407
20890,bright,main,6,0.9920887248680896,252,114,3,369
20890,bright,main,7,0.9947137667849811,212,127,3,342
20890,bright,main,8,0.9943347451746046,341,86,2,429
20890,bright,main,9,0.9943347451746046,341,86,2,429
1843,dark,main,0,0.9829958974296495,229,60,70,359
1843,dark,main,1,0.9929279195489721,199,58,80,337
1843,dark,main,2,0.9919349245954174,226,51,85,362
1843,dark,main,3,0.9892461236028667,231,33,71,335
1843,dark,main,4,0.9932491556919074,214,38,79,331
1843,dark,main,5,0.9927304420745197,224,49,80,353
1843,dark,main,6,0.9927391907475855,184,57,65,306
1843,dark,main,7,0.9905583430951181,202,25,67,294
1843,dark,main,8,0.9896017026644893,254,36,78,368
1843,dark,main,9,0.9896017026644893,254,36,78,368
1823,dark,main,0,0.9936494453290913,271,24,78,373
1823,dark,main,1,0.9919219677010449,257,21,66,344
1823,dark,main,2,0.9904453578299486,270,25,76,371
1823,dark,main,3,0.9894951500716614,236,28,65,329
1823,dark,main,4,0.9871828397718414,258,15,80,353
1823,dark,main,5,0.9909172930671316,239,23,89,351
1823,dark,main,6,0.9945010449149666,252,18,64,334
1823,dark,main,7,0.987532336292687,216,19,85,320
1823,dark,main,8,0.995821584230827,260,16,89,365
1823,dark,main,9,0.995821584230827,260,16,89,365
20910,bright,main,0,0.9936809949705583,322,106,6,434
20910,bright,main,1,0.9890812725155751,266,136,3,405
20910,bright,main,2,0.9967445295223563,302,129,3,434
20910,bright,main,3,0.9865578709235822,283,122,0,405
20910,bright,main,4,0.9839235757412309,304,99,10,413
20910,bright,main,5,0.986205329130578,278,134,1,413
20910,bright,main,6,0.9936008686796879,281,91,5,377
20910,bright,main,7,0.9890807524635625,271,78,1,350
20910,bright,main,8,0.992396649944733,321,102,3,426
20910,bright,main,9,0.992396649944733,321,102,3,426
20411,bright,main,0,0.9942159248862381,318,113,3,434
20411,bright,main,1,0.9905529454010877,314,85,5,404
20411,bright,main,2,0.9952436486825162,324,101,5,430
20411,bright,main,3,0.991255372820922,272,126,5,403
20411,bright,main,4,0.9920231282016235,305,102,3,410
20411,bright,main,5,0.960139016603116,100,34,2,136
20411,bright,main,6,0.9895748430017952,264,99,5,368
20411,bright,main,7,0.9930021489640906,256,87,3,346
20411,bright,main,8,0.9921887453167026,285,136,6,427
20411,bright,main,9,0.9918763522513233,274,144,7,425
20007,bright,main,0,0.994960675144153,295,104,8,407
20007,bright,main,1,0.9938895395793076,320,66,2,388
20007,bright,main,2,0.9931720563724421,336,72,1,409
20007,bright,main,3,0.991059511933487,311,65,5,381
20007,bright,main,4,0.994560874639276,317,75,3,395
20007,bright,main,5,0.9930361174273292,315,66,5,386
20007,bright,main,6,0.9879406872347168,300,52,3,355
20007,bright,main,7,0.99214374986664,289,48,4,341
20007,bright,main,8,0.9937321117125237,342,66,5,413
20007,bright,main,9,0.9840320984417392,309,93,2,404
20193,bright,main,0,0.9913974538151122,344,82,5,431
20193,bright,main,1,0.9929076019982402,329,55,5,389
20193,bright,main,2,0.9918985087132453,367,51,3,421
20193,bright,main,3,0.9915129220394348,317,59,5,381
20193,bright,main,4,0.9905909930689347,335,60,8,403
20193,bright,main,5,0.9955348216485691,322,63,6,391
20193,bright,main,6,0.9911669266568475,284,68,10,362
20193,bright,main,7,0.9812393010108557,276,58,2,336
20193,bright,main,8,0.9903515725587498,360,58,3,421
20193,bright,main,9,0.9888629763344092,327,74,7,408
20210,bright,main,0,0.9929682698289951,368,62,6,436
20210,bright,main,1,0.9915189534946307,352,49,2,403
20210,bright,main,2,0.9907036746223427,348,81,3,432
20210,bright,main,3,0.9907141579769096,328,58,8,394
20210,bright,main,4,0.9931869467035032,321,80,4,405
20210,bright,main,5,0.9859277138250075,349,59,4,412
20210,bright,main,6,0.9886043552434267,341,30,2,373
20210,bright,main,7,0.9927961975971594,283,56,5,344
20210,bright,main,8,0.9958913707058329,330,83,6,419
20210,bright,main,9,0.9883917222409243,349,74,2,425
1926,dark,main,0,0.9854435780841756,247,25,97,369
1926,dark,main,1,0.9894723606886315,242,18,73,333
1926,dark,main,2,0.9821610568425412,262,19,91,372
1926,dark,main,3,0.9871560340782358,226,20,85,331
1926,dark,main,4,0.9946906033925762,255,24,76,355
1926,dark,main,5,0.9962977510997401,270,23,71,364
1926,dark,main,6,0.9907139976856844,242,18,64,324
1926,dark,main,7,0.9890175970072037,229,20,60,309
1926,dark,main,8,0.9920409347408451,257,25,84,366
1926,dark,main,9,0.9885667919399488,241,22,93,356
1742,dark,main,0,0.9942643650619588,282,18,91,391
1742,dark,main,1,0.9801267819830176,257,19,73,349
1742,dark,main,2,0.9916032983134382,282,16,68,366
1742,dark,main,3,0.9936952868487332,249,17,70,336
1742,dark,main,4,0.9889492849736949,256,19,80,355
1742,dark,main,5,0.9826747237619149,254,12,87,353
1742,dark,main,6,0.9932291258031928,232,16,71,319
1742,dark,main,7,0.9806739004708478,225,17,62,304
1742,dark,main,8,0.994115551804531,277,20,79,376
1742,dark,main,9,0.9894287499371786,269,20,88,377
20224,bright,main,0,0.9949941298657079,324,104,5,433
20224,bright,main,1,0.9921532317224971,325,68,1,394
20224,bright,main,2,0.9935200288486922,369,59,1,429
20224,bright,main,3,0.9955284466554976,319,68,7,394
20224,bright,main,4,0.9922450034854856,328,69,4,401
20224,bright,main,5,0.9923954430829806,352,55,3,410
20224,bright,main,6,0.9926759887130443,329,41,2,372
20224,bright,main,7,0.9892263692083075,275,63,3,341
20224,bright,main,8,0.9925049999164345,334,82,5,421
20224,bright,main,9,0.9906977877793156,361,62,2,425
1897,dark,main,0,0.9917544619586094,289,23,74,386
1897,dark,main,1,0.9909500943268097,247,24,79,350
1897,dark,main,2,0.9931430969195968,269,21,87,377
1897,dark,main,3,0.9927383253016445,235,18,80,333
1897,dark,main,4,0.9908054189112743,233,18,84,335
1897,dark,main,5,0.9853376706422634,267,27,72,366
1897,dark,main,6,0.9956894226491969,230,25,72,327
1897,dark,main,7,0.9893634445880254,230,22,58,310
1897,dark,main,8,0.9937685110795097,247,26,83,356
1897,dark,main,9,0.9956653077474891,281,21,82,384
20404,bright,main,0,0.9936420575286143,316,112,2,430
20404,bright,main,1,0.9940753877614584,302,86,9,397
20404,bright,main,2,0.988521381470665,314,116,0,430
20404,bright,main,3,0.9968214022135828,280,114,4,398
20404,bright,main,4,0.98880276086156,287,114,6,407
20404,bright,main,5,0.9934199672380802,290,119,4,413
20404,bright,main,6,0.9897477569231629,267,95,6,368
20404,bright,main,7,0.9893656604847985,249,97,3,349
20404,bright,main,8,0.9950234625054829,336,89,3,428
20404,bright,main,9,0.9939483440417195,330,91,6,427
1929,dark,main,0,0.991914160390399,243,44,77,364
1929,dark,main,1,0.9955305097251849,208,40,86,334
1929,dark,main,2,0.9963243878244278,273,27,78,378
1929,dark,main,3,0.9897471466520846,230,47,70,347
1929,dark,main,4,0.9921574135002998,236,35,78,349
1929,dark,main,5,0.9897126298278516,238,37,74,349
1929,dark,main,6,0.9879925572864433,211,30,64,305
1929,dark,main,7,0.9938006512423536,225,23,67,315
1929,dark,main,8,0.9962292397414734,243,42,76,361
1929,dark,main,9,0.9935049511536347,235,31,77,343
1830,dark,main,0,0.9937282402125439,255,29,82,366
1830,dark,main,1,0.9958388535200308,252,26,72,350
1830,dark,main,2,0.9927161050560704,240,19,111,370
1830,dark,main,3,0.990631560660505,250,24,79,353
1830,dark,main,4,0.9916962611598445,250,21,76,347
1830,dark,main,5,0.9933703510214489,241,28,81,350
1830,dark,main,6,0.9924699245264439,215,23,82,320
1830,dark,main,7,0.9873428633415696,237,17,63,317
1830,dark,main,8,0.9826895699228132,271,17,82,370
1830,dark,main,9,0.9863308245335916,263,30,92,385
1874,dark,main,0,0.9801877430903249,247,37,72,356
1874,dark,main,1,0.9903501329301772,232,36,67,335
1874,dark,main,2,0.9916102224228217,255,28,83,366
1874,dark,main,3,0.989531362698194,198,32,98,328
1874,dark,main,4,0.9899336321321796,221,36,73,330
1874,dark,main,5,0.988988524610594,225,36,86,347
1874,dark,main,6,0.9848779115392239,225,23,71,319
1874,dark,main,7,0.9826703012097299,200,27,75,302
1874,dark,main,8,0.9908617531299686,216,42,87,345
1874,dark,main,9,0.9902341135692656,238,41,80,359
1744,dark,main,0,0.987395171425854,264,20,90,374
1744,dark,main,1,0.9870168128773,234,22,92,348
1744,dark,main,2,0.9877002044214057,272,26,84,382
1744,dark,main,3,0.9884594052064148,254,21,75,350
1744,dark,main,4,0.9911566052122261,247,16,89,352
1744,dark,main,5,0.9844101169866023,248,16,82,346
1744,dark,main,6,0.9932894555232173,220,19,88,327
1744,dark,main,7,0.9940082537254274,228,15,69,312
1744,dark,main,8,0.9892920038415639,242,24,99,365
1744,dark,main,9,0.987102155480362,270,13,96,379
1844,dark,main,0,0.9860846449897159,266,20,81,367
1844,dark,main,1,0.9907938752979579,222,19,86,327
1844,dark,main,2,0.9925112067801097,246,37,83,366
1844,dark,main,3,0.9903694647676511,254,26,60,340
1844,dark,main,4,0.9951291585100439,248,25,62,335
1844,dark,main,5,0.9947095939874774,225,28,92,345
1844,dark,main,6,0.9870077819877114,221,24,67,312
1844,dark,main,7,0.9892131159440947,197,25,76,298
1844,dark,main,8,0.9888841709177458,249,25,89,363
1844,dark,main,9,0.9931866102126037,241,27,86,354
20861,bright,main,0,0.9946133122182483,359,71,9,439
20861,bright,main,1,0.9921326159293763,334,63,4,401
20861,bright,main,2,0.9916873237472356,353,79,3,435
20861,bright,main,3,0.9872781214666576,296,94,5,395
20861,bright,main,4,0.9920453546985216,314,90,2,406
20861,bright,main,5,0.9963152187332893,360,46,4,410
20861,bright,main,6,0.9882104585947599,313,51,4,368
20861,bright,main,7,0.995682200513208,256,86,7,349
20861,bright,main,8,0.9948016042052542,340,81,5,426
20861,bright,main,9,0.9946973084927672,350,76,3,429
1894,dark,main,0,0.9948492762301965,276,24,74,374
1894,dark,main,1,0.9854299528890939,243,26,71,340
1894,dark,main,2,0.993029671234255,255,21,89,365
1894,dark,main,3,0.9939459851194775,239,29,94,362
1894,dark,main,4,0.9897507812322418,250,20,69,339
1894,dark,main,5,0.9948663713822207,245,25,83,353
1894,dark,main,6,0.9848280854427163,213,32,73,318
1894,dark,main,7,0.9872177028222833,215,30,52,297
1894,dark,main,8,0.9868975945410471,252,32,72,356
1894,dark,main,9,0.9945599570859841,268,26,84,378
1030,dark,main,0,0.9941145540927783,288,23,73,384
1030,dark,main,1,0.9881404629507479,256,20,71,347
1030,dark,main,2,0.9835356182677978,264,22,93,379
1030,dark,main,3,0.9935598704002471,252,21,83,356
1030,dark,main,4,0.9945726684872693,249,14,86,349
1030,dark,main,5,0.9950910193020285,264,22,66,352
1030,dark,main,6,0.9807327478149952,241,17,65,323
1030,dark,main,7,0.98488429750092,213,15,79,307
1030,dark,main,8,0.9912661509038854,246,30,89,365
1030,dark,main,9,0.991459187240321,291,15,73,379
20241,bright,main,0,0.9926433779116863,322,90,2,414
20241,bright,main,1,0.992461672149169,286,90,2,378
20241,bright,main,2,0.9915450554515985,298,104,6,408
20241,bright,main,3,0.9918557883633381,290,73,1,364
20241,bright,main,4,0.9928119153298606,296,80,2,378
20241,bright,main,5,0.9868543045566711,301,82,3,386
20241,bright,main,6,0.9910325645181479,292,66,4,362
20241,bright,main,7,0.9904681284354452,252,66,3,321
20241,bright,main,8,0.9941723814752326,299,107,4,410
20241,bright,main,9,0.9928959397786074,316,81,2,399
20824,bright,main,0,0.9926798021564085,339,92,4,435
20824,bright,main,1,0.9865612034507818,289,89,8,386
20824,bright,main,2,0.994345620951868,341,83,6,430
20824,bright,main,3,0.9900878612970619,288,105,4,397
20824,bright,main,4,0.9894044725681163,302,104,4,410
20824,bright,main,5,0.9947101183509394,293,108,6,407
20824,bright,main,6,0.9877568445011502,276,83,7,366
20824,bright,main,7,0.990852465950332,272,87,3,362
20824,bright,main,8,0.9953195277956156,329,89,4,422
20824,bright,main,9,0.9872828937776362,305,89,7,401
20402,bright,main,0,0.9960892262543655,328,106,2,436
20402,bright,main,1,0.9883938460756695,300,100,3,403
20402,bright,main,2,0.9931933921422734,350,72,6,428
20402,bright,main,3,0.9952968445062519,313,82,5,400
20402,bright,main,4,0.987822898915809,303,99,4,406
20402,bright,main,5,0.9974543949968151,311,93,7,411
20402,bright,main,6,0.9889767168860162,289,78,2,369
20402,bright,main,7,0.9901306234244412,274,75,2,351
20402,bright,main,8,0.9888452537985433,293,129,4,426
20402,bright,main,9,0.9957836675593071,339,87,5,431
20777,bright,main,0,0.9896298916476297,355,51,9,415
20777,bright,main,1,0.9932309042867175,321,56,1,378
20777,bright,main,2,0.9904902991945004,322,76,2,400
20777,bright,main,3,0.9921216795978985,306,72,7,385
20777,bright,main,4,0.9928689309374035,309,72,3,384
20777,bright,main,5,0.9873944074114788,343,46,4,393
20777,bright,main,6,0.9939295802538913,284,66,1,351
20777,bright,main,7,0.9926805203739417,298,39,1,338
20777,bright,main,8,0.9946504243301789,339,65,4,408
20777,bright,main,9,0.9907552016338333,327,77,4,408
20429,bright,main,0,0.9928777465060834,316,119,3,438
20429,bright,main,1,0.9926136101009582,286,115,5,406
20429,bright,main,2,0.9957839133836709,317,113,2,432
20429,bright,main,3,0.9936941879820494,287,107,7,401
20429,bright,main,4,0.9912664306335781,308,89,6,403
20429,bright,main,5,0.9880091917007405,292,102,3,397
20429,bright,main,6,0.9901782697447226,250,115,5,370
20429,bright,main,7,0.9955696783407516,254,99,3,356
20429,bright,main,8,0.9939953377320777,303,113,2,418
20429,bright,main,9,0.9955404863881581,295,133,3,431
20220,bright,main,0,0.9875780958041005,366,73,5,444
20220,bright,main,1,0.9881481888140508,297,102,2,401
20220,bright,main,2,0.9909621298679634,322,102,4,428
20220,bright,main,3,0.986330206594743,317,79,4,400
20220,bright,main,4,0.9953110247675387,305,103,2,410
20220,bright,main,5,0.9917532568707197,305,100,5,410
20220,bright,main,6,0.9883557839408141,273,94,0,367
20220,bright,main,7,0.990058981892091,270,78,1,349
20220,bright,main,8,0.9934826816859339,353,68,3,424
20220,bright,main,9,0.9946935791935234,332,87,5,424
20432,bright,main,0,0.9948133409911276,371,61,3,435
20432,bright,main,1,0.9955553857260565,301,101,4,406
20432,bright,main,2,0.9876788493561522,298,122,8,428
20432,bright,main,3,0.987495643003152,311,77,4,392
20432,bright,main,4,0.9943774769581195,350,56,5,411
20432,bright,main,5,0.988472559211683,371,38,3,412
20432,bright,main,6,0.9920933131711704,313,56,3,372
20432,bright,main,7,0.9830287376887575,292,54,4,350
20432,bright,main,8,0.9910402907300724,359,64,4,427
20432,bright,main,9,0.9920422359498766,346,77,5,428
21179,bright,main,0,0.9912259045710754,335,69,3,407
21179,bright,main,1,0.9864575319747587,289,78,6,373
21179,bright,main,2,0.996235301055362,339,59,8,406
21179,bright,main,3,0.9913378979286965,329,45,1,375
21179,bright,main,4,0.9933852603607715,311,58,6,375
21179,bright,main,5,0.9947804804082787,300,72,10,382
21179,bright,main,6,0.9887010708279752,268,65,6,339
21179,bright,main,7,0.9922740145614608,249,61,8,318
21179,bright,main,8,0.9942382387845659,301,81,4,386
21179,bright,main,9,0.9807153679690946,339,64,3,406
1747,dark,main,0,0.9861344801934723,258,22,92,372
1747,dark,main,1,0.9893764757507102,241,21,82,344
1747,dark,main,2,0.9939855650498142,253,18,100,371
1747,dark,main,3,0.9897965749313079,245,22,75,342
1747,dark,main,4,0.9859726215864895,259,21,85,365
1747,dark,main,5,0.9932026308609427,253,17,97,367
1747,dark,main,6,0.9877770759124188,214,19,93,326
1747,dark,main,7,0.9939689891207503,202,19,85,306
1747,dark,main,8,0.991541559638498,240,25,93,358
1747,dark,main,9,0.9927758126721066,246,23,94,363
20213,bright,main,0,0.9931087171596893,335,100,5,440
20213,bright,main,1,0.9955493132686014,295,100,7,402
20213,bright,main,2,0.9931926524702309,359,68,5,432
20213,bright,main,3,0.9914318180482261,310,80,2,392
20213,bright,main,4,0.9946232530732865,334,66,6,406
20213,bright,main,5,0.9963100617513463,309,92,6,407
20213,bright,main,6,0.9887630233971445,289,77,3,369
20213,bright,main,7,0.9879981420468344,268,77,4,349
20213,bright,main,8,0.9960332223846785,325,100,5,430
20213,bright,main,9,0.9917908972675366,327,92,11,430
20771,bright,main,0,0.9880461559983182,325,84,4,413
20771,bright,main,1,0.9922388397475723,285,83,6,374
20771,bright,main,2,0.992628584009031,378,35,4,417
20771,bright,main,3,0.9922354339502314,326,55,2,383
20771,bright,main,4,0.995901994019313,337,53,4,394
20771,bright,main,5,0.9961045902146486,350,50,4,404
20771,bright,main,6,0.9847694633735222,273,73,2,348
20771,bright,main,7,0.9859607712175473,252,62,4,318
20771,bright,main,8,0.994827567728875,342,61,7,410
20771,bright,main,9,0.9945519394143887,318,89,7,414
20413,bright,main,0,0.9908672846116153,311,123,3,437
20413,bright,main,1,0.9955078073326713,286,112,2,400
20413,bright,main,2,0.9955660919151192,320,104,4,428
20413,bright,main,3,0.9891549856856817,311,86,4,401
20413,bright,main,4,0.990557732571073,328,81,0,409
20413,bright,main,5,0.9926167138480713,340,65,7,412
20413,bright,main,6,0.9908588594635326,293,79,0,372
20413,bright,main,7,0.9897053413285294,236,107,7,350
20413,bright,main,8,0.9910535503766594,321,97,5,423
20413,bright,main,9,0.9870283000737702,274,112,5,391
20423,bright,main,0,0.9941224232478356,328,96,3,427
20423,bright,main,1,0.9943130161328466,290,118,0,408
20423,bright,main,2,0.9930857460781004,352,73,0,425
20423,bright,main,3,0.9901022311089059,335,61,4,400
20423,bright,main,4,0.9934526344685991,315,90,2,407
20423,bright,main,5,0.9933725595693501,315,96,1,412
20423,bright,main,6,0.9936150819432878,290,78,1,369
20423,bright,main,7,0.9905026374634863,285,61,7,353
20423,bright,main,8,0.9927210566133403,340,84,2,426
20423,bright,main,9,0.99502434913876,341,81,2,424
20913,bright,main,0,0.9926123910160166,362,75,4,441
20913,bright,main,1,0.9932647681379265,343,52,9,404
20913,bright,main,2,0.990573651675048,351,81,3,435
20913,bright,main,3,0.9953220431004958,327,71,1,399
20913,bright,main,4,0.9948835021920228,337,67,6,410
20913,bright,main,5,0.991218395906658,347,65,0,412
20913,bright,main,6,0.995158568358742,317,51,0,368
20913,bright,main,7,0.9937216878397624,295,54,5,354
20913,bright,main,8,0.9934514985315853,361,70,1,432
20913,bright,main,9,0.9936576199614745,341,84,6,431
20893,bright,main,0,0.995337715968966,329,110,6,445
20893,bright,main,1,0.9891639236291048,316,84,4,404
20893,bright,main,2,0.992312773408112,332,102,2,436
20893,bright,main,3,0.9878891995688495,304,90,7,401
20893,bright,main,4,0.9927018077789722,271,124,6,401
20893,bright,main,5,0.9867828283715993,326,83,7,416
20893,bright,main,6,0.9937974820976021,289,76,3,368
20893,bright,main,7,0.9898222091662235,273,75,5,353
20893,bright,main,8,0.9942250430300977,342,83,3,428
20893,bright,main,9,0.9938395447493572,300,123,2,425
20767,bright,main,0,0.9941805564648952,339,82,6,427
20767,bright,main,1,0.988758789177045,328,50,7,385
20767,bright,main,2,0.9910961292345557,340,71,4,415
20767,bright,main,3,0.9896812679169356,324,55,5,384
20767,bright,main,4,0.9925676701112603,338,57,5,400
20767,bright,main,5,0.993155720029385,330,44,8,382
20767,bright,main,6,0.9912470993290576,315,32,9,356
20767,bright,main,7,0.9893855292443422,266,61,4,331
20767,bright,main,8,0.9922289285297728,354,59,3,416
20767,bright,main,9,0.993558752971851,338,78,6,422
20889,bright,main,0,0.992209562032799,332,103,3,438
20889,bright,main,1,0.9941219318227341,310,86,3,399
20889,bright,main,2,0.9953476777815997,328,96,6,430
20889,bright,main,3,0.9950242526831582,320,68,5,393
20889,bright,main,4,0.9913872965444475,303,103,2,408
20889,bright,main,5,0.9951011550932938,309,95,6,410
20889,bright,main,6,0.9913808653776486,281,86,2,369
20889,bright,main,7,0.9918166886897647,284,72,0,356
20889,bright,main,8,0.9922023001794675,336,87,1,424
20889,bright,main,9,0.9908986054810575,315,112,2,429
20416,bright,main,0,0.9939529821048216,353,82,3,438
20416,bright,main,1,0.9931206674321853,336,64,4,404
20416,bright,main,2,0.9927110348120133,378,48,3,429
20416,bright,main,3,0.9936575607641036,301,95,3,399
20416,bright,main,4,0.9945557501790047,314,86,6,406
20416,bright,main,5,0.9942765216434387,324,85,6,415
20416,bright,main,6,0.9929181410688818,330,45,1,376
20416,bright,main,7,0.9943146038093259,300,52,1,353
20416,bright,main,8,0.9954528840505079,358,69,4,431
20416,bright,main,9,0.9964731727270778,358,71,4,433
20788,bright,main,0,0.9934761783036757,363,57,0,420
20788,bright,main,1,0.9913469145107653,290,81,4,375
20788,bright,main,2,0.9923200062005063,293,100,3,396
20788,bright,main,3,0.9952172818709476,275,71,3,349
20788,bright,main,4,0.9881880000231203,302,69,3,374
20788,bright,main,5,0.993153811994356,304,76,3,383
20788,bright,main,6,0.9926064842469347,309,50,1,360
20788,bright,main,7,0.995857474974054,270,59,3,332
20788,bright,main,8,0.993361854236978,330,73,3,406
20788,bright,main,9,0.9905404450522157,329,67,8,404
21166,bright,main,0,0.9914089185128129,286,106,2,394
21166,bright,main,1,0.9885485415777877,305,63,7,375
21166,bright,main,2,0.9925985046627571,318,72,5,395
21166,bright,main,3,0.9892824294354663,296,66,3,365
21166,bright,main,4,0.9918517145101641,302,72,3,377
21166,bright,main,5,0.990653804863945,313,55,7,375
21166,bright,main,6,0.9948774471864483,259,76,4,339
21166,bright,main,7,0.9930328171828388,238,66,2,306
21166,bright,main,8,0.982801140901403,318,73,3,394
21166,bright,main,9,0.9916359781487901,308,81,5,394
20387,bright,main,0,0.9902492722058956,319,109,5,433
20387,bright,main,1,0.9949754507487901,297,102,7,406
20387,bright,main,2,0.9963720423407588,302,130,2,434
20387,bright,main,3,0.9907280293481955,263,133,3,399
20387,bright,main,4,0.9956248908718872,309,94,7,410
20387,bright,main,5,0.9935500388797084,312,101,2,415
20387,bright,main,6,0.9899393937808968,281,89,3,373
20387,bright,main,7,0.9930757958892051,242,107,5,354
20387,bright,main,8,0.9961435462338866,303,120,6,429
20387,bright,main,9,0.9927309819410902,354,73,5,432
20825,bright,main,0,0.9951617817403269,328,100,5,433
20825,bright,main,1,0.9871893767881715,338,62,3,403
20825,bright,main,2,0.9919747267880492,318,101,6,425
20825,bright,main,3,0.9891959840623821,282,106,4,392
20825,bright,main,4,0.9927728339055341,325,76,2,403
20825,bright,main,5,0.9939615411501216,323,79,8,410
20825,bright,main,6,0.9928567685252911,276,90,5,371
20825,bright,main,7,0.9900836517086271,287,62,1,350
20825,bright,main,8,0.9933213791779343,333,83,8,424
20825,bright,main,9,0.993812530295186,310,112,3,425
20778,bright,main,0,0.992911839632353,334,81,0,415
20778,bright,main,1,0.9923631716499435,292,83,2,377
20778,bright,main,2,0.9899536814541133,311,88,1,400
20778,bright,main,3,0.991780584017439,291,81,1,373
20778,bright,main,4,0.996110400053904,306,74,1,381
20778,bright,main,5,0.9922026924291013,296,82,6,384
20778,bright,main,6,0.9929778314803972,274,70,7,351
20778,bright,main,7,0.9894335199820486,269,64,5,338
20778,bright,main,8,0.9905653710613344,335,62,7,404
20778,bright,main,9,0.9944653768472123,330,62,9,401
20391,bright,main,0,0.9938338808067323,311,129,3,443
20391,bright,main,1,0.9913422877196094,291,106,3,400
20391,bright,main,2,0.9957904539902885,300,118,7,425
20391,bright,main,3,0.9947524149109407,284,113,3,400
20391,bright,main,4,0.9923833526576401,282,117,4,403
20391,bright,main,5,0.9893059881246372,274,137,4,415
20391,bright,main,6,0.9892097969196759,266,99,5,370
20391,bright,main,7,0.9910309205766734,247,103,2,352
20391,bright,main,8,0.9934512554332798,338,82,3,423
20391,bright,main,9,0.99181190253865,325,95,2,422
1001,dark,main,0,0.9914165016294515,280,30,78,388
1001,dark,main,1,0.9908371631231784,228,30,75,333
1001,dark,main,2,0.9986604528166982,249,41,80,370
1001,dark,main,3,0.99430279458072,259,21,77,357
1001,dark,main,4,0.987133342358985,251,26,81,358
1001,dark,main,5,0.9877177190570294,244,26,84,354
1001,dark,main,6,0.9910300418198227,237,24,57,318
1001,dark,main,7,0.9936610135247484,204,25,80,309
1001,dark,main,8,0.9856376155369142,241,26,96,363
1001,dark,main,9,0.992770132296817,283,22,63,368
2071,dark,main,0,0.993653095153441,254,45,81,380
2071,dark,main,1,0.9942083309062203,233,36,67,336
2071,dark,main,2,0.9927614816017277,253,36,84,373
2071,dark,main,3,0.9963616485130677,253,36,62,351
2071,dark,main,4,0.9856357555920874,241,19,89,349
2071,dark,main,5,0.9930320908176489,219,25,93,337
2071,dark,main,6,0.9951580327877229,201,45,71,317
2071,dark,main,7,0.9928838640380707,210,33,60,303
2071,dark,main,8,0.993969833035535,237,46,78,361
2071,dark,main,9,0.9902672346657945,247,40,72,359
1786,dark,main,0,0.995867302565628,257,35,83,375
1786,dark,main,1,0.9913111882760667,231,25,87,343
1786,dark,main,2,0.9937052524494053,251,25,104,380
1786,dark,main,3,0.9939117561926923,265,15,84,364
1786,dark,main,4,0.9890988139966463,261,23,73,357
1786,dark,main,5,0.9893850160467085,228,16,114,358
1786,dark,main,6,0.9880108233805797,240,18,62,320
1786,dark,main,7,0.9919732206284556,206,22,82,310
1786,dark,main,8,0.9915031348183415,270,19,83,372
1786,dark,main,9,0.9952367492887424,256,22,97,375
1845,dark,main,0,0.989866889740629,280,27,72,379
1845,dark,main,1,0.9904842031908128,217,27,90,334
1845,dark,main,2,0.9921593757441589,269,19,74,362
1845,dark,main,3,0.9949412777205261,241,26,88,355
1845,dark,main,4,0.9908679713334819,227,23,81,331
1845,dark,main,5,0.9860219541484588,224,40,58,322
1845,dark,main,6,0.9867468681753204,197,21,82,300
1845,dark,main,7,0.9829657392908026,208,21,68,297
1845,dark,main,8,0.9897007360724932,250,25,90,365
1845,dark,main,9,0.9964383421436718,252,21,99,372
20399,bright,main,0,0.9949850893454919,346,86,1,433
20399,bright,main,1,0.9936690161457372,293,106,4,403
20399,bright,main,2,0.9908893693207572,331,96,7,434
20399,bright,main,3,0.9878753662021859,328,70,3,401
20399,bright,main,4,0.9931744585898946,332,73,3,408
20399,bright,main,5,0.9906066461861521,314,91,8,413
20399,bright,main,6,0.9946013575473969,287,77,7,371
20399,bright,main,7,0.9858357651510591,253,95,2,350
20399,bright,main,8,0.985513829649301,319,111,3,433
20399,bright,main,9,0.9938807285543513,317,110,6,433
20251,bright,main,0,0.9914083636927281,317,111,5,433
20251,bright,main,1,0.986504447215801,318,78,6,402
20251,bright,main,2,0.9903264349051466,345,80,2,427
20251,bright,main,3,0.9900723580664669,328,70,5,403
20251,bright,main,4,0.9946357698151567,320,82,3,405
20251,bright,main,5,0.9930820545591285,348,58,6,412
20251,bright,main,6,0.9933327774176937,297,72,3,372
20251,bright,main,7,0.9954012001731491,269,79,2,350
20251,bright,main,8,0.991101994728427,325,98,3,426
20251,bright,main,9,0.9913162760541214,326,105,0,431
20236,bright,main,0,0.985631338855848,349,89,3,441
20236,bright,main,1,0.9900539384516354,298,89,8,395
20236,bright,main,2,0.9942595198078713,349,66,7,422
20236,bright,main,3,0.9920630960907272,312,77,4,393
20236,bright,main,4,0.992903837263085,336,60,3,399
20236,bright,main,5,0.9888059216495103,361,42,4,407
20236,bright,main,6,0.9863004294953966,309,53,6,368
20236,bright,main,7,0.9931259178947903,272,64,1,337
20236,bright,main,8,0.9951379769163746,341,81,3,425
20236,bright,main,9,0.9934281858870361,368,57,7,432
1818,dark,main,0,0.9914350907937907,265,22,90,377
1818,dark,main,1,0.9927980560137943,229,23,83,335
1818,dark,main,2,0.98826375753361,264,18,87,369
1818,dark,main,3,0.9895056859441644,260,23,66,349
1818,dark,main,4,0.989669494869698,239,16,96,351
1818,dark,main,5,0.9880924212172768,266,15,77,358
1818,dark,main,6,0.9905910211976416,217,26,74,317
1818,dark,main,7,0.9886124783922733,199,15,74,288
1818,dark,main,8,0.9932310989105726,240,25,88,353
1818,dark,main,9,0.9896259076440689,260,12,90,362
20398,bright,main,0,0.994220508998021,256,166,6,428
20398,bright,main,1,0.9922468332416972,278,121,5,404
20398,bright,main,2,0.9911894928383287,298,126,4,428
20398,bright,main,3,0.992432251253874,251,154,0,405
20398,bright,main,4,0.9959986168920515,290,120,2,412
20398,bright,main,5,0.9951672386887244,277,129,7,413
20398,bright,main,6,0.9924349119381103,270,100,3,373
20398,bright,main,7,0.9959196241856025,217,133,2,352
20398,bright,main,8,0.9942607010815048,327,100,2,429
20398,bright,main,9,0.9899508842280943,306,108,4,418
1896,dark,main,0,0.9943549300209891,273,34,75,382
1896,dark,main,1,0.9871102486022225,224,30,74,328
1896,dark,main,2,0.9926706570007632,290,27,73,390
1896,dark,main,3,0.9850856172279051,244,17,89,350
1896,dark,main,4,0.9861035133204193,248,26,75,349
1896,dark,main,5,0.9881073403965854,247,30,84,361
1896,dark,main,6,0.9886970069104117,225,18,69,312
1896,dark,main,7,0.9870188553668062,211,22,74,307
1896,dark,main,8,0.993887636123968,275,28,71,374
1896,dark,main,9,0.9859581727915989,285,30,71,386
20772,bright,main,0,0.9886345634207413,323,87,5,415
20772,bright,main,1,0.9914615817493083,269,106,2,377
20772,bright,main,2,0.990053050586804,301,105,5,411
20772,bright,main,3,0.984101847988696,299,80,2,381
20772,bright,main,4,0.9916855552394596,292,94,3,389
20772,bright,main,5,0.9937133429507604,289,75,8,372
20772,bright,main,6,0.9927363595317602,261,81,7,349
20772,bright,main,7,0.9916469326290115,239,81,6,326
20772,bright,main,8,0.9956866331524711,314,81,8,403
20772,bright,main,9,0.9928161911927539,322,80,4,406
1295,dark,main,0,0.992476569153641,244,41,88,373
1295,dark,main,1,0.9772546987077311,229,36,82,347
1295,dark,main,2,0.9922008038543662,240,57,67,364
1295,dark,main,3,0.9908642882202612,216,39,89,344
1295,dark,main,4,0.9797183442238563,232,30,67,329
1295,dark,main,5,0.9946716883221844,222,38,81,341
1295,dark,main,6,0.9841299865249538,203,39,61,303
1295,dark,main,7,0.9865073954529228,183,31,66,280
1295,dark,main,8,0.9933294796628859,233,36,88,357
1295,dark,main,9,0.9889688464273001,231,50,85,366
20234,bright,main,0,0.9922471826624714,349,74,5,428
20234,bright,main,1,0.9866847773436688,314,78,2,394
20234,bright,main,2,0.9903244137437793,346,64,2,412
20234,bright,main,3,0.9961207125350907,300,70,7,377
20234,bright,main,4,0.9870193391942235,340,50,0,390
20234,bright,main,5,0.9873645745232381,358,38,4,400
20234,bright,main,6,0.9939066368363758,284,74,2,360
20234,bright,main,7,0.99294564286816,250,86,3,339
20234,bright,main,8,0.9902454420037429,309,104,2,415
20234,bright,main,9,0.9944381620586907,329,86,1,416
2075,dark,main,0,0.9927885049969747,283,22,84,389
2075,dark,main,1,0.9907449571541357,245,24,80,349
2075,dark,main,2,0.9929680235928192,273,26,81,380
2075,dark,main,3,0.9898892915121975,238,23,78,339
2075,dark,main,4,0.9930258617360382,249,23,70,342
2075,dark,main,5,0.9897516893860333,257,24,74,355
2075,dark,main,6,0.9870809499927881,216,20,78,314
2075,dark,main,7,0.9925870507806448,224,19,73,316
2075,dark,main,8,0.9907722133600696,265,39,74,378
2075,dark,main,9,0.9911065769151494,257,29,87,373
20245,bright,main,0,0.9891295859411727,334,90,5,429
20245,bright,main,1,0.9915587078403904,305,80,9,394
20245,bright,main,2,0.9932022347020877,322,96,5,423
20245,bright,main,3,0.9906613353807318,300,87,4,391
20245,bright,main,4,0.9940622891771067,338,61,4,403
20245,bright,main,5,0.9907162645006342,323,81,4,408
20245,bright,main,6,0.9948954346913075,296,59,4,359
20245,bright,main,7,0.9876428779066576,255,80,4,339
20245,bright,main,8,0.9909417509452092,325,87,5,417
20245,bright,main,9,0.9918911960648168,350,73,2,425
20733,bright,main,0,0.9879401627074403,338,83,4,425
20733,bright,main,1,0.9952666897215982,307,67,6,380
20733,bright,main,2,0.9904887530263745,352,61,5,418
20733,bright,main,3,0.9967290457298942,304,76,3,383
20733,bright,main,4,0.9926207958951575,308,71,5,384
20733,bright,main,5,0.990792218144495,318,66,4,388
20733,bright,main,6,0.9911972616194548,310,44,3,357
20733,bright,main,7,0.9889723175091173,256,68,8,332
20733,bright,main,8,0.9942267921794102,323,81,5,409
20733,bright,main,9,0.9913283706374075,303,107,2,412
20917,bright,main,0,0.9946365728571301,325,105,4,434
20917,bright,main,1,0.9940596722185554,302,101,1,404
20917,bright,main,2,0.9917333809290654,374,57,2,433
20917,bright,main,3,0.9930132778312237,340,53,8,401
20917,bright,main,4,0.9965006396888733,352,53,5,410
20917,bright,main,5,0.9965503901339738,332,79,5,416
20917,bright,main,6,0.993256047323532,281,80,5,366
20917,bright,main,7,0.9876018233371867,277,75,3,355
20917,bright,main,8,0.9901261191580324,342,75,4,421
20917,bright,main,9,0.9927722370353034,336,85,3,424
1916,dark,main,0,0.9872708915903394,248,48,89,385
1916,dark,main,1,0.9922854179734529,209,46,72,327
1916,dark,main,2,0.9909282450800668,244,33,90,367
1916,dark,main,3,0.9864586399045893,238,44,75,357
1916,dark,main,4,0.9909329691226149,244,29,83,356
1916,dark,main,5,0.9947564371594164,232,42,86,360
1916,dark,main,6,0.9860392136346593,205,33,72,310
1916,dark,main,7,0.9938660948134979,200,36,86,322
1916,dark,main,8,0.99438929949139,237,66,63,366
1916,dark,main,9,0.9871042758522672,249,35,78,362
20770,bright,main,0,0.9884371015659962,279,115,3,397
20770,bright,main,1,0.9899688199776429,270,96,6,372
20770,bright,main,2,0.9949657841622355,308,99,3,410
20770,bright,main,3,0.9936166855222133,291,79,4,374
20770,bright,main,4,0.9919222186605958,289,81,5,375
20770,bright,main,5,0.9932185271443834,251,117,4,372
20770,bright,main,6,0.9926369468215576,276,71,3,350
20770,bright,main,7,0.9928975035936293,236,83,9,328
20770,bright,main,8,0.9861368924105568,280,111,2,393
20770,bright,main,9,0.9892987426915122,289,113,4,406
2070,dark,main,0,0.9820300741790676,262,39,69,370
2070,dark,main,1,0.9918469830317377,244,36,71,351
2070,dark,main,2,0.9939320493737132,245,34,75,354
2070,dark,main,3,0.9895117252904504,231,27,83,341
2070,dark,main,4,0.9896442875415299,232,35,78,345
2070,dark,main,5,0.9909499156367263,235,22,93,350
2070,dark,main,6,0.9899988837462431,214,27,72,313
2070,dark,main,7,0.988873194223508,206,30,64,300
2070,dark,main,8,0.9941405053085381,245,34,83,362
2070,dark,main,9,0.991114943492383,249,41,68,358
1514,dark,main,0,0.9956100114846335,246,38,87,371
1514,dark,main,1,0.9892656088953355,238,31,83,352
1514,dark,main,2,0.9932517510032234,260,20,75,355
1514,dark,main,3,0.9892164739705953,238,23,88,349
1514,dark,main,4,0.9912827373290602,243,28,84,355
1514,dark,main,5,0.990544405350867,244,26,90,360
1514,dark,main,6,0.988252077207839,234,25,68,327
1514,dark,main,7,0.9867416046170905,209,31,66,306
1514,dark,main,8,0.9949557285501718,262,28,78,368
1514,dark,main,9,0.9941521108360233,250,30,79,359
20389,bright,main,0,0.9912966625565468,302,133,3,438
20389,bright,main,1,0.992431982760019,292,107,4,403
20389,bright,main,2,0.994298492680708,296,133,8,437
20389,bright,main,3,0.9899117089767013,269,134,2,405
20389,bright,main,4,0.9862665167394967,302,95,6,403
20389,bright,main,5,0.9940091694763024,313,94,6,413
20389,bright,main,6,0.9914233629424273,274,89,5,368
20389,bright,main,7,0.9896080204252249,250,96,6,352
20389,bright,main,8,0.9933370001601824,236,188,3,427
20389,bright,main,9,0.9925102092850313,285,142,5,432
1078,dark,main,0,0.9954410172986327,282,23,60,365
1078,dark,main,1,0.9923820166067719,244,28,83,355
1078,dark,main,2,0.9833334499151148,238,28,93,359
1078,dark,main,3,0.9911089307460068,234,21,71,326
1078,dark,main,4,0.9850348462826504,223,27,73,323
1078,dark,main,5,0.990977300824674,251,30,72,353
1078,dark,main,6,0.9930832885994413,228,29,64,321
1078,dark,main,7,0.9903082023426152,209,32,70,311
1078,dark,main,8,0.9955785906876323,258,22,80,360
1078,dark,main,9,0.9897388911102314,262,28,70,360
20929,bright,main,0,0.9928373963828961,333,93,5,431
20929,bright,main,1,0.9912238793130307,306,94,0,400
20929,bright,main,2,0.9954275375280914,332,99,2,433
20929,bright,main,3,0.9904357281790857,280,116,4,400
20929,bright,main,4,0.9941894313252679,325,80,3,408
20929,bright,main,5,0.9947965567766623,303,105,3,411
20929,bright,main,6,0.9945085663921046,262,99,4,365
20929,bright,main,7,0.990919991464577,258,95,1,354
20929,bright,main,8,0.995766585790488,319,103,4,426
20929,bright,main,9,0.9941320568988045,310,113,5,428
21164,bright,main,0,0.9912343190604453,320,70,7,397
21164,bright,main,1,0.9841319746773225,318,60,2,380
21164,bright,main,2,0.9900545655804799,345,55,2,402
21164,bright,main,3,0.9896033817042668,281,74,5,360
21164,bright,main,4,0.9897461587139179,304,71,3,378
21164,bright,main,5,0.9900551148017119,322,54,4,380
21164,bright,main,6,0.9896517707216999,280,62,4,346
21164,bright,main,7,0.9895950388960486,252,68,3,323
21164,bright,main,8,0.9953876254585851,347,56,4,407
21164,bright,main,9,0.9941919849405084,338,62,4,404
20920,bright,main,0,0.9951216736523237,349,87,4,440
20920,bright,main,1,0.9860246925678929,311,87,4,402
20920,bright,main,2,0.9947850405413913,323,97,9,429
20920,bright,main,3,0.9962510063099234,304,87,6,397
20920,bright,main,4,0.9884225645265003,321,87,3,411
20920,bright,main,5,0.9916104137768206,309,97,3,409
20920,bright,main,6,0.9894005153241128,270,98,6,374
20920,bright,main,7,0.9932743951200383,265,89,2,356
20920,bright,main,8,0.9952395714432145,321,107,2,430
20920,bright,main,9,0.9917616676636536,332,101,2,435
20789,bright,main,0,0.9923783104215147,342,85,6,433
20789,bright,main,1,0.9896882231130134,324,67,12,403
20789,bright,main,2,0.9957182566705052,307,105,11,423
20789,bright,main,3,0.9904019940673937,300,94,4,398
20789,bright,main,4,0.995705476240951,319,82,4,405
20789,bright,main,5,0.9931782904046859,353,53,3,409
20789,bright,main,6,0.9898231396621933,267,95,6,368
20789,bright,main,7,0.9876021233835254,246,93,6,345
20789,bright,main,8,0.9895396360652976,297,124,4,425
20789,bright,main,9,0.990706599248435,308,113,8,429
20892,bright,main,0,0.993302845243949,323,106,6,435
20892,bright,main,1,0.9914895479132081,311,87,2,400
20892,bright,main,2,0.9939570654822042,323,99,6,428
20892,bright,main,3,0.9910680986625645,277,121,4,402
20892,bright,main,4,0.9953093570940105,299,104,3,406
20892,bright,main,5,0.9918505036408036,289,118,3,410
20892,bright,main,6,0.9920597774065267,268,94,4,366
20892,bright,main,7,0.993908559172261,242,106,4,352
20892,bright,main,8,0.9969059647392287,296,129,1,426
20892,bright,main,9,0.9956995687674469,323,98,9,430
20764,bright,main,0,0.993824604600281,316,95,3,414
20764,bright,main,1,0.9942520320914207,340,54,3,397
20764,bright,main,2,0.9908992472099587,350,63,3,416
20764,bright,main,3,0.9946470135184491,301,82,5,388
20764,bright,main,4,0.9947059149854277,308,81,4,393
20764,bright,main,5,0.9926903320210695,315,78,7,400
20764,bright,main,6,0.9925395631998805,279,77,1,357
20764,bright,main,7,0.9913257404938796,234,95,2,331
20764,bright,main,8,0.9928134572245848,316,83,3,402
20764,bright,main,9,0.9932725576741963,312,99,3,414
20891,bright,main,0,0.991766648166183,337,87,4,428
20891,bright,main,1,0.9910381446491613,295,107,3,405
20891,bright,main,2,0.9964848568855621,343,79,4,426
20891,bright,main,3,0.9906517121589711,295,96,9,400
20891,bright,main,4,0.9938820004250969,308,99,2,409
20891,bright,main,5,0.9913501807298556,295,106,7,408
20891,bright,main,6,0.9970063621175616,246,119,3,368
20891,bright,main,7,0.9909917828691395,234,119,4,357
20891,bright,main,8,0.9955355130038507,299,121,3,423
20891,bright,main,9,0.9958745612535642,328,99,4,431
20395,bright,main,0,0.9919145749105172,374,50,5,429
20395,bright,main,1,0.9897187014782348,358,43,2,403
20395,bright,main,2,0.9893624815095047,364,68,4,436
20395,bright,main,3,0.9919498903132571,289,106,6,401
20395,bright,main,4,0.9863876089060852,331,73,4,408
20395,bright,main,5,0.9908201175324942,308,91,6,405
20395,bright,main,6,0.9924857185572413,279,82,6,367
20395,bright,main,7,0.9936318242740485,280,68,0,348
20395,bright,main,8,0.9963063391338837,358,65,2,425
20395,bright,main,9,0.9938114635218056,351,78,1,430
20431,bright,main,0,0.9931132243800934,338,95,4,437
20431,bright,main,1,0.9916867056255949,322,77,6,405
20431,bright,main,2,0.9930539752071438,343,86,3,432
20431,bright,main,3,0.9916422048287196,321,76,1,398
20431,bright,main,4,0.9814236053006189,311,86,5,402
20431,bright,main,5,0.9927919388479369,330,77,2,409
20431,bright,main,6,0.9945920880535845,298,68,2,368
20431,bright,main,7,0.9939171320172839,291,60,1,352
20431,bright,main,8,0.9861910483176111,337,84,3,424
20431,bright,main,9,0.9904487740420905,318,112,1,431
20784,bright,main,0,0.9940328090557131,352,66,4,422
20784,bright,main,1,0.9944511050171291,317,61,0,378
20784,bright,main,2,0.9917206615163496,324,74,5,403
20784,bright,main,3,0.9947199276457812,302,68,8,378
20784,bright,main,4,0.9937741347605489,301,78,3,382
20784,bright,main,5,0.9860251679317874,308,77,0,385
20784,bright,main,6,0.9925658779621562,258,87,4,349
20784,bright,main,7,0.9863875695495162,226,95,4,325
20784,bright,main,8,0.994196566440685,305,90,7,402
20784,bright,main,9,0.9948869891435334,336,70,5,411
20734,bright,main,0,0.9873133280549273,320,102,2,424
20734,bright,main,1,0.9962367771622339,304,79,4,387
20734,bright,main,2,0.993936172052955,296,113,1,410
20734,bright,main,3,0.9961311038731685,272,96,4,372
20734,bright,main,4,0.9860683857449296,279,103,4,386
20734,bright,main,5,0.989367076074312,315,72,9,396
20734,bright,main,6,0.9933601669249991,296,55,4,355
20734,bright,main,7,0.9858036828751051,261,80,4,345
20734,bright,main,8,0.9963243229605335,320,91,2,413
20734,bright,main,9,0.9930276426511978,345,79,2,426
21157,bright,main,0,0.9960618526422295,333,79,4,416
21157,bright,main,1,0.9888868915611935,311,62,3,376
21157,bright,main,2,0.9947982581389051,346,52,2,400
21157,bright,main,3,0.9883610980785053,314,52,5,371
21157,bright,main,4,0.9927829874094293,299,63,10,372
21157,bright,main,5,0.9972420331089659,307,62,5,374
21157,bright,main,6,0.9925645465802688,292,51,6,349
21157,bright,main,7,0.9840824230251736,274,52,5,331
21157,bright,main,8,0.994254611418819,326,66,4,396
21157,bright,main,9,0.9903021339506098,334,66,6,406
20769,bright,main,0,0.9961823886734941,350,69,4,423
20769,bright,main,1,0.9898144113591114,301,77,1,379
20769,bright,main,2,0.9900585499675881,367,46,2,415
20769,bright,main,3,0.9925423417188505,326,48,6,380
20769,bright,main,4,0.9943607178138084,338,53,4,395
20769,bright,main,5,0.9927392633471447,334,52,5,391
20769,bright,main,6,0.9911673749043942,286,66,4,356
20769,bright,main,7,0.9886962167168939,274,63,3,340
20769,bright,main,8,0.9848868377215093,325,68,3,396
20769,bright,main,9,0.9919497201643626,314,88,8,410
20751,bright,main,0,0.9954197243890097,348,84,2,434
20751,bright,main,1,0.9945980317870182,330,67,5,402
20751,bright,main,2,0.9940341303447514,357,72,1,430
20751,bright,main,3,0.9906877810071395,328,61,5,394
20751,bright,main,4,0.9936728187267315,315,83,8,406
20751,bright,main,5,0.9925765332426372,300,95,5,400
20751,bright,main,6,0.9902454663029541,308,54,2,364
20751,bright,main,7,0.9860907634359622,282,59,6,347
20751,bright,main,8,0.9967890203471956,326,93,3,422
20751,bright,main,9,0.9914555005348373,311,100,7,418
21205,bright,main,0,0.9918719829050656,347,65,5,417
21205,bright,main,1,0.9959971523683286,346,43,5,394
21205,bright,main,2,0.9952405195166932,346,65,4,415
21205,bright,main,3,0.992064053694148,284,88,3,375
21205,bright,main,4,0.9922919595836873,337,52,3,392
21205,bright,main,5,0.9944050996263115,332,56,5,393
21205,bright,main,6,0.9940317663068359,297,50,4,351
21205,bright,main,7,0.993039664995944,259,63,8,330
21205,bright,main,8,0.9955077127413197,331,67,6,404
21205,bright,main,9,0.989989167800857,343,69,4,416
20736,bright,main,0,0.9930288410550158,333,94,3,430
20736,bright,main,1,0.9917874240431689,333,58,3,394
20736,bright,main,2,0.991171527496426,349,75,2,426
20736,bright,main,3,0.9876668977709077,274,100,9,383
20736,bright,main,4,0.9960964786454977,276,112,4,392
20736,bright,main,5,0.9924931990115072,293,96,9,398
20736,bright,main,6,0.9894294316550936,281,78,2,361
20736,bright,main,7,0.9933557480075839,261,73,6,340
20736,bright,main,8,0.990394942650468,333,85,1,419
20736,bright,main,9,0.9914137127572429,314,99,1,414
20780,bright,main,0,0.9892498743015843,291,115,4,410
20780,bright,main,1,0.9908976151652745,289,83,3,375
20780,bright,main,2,0.99128566881887,318,92,2,412
20780,bright,main,3,0.9920738250406578,293,75,3,371
20780,bright,main,4,0.9909743843081936,301,85,4,390
20780,bright,main,5,0.994252082482393,298,90,5,393
20780,bright,main,6,0.9913653944739872,289,56,3,348
20780,bright,main,7,0.987853444715686,265,66,4,335
20780,bright,main,8,0.9877069353175192,323,77,5,405
20780,bright,main,9,0.9905861217634946,307,103,3,413
20903,bright,main,0,0.9944425950647101,352,83,4,439
20903,bright,main,1,0.994266774994437,329,72,3,404
20903,bright,main,2,0.9877850742472871,333,84,6,423
20903,bright,main,3,0.9928485916315473,310,78,5,393
20903,bright,main,4,0.9922812301583969,301,100,5,406
20903,bright,main,5,0.9953537108724309,309,100,5,414
20903,bright,main,6,0.9945604245649031,286,79,1,366
20903,bright,main,7,0.9916047121049805,277,73,4,354
20903,bright,main,8,0.9941549210079846,333,84,5,422
20903,bright,main,9,0.993637493836619,325,100,5,430
20919,bright,main,0,0.9937172230350764,357,79,4,440
20919,bright,main,1,0.9922107805460972,324,71,4,399
20919,bright,main,2,0.9933706908302987,340,84,4,428
20919,bright,main,3,0.9915699507122842,325,69,3,397
20919,bright,main,4,0.9905724932763837,312,93,2,407
20919,bright,main,5,0.9954244783824907,320,88,5,413
20919,bright,main,6,0.992754331954762,309,59,1,369
20919,bright,main,7,0.9903323027348893,294,54,3,351
20919,bright,main,8,0.9943223430397365,349,78,3,430
20919,bright,main,9,0.9906000014073986,373,51,6,430
20894,bright,main,0,0.9923388886174155,348,85,4,437
20894,bright,main,1,0.9934819130229756,304,96,4,404
20894,bright,main,2,0.9943140747666149,334,96,5,435
20894,bright,main,3,0.9909755282741068,281,118,4,403
20894,bright,main,4,0.9938088294137017,306,93,3,402
20894,bright,main,5,0.9881436043783188,305,106,1,412
20894,bright,main,6,0.99512314085512,259,101,2,362
20894,bright,main,7,0.9877478054234733,255,97,3,355
20894,bright,main,8,0.9857859206454933,321,98,3,422
20894,bright,main,9,0.993632542504994,341,91,2,434
20927,bright,main,0,0.9894860422544393,335,100,3,438
20927,bright,main,1,0.9888734417157756,296,90,7,393
20927,bright,main,2,0.9950953631275303,325,104,3,432
20927,bright,main,3,0.9957713085130085,325,64,4,393
20927,bright,main,4,0.9898123468094729,323,72,6,401
20927,bright,main,5,0.9902643391534651,308,93,4,405
20927,bright,main,6,0.9910557329200116,282,82,2,366
20927,bright,main,7,0.9946735003914808,290,59,5,354
20927,bright,main,8,0.9943318140735197,311,110,1,422
20927,bright,main,9,0.9912627080984666,343,78,6,427
20905,bright,main,0,0.9945095592790361,289,137,3,429
20905,bright,main,1,0.9911654868283073,289,114,0,403
20905,bright,main,2,0.9950110422389074,293,137,3,433
20905,bright,main,3,0.985395688440273,280,113,6,399
20905,bright,main,4,0.9900335835688944,294,114,2,410
20905,bright,main,5,0.9958130957703599,285,124,2,411
20905,bright,main,6,0.993064185267491,261,107,1,369
20905,bright,main,7,0.9923661370051904,263,93,0,356
20905,bright,main,8,0.993738366917086,293,137,2,432
20905,bright,main,9,0.9885601145875856,268,152,6,426
20843,bright,main,0,0.9913990977231819,320,109,4,433
20843,bright,main,1,0.9886456495845467,296,98,1,395
20843,bright,main,2,0.9931508679321551,286,129,3,418
20843,bright,main,3,0.9929770761087766,241,146,2,389
20843,bright,main,4,0.9945572401446175,277,128,3,408
20843,bright,main,5,0.9945572401446175,277,128,3,408
20843,bright,main,6,0.9930168060698438,255,112,1,368
20843,bright,main,7,0.993919892861009,226,122,1,349
20843,bright,main,8,0.9878504121190942,326,100,3,429
20843,bright,main,9,0.993175525886381,313,103,7,423
20845,bright,main,0,0.9905629664143834,329,104,3,436
20845,bright,main,1,0.9962526026379106,300,96,6,402
20845,bright,main,2,0.9953513015716812,360,66,3,429
20845,bright,main,3,0.9876722666559188,305,91,5,401
20845,bright,main,4,0.9886760398311832,320,82,2,404
20845,bright,main,5,0.9886760398311832,320,82,2,404
20845,bright,main,6,0.9926853822896804,309,59,3,371
20845,bright,main,7,0.9935246165099835,271,80,2,353
20845,bright,main,8,0.9875335118024259,340,82,5,427
20845,bright,main,9,0.992911718131007,315,107,6,428
20841,bright,main,0,0.9929265157508269,309,122,4,435
20841,bright,main,1,0.9912092144996324,298,104,3,405
20841,bright,main,2,0.9962668891204264,309,117,3,429
20841,bright,main,3,0.9921832689501802,285,111,5,401
20841,bright,main,4,0.9934937471077192,305,88,6,399
20841,bright,main,5,0.9934937471077192,305,88,6,399
20841,bright,main,6,0.9908484908579153,295,73,3,371
20841,bright,main,7,0.994963243578004,265,86,4,355
20841,bright,main,8,0.993707158990592,302,120,5,427
20841,bright,main,9,0.9902024277575614,303,122,2,427
20822,bright,main,0,0.9911859631680432,330,98,8,436
20822,bright,main,1,0.9916994989536109,302,99,2,403
20822,bright,main,2,0.9924022478133238,321,94,5,420
20822,bright,main,3,0.9921844919130459,295,99,5,399
20822,bright,main,4,0.9942004134230671,325,83,0,408
20822,bright,main,5,0.9942004134230671,325,83,0,408
20822,bright,main,6,0.9924347393120927,277,97,2,376
20822,bright,main,7,0.9918593275926368,276,75,3,354
20822,bright,main,8,0.991689088552526,337,86,7,430
20822,bright,main,9,0.9961340301683933,320,102,4,426
20928,bright,main,0,0.99557220850584,347,75,6,428
20928,bright,main,1,0.9947091724210516,336,61,1,398
20928,bright,main,2,0.9953371344259857,343,69,4,416
20928,bright,main,3,0.9919267128654827,316,68,4,388
20928,bright,main,4,0.9884766861768667,321,75,4,400
20928,bright,main,5,0.9884766861768667,321,75,4,400
20928,bright,main,6,0.9903858911171677,272,83,6,361
20928,bright,main,7,0.994114430939514,261,76,5,342
20928,bright,main,8,0.9941506313340314,300,112,4,416
20928,bright,main,9,0.9928511862666519,322,93,2,417
20732,bright,main,0,0.9903819754207329,323,92,2,417
20732,bright,main,1,0.9884445893903077,307,85,3,395
20732,bright,main,2,0.9936918974806189,305,109,5,419
20732,bright,main,3,0.9928111018352382,326,58,3,387
20732,bright,main,4,0.9932400252700203,342,49,3,394
20732,bright,main,5,0.9932400252700203,342,49,3,394
20732,bright,main,6,0.9877325605615812,297,48,1,346
20732,bright,main,7,0.9925556739449559,256,74,3,333
20732,bright,main,8,0.995150768604366,322,85,5,412
20732,bright,main,9,0.9895311705386275,336,71,5,412
20817,bright,main,0,0.995050679592613,311,124,6,441
20817,bright,main,1,0.9907229233488702,307,89,6,402
20817,bright,main,2,0.9964669070459327,319,111,3,433
20817,bright,main,3,0.9889666604915648,290,104,5,399
20817,bright,main,4,0.9861428355310882,284,117,6,407
20817,bright,main,5,0.9861428355310882,284,117,6,407
20817,bright,main,6,0.9815221087002816,260,103,4,367
20817,bright,main,7,0.9927218413140829,258,92,2,352
20817,bright,main,8,0.9812049173105084,326,97,3,426
20817,bright,main,9,0.9926695844548316,312,114,5,431
20728,bright,main,0,0.9889064456455914,312,102,4,418
20728,bright,main,1,0.9869054611071276,278,97,5,380
20728,bright,main,2,0.9959191450923669,319,94,7,420
20728,bright,main,3,0.989611504871086,309,73,2,384
20728,bright,main,4,0.9934562204483545,307,78,5,390
20728,bright,main,5,0.9934562204483545,307,78,5,390
20728,bright,main,6,0.9885577397609915,266,79,4,349
20728,bright,main,7,0.9847536412169763,251,82,3,336
20728,bright,main,8,0.9934109251510976,329,86,2,417
20728,bright,main,9,0.9865666299584687,313,92,7,412
21072,bright,main,0,0.993915096964077,296,134,8,438
21072,bright,main,1,0.9939376516426919,262,132,10,404
21072,bright,main,2,0.9932891537252908,304,125,3,432
21072,bright,main,3,0.9946746456542481,281,116,5,402
21072,bright,main,4,0.9958085619903512,315,88,6,409
21072,bright,main,5,0.9950219633332986,311,100,1,412
21072,bright,main,6,0.9933364822961216,293,72,2,367
21072,bright,main,7,0.9900192073100619,242,111,0,353
21072,bright,main,8,0.992784796689784,314,111,5,430
21072,bright,main,9,0.9919802680965183,286,147,1,434
1824,dark,main,0,0.9929249272252703,276,24,75,375
1824,dark,main,1,0.9952537258604118,227,34,68,329
1824,dark,main,2,0.9898423043333887,246,26,98,370
1824,dark,main,3,0.9925984847725906,258,18,76,352
1824,dark,main,4,0.992814870398603,260,16,85,361
1824,dark,main,5,0.9952514479560121,237,15,63,315
1824,dark,main,6,0.9909497328577983,221,19,69,309
1824,dark,main,7,0.9909862085622296,237,12,41,290
1824,dark,main,8,0.9885202633413208,267,18,74,359
1824,dark,main,9,0.9884340227610051,277,25,77,379
21193,bright,main,0,0.993517240165717,342,50,4,396
21193,bright,main,1,0.9904235326200926,307,47,9,363
21193,bright,main,2,0.9909070405254999,318,65,7,390
21193,bright,main,3,0.9913997384443914,310,53,2,365
21193,bright,main,4,0.9857003082013085,323,53,3,379
21193,bright,main,5,0.9857003082013085,323,53,3,379
21193,bright,main,6,0.9907987896472296,294,40,4,338
21193,bright,main,7,0.9834261883496106,276,42,1,319
21193,bright,main,8,0.9938755267728112,313,79,5,397
21193,bright,main,9,0.9907011163301854,365,45,5,415
20816,bright,main,0,0.9904651899769363,367,65,4,436
20816,bright,main,1,0.9920854381024728,310,89,4,403
20816,bright,main,2,0.9887492630327773,331,100,1,432
20816,bright,main,3,0.9938816351136869,303,97,1,401
20816,bright,main,4,0.996108906235763,300,108,2,410
20816,bright,main,5,0.996108906235763,300,108,2,410
20816,bright,main,6,0.9933114258658157,271,98,5,374
20816,bright,main,7,0.9847735105968541,257,95,3,355
20816,bright,main,8,0.9946972662244571,349,75,5,429
20816,bright,main,9,0.9921891961060255,360,68,3,431
21700,bright,main,0,0.9943290289172895,273,168,3,444
21700,bright,main,1,0.9896744307290181,256,143,7,406
21700,bright,main,2,0.9928826996392225,285,142,7,434
21700,bright,main,3,0.9881408047016645,270,127,6,403
21700,bright,main,4,0.9934150800638947,299,100,5,404
21700,bright,main,5,0.993211391536303,284,121,9,414
21700,bright,main,6,0.9953807819560252,227,141,2,370
21700,bright,main,7,0.9936017960668975,222,144,4,370
21700,bright,main,8,0.9912953577002668,221,206,2,429
21700,bright,main,9,0.9956946271862779,278,150,5,433
20899,bright,main,0,0.9921611159808248,346,90,6,442
20899,bright,main,1,0.9876378653636452,335,60,7,402
20899,bright,main,2,0.9964591644846545,344,79,5,428
20899,bright,main,3,0.9929884136616998,312,83,5,400
20899,bright,main,4,0.9944209237245918,317,88,4,409
20899,bright,main,5,0.9891250172907872,317,94,3,414
20899,bright,main,6,0.9881939753917555,292,77,2,371
20899,bright,main,7,0.9921057927051439,291,74,3,368
20899,bright,main,8,0.9941229685906054,343,82,2,427
20899,bright,main,9,0.992633596147468,341,81,8,430
20931,bright,main,0,0.9955304625598224,361,78,4,443
20931,bright,main,1,0.9910895734216119,315,84,2,401
20931,bright,main,2,0.9940596917360396,352,75,5,432
20931,bright,main,3,0.994711168037281,327,71,3,401
20931,bright,main,4,0.9913482394833372,320,79,5,404
20931,bright,main,5,0.9930384438078221,356,53,4,413
20931,bright,main,6,0.987810463892909,321,45,2,368
20931,bright,main,7,0.9948026697157007,306,59,2,367
20931,bright,main,8,0.9916801743558669,331,90,2,423
20931,bright,main,9,0.9907249754026903,334,89,4,427
21672,bright,main,0,0.9911212787162316,326,113,1,440
21672,bright,main,1,0.9879714289043482,276,122,5,403
21672,bright,main,2,0.9959679400866803,335,99,1,435
21672,bright,main,3,0.9903126586146466,294,100,4,398
21672,bright,main,4,0.9959052761876855,299,106,4,409
21672,bright,main,5,0.9984907311234645,318,92,4,414
21672,bright,main,6,0.9924206177658992,279,89,3,371
21672,bright,main,7,0.993232583443492,225,142,3,370
21672,bright,main,8,0.9938291193919169,271,152,4,427
21672,bright,main,9,0.9952576728362995,281,150,3,434
21070,bright,main,0,0.9946171874776303,336,97,1,434
21070,bright,main,1,0.990677127806631,309,90,4,403
21070,bright,main,2,0.9909260162929914,327,102,4,433
21070,bright,main,3,0.991641837746222,296,99,6,401
21070,bright,main,4,0.9939294951516976,316,87,3,406
21070,bright,main,5,0.9940047353401301,303,107,2,412
21070,bright,main,6,0.9851327164574586,278,93,2,373
21070,bright,main,7,0.9893011332259951,268,95,2,365
21070,bright,main,8,0.9910819270450164,316,108,4,428
21070,bright,main,9,0.9944085458432527,329,94,3,426
20503,bright,main,0,0.9931593297549411,337,103,3,443
20503,bright,main,1,0.9928392068427744,312,90,3,405
20503,bright,main,2,0.9951680732204262,331,96,3,430
20503,bright,main,3,0.9941581723968378,301,94,3,398
20503,bright,main,4,0.9842639959902239,307,93,4,404
20503,bright,main,5,0.9904133761281217,339,70,1,410
20503,bright,main,6,0.9953015917118213,308,59,2,369
20503,bright,main,7,0.9929666243362261,288,60,7,355
20503,bright,main,8,0.9956993106475037,356,64,7,427
20503,bright,main,9,0.9919054535713737,344,77,5,426
22440,bright,main,0,0.9968286430037333,293,144,1,438
22440,bright,main,1,0.9935387085252935,270,126,5,401
22440,bright,main,2,0.9832674316167016,242,188,3,433
22440,bright,main,3,0.9921032693140366,236,164,2,402
22440,bright,main,4,0.98942693774859,225,184,1,410
22440,bright,main,5,0.99153944101134,284,126,3,413
22440,bright,main,6,0.9902853738285929,286,83,4,373
22440,bright,main,7,0.993768955445339,256,108,4,368
22440,bright,main,8,0.9927574713603556,335,82,4,421
22440,bright,main,9,0.992461681367359,302,117,2,421
20508,bright,main,0,0.9934098469883076,349,93,5,447
20508,bright,main,1,0.9919091329782704,310,90,1,401
20508,bright,main,2,0.9889288542006118,328,106,1,435
20508,bright,main,3,0.9909189897938602,317,78,2,397
20508,bright,main,4,0.9829257284212369,303,103,2,408
20508,bright,main,5,0.9948898386888951,300,107,4,411
20508,bright,main,6,0.990002522206028,286,83,3,372
20508,bright,main,7,0.9871138235989381,291,71,3,365
20508,bright,main,8,0.9918982127922013,352,71,4,427
20508,bright,main,9,0.9934185651279528,310,117,3,430
20902,bright,main,0,0.9935873519391726,334,99,5,438
20902,bright,main,1,0.9846708047339119,314,87,4,405
20902,bright,main,2,0.9909799755015821,350,77,7,434
20902,bright,main,3,0.991669152078802,321,80,1,402
20902,bright,main,4,0.9883607152365481,347,62,1,410
20902,bright,main,5,0.9917177644395787,341,61,3,405
20902,bright,main,6,0.9947564037509598,293,73,4,370
20902,bright,main,7,0.99315556223125,272,90,6,368
20902,bright,main,8,0.9895424344514606,344,79,4,427
20902,bright,main,9,0.9920523893088592,367,65,4,436
20223,bright,main,0,0.991281229023959,354,72,5,431
20223,bright,main,1,0.9948031727226286,332,66,3,401
20223,bright,main,2,0.9904955097630255,368,59,5,432
20223,bright,main,3,0.9923013955749113,307,82,2,391
20223,bright,main,4,0.9900377837307269,331,69,4,404
20223,bright,main,5,0.9909230688037334,331,70,6,407
20223,bright,main,6,0.9857269273686149,277,88,3,368
20223,bright,main,7,0.9944964546069561,278,82,2,362
20223,bright,main,8,0.9908974733834742,318,97,4,419
20223,bright,main,9,0.9942178025132516,324,103,3,430
20299,bright,main,0,0.9873141073744394,286,149,5,440
20299,bright,main,1,0.9953874552379262,289,111,4,404
20299,bright,main,2,0.9900828994222186,293,126,8,427
20299,bright,main,3,0.993926085134188,299,82,12,393
20299,bright,main,4,0.9920102823724429,316,87,4,407
20299,bright,main,5,0.9913054210686243,316,93,2,411
20299,bright,main,6,0.9926563744663812,284,78,5,367
20299,bright,main,7,0.9908071028508136,278,81,7,366
20299,bright,main,8,0.9950973222133719,299,118,8,425
20299,bright,main,9,0.9935440314864481,315,115,2,432
20397,bright,main,0,0.9909822258182626,339,101,3,443
20397,bright,main,1,0.9939633262384838,315,92,0,407
20397,bright,main,2,0.995029443917152,348,83,2,433
20397,bright,main,3,0.9939610674294184,306,89,5,400
20397,bright,main,4,0.9832290134711067,338,66,3,407
20397,bright,main,5,0.9941477004579421,334,79,1,414
20397,bright,main,6,0.9888610329252185,306,56,6,368
20397,bright,main,7,0.9917639656207342,301,65,3,369
20397,bright,main,8,0.989365464460479,319,93,5,417
20397,bright,main,9,0.9970291142214817,327,106,2,435
20310,bright,main,0,0.9950254578519236,312,128,3,443
20310,bright,main,1,0.9916832969243434,269,133,5,407
20310,bright,main,2,0.9902839599485184,290,138,2,430
20310,bright,main,3,0.992202566701828,268,128,5,401
20310,bright,main,4,0.9948743891054614,311,94,0,405
20310,bright,main,5,0.9940143718791921,304,103,5,412
20310,bright,main,6,0.9866594966414594,257,114,2,373
20310,bright,main,7,0.9961190468624292,227,130,3,360
20310,bright,main,8,0.9899658368885856,296,125,3,424
20310,bright,main,9,0.9922944121687752,306,123,2,431
20303,bright,main,0,0.9955348910916917,349,84,5,438
20303,bright,main,1,0.9900649217576969,311,89,5,405
20303,bright,main,2,0.9904814048039113,303,125,6,434
20303,bright,main,3,0.9900541109322547,262,136,2,400
20303,bright,main,4,0.9860436394461204,263,142,2,407
20303,bright,main,5,0.9860593349216981,278,128,6,412
20303,bright,main,6,0.9923362953816974,284,86,3,373
20303,bright,main,7,0.9938901446724142,292,74,3,369
20303,bright,main,8,0.9958696429814641,303,120,6,429
20303,bright,main,9,0.9921152075297202,327,100,3,430
20302,bright,main,0,0.9937519740023975,376,60,4,440
20302,bright,main,1,0.9924522302714269,312,82,6,400
20302,bright,main,2,0.9940721679989551,336,88,7,431
20302,bright,main,3,0.9934076114163706,301,91,4,396
20302,bright,main,4,0.9940519490653906,309,96,3,408
20302,bright,main,5,0.9936405487120173,315,93,7,415
20302,bright,main,6,0.9855385157895812,283,83,5,371
20302,bright,main,7,0.9934350593072678,304,59,4,367
20302,bright,main,8,0.9912141440389557,334,85,4,423
20302,bright,main,9,0.9926340514545634,326,101,3,430
20415,bright,main,0,0.994174340046562,326,119,1,446
20415,bright,main,1,0.9890010370809227,301,98,6,405
20415,bright,main,2,0.9930205706825959,319,112,1,432
20415,bright,main,3,0.9952977392496765,320,68,8,396
20415,bright,main,4,0.9929892175914233,321,80,4,405
20415,bright,main,5,0.9915281075291609,323,89,2,414
20415,bright,main,6,0.990306865482169,314,53,3,370
20415,bright,main,7,0.9911982044710322,286,78,3,367
20415,bright,main,8,0.9888228595878354,306,118,2,426
20415,bright,main,9,0.9948415785841976,317,104,11,432
20298,bright,main,0,0.9946924990692737,361,69,5,435
20298,bright,main,1,0.9921733055879867,314,80,5,399
20298,bright,main,2,0.9917222829031296,315,114,4,433
20298,bright,main,3,0.9909560464070498,288,109,4,401
20298,bright,main,4,0.9902263866506015,286,113,6,405
20298,bright,main,5,0.9898662912886836,269,142,4,415
20298,bright,main,6,0.9904067152409967,274,98,1,373
20298,bright,main,7,0.9916762915825915,283,83,4,370
20298,bright,main,8,0.9952751608512258,312,110,4,426
20298,bright,main,9,0.9927980207101508,335,84,9,428
20400,bright,main,0,0.9926745413091855,343,88,5,436
20400,bright,main,1,0.9909069833115532,299,99,4,402
20400,bright,main,2,0.9862462573373783,326,109,3,438
20400,bright,main,3,0.9913978133705916,309,88,2,399
20400,bright,main,4,0.9914681736474571,320,85,4,409
20400,bright,main,5,0.9948161952463686,354,55,7,416
20400,bright,main,6,0.9932044425174053,292,71,3,366
20400,bright,main,7,0.9905189663852052,283,84,4,371
20400,bright,main,8,0.9874793618182391,329,88,8,425
20400,bright,main,9,0.9967331525810612,356,73,4,433
20401,bright,main,0,0.9919007651664382,312,123,5,440
20401,bright,main,1,0.992972490143047,308,95,4,407
20401,bright,main,2,0.9913637598198873,326,103,7,436
20401,bright,main,3,0.9920611375043278,320,77,2,399
20401,bright,main,4,0.989732603722545,336,68,5,409
20401,bright,main,5,0.9936476092305003,338,72,2,412
20401,bright,main,6,0.995122166547302,283,91,0,374
20401,bright,main,7,0.9872526141119439,284,77,5,366
20401,bright,main,8,0.9929320182688998,299,126,2,427
20401,bright,main,9,0.9913624999116865,313,116,2,431
20390,bright,main,0,0.9924523608713787,341,95,3,439
20390,bright,main,1,0.9927191995359838,297,102,4,403
20390,bright,main,2,0.9943642817243593,350,80,4,434
20390,bright,main,3,0.9846965696366959,302,95,5,402
20390,bright,main,4,0.9898115445564886,334,70,2,406
20390,bright,main,5,0.9915846029239515,327,84,5,416
20390,bright,main,6,0.9857378988032643,282,87,3,372
20390,bright,main,7,0.9943834492944469,269,91,8,368
20390,bright,main,8,0.9888368018651823,296,129,2,427
20390,bright,main,9,0.9947140879266044,331,90,8,429
20506,bright,main,0,0.9920225119106074,337,97,3,437
20506,bright,main,1,0.9904505073307501,306,92,3,401
20506,bright,main,2,0.9882288698458697,312,109,2,423
20506,bright,main,3,0.9947952572954273,298,89,9,396
20506,bright,main,4,0.9925430656898134,304,99,5,408
20506,bright,main,5,0.9922810572394162,344,72,0,416
20506,bright,main,6,0.9900985785310307,274,93,4,371
20506,bright,main,7,0.9893524614751769,265,96,4,365
20506,bright,main,8,0.9957184705293446,332,89,2,423
20506,bright,main,9,0.9900991901739529,308,116,6,430
2677,dark,main,0,0.9937184473773146,242,14,60,316
2677,dark,main,1,0.9905854651760757,197,14,41,252
2677,dark,main,2,0.9905824871907172,242,15,66,323
2677,dark,main,3,0.9887793357101686,247,15,85,347
2677,dark,main,4,0.9906840861318041,262,19,61,342
2677,dark,main,5,0.9948609743400441,284,15,63,362
2677,dark,main,6,0.9858771495589044,250,14,57,321
2677,dark,main,7,0.9876884093139638,243,13,53,309
2677,dark,main,8,0.9924618452159069,241,11,59,311
2677,dark,main,9,0.9933480050696644,215,10,77,302
2782,dark,main,0,0.9815231128676297,250,18,35,303
2782,dark,main,1,0.9833286372797397,236,16,45,297
2782,dark,main,2,0.989294301522036,249,20,71,340
2782,dark,main,3,0.9921700819847229,262,12,53,327
2782,dark,main,4,0.9938723262889673,296,16,52,364
2782,dark,main,5,0.995341497271577,285,16,65,366
2782,dark,main,6,0.9881214062700294,244,17,61,322
2782,dark,main,7,0.9928821168490488,236,21,59,316
2782,dark,main,8,0.9834154183909355,302,24,53,379
2782,dark,main,9,0.9948886525453317,288,21,62,371
21676,bright,main,0,0.9951914281298639,255,174,6,435
21676,bright,main,1,0.9877152289695894,237,149,2,388
21676,bright,main,2,0.9937857455872503,304,117,6,427
21676,bright,main,3,0.9928670811678807,291,103,3,397
21676,bright,main,4,0.9901825809371985,257,138,2,397
21676,bright,main,5,0.9875767375353953,276,121,5,402
21676,bright,main,6,0.9867634929990619,243,117,2,362
21676,bright,main,7,0.9919647935886224,253,108,1,362
21676,bright,main,8,0.9910988044427793,257,149,1,407
21676,bright,main,9,0.9946794272909435,293,131,2,426
21996,bright,main,0,0.9884891240496307,376,48,4,428
21996,bright,main,1,0.9930876662748271,311,89,1,401
21996,bright,main,2,0.993787438633882,327,95,4,426
21996,bright,main,3,0.9915928472586513,274,129,0,403
21996,bright,main,4,0.9912350109979526,258,146,3,407
21996,bright,main,5,0.993998486510206,268,134,6,408
21996,bright,main,6,0.9942763395151388,221,146,2,369
21996,bright,main,7,0.9900742046873647,196,169,2,367
21996,bright,main,8,0.9928036934939889,322,85,3,410
21996,bright,main,9,0.9913966981490994,351,65,5,421
20417,bright,main,0,0.9916524711743634,381,58,1,440
20417,bright,main,1,0.9940285256162729,334,63,7,404
20417,bright,main,2,0.9937318610209185,338,83,6,427
20417,bright,main,3,0.9967595876949432,316,82,2,400
20417,bright,main,4,0.9946814332630308,321,87,1,409
20417,bright,main,5,0.9932551648501233,335,75,3,413
20417,bright,main,6,0.9972234062053601,273,101,0,374
20417,bright,main,7,0.9922449409451064,255,111,2,368
20417,bright,main,8,0.9957311861668368,336,90,2,428
20417,bright,main,9,0.9926821376176918,341,79,2,422
20505,bright,main,0,0.9911080571410466,364,72,3,439
20505,bright,main,1,0.9823434795615098,321,73,4,398
20505,bright,main,2,0.9953350545564067,351,67,9,427
20505,bright,main,3,0.9929234764320104,306,85,10,401
20505,bright,main,4,0.9895877632560374,297,105,6,408
20505,bright,main,5,0.9943524801650107,302,105,6,413
20505,bright,main,6,0.99418372728537,261,102,3,366
20505,bright,main,7,0.9938736018815749,276,81,5,362
20505,bright,main,8,0.9915319773478674,329,93,2,424
20505,bright,main,9,0.9860113599078631,356,70,7,433
21075,bright,main,0,0.9958160534435618,326,105,4,435
21075,bright,main,1,0.9948198735390843,291,104,4,399
21075,bright,main,2,0.9928855503542402,339,88,3,430
21075,bright,main,3,0.9968425218194105,309,82,8,399
21075,bright,main,4,0.9951838258550452,333,70,2,405
21075,bright,main,5,0.9940558426422033,332,74,3,409
21075,bright,main,6,0.9956596188485153,308,61,2,371
21075,bright,main,7,0.9930623470845718,299,60,4,363
21075,bright,main,8,0.9925666345156225,327,94,7,428
21075,bright,main,9,0.9868859295244313,307,125,2,434
22465,bright,main,0,0.9964417483034078,318,112,5,435
22465,bright,main,1,0.9934638981377456,237,157,4,398
22465,bright,main,2,0.9950295296215056,273,152,6,431
22465,bright,main,3,0.9908837077362841,273,122,2,397
22465,bright,main,4,0.9902606972899373,253,156,4,413
22465,bright,main,5,0.9938919257398969,266,135,6,407
22465,bright,main,6,0.9952409467441374,252,112,6,370
22465,bright,main,7,0.9932696805793412,228,131,6,365
22465,bright,main,8,0.989110267915461,314,108,2,424
22465,bright,main,9,0.9916954097425635,329,88,7,424
20896,bright,main,0,0.9926651039166687,370,52,3,425
20896,bright,main,1,0.9882972082873586,279,94,4,377
20896,bright,main,2,0.9941574135170262,336,92,3,431
20896,bright,main,3,0.9929442086150635,304,96,2,402
20896,bright,main,4,0.9901332330484901,327,76,5,408
20896,bright,main,5,0.9909405570797019,359,51,3,413
20896,bright,main,6,0.9889294570209275,300,70,4,374
20896,bright,main,7,0.9890370155736478,288,73,5,366
20896,bright,main,8,0.9942561569062125,359,66,2,427
20896,bright,main,9,0.9903443811872124,357,74,4,435
20410,bright,main,0,0.9886176588955757,396,40,5,441
20410,bright,main,1,0.9952234761508143,326,71,7,404
20410,bright,main,2,0.992949193271114,346,81,3,430
20410,bright,main,3,0.991794455377331,333,66,5,404
20410,bright,main,4,0.9941016831349115,332,71,2,405
20410,bright,main,5,0.9980102863686712,321,80,4,405
20410,bright,main,6,0.9943284554256628,311,60,0,371
20410,bright,main,7,0.9894314206479233,286,79,4,369
20410,bright,main,8,0.9915547957200234,346,83,1,430
20410,bright,main,9,0.9957825493409097,334,93,5,432
20394,bright,main,0,0.9903324932249713,299,138,4,441
20394,bright,main,1,0.9896943794715948,256,141,7,404
20394,bright,main,2,0.9869245876938544,327,102,4,433
20394,bright,main,3,0.98832981204208,319,80,1,400
20394,bright,main,4,0.9881796963661196,327,73,6,406
20394,bright,main,5,0.9862632992807612,351,63,2,416
20394,bright,main,6,0.9934636238180924,300,76,0,376
20394,bright,main,7,0.9926846817135491,265,99,3,367
20394,bright,main,8,0.9911454506945074,298,126,4,428
20394,bright,main,9,0.988624970997192,315,115,3,433
1775,dark,main,0,0.9944883916827914,296,12,86,394
1775,dark,main,1,0.9884995754303959,255,10,87,352
1775,dark,main,2,0.9830733136537054,270,14,93,377
1775,dark,main,3,0.9864497839007182,257,17,73,347
1775,dark,main,4,0.9835765804365134,261,12,80,353
1775,dark,main,5,0.994090109187912,247,17,91,355
1775,dark,main,6,0.9922030714862936,243,20,67,330
1775,dark,main,7,0.9919277308125417,232,14,81,327
1775,dark,main,8,0.9912694653230907,274,16,84,374
1775,dark,main,9,0.9915979848316051,261,20,99,380
20900,bright,main,0,0.9937149261813718,354,83,3,440
20900,bright,main,1,0.9910229914664506,326,68,4,398
20900,bright,main,2,0.9934552660022736,308,115,7,430
20900,bright,main,3,0.9939920479519616,285,111,3,399
20900,bright,main,4,0.9880363222401624,307,93,5,405
20900,bright,main,5,0.9938580789905909,337,76,0,413
20900,bright,main,6,0.9926283166911188,288,81,3,372
20900,bright,main,7,0.995569023022849,264,92,6,362
20900,bright,main,8,0.9946593657590039,350,67,6,423
20900,bright,main,9,0.9913907652517144,355,76,4,435
20511,bright,main,0,0.9910090281312292,329,109,5,443
20511,bright,main,1,0.9882026781290899,333,73,1,407
20511,bright,main,2,0.9945504523824836,366,67,5,438
20511,bright,main,3,0.9879786840910186,317,85,3,405
20511,bright,main,4,0.9919690364386018,323,92,1,416
20511,bright,main,5,0.9921838041581071,324,95,2,421
20511,bright,main,6,0.9936936121896877,257,109,3,369
20511,bright,main,7,0.9912847462766821,281,94,3,378
20511,bright,main,8,0.9960136296335879,317,106,5,428
20511,bright,main,9,0.9931829331016383,318,107,4,429
20921,bright,main,0,0.9944174405309776,379,64,1,444
20921,bright,main,1,0.9901962458283059,288,111,5,404
20921,bright,main,2,0.9897574581394394,350,82,6,438
20921,bright,main,3,0.9932116033462671,322,79,0,401
20921,bright,main,4,0.992240489994445,350,61,4,415
20921,bright,main,5,0.9924169423418295,352,65,2,419
20921,bright,main,6,0.994713411192544,312,58,1,371
20921,bright,main,7,0.9900434069283948,300,73,1,374
20921,bright,main,8,0.9854302108681502,355,76,2,433
20921,bright,main,9,0.9925219005671977,322,104,1,427
20510,bright,main,0,0.9937211925528463,358,83,1,442
20510,bright,main,1,0.9910101788858364,322,70,6,398
20510,bright,main,2,0.9917027650238183,354,80,1,435
20510,bright,main,3,0.9944082278833491,309,91,6,406
20510,bright,main,4,0.9958860701802054,320,85,4,409
20510,bright,main,5,0.9855808823029664,330,86,3,419
20510,bright,main,6,0.9916318620316127,272,95,1,368
20510,bright,main,7,0.9952978439820466,283,91,1,375
20510,bright,main,8,0.9951046737656153,331,99,2,432
20510,bright,main,9,0.9869458064090405,345,92,3,440
20514,bright,main,0,0.9889929931485447,369,55,5,429
20514,bright,main,1,0.995523862044373,333,61,5,399
20514,bright,main,2,0.9945033560728453,330,96,5,431
20514,bright,main,3,0.9946434315885391,285,107,5,397
20514,bright,main,4,0.9925325201760983,329,73,5,407
20514,bright,main,5,0.9951223426812397,313,96,3,412
20514,bright,main,6,0.9945222597256254,284,77,6,367
20514,bright,main,7,0.9848726015907098,267,89,6,362
20514,bright,main,8,0.995501795407503,326,100,4,430
20514,bright,main,9,0.9884707743115708,319,111,3,433
20922,bright,main,0,0.9902175032233533,379,58,1,438
20922,bright,main,1,0.995832970759836,317,80,3,400
20922,bright,main,2,0.9951715313052675,372,68,2,442
20922,bright,main,3,0.9896462290306534,335,63,2,400
20922,bright,main,4,0.9926905686756852,327,87,2,416
20922,bright,main,5,0.9862692555973235,338,71,3,412
20922,bright,main,6,0.9906207440642956,233,130,3,366
20922,bright,main,7,0.9940322151487485,270,97,6,373
20922,bright,main,8,0.9929162562440017,321,97,5,423
20922,bright,main,9,0.994060604531617,340,86,3,429
20895,bright,main,0,0.9920862459712797,328,110,5,443
20895,bright,main,1,0.9907769336981374,295,108,6,409
20895,bright,main,2,0.9929986553372236,339,98,4,441
20895,bright,main,3,0.9924732819700568,291,103,2,396
20895,bright,main,4,0.9953445866644136,322,89,5,416
20895,bright,main,5,0.9920910628533651,349,68,2,419
20895,bright,main,6,0.9907060026413171,304,67,2,373
20895,bright,main,7,0.9885313631670719,280,93,3,376
20895,bright,main,8,0.9921796814468459,325,100,6,431
20895,bright,main,9,0.9889116460154602,325,103,6,434
20407,bright,main,0,0.9880932390256232,363,74,4,441
20407,bright,main,1,0.9882776760948049,325,74,5,404
20407,bright,main,2,0.9936401890888794,349,98,1,448
20407,bright,main,3,0.9941491017938764,332,72,3,407
20407,bright,main,4,0.9948427137041277,335,82,2,419
20407,bright,main,5,0.9918928811295878,313,102,3,418
20407,bright,main,6,0.9956330878015275,302,74,0,376
20407,bright,main,7,0.9899358023344149,316,62,1,379
20407,bright,main,8,0.9932873886341114,341,93,2,436
20407,bright,main,9,0.9890803730272648,360,70,6,436
20926,bright,main,0,0.9948517944385314,351,90,4,445
20926,bright,main,1,0.9924268805376129,331,72,1,404
20926,bright,main,2,0.9951199508642421,363,70,3,436
20926,bright,main,3,0.9891588705041392,316,83,4,403
20926,bright,main,4,0.9946076790873103,310,103,4,417
20926,bright,main,5,0.9941079726275805,329,82,3,414
20926,bright,main,6,0.9874540794574094,300,65,6,371
20926,bright,main,7,0.9888499266738295,302,72,2,376
20926,bright,main,8,0.9924729606915456,345,83,2,430
20926,bright,main,9,0.993747144223101,376,62,2,440
21671,bright,main,0,0.9889593892915837,253,83,3,339
21671,bright,main,1,0.9895613364979211,336,58,3,397
21671,bright,main,2,0.995218440242505,360,76,4,440
21671,bright,main,3,0.9972923661623221,261,141,5,407
21671,bright,main,4,0.9917361230061408,298,119,1,418
21671,bright,main,5,0.9900204480481767,270,147,5,422
21671,bright,main,6,0.9851805908088871,278,93,1,372
21671,bright,main,7,0.9952778226962783,280,97,1,378
21671,bright,main,8,0.9927651373161006,313,113,5,431
21671,bright,main,9,0.9955975606119859,309,126,3,438
20211,bright,main,0,0.9925733228763689,356,88,3,447
20211,bright,main,1,0.99232960922479,336,70,1,407
20211,bright,main,2,0.9925050182003657,364,76,2,442
20211,bright,main,3,0.9937620025090474,347,54,2,403
20211,bright,main,4,0.9873362130638348,356,58,6,420
20211,bright,main,5,0.9843692483186199,348,72,2,422
20211,bright,main,6,0.9879836940197972,302,70,3,375
20211,bright,main,7,0.9947317599877751,311,64,2,377
20211,bright,main,8,0.9945600438530602,301,118,8,427
20211,bright,main,9,0.9932662485612749,345,92,1,438
20925,bright,main,0,0.9936993502691229,336,106,6,448
20925,bright,main,1,0.9900508042467466,293,101,3,397
20925,bright,main,2,0.9948183849837294,337,96,2,435
20925,bright,main,3,0.9788367403289037,156,50,3,209
20925,bright,main,4,0.9941586544867456,309,106,4,419
20925,bright,main,5,0.9969740613849291,312,99,8,419
20925,bright,main,6,0.9894255986100932,297,69,6,372
20925,bright,main,7,0.9928892254067014,287,80,4,371
20925,bright,main,8,0.9953238353755754,320,105,1,426
20925,bright,main,9,0.9936073223323107,312,115,4,431
20897,bright,main,0,0.9945175420292077,359,83,4,446
20897,bright,main,1,0.9946184363803608,291,115,1,407
20897,bright,main,2,0.994251046912817,311,129,0,440
20897,bright,main,3,0.9914367496994712,303,88,5,396
20897,bright,main,4,0.9928602587412158,302,113,6,421
20897,bright,main,5,0.9888469238596689,312,100,7,419
20897,bright,main,6,0.9916949923597178,256,110,6,372
20897,bright,main,7,0.9932654989453681,270,98,7,375
20897,bright,main,8,0.9956782072783658,336,91,5,432
20897,bright,main,9,0.9925261434660705,344,91,2,437
20388,bright,main,0,0.9831338369426248,319,123,4,446
20388,bright,main,1,0.9931767633134259,260,140,4,404
20388,bright,main,2,0.9956231989810497,304,130,8,442
20388,bright,main,3,0.9934092741886202,307,91,5,403
20388,bright,main,4,0.9968016568134891,298,113,5,416
20388,bright,main,5,0.9924731414277952,326,90,2,418
20388,bright,main,6,0.9922377574531412,285,87,2,374
20388,bright,main,7,0.9891604696362181,286,87,5,378
20388,bright,main,8,0.9927235666535995,352,73,6,431
20388,bright,main,9,0.9953301750708877,356,74,4,434
20069,bright,main,0,0.9949877785414238,323,122,3,448
20069,bright,main,1,0.9893668372069545,292,103,3,398
20069,bright,main,2,0.9875388305253116,327,105,4,436
20069,bright,main,3,0.9930783591232751,301,95,3,399
20069,bright,main,4,0.9924733264329694,323,91,2,416
20069,bright,main,5,0.9919892901320649,331,84,0,415
20069,bright,main,6,0.9918395287974675,295,70,6,371
20069,bright,main,7,0.9943414064888403,304,63,5,372
20069,bright,main,8,0.9949735906300906,369,62,3,434
20069,bright,main,9,0.9938797849969806,327,104,4,435
20512,bright,main,0,0.9924174997315137,369,73,5,447
20512,bright,main,1,0.9879632163148273,337,62,5,404
20512,bright,main,2,0.9920043997253568,356,80,4,440
20512,bright,main,3,0.9809019449510726,324,72,6,402
20512,bright,main,4,0.9938336189564272,330,86,3,419
20512,bright,main,5,0.9927967082024264,330,84,2,416
20512,bright,main,6,0.9872254820539482,296,71,2,369
20512,bright,main,7,0.9952151097649797,286,85,5,376
20512,bright,main,8,0.9949980617029559,326,95,7,428
20512,bright,main,9,0.9902708608326969,356,75,3,434
20248,bright,main,0,0.9935133012354944,374,71,2,447
20248,bright,main,1,0.9874287295714105,334,63,1,398
20248,bright,main,2,0.9932854725692672,356,77,3,436
20248,bright,main,3,0.9914710096752182,325,74,2,401
20248,bright,main,4,0.9909653331825619,312,95,3,410
20248,bright,main,5,0.9938454116628037,330,88,1,419
20248,bright,main,6,0.9931205403036669,295,74,2,371
20248,bright,main,7,0.9957200874126848,306,66,1,373
20248,bright,main,8,0.9932297086648251,339,84,7,430
20248,bright,main,9,0.9922123013041813,363,67,2,432
20219,bright,main,0,0.9960923659220433,360,87,0,447
20219,bright,main,1,0.9883035119489726,332,70,2,404
20219,bright,main,2,0.9956363328949486,344,93,0,437
20219,bright,main,3,0.9983740880244668,327,78,3,408
20219,bright,main,4,0.9948456029364443,345,66,2,413
20219,bright,main,5,0.9970097052362115,334,80,4,418
20219,bright,main,6,0.989313111903653,305,63,3,371
20219,bright,main,7,0.9874982797895963,312,54,1,367
20219,bright,main,8,0.9948935161322108,345,83,6,434
20219,bright,main,9,0.9944067270260543,327,103,2,432
20134,bright,main,0,0.9903495713150331,358,78,5,441
20134,bright,main,1,0.9940424907297508,320,81,4,405
20134,bright,main,2,0.993915127977241,373,53,2,428
20134,bright,main,3,0.9953755090615163,346,55,5,406
20134,bright,main,4,0.9900776635663664,363,50,1,414
20134,bright,main,5,0.995212733657743,357,58,4,419
20134,bright,main,6,0.9961691394305006,292,73,2,367
20134,bright,main,7,0.9934352100488805,309,59,2,370
20134,bright,main,8,0.9912436260401035,325,86,6,417
20134,bright,main,9,0.9936637761458792,358,68,3,429
20515,bright,main,0,0.9972878565129667,339,93,5,437
20515,bright,main,1,0.9911702468811049,307,93,4,404
20515,bright,main,2,0.9869326565116362,339,100,3,442
20515,bright,main,3,0.9886362673773698,326,74,4,404
20515,bright,main,4,0.9936444050955296,316,96,1,413
20515,bright,main,5,0.9917204032078368,312,110,0,422
20515,bright,main,6,0.9819151998912813,259,106,5,370
20515,bright,main,7,0.9912773437274432,271,103,2,376
20515,bright,main,8,0.9936287307881412,341,85,1,427
20515,bright,main,9,0.9958776972645242,340,90,6,436
20207,bright,main,0,0.9925435534371723,371,70,2,443
20207,bright,main,1,0.9932347644128686,326,73,2,401
20207,bright,main,2,0.9927904197800562,360,72,4,436
20207,bright,main,3,0.9874155075203735,303,94,2,399
20207,bright,main,4,0.9930758580506797,325,88,1,414
20207,bright,main,5,0.992162472217938,317,97,3,417
20207,bright,main,6,0.9899883669760047,302,68,3,373
20207,bright,main,7,0.9830628903146359,286,78,2,366
20207,bright,main,8,0.9948730462461287,341,80,2,423
20207,bright,main,9,0.9878684334859922,371,60,2,433
20507,bright,main,0,0.9960314376745177,377,72,1,450
20507,bright,main,1,0.9919754246105167,309,92,4,405
20507,bright,main,2,0.9939882579460656,337,98,6,441
20507,bright,main,3,0.994143575155875,308,96,1,405
20507,bright,main,4,0.9902365103566096,321,98,3,422
20507,bright,main,5,0.9915727213373924,354,65,4,423
20507,bright,main,6,0.9921871246114385,294,75,4,373
20507,bright,main,7,0.9946600600073429,296,74,5,375
20507,bright,main,8,0.9944174527890376,326,99,4,429
20507,bright,main,9,0.9926920060246051,325,106,2,433
20384,bright,main,0,0.9973140788004853,369,73,5,447
20384,bright,main,1,0.994902669956315,284,119,4,407
20384,bright,main,2,0.9906986428077617,337,102,7,446
20384,bright,main,3,0.9955707472439826,301,102,6,409
20384,bright,main,4,0.9936060461324451,346,76,1,423
20384,bright,main,5,0.9935562767692372,348,66,3,417
20384,bright,main,6,0.9920967218145045,296,67,8,371
20384,bright,main,7,0.9833184131938395,256,120,1,377
20384,bright,main,8,0.9951268021138785,288,142,2,432
20384,bright,main,9,0.991425080293783,338,99,1,438
20040,bright,main,0,0.9885943370678278,346,96,5,447
20040,bright,main,1,0.9922319769551523,330,68,3,401
20040,bright,main,2,0.9890650059789233,367,65,6,438
20040,bright,main,3,0.9963017207229536,316,78,3,397
20040,bright,main,4,0.9906982002833465,324,84,6,414
20040,bright,main,5,0.988106655668496,361,54,0,415
20040,bright,main,6,0.9897390008018684,306,61,3,370
20040,bright,main,7,0.9912793432705059,279,84,4,367
20040,bright,main,8,0.9904501172251554,345,76,5,426
20040,bright,main,9,0.996465628472408,318,106,6,430
20249,bright,main,0,0.9829839773257605,380,64,3,447
20249,bright,main,1,0.9894870277431483,315,87,6,408
20249,bright,main,2,0.9914749239750429,341,88,2,431
20249,bright,main,3,0.9931806974385861,313,85,4,402
20249,bright,main,4,0.992387555642024,341,69,2,412
20249,bright,main,5,0.99309882497627,348,71,2,421
20249,bright,main,6,0.987903008701566,329,38,3,370
20249,bright,main,7,0.9946567328028951,335,39,2,376
20249,bright,main,8,0.9920646443437887,381,48,4,433
20249,bright,main,9,0.9912409787851516,391,43,6,440
20396,bright,main,0,0.994840414950476,363,76,4,443
20396,bright,main,1,0.9883985554370931,342,66,0,408
20396,bright,main,2,0.9982403915768395,371,63,5,439
20396,bright,main,3,0.9937358815380601,314,88,4,406
20396,bright,main,4,0.9898389057448057,330,87,6,423
20396,bright,main,5,0.9875906971823843,339,79,2,420
20396,bright,main,6,0.9948015122686678,283,84,4,371
20396,bright,main,7,0.9857291538153786,288,88,1,377
20396,bright,main,8,0.9963677319178459,307,117,4,428
20396,bright,main,9,0.9946640929263646,349,82,6,437
20786,bright,main,0,0.9938037783767107,329,111,5,445
20786,bright,main,1,0.9939281803147293,317,83,2,402
20786,bright,main,2,0.9961940466096182,319,106,3,428
20786,bright,main,3,0.993412958477863,309,83,6,398
20786,bright,main,4,0.9946183523991865,331,82,2,415
20786,bright,main,5,0.9908301772430745,309,102,4,415
20786,bright,main,6,0.9866752562373482,284,85,3,372
20786,bright,main,7,0.9885381206542961,293,76,7,376
20786,bright,main,8,0.9954531783917602,330,90,5,425
20786,bright,main,9,0.9946321100513704,340,89,4,433
20067,bright,main,0,0.9940566552810447,353,79,3,435
20067,bright,main,1,0.9915677908724482,304,97,6,407
20067,bright,main,2,0.9821385998475219,350,85,1,436
20067,bright,main,3,0.9940238894459338,297,91,5,393
20067,bright,main,4,0.9940719810718359,333,82,6,421
20067,bright,main,5,0.9934104316414215,354,64,3,421
20067,bright,main,6,0.985385134171748,294,74,4,372
20067,bright,main,7,0.989524654314028,293,79,5,377
20067,bright,main,8,0.9956209575908799,316,100,5,421
20067,bright,main,9,0.9930258472438689,331,90,6,427
20746,bright,main,0,0.993312776696508,379,64,1,444
20746,bright,main,1,0.9938080418445312,282,107,8,397
20746,bright,main,2,0.9905342683498792,364,72,1,437
20746,bright,main,3,0.9885501211696096,310,87,4,401
20746,bright,main,4,0.9947023682788433,339,72,4,415
20746,bright,main,5,0.9892022511370063,319,94,1,414
20746,bright,main,6,0.9932670423019566,288,76,3,367
20746,bright,main,7,0.9887283385425456,300,72,3,375
20746,bright,main,8,0.9902445319663309,351,68,7,426
20746,bright,main,9,0.9931174470726838,350,79,4,433
20031,bright,main,0,0.9945268580505595,327,109,4,440
20031,bright,main,1,0.9863729858541129,281,112,2,395
20031,bright,main,2,0.9876032143272038,302,131,6,439
20031,bright,main,3,0.9945181336927706,256,136,5,397
20031,bright,main,4,0.9953962003874071,311,97,3,411
20031,bright,main,5,0.9915227643148655,285,123,5,413
20031,bright,main,6,0.9920122235082599,259,104,3,366
20031,bright,main,7,0.9927454592659409,283,82,1,366
20031,bright,main,8,0.9951276680451115,340,84,3,427
20031,bright,main,9,0.9963957782740187,309,115,4,428
20032,bright,main,0,0.9912281021677688,347,92,4,443
20032,bright,main,1,0.9908754689451968,333,67,3,403
20032,bright,main,2,0.9914352094380965,322,111,4,437
20032,bright,main,3,0.9888268855897955,285,110,4,399
20032,bright,main,4,0.9858937349717599,318,96,5,419
20032,bright,main,5,0.9879065452570865,308,108,3,419
20032,bright,main,6,0.9908926827942889,293,80,1,374
20032,bright,main,7,0.9942024385375393,269,101,4,374
20032,bright,main,8,0.9901512939183731,329,90,6,425
20032,bright,main,9,0.995886309493301,309,116,7,432
2969,dark,main,0,0.994590963565358,323,18,58,399
2969,dark,main,1,0.9953507505933963,243,32,64,339
2969,dark,main,2,0.9900598068529985,302,23,64,389
2969,dark,main,3,0.9916831256758408,269,19,73,361
2969,dark,main,4,0.9946517177986677,251,32,79,362
2969,dark,main,5,0.9909490988814972,297,18,55,370
2969,dark,main,6,0.9915792136101799,257,28,40,325
2969,dark,main,7,0.9913350451934938,242,31,50,323
2969,dark,main,8,0.9889987783047502,269,21,57,347
2969,dark,main,9,0.9870940338784326,290,21,60,371
20033,bright,main,0,0.9913462263398889,355,88,7,450
20033,bright,main,1,0.9910161713956812,302,97,3,402
20033,bright,main,2,0.9929998434791575,340,100,2,442
20033,bright,main,3,0.9897245428534532,277,123,4,404
20033,bright,main,4,0.9908679305007584,295,114,3,412
20033,bright,main,5,0.9958694941041986,325,90,6,421
20033,bright,main,6,0.99631091859974,273,83,6,362
20033,bright,main,7,0.9935523506866087,276,89,5,370
20033,bright,main,8,0.9910974778546715,332,89,3,424
20033,bright,main,9,0.9935856070015385,360,75,2,437
20790,bright,main,0,0.9909756088764379,331,107,6,444
20790,bright,main,1,0.9924467118662735,320,78,4,402
20790,bright,main,2,0.9917076271477536,359,76,4,439
20790,bright,main,3,0.9848794304354984,317,79,2,398
20790,bright,main,4,0.9943865542443892,315,92,5,412
20790,bright,main,5,0.9939323658276651,331,79,3,413
20790,bright,main,6,0.9921008080783675,294,71,3,368
20790,bright,main,7,0.9894894698808003,295,78,1,374
20790,bright,main,8,0.9965439861829931,311,94,2,407
20790,bright,main,9,0.993730137347699,320,107,3,430
20030,bright,main,0,0.9919805818477428,368,70,2,440
20030,bright,main,1,0.9889656386196983,320,65,2,387
20030,bright,main,2,0.990713336175966,362,71,3,436
20030,bright,main,3,0.992317738230416,289,100,4,393
20030,bright,main,4,0.9921192777326784,321,80,3,404
20030,bright,main,5,0.9907080496923893,296,106,7,409
20030,bright,main,6,0.9895179340405149,289,78,1,368
20030,bright,main,7,0.9886697411125946,262,108,2,372
20030,bright,main,8,0.9908748348613641,330,90,2,422
20030,bright,main,9,0.9935125514232075,366,56,4,426
20747,bright,main,0,0.9944256140290246,320,123,4,447
20747,bright,main,1,0.9933174363515308,314,79,5,398
20747,bright,main,2,0.9926334043201771,360,71,2,433
20747,bright,main,3,0.9960169562981105,331,67,2,400
20747,bright,main,4,0.9928061839183718,337,75,3,415
20747,bright,main,5,0.9935634303090946,336,76,1,413
20747,bright,main,6,0.9887682356750473,271,97,1,369
20747,bright,main,7,0.993534679953425,321,53,2,376
20747,bright,main,8,0.9934435128828797,356,69,5,430
20747,bright,main,9,0.9891438355911724,337,86,5,428
20068,bright,main,0,0.9953568008814124,359,77,6,442
20068,bright,main,1,0.9904453854964119,322,79,5,406
20068,bright,main,2,0.9909173573784221,367,71,3,441
20068,bright,main,3,0.9909517218642778,307,87,3,397
20068,bright,main,4,0.9945500350508457,314,93,4,411
20068,bright,main,5,0.9958372053626251,340,69,5,414
20068,bright,main,6,0.9851256167611436,277,87,3,367
20068,bright,main,7,0.990717576173481,255,109,3,367
20068,bright,main,8,0.9921762015838467,322,103,5,430
20068,bright,main,9,0.992238307937925,369,60,3,432
2986,dark,main,0,0.9917427807459345,280,39,60,379
2986,dark,main,1,0.9750956656928812,113,23,30,166
2986,dark,main,2,0.9941544889434201,271,43,70,384
2986,dark,main,3,0.9902289345945225,259,31,66,356
2986,dark,main,4,0.9954122304723743,260,43,67,370
2986,dark,main,5,0.9898946634195751,277,22,58,357
2986,dark,main,6,0.9879273281863574,244,35,42,321
2986,dark,main,7,0.992284716103595,227,42,55,324
2986,dark,main,8,0.9880284504518105,262,43,53,358
2986,dark,main,9,0.984226667936049,254,43,54,351
22393,bright,main,0,0.987112186809443,279,157,4,440
22393,bright,main,1,0.9761211596353345,117,82,2,201
22393,bright,main,2,0.997089830589495,342,90,2,434
22393,bright,main,3,0.9948230733913809,327,78,3,408
22393,bright,main,4,0.9916847499011334,310,90,7,407
22393,bright,main,5,0.9869577951776864,265,140,5,410
22393,bright,main,6,0.9866421349597677,251,120,4,375
22393,bright,main,7,0.9942908147966113,255,123,0,378
22393,bright,main,8,0.9951942953286964,245,175,4,424
22393,bright,main,9,0.9926551879048353,255,166,5,426
20763,bright,main,0,0.9939577892100013,394,51,5,450
20763,bright,main,1,0.9754121482642344,174,23,3,200
20763,bright,main,2,0.995587102818211,330,102,7,439
20763,bright,main,3,0.9933740824382611,326,68,4,398
20763,bright,main,4,0.9889793966517364,329,81,6,416
20763,bright,main,5,0.9953579544572598,345,72,2,419
20763,bright,main,6,0.9948698285421587,306,65,3,374
20763,bright,main,7,0.9914415252265102,300,71,5,376
20763,bright,main,8,0.9952449253202088,364,68,0,432
20763,bright,main,9,0.9954806755742259,361,68,2,431
20258,bright,main,0,0.9943312167375792,358,87,3,448
20258,bright,main,1,0.988654032404666,151,45,0,196
20258,bright,main,2,0.9946023600043025,368,62,7,437
20258,bright,main,3,0.9904315285921218,356,40,3,399
20258,bright,main,4,0.9955498536252805,345,70,1,416
20258,bright,main,5,0.9920461024505143,343,72,5,420
20258,bright,main,6,0.9953602513466703,300,66,3,369
20258,bright,main,7,0.9937592440274681,282,84,4,370
20258,bright,main,8,0.9894198158413788,361,65,3,429
20258,bright,main,9,0.9909714063522892,366,65,3,434
20744,bright,main,0,0.991631317942566,335,106,5,446
20744,bright,main,1,0.9866680057211913,157,34,4,195
20744,bright,main,2,0.982994049072337,375,59,6,440
20744,bright,main,3,0.9919508246760658,320,73,5,398
20744,bright,main,4,0.9922615788812247,317,94,3,414
20744,bright,main,5,0.9899910434174465,320,93,2,415
20744,bright,main,6,0.9922374950534207,275,82,4,361
20744,bright,main,7,0.9888589334625498,302,67,1,370
20744,bright,main,8,0.9959646262018964,304,111,8,423
20744,bright,main,9,0.9913542771882883,336,91,2,429
20408,bright,main,0,0.9854285439251614,322,122,3,447
20408,bright,main,1,0.9897053759977612,142,52,1,195
20408,bright,main,2,0.9958175690845396,350,86,2,438
20408,bright,main,3,0.9958583135053238,286,111,5,402
20408,bright,main,4,0.9946855842179984,328,87,5,420
20408,bright,main,5,0.9886760468493206,322,97,4,423
20408,bright,main,6,0.9920619640827182,306,68,2,376
20408,bright,main,7,0.9906819826608243,297,77,3,377
20408,bright,main,8,0.9910091997019064,330,102,3,435
20408,bright,main,9,0.9960965973180945,288,147,3,438
2997,dark,main,0,0.9957648144690814,230,54,85,369
2997,dark,main,1,0.965210005507797,107,31,29,167
2997,dark,main,2,0.993210259630423,277,30,61,368
2997,dark,main,3,0.9856465292018785,236,51,54,341
2997,dark,main,4,0.9935923036118138,238,58,53,349
2997,dark,main,5,0.9891684769155934,222,63,57,342
2997,dark,main,6,0.9897990656476822,199,60,57,316
2997,dark,main,7,0.9941991449189698,199,57,68,324
2997,dark,main,8,0.9928337141185823,184,84,80,348
2997,dark,main,9,0.9879006596691803,210,71,86,367
20831,bright,main,0,0.9920164524819357,331,99,4,434
20831,bright,main,1,0.9876955728973795,156,41,1,198
20831,bright,main,2,0.9919245197337878,340,89,5,434
20831,bright,main,3,0.9919105318059114,313,94,3,410
20831,bright,main,4,0.9930393870655458,316,100,0,416
20831,bright,main,5,0.9890212556101566,298,118,3,419
20831,bright,main,6,0.9943546771138646,266,104,4,374
20831,bright,main,7,0.9950625240700668,294,80,2,376
20831,bright,main,8,0.9901923040374858,324,99,3,426
20831,bright,main,9,0.991227460368254,320,103,1,424
20247,bright,main,0,0.9939148340190942,357,83,2,442
20247,bright,main,1,0.9858787242423929,148,50,1,199
20247,bright,main,2,0.9898702979345466,329,110,1,440
20247,bright,main,3,0.9918340720970575,322,81,2,405
20247,bright,main,4,0.9901227084845259,312,94,4,410
20247,bright,main,5,0.9911798620849701,322,91,7,420
20247,bright,main,6,0.9933564070210785,259,104,5,368
20247,bright,main,7,0.9892073440466795,292,82,3,377
20247,bright,main,8,0.9930080119819075,319,106,2,427
20247,bright,main,9,0.9928176693869468,345,86,1,432
20409,bright,main,0,0.9940652236513841,356,93,1,450
20409,bright,main,1,0.9857814139682991,138,55,3,196
20409,bright,main,2,0.9872556118838817,351,87,1,439
20409,bright,main,3,0.9956216767743016,343,57,2,402
20409,bright,main,4,0.994199329054228,345,67,3,415
20409,bright,main,5,0.9944205958146906,355,62,4,421
20409,bright,main,6,0.9913697621300344,314,58,2,374
20409,bright,main,7,0.9902849945754112,302,70,4,376
20409,bright,main,8,0.9938065788667134,350,78,3,431
20409,bright,main,9,0.9917048406546953,333,106,2,441
20208,bright,main,0,0.9939770220965698,370,67,3,440
20208,bright,main,1,0.9856409697951043,175,22,2,199
20208,bright,main,2,0.9919452012670237,343,95,2,440
20208,bright,main,3,0.992969166146841,317,84,3,404
20208,bright,main,4,0.9941984047934102,310,93,3,406
20208,bright,main,5,0.9976799489210805,343,69,5,417
20208,bright,main,6,0.9945212749958299,286,78,5,369
20208,bright,main,7,0.9887590412027526,296,76,2,374
20208,bright,main,8,0.9903393050974489,376,54,2,432
20208,bright,main,9,0.989551506402723,381,55,4,440
20760,bright,main,0,0.9952122008712024,374,69,2,445
20760,bright,main,1,0.9720921755773593,156,33,7,196
20760,bright,main,2,0.9936603722505143,351,80,5,436
20760,bright,main,3,0.9974633886340368,337,66,3,406
20760,bright,main,4,0.9924650763323378,362,46,4,412
20760,bright,main,5,0.988706608116854,332,77,8,417
20760,bright,main,6,0.9835453148941079,291,76,3,370
20760,bright,main,7,0.992970612810298,308,66,1,375
20760,bright,main,8,0.9910914853625441,346,83,2,431
20760,bright,main,9,0.9957041136676481,373,61,2,436
20758,bright,main,0,0.990718864347453,370,75,3,448
20758,bright,main,1,0.9874673480841926,147,44,2,193
20758,bright,main,2,0.9951306445616165,352,82,3,437
20758,bright,main,3,0.9924613267291185,336,69,1,406
20758,bright,main,4,0.9927102855158371,343,73,1,417
20758,bright,main,5,0.9958353510394922,337,77,4,418
20758,bright,main,6,0.9959414593398735,274,88,4,366
20758,bright,main,7,0.9869997869721834,290,77,3,370
20758,bright,main,8,0.9918543288691445,357,61,6,424
20758,bright,main,9,0.9926754483564612,364,67,6,437
20853,bright,main,0,0.993776261475808,336,104,3,443
20853,bright,main,1,0.9802417129554698,138,60,1,199
20853,bright,main,2,0.990268668084685,303,128,9,440
20853,bright,main,3,0.9926734076904821,313,91,2,406
20853,bright,main,4,0.9923701648472901,297,114,4,415
20853,bright,main,5,0.9948003541392166,282,119,6,407
20853,bright,main,6,0.9867741905182542,266,96,3,365
20853,bright,main,7,0.9873960399971771,264,104,4,372
20853,bright,main,8,0.9900004581149641,292,133,5,430
20853,bright,main,9,0.9890529028632287,273,151,4,428
20901,bright,main,0,0.9930210476356595,375,66,2,443
20901,bright,main,1,0.9839428816048814,174,24,0,198
20901,bright,main,2,0.9922991270622074,352,78,10,440
20901,bright,main,3,0.992357489314332,303,100,3,406
20901,bright,main,4,0.9843631586154392,310,97,4,411
20901,bright,main,5,0.9949256096167894,312,101,4,417
20901,bright,main,6,0.9955292029579359,266,106,1,373
20901,bright,main,7,0.9920207468661506,287,82,5,374
20901,bright,main,8,0.9926174944480081,340,91,0,431
20901,bright,main,9,0.9892029997540209,362,73,4,439
2968,dark,main,0,0.9933972164466521,255,54,61,370
2968,dark,main,1,0.9693092896394835,104,22,27,153
2968,dark,main,2,0.9909344940945717,271,31,57,359
2968,dark,main,3,0.9926246224935183,231,66,46,343
2968,dark,main,4,0.9926393111130496,268,42,55,365
2968,dark,main,5,0.9855957074129224,275,41,63,379
2968,dark,main,6,0.9891117403372359,237,39,46,322
2968,dark,main,7,0.9891265447564946,251,38,38,327
2968,dark,main,8,0.9953491232304367,249,54,58,361
2968,dark,main,9,0.9949531733457926,253,38,68,359
20757,bright,main,0,0.9921011894622501,350,91,4,445
20757,bright,main,1,0.9807134544483715,166,33,1,200
20757,bright,main,2,0.9931766320924147,342,86,8,436
20757,bright,main,3,0.990684060263865,331,69,1,401
20757,bright,main,4,0.9950576693616873,332,78,4,414
20757,bright,main,5,0.9892104194725682,320,86,8,414
20757,bright,main,6,0.9975830849584615,302,62,3,367
20757,bright,main,7,0.993046961532752,294,77,4,375
20757,bright,main,8,0.9958202483389392,337,88,3,428
20757,bright,main,9,0.9929338121896255,346,72,7,425
20421,bright,main,0,0.9880434264890849,357,81,3,441
20421,bright,main,1,0.9900899181161803,157,40,3,200
20421,bright,main,2,0.9961632247781824,358,80,2,440
20421,bright,main,3,0.9895037956494728,331,68,2,401
20421,bright,main,4,0.9822066046852953,337,77,3,417
20421,bright,main,5,0.9868945837936333,339,82,0,421
20421,bright,main,6,0.9905758526345718,288,81,2,371
20421,bright,main,7,0.9881817970633571,302,71,3,376
20421,bright,main,8,0.9953230570029696,301,119,2,422
20421,bright,main,9,0.9916765606143013,310,122,3,435
21272,bright,main,0,0.9895337735463949,340,90,9,439
21272,bright,main,1,0.9838291628905457,158,34,5,197
21272,bright,main,2,0.9935893877987635,330,88,7,425
21272,bright,main,3,0.991879203592595,288,104,2,394
21272,bright,main,4,0.9926130623105316,305,102,3,410
21272,bright,main,5,0.9897125227651525,321,85,4,410
21272,bright,main,6,0.9870181720530484,277,80,4,361
21272,bright,main,7,0.9965519772244726,268,96,4,368
21272,bright,main,8,0.9902205830129764,320,96,2,418
21272,bright,main,9,0.9910695948424739,360,66,2,428
80979,bright,special,0,0.9913911941219823,346,85,4,435
80979,bright,special,1,0.9917858847191421,316,87,2,405
80979,bright,special,2,0.9901420874435513,325,109,1,435
80979,bright,special,3,0.9938516721743474,298,107,2,407
80979,bright,special,4,0.9973171464093084,344,67,2,413
80979,bright,special,5,0.9923668856454764,303,109,4,416
80979,bright,special,6,0.9863464604320169,281,93,2,376
80979,bright,special,7,0.9905886513024484,274,95,3,372
80979,bright,special,8,0.9906612526582389,300,127,3,430
80979,bright,special,9,0.9910198390872023,339,91,2,432
20878,bright,main,0,0.9912710684937658,339,101,4,444
20878,bright,main,1,0.9691182367735208,141,48,4,193
20878,bright,main,2,0.9920383633563844,367,67,3,437
20878,bright,main,3,0.9899698212860228,340,58,4,402
20878,bright,main,4,0.9882941904675699,353,52,4,409
20878,bright,main,5,0.9953878007878922,349,65,7,421
20878,bright,main,6,0.9877711330154834,275,85,6,366
20878,bright,main,7,0.9873521119434014,269,94,5,368
20878,bright,main,8,0.9940945113501451,310,105,3,418
20878,bright,main,9,0.9922050319129977,308,109,5,422
20010,bright,main,0,0.992581035484789,363,75,5,443
20010,bright,main,1,0.9926822903616194,153,38,1,192
20010,bright,main,2,0.9914327681408067,316,106,4,426
20010,bright,main,3,0.9876214621892103,334,63,5,402
20010,bright,main,4,0.9962574561120158,345,60,5,410
20010,bright,main,5,0.9907604317442138,338,71,5,414
20010,bright,main,6,0.9919763822330618,309,57,3,369
20010,bright,main,7,0.9858152331403597,258,95,5,358
20010,bright,main,8,0.9928741731325339,326,87,7,420
20010,bright,main,9,0.9952543489585277,358,66,3,427
20209,bright,main,0,0.9936451057502981,362,81,7,450
20209,bright,main,1,0.9766574092805884,144,52,0,196
20209,bright,main,2,0.9909749561160722,341,87,1,429
20209,bright,main,3,0.9873667465027643,305,88,3,396
20209,bright,main,4,0.9885711009645665,344,69,3,416
20209,bright,main,5,0.9945608913838179,332,75,7,414
20209,bright,main,6,0.9849760498041992,297,70,3,370
20209,bright,main,7,0.9922170697882856,287,83,3,373
20209,bright,main,8,0.9917467580373244,320,108,4,432
20209,bright,main,9,0.9894094545954492,367,65,3,435
20305,bright,main,0,0.9892658870469347,362,81,2,445
20305,bright,main,1,0.9898920747290021,152,45,1,198
20305,bright,main,2,0.9874633458248948,339,82,5,426
20305,bright,main,3,0.9933730387490999,302,105,1,408
20305,bright,main,4,0.9927790569562027,318,100,1,419
20305,bright,main,5,0.9915509799663187,327,93,2,422
20305,bright,main,6,0.9871253033987681,306,66,3,375
20305,bright,main,7,0.9902753446733878,233,141,3,377
20305,bright,main,8,0.9903245210191882,323,104,1,428
20305,bright,main,9,0.9940359806107026,331,95,9,435
1308,dark,main,0,0.9879839093601291,270,19,105,394
1308,dark,main,1,0.9875525881037717,112,13,45,170
1308,dark,main,2,0.9810628939771434,252,29,88,369
1308,dark,main,3,0.9949041064931802,229,32,92,353
1308,dark,main,4,0.9905638718085154,233,21,107,361
1308,dark,main,5,0.9889561204542127,233,39,87,359
1308,dark,main,6,0.9847921365337255,179,61,77,317
1308,dark,main,7,0.9866172585342862,237,31,74,342
1308,dark,main,8,0.9933485537956273,275,30,76,381
1308,dark,main,9,0.9929467749026586,249,30,94,373
1299,dark,main,0,0.9961953549006707,266,26,93,385
1299,dark,main,1,0.9845551621146599,116,21,37,174
1299,dark,main,2,0.9914010796238633,245,28,105,378
1299,dark,main,3,0.994321964986564,232,38,87,357
1299,dark,main,4,0.9943396730663366,240,36,81,357
1299,dark,main,5,0.9927928814861255,250,33,75,358
1299,dark,main,6,0.9898072807817337,229,22,65,316
1299,dark,main,7,0.9939975504040398,256,26,60,342
1299,dark,main,8,0.9905020377521453,257,37,86,380
1299,dark,main,9,0.9866991378792527,276,18,85,379
1311,dark,main,0,0.9881237921185121,260,23,110,393
1311,dark,main,1,0.9851967416934732,125,7,39,171
1311,dark,main,2,0.9910686963843244,266,21,86,373
1311,dark,main,3,0.9927721277278982,228,34,71,333
1311,dark,main,4,0.991553335375419,255,20,79,354
1311,dark,main,5,0.9937433341048645,254,20,83,357
1311,dark,main,6,0.9889687899194965,225,31,70,326
1311,dark,main,7,0.9892236426145963,222,24,79,325
1311,dark,main,8,0.9925441490231818,262,28,91,381
1311,dark,main,9,0.9891163236570618,270,23,91,384
1310,dark,main,0,0.9952537457728295,260,28,102,390
1310,dark,main,1,0.987123579362065,135,5,36,176
1310,dark,main,2,0.9896792008368179,260,24,83,367
1310,dark,main,3,0.9895091563113538,254,27,80,361
1310,dark,main,4,0.9920199432579182,251,22,83,356
1310,dark,main,5,0.9862128364161408,237,30,99,366
1310,dark,main,6,0.995820273789545,217,17,85,319
1310,dark,main,7,0.986885020464158,228,18,80,326
1310,dark,main,8,0.9909695248997731,266,19,95,380
1310,dark,main,9,0.9831211996329473,280,20,83,383
20301,bright,main,0,0.9950232278109483,331,110,3,444
20301,bright,main,1,0.9852638644723895,149,48,1,198
20301,bright,main,2,0.9941899409427964,316,113,3,432
20301,bright,main,3,0.9877317006876725,304,98,3,405
20301,bright,main,4,0.9894949190746478,299,116,3,418
20301,bright,main,5,0.9945904562248343,280,128,5,413
20301,bright,main,6,0.9889646605482117,297,71,1,369
20301,bright,main,7,0.9929535965302115,291,83,3,377
20301,bright,main,8,0.993628616112088,322,101,3,426
20301,bright,main,9,0.9961181862258757,333,97,7,437
1869,dark,main,0,0.9920039533407784,264,26,96,386
1869,dark,main,1,0.9826378884005983,116,19,33,168
1869,dark,main,2,0.9946911053372367,240,41,87,368
1869,dark,main,3,0.989873509281838,226,31,92,349
1869,dark,main,4,0.9864201773589818,250,13,88,351
1869,dark,main,5,0.9884656994071833,241,21,83,345
1869,dark,main,6,0.9896751975111904,244,17,62,323
1869,dark,main,7,0.9887097275106956,225,23,74,322
1869,dark,main,8,0.9867157568140345,257,25,82,364
1869,dark,main,9,0.9933972165775645,274,21,82,377
2988,dark,main,0,0.9914066316371648,327,18,47,392
2988,dark,main,1,0.994941362922672,134,7,23,164
2988,dark,main,2,0.9913204050530697,277,30,68,375
2988,dark,main,3,0.9851722219652924,285,20,47,352
2988,dark,main,4,0.9886296681399366,239,20,70,329
2988,dark,main,5,0.9915437709189685,252,24,80,356
2988,dark,main,6,0.9913104956264568,244,19,61,324
2988,dark,main,7,0.989896565888691,262,23,50,335
2988,dark,main,8,0.9910928624289529,293,25,59,377
2988,dark,main,9,0.9844776057155077,287,25,64,376
80981,bright,special,0,0.9863642128023236,204,46,1,251
80981,bright,special,1,0.9908873422273409,104,17,2,123
80981,bright,special,2,0.9854322824646885,174,41,5,220
80981,bright,special,3,0.9750433299801621,132,42,4,178
80981,bright,special,4,0.9768660985741169,111,43,1,155
80981,bright,special,5,0.9760826797207489,124,38,2,164
80981,bright,special,6,0.9790137445483348,115,36,0,151
80981,bright,special,7,0.9876810599143796,124,48,0,172
80981,bright,special,8,0.9820000744059382,132,38,1,171
80981,bright,special,9,0.9790733799902496,155,36,1,192
1010,dark,main,0,0.9888717824997755,301,14,90,405
1010,dark,main,1,0.9805737117015899,126,6,36,168
1010,dark,main,2,0.9916348941733767,266,15,101,382
1010,dark,main,3,0.9884623557834222,237,18,96,351
1010,dark,main,4,0.9882262122621468,223,32,101,356
1010,dark,main,5,0.994183296042153,269,18,73,360
1010,dark,main,6,0.9826660243945948,251,13,68,332
1010,dark,main,7,0.9922287387294935,234,11,80,325
1010,dark,main,8,0.9917337812412732,273,11,84,368
1010,dark,main,9,0.99033807367259,278,17,83,378
1548,dark,main,0,0.9924387484501943,281,15,104,400
1548,dark,main,1,0.9810059175065252,115,6,44,165
1548,dark,main,2,0.9910880299739525,266,13,102,381
1548,dark,main,3,0.9934615607690821,256,11,95,362
1548,dark,main,4,0.9888193174215304,273,15,83,371
1548,dark,main,5,0.9932877631651033,256,10,89,355
1548,dark,main,6,0.9901198035627208,225,18,81,324
1548,dark,main,7,0.9915215686854862,231,14,79,324
1548,dark,main,8,0.9921804323727472,270,16,92,378
1548,dark,main,9,0.9964877421065973,270,16,90,376
1842,dark,main,0,0.9914865408496321,261,29,106,396
1842,dark,main,1,0.9621674115088795,121,13,39,173
1842,dark,main,2,0.9922737492310574,240,35,97,372
1842,dark,main,3,0.9843014182412887,203,33,95,331
1842,dark,main,4,0.9885235953016177,221,35,86,342
1842,dark,main,5,0.9935723563511676,235,34,78,347
1842,dark,main,6,0.9941174885055679,210,25,75,310
1842,dark,main,7,0.9828631382878077,205,35,67,307
1842,dark,main,8,0.992729119592435,239,36,75,350
1842,dark,main,9,0.9920237505869316,250,27,84,361
1853,dark,main,0,0.992209916006451,276,18,90,384
1853,dark,main,1,0.9871204602128113,110,8,55,173
1853,dark,main,2,0.9942154970934816,244,16,113,373
1853,dark,main,3,0.992346410530586,248,24,89,361
1853,dark,main,4,0.9945798733829418,230,20,90,340
1853,dark,main,5,0.9888292621866595,229,36,92,357
1853,dark,main,6,0.989778747670545,226,19,74,319
1853,dark,main,7,0.9881673373993712,226,16,82,324
1853,dark,main,8,0.9857568223831819,255,21,82,358
1853,dark,main,9,0.9921427634166963,282,19,72,373
2977,dark,main,0,0.9949257451756536,297,33,48,378
2977,dark,main,1,0.9656517494453627,137,12,24,173
2977,dark,main,2,0.985928786041899,257,43,69,369
2977,dark,main,3,0.9904239977141062,246,45,68,359
2977,dark,main,4,0.9920381965912186,252,37,76,365
2977,dark,main,5,0.9932940814144929,273,33,58,364
2977,dark,main,6,0.9875924165485445,232,29,51,312
2977,dark,main,7,0.9906682501944688,221,40,51,312
2977,dark,main,8,0.9930620451734914,292,26,47,365
2977,dark,main,9,0.9845520961754892,270,45,53,368
20846,bright,main,0,0.9913197154509518,344,97,4,445
20846,bright,main,1,0.9890760699792729,155,43,0,198
20846,bright,main,2,0.9923134576272811,331,98,4,433
20846,bright,main,3,0.9936970282585406,294,111,0,405
20846,bright,main,4,0.9885536884941613,314,99,5,418
20846,bright,main,5,0.991545744477389,285,127,0,412
20846,bright,main,6,0.9919861490713079,262,107,4,373
20846,bright,main,7,0.9895807322422684,257,115,3,375
20846,bright,main,8,0.9915584765119838,299,127,6,432
20846,bright,main,9,0.9913147337788073,347,83,3,433
2996,dark,main,0,0.9934521454151555,214,79,73,366
2996,dark,main,1,0.9864502495745139,127,20,28,175
2996,dark,main,2,0.9472766100529503,84,10,11,105
2996,dark,main,3,0.9892635804098617,250,45,59,354
2996,dark,main,4,0.986244145361156,248,39,70,357
2996,dark,main,5,0.9903240169678026,253,37,58,348
2996,dark,main,6,0.9932260920428337,209,56,47,312
2996,dark,main,7,0.9837165386556139,226,46,43,315
2996,dark,main,8,0.9889011629820722,221,49,69,339
2996,dark,main,9,0.9810121425179957,208,75,88,371
3440,dark,main,0,0.9976595398111688,276,41,68,385
3440,dark,main,1,0.9857739584113706,126,17,28,171
3440,dark,main,2,0.9932735454098559,277,40,60,377
3440,dark,main,3,0.9931003440012297,255,54,52,361
3440,dark,main,4,0.9916936024114321,252,27,52,331
3440,dark,main,5,0.9896646923972279,251,27,67,345
3440,dark,main,6,0.9873813217748905,209,39,73,321
3440,dark,main,7,0.991760953190788,223,36,64,323
3440,dark,main,8,0.9853323709116183,233,53,88,374
3440,dark,main,9,0.988829312786946,240,62,61,363
20419,bright,main,0,0.9961879154154923,342,103,2,447
20419,bright,main,1,0.98186034229442,167,29,1,197
20419,bright,main,2,0.9896135871505988,354,83,4,441
20419,bright,main,3,0.9889211462366165,319,84,4,407
20419,bright,main,4,0.9866685461421913,360,50,2,412
20419,bright,main,5,0.9914065563951262,343,78,2,423
20419,bright,main,6,0.9869666339964317,315,55,4,374
20419,bright,main,7,0.9910035909542856,309,65,3,377
20419,bright,main,8,0.9918564623604895,358,72,2,432
20419,bright,main,9,0.9903136230504719,357,79,4,440
20420,bright,main,0,0.9927173577587586,351,94,2,447
20420,bright,main,1,0.9628131755181102,158,36,2,196
20420,bright,main,2,0.991546131942554,371,70,2,443
20420,bright,main,3,0.9893556893687673,334,73,2,409
20420,bright,main,4,0.9960198533204951,358,59,2,419
20420,bright,main,5,0.9943100514749431,341,77,1,419
20420,bright,main,6,0.9913758434517883,307,61,4,372
20420,bright,main,7,0.9915287589748772,303,72,1,376
20420,bright,main,8,0.987831706455041,349,81,3,433
20420,bright,main,9,0.9968804196791164,318,111,2,431
20548,bright,main,0,0.9976454459588845,384,57,5,446
20548,bright,main,1,0.9855102445759361,158,32,3,193
20548,bright,main,2,0.993554868982788,328,89,6,423
20548,bright,main,3,0.9915736624898729,328,56,6,390
20548,bright,main,4,0.9930744056478124,356,48,6,410
20548,bright,main,5,0.9925393662485325,344,63,0,407
20548,bright,main,6,0.9926980794152578,291,63,2,356
20548,bright,main,7,0.9873517767860174,280,81,4,365
20548,bright,main,8,0.9890118146862731,333,83,5,421
20548,bright,main,9,0.9846583484759229,332,80,7,419
3393,dark,main,0,0.9935184785988075,290,37,60,387
3393,dark,main,1,0.9858520289022322,97,23,30,150
3393,dark,main,2,0.9903121896311331,210,62,71,343
3393,dark,main,3,0.992972925251263,206,61,72,339
3393,dark,main,4,0.9894656024401984,196,67,75,338
3393,dark,main,5,0.9938227252361856,204,55,73,332
3393,dark,main,6,0.9941944988751787,186,46,76,308
3393,dark,main,7,0.9924960441790359,225,35,59,319
3393,dark,main,8,0.9970009905213137,268,37,59,364
3393,dark,main,9,0.989753287890045,277,39,45,361
80980,bright,special,0,0.9852202583013635,255,45,5,305
80980,bright,special,1,0.9665570256576365,104,14,0,118
80980,bright,special,2,0.9889830327434506,173,44,0,217
80980,bright,special,3,0.9878303860675058,182,37,2,221
80980,bright,special,4,0.9843260455737544,186,46,3,235
80980,bright,special,5,0.9903675616170043,205,40,5,250
80980,bright,special,6,0.9774754183820046,123,47,2,172
80980,bright,special,7,0.9779780972161067,104,38,1,143
80980,bright,special,8,0.9715998873180985,141,52,0,193
80980,bright,special,9,0.9722761491544181,161,46,1,208
20924,bright,main,0,0.994815833814127,367,78,1,446
20924,bright,main,1,0.9775235625476294,164,33,1,198
20924,bright,main,2,0.9948127227402939,311,115,6,432
20924,bright,main,3,0.9940983785134413,324,77,3,404
20924,bright,main,4,0.9936094184572456,319,91,2,412
20924,bright,main,5,0.9956085755972667,338,82,2,422
20924,bright,main,6,0.9934297108948841,294,78,3,375
20924,bright,main,7,0.9939306766852527,318,53,2,373
20924,bright,main,8,0.9880066380692623,347,79,0,426
20924,bright,main,9,0.9929970917894659,362,70,6,438
20095,bright,main,0,0.9949015632752386,336,104,3,443
20095,bright,main,1,0.986503207108811,151,41,3,195
20095,bright,main,2,0.9920852479088011,337,97,2,436
20095,bright,main,3,0.990140857050286,308,88,7,403
20095,bright,main,4,0.9935278788228306,300,106,7,413
20095,bright,main,5,0.992757148849022,325,85,8,418
20095,bright,main,6,0.9939166915762647,290,71,8,369
20095,bright,main,7,0.9910126848001001,287,79,4,370
20095,bright,main,8,0.9900683436451635,328,83,5,416
20095,bright,main,9,0.9969071237180055,350,73,5,428
20206,bright,main,0,0.9918133036819756,351,96,1,448
20206,bright,main,1,0.9816013076114114,159,37,0,196
20206,bright,main,2,0.9924547345227684,357,77,5,439
20206,bright,main,3,0.9877216311083259,326,71,5,402
20206,bright,main,4,0.9942628304357181,322,85,5,412
20206,bright,main,5,0.9886993821943401,323,87,6,416
20206,bright,main,6,0.9894969236606139,278,82,7,367
20206,bright,main,7,0.99140600200794,312,60,1,373
20206,bright,main,8,0.9946051069934397,349,75,3,427
20206,bright,main,9,0.9978208294293633,351,79,3,433
20761,bright,main,0,0.9934946374073836,390,55,3,448
20761,bright,main,1,0.9795529246237409,153,44,2,199
20761,bright,main,2,0.9904130401684493,360,79,1,440
20761,bright,main,3,0.987892585711004,303,95,3,401
20761,bright,main,4,0.9895142802786608,324,89,1,414
20761,bright,main,5,0.9896569645165585,315,100,1,416
20761,bright,main,6,0.9930866611500433,289,70,3,362
20761,bright,main,7,0.9898958455993693,286,79,4,369
20761,bright,main,8,0.990649895202987,345,72,5,422
20761,bright,main,9,0.9900772131786552,321,100,7,428
20762,bright,main,0,0.993178304989919,338,95,6,439
20762,bright,main,1,0.9842755232333528,152,45,1,198
20762,bright,main,2,0.995039853050476,356,84,3,443
20762,bright,main,3,0.9883779096595972,309,87,3,399
20762,bright,main,4,0.9916824469854533,331,82,3,416
20762,bright,main,5,0.9843180255453734,240,176,2,418
20762,bright,main,6,0.9927928880878923,278,87,3,368
20762,bright,main,7,0.989435614465702,292,82,1,375
20762,bright,main,8,0.9830514061412119,331,97,3,431
20762,bright,main,9,0.9892948337822978,338,98,2,438
80978,bright,special,0,0.9920178047134702,307,86,3,396
80978,bright,special,1,0.9888974394113019,298,71,6,375
80978,bright,special,2,0.9925698078056465,323,64,3,390
80978,bright,special,3,0.9930988736136344,328,50,0,378
80978,bright,special,4,0.9957246446742092,337,48,2,387
80978,bright,special,5,0.9922529593083366,314,69,2,385
80978,bright,special,6,0.9874630785480882,292,52,4,348
80978,bright,special,7,0.9905317595029403,272,60,3,335
80978,bright,special,8,0.9934975989861227,350,57,2,409
80978,bright,special,9,0.9944019105921801,328,66,3,397
