TILEID,PROGRAM,SURVEY,PETALID,H,N_GAL,N_STAR,N_QSO,N_GOOD_Z
1,dark,sv3,0,0.9448518572574921,274,14,81,369
1,dark,sv3,1,0.9492063559428078,249,11,69,329
1,dark,sv3,2,0.9607638160458797,256,14,86,356
1,dark,sv3,3,0.9630385382320449,222,13,85,320
1,dark,sv3,4,0.970563099124683,230,19,85,334
1,dark,sv3,5,0.972262857209204,249,15,97,361
1,dark,sv3,6,0.9501670417603361,215,15,85,315
1,dark,sv3,7,0.9501670417603361,215,15,85,315
1,dark,sv3,8,0.968849690970978,243,10,94,347
1,dark,sv3,9,0.9576138347790567,260,12,87,359
2,dark,sv3,0,0.9427420674477562,294,13,66,373
2,dark,sv3,1,0.9167861917158745,254,11,51,316
2,dark,sv3,2,0.9427852351646824,267,12,65,344
2,dark,sv3,3,0.9669329056395206,234,15,65,314
2,dark,sv3,4,0.9515687550408007,264,12,62,338
2,dark,sv3,5,0.9409361531381041,277,10,69,356
2,dark,sv3,6,0.9274070343066866,217,11,75,303
2,dark,sv3,7,0.9311179475817374,218,12,58,288
2,dark,sv3,8,0.9557547014598184,276,12,57,345
2,dark,sv3,9,0.9387627982243579,269,11,65,345
3,dark,sv3,0,0.9577579741172954,274,12,61,347
3,dark,sv3,1,0.9620313515755727,273,10,43,326
3,dark,sv3,2,0.9576370094590665,286,10,59,355
3,dark,sv3,3,0.9603509123650165,246,9,47,302
3,dark,sv3,4,0.9461507827328794,238,10,57,305
3,dark,sv3,5,0.9673466835979682,260,10,70,340
3,dark,sv3,6,0.9844265025993805,235,9,49,293
3,dark,sv3,7,0.9262849600092683,199,7,59,265
3,dark,sv3,8,0.9688358758475281,256,12,53,321
3,dark,sv3,9,0.9582827512897658,263,12,55,330
4,dark,sv3,0,0.9725239139270346,303,7,57,367
4,dark,sv3,1,0.926509334970846,258,11,57,326
4,dark,sv3,2,0.9649196963655208,292,9,60,361
4,dark,sv3,3,0.936766114701503,246,10,53,309
4,dark,sv3,4,0.9560033041106065,254,10,58,322
4,dark,sv3,5,0.9564211498405454,293,8,60,361
4,dark,sv3,6,0.9381540966558459,227,10,51,288
4,dark,sv3,7,0.9496727236036008,231,9,47,287
4,dark,sv3,8,0.9305010050213496,271,10,60,341
4,dark,sv3,9,0.9788242306290682,293,11,53,357
5,dark,sv3,0,0.9568351376612687,277,12,45,334
5,dark,sv3,1,0.9358321272744787,245,13,35,293
5,dark,sv3,2,0.9507573864356832,270,11,42,323
5,dark,sv3,3,0.9663689520352258,259,9,33,301
5,dark,sv3,4,0.931776640630031,264,10,44,318
5,dark,sv3,5,0.9449837008644378,293,8,49,350
5,dark,sv3,6,0.9399091728993264,234,11,43,288
5,dark,sv3,7,0.9464751609781937,219,7,42,268
5,dark,sv3,8,0.9419324780833285,285,12,50,347
5,dark,sv3,9,0.9510631932054893,270,9,45,324
6,dark,sv3,0,0.9469038776642126,271,12,35,318
6,dark,sv3,1,0.9618625342919278,261,16,30,307
6,dark,sv3,2,0.9490680844239449,285,15,25,325
6,dark,sv3,3,0.955697491869339,252,14,29,295
6,dark,sv3,4,0.947364684599355,266,13,39,318
6,dark,sv3,5,0.95396170548027,277,11,44,332
6,dark,sv3,6,0.9514667500522561,248,10,37,295
6,dark,sv3,7,0.9631626972564017,242,12,38,292
6,dark,sv3,8,0.9623472699203114,283,10,34,327
6,dark,sv3,9,0.9551208338633972,272,12,35,319
7,dark,sv3,0,0.9711181997180395,285,10,20,315
7,dark,sv3,1,0.8999309466086225,193,7,18,218
7,dark,sv3,2,0.9674313423385722,295,12,25,332
7,dark,sv3,3,0.9613610881646855,240,12,32,284
7,dark,sv3,4,0.9304913268231778,258,12,28,298
7,dark,sv3,5,0.9434594428052682,275,9,26,310
7,dark,sv3,6,0.9568509980927703,241,11,26,278
7,dark,sv3,7,0.9236750881020133,154,6,21,181
7,dark,sv3,8,0.9110172525793705,250,14,21,285
7,dark,sv3,9,0.9211045401949054,190,10,18,218
8,dark,sv3,0,0.9683838070832957,288,15,25,328
8,dark,sv3,1,0.9513305311353053,249,14,23,286
8,dark,sv3,2,0.9318641534554127,267,15,23,305
8,dark,sv3,3,0.9655517376994723,257,17,13,287
8,dark,sv3,4,0.9641365279131131,267,10,21,298
8,dark,sv3,5,0.9503854722768151,277,15,27,319
8,dark,sv3,6,0.9565616965620944,249,12,20,281
8,dark,sv3,7,0.9300811822233832,221,10,23,254
8,dark,sv3,8,0.952379290899426,281,16,20,317
8,dark,sv3,9,0.9153621732252872,270,12,22,304
9,dark,sv3,0,0.9717141433752184,298,14,15,327
9,dark,sv3,1,0.9259723609789869,252,15,14,281
9,dark,sv3,2,0.9568805872777042,270,17,15,302
9,dark,sv3,3,0.9460150027209521,234,12,16,262
9,dark,sv3,4,0.9193311468320967,268,15,16,299
9,dark,sv3,5,0.9268577811161102,244,17,29,290
9,dark,sv3,6,0.9401822616587864,221,10,33,264
9,dark,sv3,7,0.9113224134711773,218,9,24,251
9,dark,sv3,8,0.9441988960536899,276,11,17,304
9,dark,sv3,9,0.943469928828646,282,15,15,312
10,dark,sv3,0,0.9665320056731161,279,15,22,316
10,dark,sv3,1,0.9318112485566428,242,17,26,285
10,dark,sv3,2,0.9545343607280835,282,15,25,322
10,dark,sv3,3,0.9564800447983636,248,16,18,282
10,dark,sv3,4,0.9300696285659983,236,11,22,269
10,dark,sv3,5,0.8820276627036133,143,3,6,152
10,dark,sv3,6,0.9302681852978113,243,9,12,264
10,dark,sv3,7,0.9209073034695116,217,12,10,239
10,dark,sv3,8,0.9606377198621959,258,11,19,288
10,dark,sv3,9,0.9321304247913458,263,12,15,290
11,dark,sv3,0,0.9512924877625347,302,16,14,332
11,dark,sv3,1,0.9345566704047433,257,19,15,291
11,dark,sv3,2,0.96631587549477,281,24,18,323
11,dark,sv3,3,0.9415388575168425,244,13,14,271
11,dark,sv3,4,0.9698136169037835,264,15,18,297
11,dark,sv3,5,0.9441287996110365,261,11,22,294
11,dark,sv3,6,0.9526283410022517,244,11,19,274
11,dark,sv3,7,0.9452117374927327,208,12,22,242
11,dark,sv3,8,0.9449823538521818,262,9,17,288
11,dark,sv3,9,0.9275202064094233,279,14,13,306
12,bright,sv3,0,0.9679295721426323,363,41,1,405
12,bright,sv3,1,0.9681904218991503,306,46,5,357
12,bright,sv3,2,0.9616775846976403,331,52,5,388
12,bright,sv3,3,0.9633986137902885,301,46,4,351
12,bright,sv3,4,0.9614749921692435,320,45,4,369
12,bright,sv3,5,0.9041177629497897,366,19,6,391
12,bright,sv3,6,0.9538427961152557,283,40,4,327
12,bright,sv3,7,0.8959073985211233,279,26,2,307
12,bright,sv3,8,0.9594831350628105,316,64,4,384
12,bright,sv3,9,0.9568044064246367,302,87,5,394
13,bright,sv3,0,0.9657101103614856,293,100,2,395
13,bright,sv3,1,0.9631090017109019,274,85,1,360
13,bright,sv3,2,0.9362758934691154,293,100,4,397
13,bright,sv3,3,0.9397024979765604,228,103,2,333
13,bright,sv3,4,0.956397491556341,288,71,4,363
13,bright,sv3,5,0.9621922563472075,311,69,7,387
13,bright,sv3,6,0.9415574245719555,251,73,1,325
13,bright,sv3,7,0.9108019156565997,214,80,2,296
13,bright,sv3,8,0.9312277616078718,240,133,3,376
13,bright,sv3,9,0.966740864073641,278,104,5,387
14,bright,sv3,0,0.9634784176013012,203,158,3,364
14,bright,sv3,1,0.9400003806566035,224,112,5,341
14,bright,sv3,2,0.973107341072565,225,154,3,382
14,bright,sv3,3,0.9315319445304401,211,111,4,326
14,bright,sv3,4,0.9681184863933938,225,126,3,354
14,bright,sv3,5,0.9461635355084353,262,114,2,378
14,bright,sv3,6,0.9388844201820833,203,121,3,327
14,bright,sv3,7,0.9541755486753106,191,84,5,280
14,bright,sv3,8,0.9656133055099636,205,138,2,345
14,bright,sv3,9,0.949464635556849,166,168,1,335
15,bright,sv3,0,0.9393547657915298,174,165,1,340
15,bright,sv3,1,0.9574132192156675,170,145,1,316
15,bright,sv3,2,0.9611825809849134,177,159,2,338
15,bright,sv3,3,0.9462306843855585,147,140,2,289
15,bright,sv3,4,0.9675979793415729,172,148,1,321
15,bright,sv3,5,0.9661931966891705,208,145,3,356
15,bright,sv3,6,0.9585418947906755,129,141,1,271
15,bright,sv3,7,0.9351448095533763,170,102,1,273
15,bright,sv3,8,0.947251418110444,124,171,1,296
15,bright,sv3,9,0.9588250260136464,131,158,1,290
16,bright,sv3,0,0.9294711596130457,138,154,3,295
16,bright,sv3,1,0.9576182501073373,139,135,1,275
16,bright,sv3,2,0.9318264345885411,94,170,2,266
16,bright,sv3,3,0.9361021044571447,98,145,1,244
16,bright,sv3,4,0.9607617393881457,107,169,2,278
16,bright,sv3,5,0.9197414383523961,116,151,5,272
16,bright,sv3,6,0.9419857295297974,114,135,3,252
16,bright,sv3,7,0.9375210892561908,109,137,1,247
16,bright,sv3,8,0.9618732148251037,101,160,3,264
16,bright,sv3,9,0.9424211577607311,87,153,1,241
17,bright,sv3,0,0.9493377404401037,190,187,5,382
17,bright,sv3,1,0.9535547066316162,146,198,9,353
17,bright,sv3,2,0.9523804773999748,163,211,2,376
17,bright,sv3,3,0.9605421978603029,155,173,4,332
17,bright,sv3,4,0.9680641535549444,194,162,1,357
17,bright,sv3,5,0.9551414241955105,186,185,7,378
17,bright,sv3,6,0.9370898136597607,135,179,3,317
17,bright,sv3,7,0.9376394288956491,144,140,6,290
17,bright,sv3,8,0.9686588063464554,153,205,4,362
17,bright,sv3,9,0.9451064703249059,135,238,2,375
18,bright,sv3,0,0.9652557474626285,161,207,3,371
18,bright,sv3,1,0.9501027249333698,150,185,3,338
18,bright,sv3,2,0.9360302752984018,171,210,1,382
18,bright,sv3,3,0.9630983669185358,164,169,4,337
18,bright,sv3,4,0.9651904473812449,171,173,3,347
18,bright,sv3,5,0.9461720482155054,193,175,3,371
18,bright,sv3,6,0.9571774600891622,156,162,4,322
18,bright,sv3,7,0.9490226849799375,112,157,2,271
18,bright,sv3,8,0.9526261084235181,135,207,3,345
18,bright,sv3,9,0.9698710880150653,148,205,3,356
19,bright,sv3,0,0.9583645332326338,162,161,3,326
19,bright,sv3,1,0.9513271371820844,176,167,1,344
19,bright,sv3,2,0.9683402609945782,168,198,4,370
19,bright,sv3,3,0.9413627942463466,141,180,1,322
19,bright,sv3,4,0.9338715997563355,173,166,2,341
19,bright,sv3,5,0.9518174742277051,176,179,3,358
19,bright,sv3,6,0.9508059527603581,155,156,2,313
19,bright,sv3,7,0.9724222107366282,121,157,0,278
19,bright,sv3,8,0.9592508990492915,159,186,4,349
19,bright,sv3,9,0.9519068491631155,156,200,5,361
20,bright,sv3,0,0.9745468000691438,193,180,5,378
20,bright,sv3,1,0.9439650147362035,157,173,2,332
20,bright,sv3,2,0.9645211278997975,179,189,3,371
20,bright,sv3,3,0.9547225306730167,152,172,3,327
20,bright,sv3,4,0.9275385173307353,164,180,3,347
20,bright,sv3,5,0.9342730460152453,192,169,3,364
20,bright,sv3,6,0.9626618345317496,133,183,2,318
20,bright,sv3,7,0.9273865326850735,147,124,1,272
20,bright,sv3,8,0.9571381090946055,159,185,3,347
20,bright,sv3,9,0.9397017084987122,151,209,2,362
21,bright,sv3,0,0.9635471557254046,185,181,4,370
21,bright,sv3,1,0.9224028785192152,156,180,2,338
21,bright,sv3,2,0.9656909655971431,195,175,2,372
21,bright,sv3,3,0.9713843717677042,166,150,1,317
21,bright,sv3,4,0.9692795899236133,183,160,3,346
21,bright,sv3,5,0.8772300630500438,94,72,5,171
21,bright,sv3,6,0.9446054506711745,143,156,3,302
21,bright,sv3,7,0.9591893838646915,131,144,1,276
21,bright,sv3,8,0.9684638480702887,152,184,3,339
21,bright,sv3,9,0.9694877103670511,180,164,2,346
23,backup,sv3,0,0.9560525646340594,5,343,1,349
23,backup,sv3,1,0.9568801818741477,5,311,0,316
23,backup,sv3,2,0.9745745205838411,2,336,0,338
23,backup,sv3,3,0.9419789470753246,1,289,1,291
23,backup,sv3,4,0.965476169337366,7,289,1,297
23,backup,sv3,5,0.9593487071359094,3,336,1,340
23,backup,sv3,6,0.9127808043864024,7,287,1,295
23,backup,sv3,7,0.9270200570102738,3,244,1,248
23,backup,sv3,8,0.9512193447573702,3,343,0,346
23,backup,sv3,9,0.9534564531242987,3,324,0,327
24,backup,sv3,0,0.9490346284400362,7,281,2,290
24,backup,sv3,1,0.9318264345885411,5,259,0,264
24,backup,sv3,2,0.94052954184551,4,256,1,261
24,backup,sv3,3,0.8898626444885724,3,193,0,196
24,backup,sv3,4,0.9050383459410858,4,220,0,224
24,backup,sv3,5,0.9123848312639968,7,206,0,213
24,backup,sv3,6,0.8946243799084386,3,228,1,232
24,backup,sv3,7,0.9297021907939819,5,224,0,229
24,backup,sv3,8,0.9585418947906758,2,267,1,270
24,backup,sv3,9,0.9415928194788519,5,286,0,291
28,dark,sv3,0,0.9545221912995693,262,13,93,368
28,dark,sv3,1,0.965795185843029,219,9,70,298
28,dark,sv3,2,0.9507462760508052,263,16,80,359
28,dark,sv3,3,0.9502039100551612,249,10,59,318
28,dark,sv3,4,0.964116248206004,225,13,82,320
28,dark,sv3,5,0.9636910915812066,240,14,84,338
28,dark,sv3,6,0.9817520273869509,204,12,84,300
28,dark,sv3,7,0.920783243686325,199,12,66,277
28,dark,sv3,8,0.9440278004121474,240,12,76,328
28,dark,sv3,9,0.976234796957124,253,12,83,348
29,dark,sv3,0,0.9520894719775739,278,14,75,367
29,dark,sv3,1,0.9687352469189976,258,14,60,332
29,dark,sv3,2,0.9525600113067545,282,11,66,359
29,dark,sv3,3,0.9699688261840906,260,12,44,316
29,dark,sv3,4,0.9557867692723012,251,13,63,327
29,dark,sv3,5,0.9580445958584936,267,11,58,336
29,dark,sv3,6,0.8876366082553443,214,12,75,301
29,dark,sv3,7,0.9349038078227093,214,9,49,272
29,dark,sv3,8,0.9647479920137689,271,10,68,349
29,dark,sv3,9,0.9688467392702979,271,12,70,353
30,dark,sv3,0,0.9481436763532997,276,10,76,362
30,dark,sv3,1,0.9515319102287788,242,11,56,309
30,dark,sv3,2,0.9623610563728158,279,13,58,350
30,dark,sv3,3,0.9554357200399359,253,10,40,303
30,dark,sv3,4,0.9607237311932079,268,10,60,338
30,dark,sv3,5,0.9554066126061546,284,12,57,353
30,dark,sv3,6,0.9406102364537338,227,11,59,297
30,dark,sv3,7,0.9552129989989624,207,12,54,273
30,dark,sv3,8,0.9850637191282272,256,11,68,335
30,dark,sv3,9,0.9500558937013107,277,12,60,349
31,dark,sv3,0,0.9606708617052715,285,9,60,354
31,dark,sv3,1,0.9605632009729986,269,10,43,322
31,dark,sv3,2,0.93790961756093,291,10,46,347
31,dark,sv3,3,0.9492453567920615,261,10,35,306
31,dark,sv3,4,0.9523044549708862,266,10,51,327
31,dark,sv3,5,0.949481385794982,288,9,46,343
31,dark,sv3,6,0.9433692366659494,215,12,58,285
31,dark,sv3,7,0.9536040642425114,212,11,43,266
31,dark,sv3,8,0.957689531700088,276,12,52,340
31,dark,sv3,9,0.9391586272359816,275,10,52,337
32,dark,sv3,0,0.9502234757921696,292,9,54,355
32,dark,sv3,1,0.9455335677780766,262,11,45,318
32,dark,sv3,2,0.9598023335974429,283,10,51,344
32,dark,sv3,3,0.9397661437078023,278,8,22,308
32,dark,sv3,4,0.9552252093262451,260,10,40,310
32,dark,sv3,5,0.9472118708210274,278,9,38,325
32,dark,sv3,6,0.9104439379161791,229,9,42,280
32,dark,sv3,7,0.9644513228563611,206,11,44,261
32,dark,sv3,8,0.9627073076291366,246,10,50,306
32,dark,sv3,9,0.9423691881228696,269,10,44,323
33,dark,sv3,0,0.9242466301537331,309,11,33,353
33,dark,sv3,1,0.9248867817452966,276,10,34,320
33,dark,sv3,2,0.9564421676069402,296,14,33,343
33,dark,sv3,3,0.9304913268231783,263,10,26,299
33,dark,sv3,4,0.9439898481909965,260,10,45,315
33,dark,sv3,5,0.9564392006128822,287,9,24,320
33,dark,sv3,6,0.9267154847319893,234,12,41,287
33,dark,sv3,7,0.9623724542253206,222,10,32,264
33,dark,sv3,8,0.9430389890594292,258,10,29,297
33,dark,sv3,9,0.9418699493479712,281,9,26,316
34,dark,sv3,0,0.9596010144373237,295,10,17,322
34,dark,sv3,1,0.9582382455532003,257,10,31,298
34,dark,sv3,2,0.9434963823613074,273,11,20,304
34,dark,sv3,3,0.933270619983751,203,7,17,227
34,dark,sv3,4,0.9443030242159716,261,12,29,302
34,dark,sv3,5,0.9544055226183199,272,9,26,307
34,dark,sv3,6,0.8718766260236226,232,12,26,270
34,dark,sv3,7,0.9643511275479931,231,8,20,259
34,dark,sv3,8,0.9619863405967666,285,15,18,318
34,dark,sv3,9,0.9048264556022018,265,13,19,297
35,dark,sv3,0,0.9530508211116224,299,12,16,327
35,dark,sv3,1,0.9481540368753676,263,14,17,294
35,dark,sv3,2,0.9140575042373819,270,12,19,301
35,dark,sv3,3,0.9524904323509356,238,12,11,261
35,dark,sv3,4,0.958211878311098,244,12,12,268
35,dark,sv3,5,0.9344253744425699,256,14,23,293
35,dark,sv3,6,0.9017112166088374,213,12,19,244
35,dark,sv3,7,0.9225071252298526,206,15,14,235
35,dark,sv3,8,0.9326319981322728,210,17,19,246
35,dark,sv3,9,0.9619834049547458,247,14,25,286
36,dark,sv3,0,0.9598767244076034,295,16,12,323
36,dark,sv3,1,0.936466786877576,266,16,14,296
36,dark,sv3,2,0.960193976938421,292,17,17,326
36,dark,sv3,3,0.9673249657119544,281,12,23,316
36,dark,sv3,4,0.976490118176735,273,12,24,309
36,dark,sv3,5,0.9571232714672373,298,14,13,325
36,dark,sv3,6,0.9065064082044647,223,9,14,246
36,dark,sv3,7,0.9603309439797717,251,14,23,288
36,dark,sv3,8,0.9603585115874829,298,14,19,331
36,dark,sv3,9,0.9557867692723014,289,13,23,325
37,dark,sv3,0,0.9510319141876553,306,11,23,340
37,dark,sv3,1,0.9431388278370855,279,16,12,307
37,dark,sv3,2,0.9315652162700252,301,14,21,336
37,dark,sv3,3,0.9602455626188732,294,14,17,325
37,dark,sv3,4,0.9313803914085365,278,13,26,317
37,dark,sv3,5,0.9659371794347028,305,11,20,336
37,dark,sv3,6,0.9615592636332372,255,11,12,278
37,dark,sv3,7,0.9558323390651228,254,16,15,285
37,dark,sv3,8,0.9412029610414351,309,11,18,338
37,dark,sv3,9,0.969406373221775,286,15,20,321
38,dark,sv3,0,0.964911407290814,305,16,15,336
38,dark,sv3,1,0.9428203388378016,272,14,19,305
38,dark,sv3,2,0.962701788386934,280,17,17,314
38,dark,sv3,3,0.9599186760068467,281,14,16,311
38,dark,sv3,4,0.958026381015426,273,18,16,307
38,dark,sv3,5,0.9462882697233613,269,13,12,294
38,dark,sv3,6,0.9131519544997023,242,13,14,269
38,dark,sv3,7,0.9581030435036932,244,14,20,278
38,dark,sv3,8,0.9532866122708155,313,18,22,353
38,dark,sv3,9,0.9413481047471108,281,16,27,324
39,bright,sv3,0,0.979295183593832,382,8,2,392
39,bright,sv3,1,0.9631297976310197,311,41,5,357
39,bright,sv3,2,0.9784029308521199,366,29,4,399
39,bright,sv3,3,0.9645821206778868,281,47,4,332
39,bright,sv3,4,0.9531070800231977,299,48,4,351
39,bright,sv3,5,0.9640982182500702,350,24,5,379
39,bright,sv3,6,0.9418138437433987,314,20,3,337
39,bright,sv3,7,0.9486519647964856,268,39,1,308
39,bright,sv3,8,0.9523901129332423,359,17,3,379
39,bright,sv3,9,0.9776343528875553,334,40,6,380
40,bright,sv3,0,0.9716826957520562,345,52,3,400
40,bright,sv3,1,0.9752432470485318,291,64,1,356
40,bright,sv3,2,0.9527428812364578,322,59,3,384
40,bright,sv3,3,0.9653554816766419,237,84,5,326
40,bright,sv3,4,0.9334929861388305,247,94,1,342
40,bright,sv3,5,0.971114532056152,292,73,7,372
40,bright,sv3,6,0.9311466116443103,260,50,0,310
40,bright,sv3,7,0.9094178857613787,222,58,5,285
40,bright,sv3,8,0.9390837264065698,275,54,3,332
40,bright,sv3,9,0.953101990682883,306,82,3,391
41,bright,sv3,0,0.940140180883548,267,110,1,378
41,bright,sv3,1,0.9614096114386281,227,97,4,328
41,bright,sv3,2,0.9572817515363478,270,81,4,355
41,bright,sv3,3,0.9350047138173081,166,114,0,280
41,bright,sv3,4,0.957077282079426,186,120,5,311
41,bright,sv3,5,0.9728998252664111,254,99,5,358
41,bright,sv3,6,0.9497552140393097,225,93,0,318
41,bright,sv3,7,0.9333096338870555,189,80,2,271
41,bright,sv3,8,0.9557475880711739,295,78,6,379
41,bright,sv3,9,0.9528182583448999,249,103,5,357
42,bright,sv3,0,0.9353701880525539,234,128,1,363
42,bright,sv3,1,0.9632417482913305,199,110,4,313
42,bright,sv3,2,0.9524723265039526,197,127,7,331
42,bright,sv3,3,0.9478837096491608,137,112,2,251
42,bright,sv3,4,0.9365688269756723,160,128,1,289
42,bright,sv3,5,0.9790962085679427,197,120,4,321
42,bright,sv3,6,0.956075767676345,162,92,3,257
42,bright,sv3,7,0.934901481725936,156,104,1,261
42,bright,sv3,8,0.9663746989787327,249,88,5,342
42,bright,sv3,9,0.9452538614687384,170,147,2,319
43,bright,sv3,0,0.9521745469073213,190,128,4,322
43,bright,sv3,1,0.9590090281048556,142,137,5,284
43,bright,sv3,2,0.9088333166668102,164,124,5,293
43,bright,sv3,3,0.9414081562071194,89,123,2,214
43,bright,sv3,4,0.9530207566952401,98,124,5,227
43,bright,sv3,5,0.9553277967368371,152,126,4,282
43,bright,sv3,6,0.9112554940211558,122,102,1,225
43,bright,sv3,7,0.9475353023921768,146,98,1,245
43,bright,sv3,8,0.9393942138341486,184,135,4,323
43,bright,sv3,9,0.9294506389249143,147,138,2,287
44,bright,sv3,0,0.9752723489425354,212,176,3,391
44,bright,sv3,1,0.9536772639023476,177,155,3,335
44,bright,sv3,2,0.9512363831894635,192,184,5,381
44,bright,sv3,3,0.9182662950131362,152,164,2,318
44,bright,sv3,4,0.9613771245506323,166,170,0,336
44,bright,sv3,5,0.9714504824830709,208,159,5,372
44,bright,sv3,6,0.9558646524442552,183,125,1,309
44,bright,sv3,7,0.942448978334873,153,123,2,278
44,bright,sv3,8,0.9413873583377702,221,140,5,366
44,bright,sv3,9,0.9601433259196678,170,187,3,360
45,bright,sv3,0,0.9727241093759647,199,191,2,392
45,bright,sv3,1,0.943173343491347,186,155,2,343
45,bright,sv3,2,0.9664892745165358,206,169,4,379
45,bright,sv3,3,0.9676617198689722,161,161,1,323
45,bright,sv3,4,0.9567848101681451,178,151,4,333
45,bright,sv3,5,0.9587426637075568,188,169,0,357
45,bright,sv3,6,0.979487225217564,168,143,4,315
45,bright,sv3,7,0.9198776525557456,137,133,2,272
45,bright,sv3,8,0.9641881054232346,185,166,4,355
45,bright,sv3,9,0.9716848232710147,175,179,4,358
46,bright,sv3,0,0.9687356908981826,233,147,3,383
46,bright,sv3,1,0.9646489845480176,176,158,4,338
46,bright,sv3,2,0.9551103068848212,221,149,9,379
46,bright,sv3,3,0.962530275452044,149,158,4,311
46,bright,sv3,4,0.9366501166396887,170,166,3,339
46,bright,sv3,5,0.9414950647068422,200,159,3,362
46,bright,sv3,6,0.9419285203752159,174,132,1,307
46,bright,sv3,7,0.9462255085769481,152,124,0,276
46,bright,sv3,8,0.9420946194910502,186,164,3,353
46,bright,sv3,9,0.9797768133621239,174,175,2,351
47,bright,sv3,0,0.9587508762235911,192,131,1,324
47,bright,sv3,1,0.9480998795185617,176,159,8,343
47,bright,sv3,2,0.9586684031791142,227,153,4,384
47,bright,sv3,3,0.940473725780528,154,163,2,319
47,bright,sv3,4,0.9559270558768282,189,142,6,337
47,bright,sv3,5,0.953214874243101,197,163,5,365
47,bright,sv3,6,0.919711724414945,211,111,1,323
47,bright,sv3,7,0.9731411392827481,142,138,2,282
47,bright,sv3,8,0.9275066375764658,205,142,6,353
47,bright,sv3,9,0.9735479122856235,186,176,2,364
48,bright,sv3,0,0.9512203500271094,221,156,5,382
48,bright,sv3,1,0.9744244853728354,179,148,5,332
48,bright,sv3,2,0.961018380292119,233,143,6,382
48,bright,sv3,3,0.9235601460266958,185,132,2,319
48,bright,sv3,4,0.9576929761996178,166,165,3,334
48,bright,sv3,5,0.9690445662334624,195,168,3,366
48,bright,sv3,6,0.9399962466231515,193,115,4,312
48,bright,sv3,7,0.9367470626943721,161,125,3,289
48,bright,sv3,8,0.9720577706558462,215,141,5,361
48,bright,sv3,9,0.9577815657258965,187,168,2,357
49,bright,sv3,0,0.9640044519028359,238,142,2,382
49,bright,sv3,1,0.9574704630239862,186,151,2,339
49,bright,sv3,2,0.9547645576947488,237,144,3,384
49,bright,sv3,3,0.93364113270729,174,147,3,324
49,bright,sv3,4,0.9512384531209266,183,155,0,338
49,bright,sv3,5,0.9621224753413206,227,138,4,369
49,bright,sv3,6,0.9445860402264852,204,110,3,317
49,bright,sv3,7,0.9564478354552769,155,119,3,277
49,bright,sv3,8,0.9500846189295056,218,152,3,373
49,bright,sv3,9,0.9784505195882446,204,144,0,348
50,backup,sv3,0,0.954898505423828,6,307,2,315
50,backup,sv3,1,0.9514182447754923,2,293,0,295
50,backup,sv3,2,0.9570694167885307,3,315,0,318
50,backup,sv3,3,0.937962314446266,3,284,0,287
50,backup,sv3,4,0.9064792848613991,5,267,2,274
50,backup,sv3,5,0.9261665517051281,2,309,0,311
50,backup,sv3,6,0.9563773021158883,7,261,2,270
50,backup,sv3,7,0.9185657340559067,3,247,1,251
50,backup,sv3,8,0.9282969843642976,2,292,1,295
50,backup,sv3,9,0.9719693236071034,1,302,0,303
51,backup,sv3,0,0.9684286169162901,5,272,1,278
51,backup,sv3,1,0.9195056514676043,2,251,2,255
51,backup,sv3,2,0.9183520444490442,4,253,0,257
51,backup,sv3,3,0.9191301608256572,6,196,2,204
51,backup,sv3,4,0.939409922382913,1,191,0,192
51,backup,sv3,5,0.9447915141617063,4,223,1,228
51,backup,sv3,6,0.9212984208822929,3,198,0,201
51,backup,sv3,7,0.9155333168494451,4,189,2,195
51,backup,sv3,8,0.9142243567970583,21,217,1,239
51,backup,sv3,9,0.9333504812721741,8,248,0,256
52,backup,sv3,0,0.8976810806011721,4,155,0,159
52,backup,sv3,1,0.8957581897233345,2,148,1,151
52,backup,sv3,2,0.8757020393452623,4,120,1,125
52,backup,sv3,3,0.8526499536973292,2,121,0,123
52,backup,sv3,4,0.8254217337265677,3,146,2,151
52,backup,sv3,5,0.9111453270249977,6,161,0,167
52,backup,sv3,6,0.7803377956857963,8,126,1,135
52,backup,sv3,7,0.8399872385226492,0,147,0,147
52,backup,sv3,8,0.9201537843176603,5,181,0,186
52,backup,sv3,9,0.9279120265529271,3,177,1,181
53,backup,sv3,0,0.9262135627971316,7,241,0,248
53,backup,sv3,1,0.9367642127427939,3,266,1,270
53,backup,sv3,2,0.9355781174449629,5,289,1,295
53,backup,sv3,3,0.9520282113977212,5,249,1,255
53,backup,sv3,4,0.9483976833194251,5,260,2,267
53,backup,sv3,5,0.937555898059019,11,284,2,297
53,backup,sv3,6,0.9392614070515751,5,233,3,241
53,backup,sv3,7,0.9511612189425231,7,221,2,230
53,backup,sv3,8,0.9417114291342448,6,277,1,284
53,backup,sv3,9,0.9605651450081638,4,289,2,295
55,dark,sv3,0,0.9621523827452526,260,13,88,361
55,dark,sv3,1,0.9552858968300858,218,17,91,326
55,dark,sv3,2,0.9315754694766526,251,20,78,349
55,dark,sv3,3,0.9514037847335644,233,12,89,334
55,dark,sv3,4,0.9579072544111014,243,16,81,340
55,dark,sv3,5,0.9600937403506297,248,10,92,350
55,dark,sv3,6,0.9400713851291941,206,18,78,302
55,dark,sv3,7,0.923412707057892,204,11,78,293
55,dark,sv3,8,0.9573465098317205,245,12,97,354
55,dark,sv3,9,0.9790773151851212,243,17,103,363
56,dark,sv3,0,0.9573017084877218,288,11,66,365
56,dark,sv3,1,0.9752750269346943,239,12,70,321
56,dark,sv3,2,0.9708918110398628,266,12,71,349
56,dark,sv3,3,0.9413357391514031,216,8,64,288
56,dark,sv3,4,0.9640894041279239,257,8,61,326
56,dark,sv3,5,0.9135241113098578,262,12,67,341
56,dark,sv3,6,0.9603309439797717,222,9,59,290
56,dark,sv3,7,0.908268098229378,188,10,61,259
56,dark,sv3,8,0.9348186034008923,177,5,42,224
56,dark,sv3,9,0.949737113941432,263,13,73,349
57,dark,sv3,0,0.9379803841583582,265,12,66,343
57,dark,sv3,1,0.9714904770722573,254,9,58,321
57,dark,sv3,2,0.9447833897076903,279,11,51,341
57,dark,sv3,3,0.9606782026988625,230,11,67,308
57,dark,sv3,4,0.9452538614687384,261,10,45,316
57,dark,sv3,5,0.9517632986065198,259,11,69,339
57,dark,sv3,6,0.9627512941323356,222,11,47,280
57,dark,sv3,7,0.954026597158393,208,11,59,278
57,dark,sv3,8,0.9775352789379003,233,12,72,317
57,dark,sv3,9,0.9584781671587093,266,10,68,344
58,dark,sv3,0,0.9524695205034402,285,9,56,350
58,dark,sv3,1,0.9440032909965216,269,5,55,329
58,dark,sv3,2,0.969306897786401,298,9,47,354
58,dark,sv3,3,0.9478197544507962,243,7,57,307
58,dark,sv3,4,0.9700928497871705,251,12,58,321
58,dark,sv3,5,0.965371633625784,271,11,68,350
58,dark,sv3,6,0.9526259809130659,213,10,57,280
58,dark,sv3,7,0.9497126932255241,204,11,61,276
58,dark,sv3,8,0.9575017260272705,265,9,72,346
58,dark,sv3,9,0.9423245250291576,243,11,67,321
59,dark,sv3,0,0.9754786962390961,297,12,55,364
59,dark,sv3,1,0.9556120707020423,260,11,52,323
59,dark,sv3,2,0.9529826845322669,274,10,62,346
59,dark,sv3,3,0.942666780582406,253,8,39,300
59,dark,sv3,4,0.9666200649038392,267,11,51,329
59,dark,sv3,5,0.9489699266932012,245,11,60,316
59,dark,sv3,6,0.9106268180835909,219,10,51,280
59,dark,sv3,7,0.9603863133871857,202,9,48,259
59,dark,sv3,8,0.9365879605431706,249,11,55,315
59,dark,sv3,9,0.9570096979871294,257,10,54,321
60,dark,sv3,0,0.9553374825105377,275,12,40,327
60,dark,sv3,1,0.9553089256738888,254,9,36,299
60,dark,sv3,2,0.964580031888765,282,13,34,329
60,dark,sv3,3,0.9468568721928775,246,10,43,299
60,dark,sv3,4,0.953271300270542,257,9,42,308
60,dark,sv3,5,0.9505816097849933,272,12,43,327
60,dark,sv3,6,0.9388674287361324,238,9,37,284
60,dark,sv3,7,0.9455833308284525,207,7,51,265
60,dark,sv3,8,0.9475955726112419,260,12,51,323
60,dark,sv3,9,0.9450920828591048,273,11,35,319
61,dark,sv3,0,0.9305215186828117,277,16,22,315
61,dark,sv3,1,0.9235919099160325,251,10,38,299
61,dark,sv3,2,0.9324940714430706,295,12,22,329
61,dark,sv3,3,0.928440160629502,244,12,26,282
61,dark,sv3,4,0.9402346876955209,255,12,30,297
61,dark,sv3,5,0.9542851918244927,262,11,28,301
61,dark,sv3,6,0.9581985734685915,227,9,21,257
61,dark,sv3,7,0.9170267700427313,219,8,34,261
61,dark,sv3,8,0.9470952224607222,278,13,21,312
61,dark,sv3,9,0.965068657601381,263,10,22,295
62,dark,sv3,0,0.9163701588823603,282,14,21,317
62,dark,sv3,1,0.9296285404879875,220,12,35,267
62,dark,sv3,2,0.9522993274123864,258,15,29,302
62,dark,sv3,3,0.9190871783912282,182,9,28,219
62,dark,sv3,4,0.9343275796408971,244,16,18,278
62,dark,sv3,5,0.9387142318828997,246,10,12,268
62,dark,sv3,6,0.964362740938521,212,13,22,247
62,dark,sv3,7,0.9024372735153768,204,10,21,235
62,dark,sv3,8,0.9442727194592059,279,13,21,313
62,dark,sv3,9,0.9434240875452138,258,12,23,293
63,dark,sv3,0,0.9781216547100384,268,11,20,299
63,dark,sv3,1,0.9418598400946157,233,13,17,263
63,dark,sv3,2,0.9638490185168261,256,15,20,291
63,dark,sv3,3,0.9461309198853103,224,13,14,251
63,dark,sv3,4,0.9184796380850846,249,12,14,275
63,dark,sv3,5,0.9481659613137063,236,13,23,272
63,dark,sv3,6,0.9346586209535586,211,13,19,243
63,dark,sv3,7,0.9301599074047834,205,11,19,235
63,dark,sv3,8,0.9230316400026786,209,9,25,243
63,dark,sv3,9,0.9401436510470124,253,9,13,275
64,dark,sv3,0,0.9278277526333711,316,11,22,349
64,dark,sv3,1,0.9536484963039202,269,17,26,312
64,dark,sv3,2,0.9589340710584797,284,17,22,323
64,dark,sv3,3,0.9600328123607477,267,12,27,306
64,dark,sv3,4,0.9514577790222339,267,17,24,308
64,dark,sv3,5,0.9294515181321126,269,12,23,304
64,dark,sv3,6,0.9506917575239705,195,11,16,222
64,dark,sv3,7,0.9567735856135444,259,14,25,298
64,dark,sv3,8,0.9368558046437498,278,19,19,316
64,dark,sv3,9,0.9413645039903883,302,14,19,335
65,dark,sv3,0,0.9344877466569043,278,16,29,323
65,dark,sv3,1,0.9590770550735678,261,14,25,300
65,dark,sv3,2,0.9443968053121019,291,14,14,319
65,dark,sv3,3,0.9400618283591997,266,15,15,296
65,dark,sv3,4,0.9632848816723747,288,17,14,319
65,dark,sv3,5,0.8981018348732043,247,19,24,290
65,dark,sv3,6,0.9722040456448175,224,13,17,254
65,dark,sv3,7,0.945510836856819,250,12,17,279
65,dark,sv3,8,0.9605710778675174,310,15,22,347
65,dark,sv3,9,0.9634422559347772,295,13,23,331
66,bright,sv3,0,0.962321742214813,361,44,1,406
66,bright,sv3,1,0.9675131482904465,326,37,3,366
66,bright,sv3,2,0.9436537597716219,342,48,2,392
66,bright,sv3,3,0.9664407090488537,302,53,4,359
66,bright,sv3,4,0.9661360066524991,330,32,6,368
66,bright,sv3,5,0.9666143350050249,347,35,4,386
66,bright,sv3,6,0.9538076324119731,323,9,4,336
66,bright,sv3,7,0.9158414124378352,258,47,2,307
66,bright,sv3,8,0.9799092502406379,348,31,2,381
66,bright,sv3,9,0.9487458485609441,367,23,2,392
67,bright,sv3,0,0.9553520741089233,301,96,6,403
67,bright,sv3,1,0.9301616550109025,286,56,2,344
67,bright,sv3,2,0.9523314840625975,267,98,0,365
67,bright,sv3,3,0.9612393765719396,245,77,4,326
67,bright,sv3,4,0.9468341449285379,274,65,2,341
67,bright,sv3,5,0.9418333756228288,284,93,1,378
67,bright,sv3,6,0.9591651179350476,271,49,1,321
67,bright,sv3,7,0.9486086135003062,200,76,4,280
67,bright,sv3,8,0.967699175394855,291,51,2,344
67,bright,sv3,9,0.9719044690023015,297,87,9,393
68,bright,sv3,0,0.9705752064803975,211,158,7,376
68,bright,sv3,1,0.9501027249333698,231,103,4,338
68,bright,sv3,2,0.955196811419386,240,112,2,354
68,bright,sv3,3,0.9329489230904378,184,112,3,299
68,bright,sv3,4,0.9390186227323088,229,112,5,346
68,bright,sv3,5,0.9545475566778231,248,111,3,362
68,bright,sv3,6,0.9562351846490531,245,88,2,335
68,bright,sv3,7,0.943785703524898,200,77,3,280
68,bright,sv3,8,0.9436203361166529,278,95,3,376
68,bright,sv3,9,0.9718419636263415,261,107,3,371
69,bright,sv3,0,0.9633756707901979,226,167,3,396
69,bright,sv3,1,0.9574097943292323,221,114,2,337
69,bright,sv3,2,0.9460547079823967,189,172,3,364
69,bright,sv3,3,0.9581245662957152,193,129,4,326
69,bright,sv3,4,0.9503862993225812,197,141,4,342
69,bright,sv3,5,0.9559084938822577,227,139,4,370
69,bright,sv3,6,0.9169877930491135,164,149,2,315
69,bright,sv3,7,0.9312742424188445,177,101,3,281
69,bright,sv3,8,0.9438605343079324,204,137,1,342
69,bright,sv3,9,0.9698317118470754,210,157,3,370
70,bright,sv3,0,0.9771487260732927,214,176,2,392
70,bright,sv3,1,0.9715219740425091,199,161,5,365
70,bright,sv3,2,0.9713755949571249,196,185,4,385
70,bright,sv3,3,0.9696432068562783,170,172,4,346
70,bright,sv3,4,0.9477243395952879,196,159,1,356
70,bright,sv3,5,0.9557099925735775,183,171,5,359
70,bright,sv3,6,0.9405607942426676,180,140,2,322
70,bright,sv3,7,0.9312342261199755,153,142,1,296
70,bright,sv3,8,0.95553206433237,210,168,5,383
70,bright,sv3,9,0.9479687461885218,200,162,4,366
71,bright,sv3,0,0.9405810891263929,141,186,4,331
71,bright,sv3,1,0.9609440770694143,174,160,5,339
71,bright,sv3,2,0.9566535881478332,171,203,1,375
71,bright,sv3,3,0.9560590328679527,140,183,3,326
71,bright,sv3,4,0.9447055013871445,178,162,1,341
71,bright,sv3,5,0.9693146288225564,201,164,3,368
71,bright,sv3,6,0.9595296983398875,163,155,2,320
71,bright,sv3,7,0.9569681264400557,153,127,4,284
71,bright,sv3,8,0.9351158654584094,183,171,3,357
71,bright,sv3,9,0.9560319217824624,188,177,3,368
72,bright,sv3,0,0.9650670721526867,185,201,1,387
72,bright,sv3,1,0.9535772040294828,170,166,5,341
72,bright,sv3,2,0.9742862966832989,165,207,1,373
72,bright,sv3,3,0.8891339298196349,127,137,4,268
72,bright,sv3,4,0.944212398296024,188,146,4,338
72,bright,sv3,5,0.942159377786423,170,181,3,354
72,bright,sv3,6,0.9468844218915502,163,157,3,323
72,bright,sv3,7,0.943058078270919,144,141,2,287
72,bright,sv3,8,0.9715638375597989,186,183,2,371
72,bright,sv3,9,0.9552546539897452,172,181,5,358
73,bright,sv3,0,0.9721480369278067,197,185,1,383
73,bright,sv3,1,0.9673959990598097,175,157,6,338
73,bright,sv3,2,0.9394776084554837,181,191,0,372
73,bright,sv3,3,0.9472432666527998,160,166,5,331
73,bright,sv3,4,0.9476038070422966,169,163,2,334
73,bright,sv3,5,0.9196933107446085,184,164,4,352
73,bright,sv3,6,0.9525657803158853,183,136,2,321
73,bright,sv3,7,0.888216381414781,137,134,6,277
73,bright,sv3,8,0.9557867692723012,164,158,3,325
73,bright,sv3,9,0.967099320044589,171,182,1,354
74,bright,sv3,0,0.9373981624050504,207,206,5,418
74,bright,sv3,1,0.9497673443050134,218,166,4,388
74,bright,sv3,2,0.9611270887938539,204,211,1,416
74,bright,sv3,3,0.9652414623958979,192,180,7,379
74,bright,sv3,4,0.9648076529934093,218,168,5,391
74,bright,sv3,5,0.9514383903275742,209,189,0,398
74,bright,sv3,6,0.9718926494951637,211,145,2,358
74,bright,sv3,7,0.9382023223185867,193,155,2,350
74,bright,sv3,8,0.9546665548116728,230,180,5,415
74,bright,sv3,9,0.9585356157329183,241,167,5,413
75,bright,sv3,0,0.9712295524060598,231,181,5,417
75,bright,sv3,1,0.9775523057431013,222,164,5,391
75,bright,sv3,2,0.9766326879491113,220,183,2,405
75,bright,sv3,3,0.9595370534925157,227,148,3,378
75,bright,sv3,4,0.9732210020892306,219,163,3,385
75,bright,sv3,5,0.9473136300524498,251,150,0,401
75,bright,sv3,6,0.9495314135031504,220,127,3,350
75,bright,sv3,7,0.9579072544111017,168,169,4,341
75,bright,sv3,8,0.9632751465342293,241,157,4,402
75,bright,sv3,9,0.9633612867523255,225,173,5,403
76,bright,sv3,0,0.9494392522104682,237,175,6,418
76,bright,sv3,1,0.9776536059686984,212,173,5,390
76,bright,sv3,2,0.9606066360844542,218,190,4,412
76,bright,sv3,3,0.948431637740711,205,162,4,371
76,bright,sv3,4,0.9417416779713069,213,162,4,379
76,bright,sv3,5,0.9625759357140932,238,155,2,395
76,bright,sv3,6,0.9739077055343642,219,137,6,362
76,bright,sv3,7,0.9686841939464951,178,155,6,339
76,bright,sv3,8,0.9599019955035946,241,164,7,412
76,bright,sv3,9,0.9501086696245935,240,150,2,392
77,backup,sv3,0,0.9381905536014052,2,338,0,340
77,backup,sv3,1,0.9475157795927479,4,271,0,275
77,backup,sv3,2,0.9710328966478381,3,313,0,316
77,backup,sv3,3,0.9580736002561824,2,266,3,271
77,backup,sv3,4,0.9159236652862662,4,267,0,271
77,backup,sv3,5,0.9508538733806446,0,324,0,324
77,backup,sv3,6,0.9641809510610395,3,270,0,273
77,backup,sv3,7,0.9135656390035211,2,245,0,247
77,backup,sv3,8,0.9261317760924546,2,312,5,319
77,backup,sv3,9,0.9362324477922854,0,254,0,254
78,backup,sv3,0,0.9265771050930406,2,272,1,275
78,backup,sv3,1,0.9310225048862315,3,245,1,249
78,backup,sv3,2,0.8900808215945469,2,253,0,255
78,backup,sv3,3,0.9039850521911194,4,183,2,189
78,backup,sv3,4,0.8891762156148652,6,217,1,224
78,backup,sv3,5,0.923894007252544,2,222,1,225
78,backup,sv3,6,0.9054383213262855,5,183,1,189
78,backup,sv3,7,0.9123756350601236,0,198,1,199
78,backup,sv3,8,0.9025323893070596,4,221,1,226
78,backup,sv3,9,0.9183237615424333,1,247,1,249
79,backup,sv3,0,0.9476175028337035,0,324,0,324
79,backup,sv3,1,0.908484410576288,2,282,0,284
79,backup,sv3,2,0.9525160790194513,6,312,0,318
79,backup,sv3,3,0.9197588931453895,5,249,2,256
79,backup,sv3,4,0.9317727056665874,5,259,1,265
79,backup,sv3,5,0.927417001833561,1,180,0,181
79,backup,sv3,6,0.9310609074728192,3,242,2,247
79,backup,sv3,7,0.8514465697114242,2,232,1,235
79,backup,sv3,8,0.9329306414302869,10,279,0,289
79,backup,sv3,9,0.9437523307990446,5,277,2,284
82,dark,sv3,0,0.9730537719059211,274,11,96,381
82,dark,sv3,1,0.9570794924093584,232,13,91,336
82,dark,sv3,2,0.9579257860044519,262,13,104,379
82,dark,sv3,3,0.9718881747668027,231,11,96,338
82,dark,sv3,4,0.967591688638597,269,9,78,356
82,dark,sv3,5,0.9569364336610168,263,10,77,350
82,dark,sv3,6,0.9382189114846855,225,11,73,309
82,dark,sv3,7,0.9551955307712656,208,10,65,283
82,dark,sv3,8,0.9513053231758243,261,11,87,359
82,dark,sv3,9,0.9542063179975752,266,16,82,364
83,dark,sv3,0,0.9498824949562785,267,10,81,358
83,dark,sv3,1,0.9335451712942159,240,12,78,330
83,dark,sv3,2,0.956817684317675,269,10,85,364
83,dark,sv3,3,0.9372387938862302,235,9,77,321
83,dark,sv3,4,0.932157940932696,252,11,75,338
83,dark,sv3,5,0.9635984643547695,285,10,66,361
83,dark,sv3,6,0.949242520317809,226,9,55,290
83,dark,sv3,7,0.9395120743464136,206,10,48,264
83,dark,sv3,8,0.9525890939279246,261,10,61,332
83,dark,sv3,9,0.894605915775008,258,15,63,336
84,dark,sv3,0,0.9692143392442658,271,10,89,370
84,dark,sv3,1,0.9645712221419671,250,11,61,322
84,dark,sv3,2,0.9578039283972819,286,11,66,363
84,dark,sv3,3,0.9692908497834912,249,9,64,322
84,dark,sv3,4,0.9788159318807346,254,10,65,329
84,dark,sv3,5,0.9596286827348323,278,9,57,344
84,dark,sv3,6,0.9383238568232284,228,9,57,294
84,dark,sv3,7,0.9640358081594336,212,10,58,280
84,dark,sv3,8,0.9663030706755308,268,13,70,351
84,dark,sv3,9,0.9499999831200324,273,13,57,343
85,dark,sv3,0,0.9479245162569511,269,11,56,336
85,dark,sv3,1,0.95320947824789,258,8,65,331
85,dark,sv3,2,0.9631047362602987,279,11,61,351
85,dark,sv3,3,0.9472337870498387,234,10,68,312
85,dark,sv3,4,0.9357336025996421,249,10,69,328
85,dark,sv3,5,0.9573528467798859,282,9,55,346
85,dark,sv3,6,0.9515614527711622,225,10,53,288
85,dark,sv3,7,0.9504738491995381,225,11,46,282
85,dark,sv3,8,0.9383231026148254,256,11,62,329
85,dark,sv3,9,0.9724853361961202,275,9,49,333
86,dark,sv3,0,0.951933923344941,272,11,55,338
86,dark,sv3,1,0.9652184238197831,239,11,51,301
86,dark,sv3,2,0.9684638480702885,271,11,54,336
86,dark,sv3,3,0.9641226158128408,243,10,63,316
86,dark,sv3,4,0.9377902138267902,241,11,70,322
86,dark,sv3,5,0.9380923670987144,262,13,31,306
86,dark,sv3,6,0.9571713082053015,223,13,43,279
86,dark,sv3,7,0.9266321443009676,198,9,46,253
86,dark,sv3,8,0.9564119539636415,244,11,49,304
86,dark,sv3,9,0.9454969459470917,261,13,41,315
87,dark,sv3,0,0.9514212266528075,280,12,38,330
87,dark,sv3,1,0.9277894647674364,244,10,38,292
87,dark,sv3,2,0.9789714437104015,278,11,43,332
87,dark,sv3,3,0.916198203730054,240,8,53,301
87,dark,sv3,4,0.942942023526127,268,11,26,305
87,dark,sv3,5,0.9630827455728926,270,11,40,321
87,dark,sv3,6,0.9426840696652119,244,11,26,281
87,dark,sv3,7,0.9383524900830824,207,10,41,258
87,dark,sv3,8,0.9738502908930196,263,13,45,321
87,dark,sv3,9,0.9644934129488771,269,13,35,317
88,dark,sv3,0,0.9311719213806607,270,15,40,325
88,dark,sv3,1,0.9472451203807633,259,13,37,309
88,dark,sv3,2,0.942507223185639,288,14,33,335
88,dark,sv3,3,0.9343364053356085,254,10,35,299
88,dark,sv3,4,0.9504576114390976,269,9,31,309
88,dark,sv3,5,0.9660111124974745,264,10,35,309
88,dark,sv3,6,0.908682982418645,229,10,23,262
88,dark,sv3,7,0.954360928042537,215,17,32,264
88,dark,sv3,8,0.9565083196297164,281,12,34,327
88,dark,sv3,9,0.9357657238452187,260,14,28,302
89,dark,sv3,0,0.9459124071715866,264,13,31,308
89,dark,sv3,1,0.9537233416537018,262,8,32,302
89,dark,sv3,2,0.9482248112978037,290,14,26,330
89,dark,sv3,3,0.9315899103558318,247,13,21,281
89,dark,sv3,4,0.9407863421040028,266,12,17,295
89,dark,sv3,5,0.9305043958168889,264,13,11,288
89,dark,sv3,6,0.9328905244877017,226,11,24,261
89,dark,sv3,7,0.9471722842646415,208,12,27,247
89,dark,sv3,8,0.9468932999359204,263,12,20,295
89,dark,sv3,9,0.9537192472188297,263,12,21,296
90,dark,sv3,0,0.9386963094526263,263,12,20,295
90,dark,sv3,1,0.9371987862539386,247,13,21,281
90,dark,sv3,2,0.9524962954074315,296,10,12,318
90,dark,sv3,3,0.9788394690785484,251,15,19,285
90,dark,sv3,4,0.9404951564493483,254,12,20,286
90,dark,sv3,5,0.934252809287659,266,12,22,300
90,dark,sv3,6,0.9415364130216408,225,14,20,259
90,dark,sv3,7,0.950517980651144,195,11,31,237
90,dark,sv3,8,0.9671490064756746,265,8,28,301
90,dark,sv3,9,0.9234682467427805,258,12,18,288
91,dark,sv3,0,0.9569947789827868,256,12,29,297
91,dark,sv3,1,0.9475371396293037,249,13,29,291
91,dark,sv3,2,0.9373166115788918,283,14,20,317
91,dark,sv3,3,0.9654625185174317,213,9,14,236
91,dark,sv3,4,0.9590090281048556,249,13,22,284
91,dark,sv3,5,0.9107084698473218,240,12,28,280
91,dark,sv3,6,0.8980017699005048,216,10,16,242
91,dark,sv3,7,0.9049141395768657,200,11,17,228
91,dark,sv3,8,0.9270409671968755,272,13,20,305
91,dark,sv3,9,0.9547412688785221,247,17,15,279
92,dark,sv3,0,0.9192148091818674,265,10,33,308
92,dark,sv3,1,0.8834865645013534,230,10,25,265
92,dark,sv3,2,0.9445242944410206,259,17,22,298
92,dark,sv3,3,0.9245625649745081,239,12,13,264
92,dark,sv3,4,0.9715915715205033,235,18,29,282
92,dark,sv3,5,0.9461926902825153,230,11,17,258
92,dark,sv3,6,0.9474342824467089,225,14,12,251
92,dark,sv3,7,0.9609518218583504,191,12,21,224
92,dark,sv3,8,0.952150102856371,235,7,18,260
92,dark,sv3,9,0.9490499095113252,244,13,21,278
93,bright,sv3,0,0.9590119493830215,338,60,1,399
93,bright,sv3,1,0.9367892580457032,297,67,3,367
93,bright,sv3,2,0.958449485785949,338,50,7,395
93,bright,sv3,3,0.9495437933565255,320,36,5,361
93,bright,sv3,4,0.9623971140671868,316,42,4,362
93,bright,sv3,5,0.9605574826761326,331,45,2,378
93,bright,sv3,6,0.9609671129762881,285,39,2,326
93,bright,sv3,7,0.9354596746450808,236,56,2,294
93,bright,sv3,8,0.9778660665859821,336,43,3,382
93,bright,sv3,9,0.9483804865383636,327,53,5,385
94,bright,sv3,0,0.9782053889066386,285,78,5,368
94,bright,sv3,1,0.9408684521586118,226,74,6,306
94,bright,sv3,2,0.9611804221917507,279,84,3,366
94,bright,sv3,3,0.9584081879817214,263,58,3,324
94,bright,sv3,4,0.9562360560340647,260,64,0,324
94,bright,sv3,5,0.9615902666674551,257,87,7,351
94,bright,sv3,6,0.9682678838363875,235,75,5,315
94,bright,sv3,7,0.9514848901611885,208,63,3,274
94,bright,sv3,8,0.944748280431968,234,78,4,316
94,bright,sv3,9,0.964677951201195,267,77,2,346
95,bright,sv3,0,0.9592216895958859,227,110,4,341
95,bright,sv3,1,0.9236976417753611,195,111,6,312
95,bright,sv3,2,0.9526521613859206,210,96,3,309
95,bright,sv3,3,0.9514821010571137,192,90,8,290
95,bright,sv3,4,0.9586072100194826,204,96,5,305
95,bright,sv3,5,0.9320566167387062,223,93,5,321
95,bright,sv3,6,0.9395063441557666,200,90,4,294
95,bright,sv3,7,0.9367488179377805,191,86,2,279
95,bright,sv3,8,0.9644561997840353,230,119,3,352
95,bright,sv3,9,0.9552726202043634,192,127,2,321
96,bright,sv3,0,0.9688893798869633,211,157,4,372
96,bright,sv3,1,0.9531212457578405,194,127,6,327
96,bright,sv3,2,0.9648458319518519,222,140,4,366
96,bright,sv3,3,0.8948673917697278,93,59,5,157
96,bright,sv3,4,0.9749504678365197,164,88,2,254
96,bright,sv3,5,0.9643577643119915,208,142,4,354
96,bright,sv3,6,0.946199000430167,176,130,3,309
96,bright,sv3,7,0.9195504583473117,182,103,1,286
96,bright,sv3,8,0.9127131603105684,199,136,1,336
96,bright,sv3,9,0.9588928591801058,189,163,5,357
97,bright,sv3,0,0.9567334262078204,217,144,5,366
97,bright,sv3,1,0.9659792563012931,216,113,8,337
97,bright,sv3,2,0.9563484256504008,204,159,5,368
97,bright,sv3,3,0.9224948276396688,182,149,5,336
97,bright,sv3,4,0.9522642252648154,200,137,2,339
97,bright,sv3,5,0.9785076155866606,192,165,3,360
97,bright,sv3,6,0.9536358689037434,178,128,1,307
97,bright,sv3,7,0.9695210915707067,149,127,4,280
97,bright,sv3,8,0.9626195390670339,204,157,1,362
97,bright,sv3,9,0.9430512900978605,191,153,4,348
98,bright,sv3,0,0.9632433245270022,196,179,1,376
98,bright,sv3,1,0.9566223990250218,172,152,3,327
98,bright,sv3,2,0.9510005892063169,187,160,10,357
98,bright,sv3,3,0.945326091875116,167,147,2,316
98,bright,sv3,4,0.9281834002289718,201,133,3,337
98,bright,sv3,5,0.9378890241774598,195,141,2,338
98,bright,sv3,6,0.9606807813869979,170,129,5,304
98,bright,sv3,7,0.9576998808661998,129,145,4,278
98,bright,sv3,8,0.9621147468656156,197,147,6,350
98,bright,sv3,9,0.9657621847573481,191,155,1,347
99,bright,sv3,0,0.9698081633138694,214,155,4,373
99,bright,sv3,1,0.969313402580998,180,141,3,324
99,bright,sv3,2,0.9709023849745542,199,154,8,361
99,bright,sv3,3,0.944358869416057,183,143,3,329
99,bright,sv3,4,0.9728881446002039,202,134,3,339
99,bright,sv3,5,0.9691090287664245,212,148,3,363
99,bright,sv3,6,0.9796764117754315,173,130,3,306
99,bright,sv3,7,0.9574828172879367,153,120,4,277
99,bright,sv3,8,0.9699586961423567,190,150,4,344
99,bright,sv3,9,0.9750598662573774,182,161,0,343
100,bright,sv3,0,0.9429996476371565,224,153,2,379
100,bright,sv3,1,0.9609224409832187,202,133,5,340
100,bright,sv3,2,0.9646813542572339,229,144,3,376
100,bright,sv3,3,0.950757386435683,178,141,3,322
100,bright,sv3,4,0.9192043758141204,200,132,6,338
100,bright,sv3,5,0.957694888788544,204,144,7,355
100,bright,sv3,6,0.9436462988515285,181,119,1,301
100,bright,sv3,7,0.9625711433980321,140,130,1,271
100,bright,sv3,8,0.9455993919534453,214,147,5,366
100,bright,sv3,9,0.946399128131229,194,147,0,341
101,bright,sv3,0,0.9437716353441638,230,175,3,408
101,bright,sv3,1,0.9771556570082566,214,151,7,372
101,bright,sv3,2,0.9580307962538708,247,161,4,412
101,bright,sv3,3,0.9558230801607461,218,155,3,376
101,bright,sv3,4,0.9659102677977208,225,151,8,384
101,bright,sv3,5,0.9358863296030396,230,160,5,395
101,bright,sv3,6,0.9570694167885306,192,123,1,316
101,bright,sv3,7,0.9661154003162076,189,152,1,342
101,bright,sv3,8,0.9604983977960097,244,159,1,404
101,bright,sv3,9,0.9686398331587475,229,161,3,393
102,bright,sv3,0,0.9584520090506486,228,174,11,413
102,bright,sv3,1,0.9602037977090119,222,148,8,378
102,bright,sv3,2,0.9631350248756005,241,148,6,395
102,bright,sv3,3,0.9568356053868287,231,140,4,375
102,bright,sv3,4,0.9588120350707005,253,133,2,388
102,bright,sv3,5,0.9633231970740425,222,160,12,394
102,bright,sv3,6,0.9535614627322867,191,149,4,344
102,bright,sv3,7,0.9687008117235935,195,145,6,346
102,bright,sv3,8,0.961007374316334,237,157,5,399
102,bright,sv3,9,0.9588560354856198,230,160,3,393
103,bright,sv3,0,0.9709686394904808,241,160,7,408
103,bright,sv3,1,0.9560706188148625,229,140,5,374
103,bright,sv3,2,0.9464893964696629,234,157,2,393
103,bright,sv3,3,0.9545887933499657,239,137,5,381
103,bright,sv3,4,0.9558670677947233,238,135,3,376
103,bright,sv3,5,0.9484659921148192,222,154,5,381
103,bright,sv3,6,0.9538168380874168,186,141,3,330
103,bright,sv3,7,0.935386461181753,194,151,4,349
103,bright,sv3,8,0.9686433307495846,144,127,1,272
103,bright,sv3,9,0.9603956337439992,226,162,3,391
104,backup,sv3,0,0.9741295322884458,4,302,2,308
104,backup,sv3,1,0.9350409777189327,2,251,0,253
104,backup,sv3,2,0.9315625386407955,1,299,0,300
104,backup,sv3,3,0.9621499920469408,2,213,2,217
104,backup,sv3,4,0.9269862850833324,1,271,3,275
104,backup,sv3,5,0.9460915773165702,5,287,1,293
104,backup,sv3,6,0.9015333920528042,2,241,2,245
104,backup,sv3,7,0.9412016851468614,0,225,2,227
104,backup,sv3,8,0.9256107649001531,0,271,1,272
104,backup,sv3,9,0.9752659687674297,2,223,0,225
105,backup,sv3,0,0.9425769769443277,6,226,3,235
105,backup,sv3,1,0.9196196841587568,2,190,2,194
105,backup,sv3,2,0.952247349559378,1,212,4,217
105,backup,sv3,3,0.9191163764823974,7,194,2,203
105,backup,sv3,4,0.9280185924818068,2,201,0,203
105,backup,sv3,5,0.9019400474261903,6,207,2,215
105,backup,sv3,6,0.8924285231429874,6,171,2,179
105,backup,sv3,7,0.9079639677687926,2,159,0,161
105,backup,sv3,8,0.9196938882705955,4,207,0,211
105,backup,sv3,9,0.9268875382377821,2,224,0,226
106,backup,sv3,0,0.9482452879638994,4,301,3,308
106,backup,sv3,1,0.9408210274253627,3,253,1,257
106,backup,sv3,2,0.9445499065192255,1,275,2,278
106,backup,sv3,3,0.9235144774825728,9,238,3,250
106,backup,sv3,4,0.9413915502974435,4,254,1,259
106,backup,sv3,5,0.9522951155443419,9,280,0,289
106,backup,sv3,6,0.8979925162375392,6,220,2,228
106,backup,sv3,7,0.9183800105631512,0,222,0,222
106,backup,sv3,8,0.9445277430300889,3,273,1,277
106,backup,sv3,9,0.9707820102175198,3,262,0,265
107,backup,sv3,0,0.8841207946740235,2,100,2,104
107,backup,sv3,1,0.9151327796751387,1,235,1,237
107,backup,sv3,2,0.9151327796751387,1,235,1,237
107,backup,sv3,3,0.929911294489584,2,239,2,243
107,backup,sv3,4,0.9516026573418395,4,263,3,270
107,backup,sv3,5,0.886461393669016,5,163,0,168
107,backup,sv3,6,0.9237068393788925,0,244,2,246
107,backup,sv3,7,0.8868731607954886,4,204,2,210
107,backup,sv3,8,0.9169636017042884,4,260,1,265
107,backup,sv3,9,0.9482260679525802,8,249,0,257
109,dark,sv3,0,0.9711095584562921,280,12,93,385
109,dark,sv3,1,0.957186236741192,241,13,91,345
109,dark,sv3,2,0.9662739349301138,276,11,88,375
109,dark,sv3,3,0.9634018861803801,217,8,92,317
109,dark,sv3,4,0.9575490909508848,225,11,112,348
109,dark,sv3,5,0.9711501124161145,251,14,92,357
109,dark,sv3,6,0.9561634906426023,219,13,88,320
109,dark,sv3,7,0.9337504067068925,215,11,66,292
109,dark,sv3,8,0.9512584271026862,242,11,106,359
109,dark,sv3,9,0.9455595475089801,270,10,82,362
110,dark,sv3,0,0.9414952002631232,264,9,86,359
110,dark,sv3,1,0.9234678984287087,218,13,82,313
110,dark,sv3,2,0.9454193852091558,263,12,80,355
110,dark,sv3,3,0.916564501086718,226,8,71,305
110,dark,sv3,4,0.9432727888824372,231,13,81,325
110,dark,sv3,5,0.9731668872991553,266,11,65,342
110,dark,sv3,6,0.9679690632469038,233,9,64,306
110,dark,sv3,7,0.9405295418455097,186,11,64,261
110,dark,sv3,8,0.9464598985743977,233,8,59,300
110,dark,sv3,9,0.9626653194373177,256,9,73,338
111,dark,sv3,0,0.9742797203976463,252,11,86,349
111,dark,sv3,1,0.9445098855122189,236,9,59,304
111,dark,sv3,2,0.9702947990784492,267,9,64,340
111,dark,sv3,3,0.9425672654473771,230,10,58,298
111,dark,sv3,4,0.9473440021722274,208,8,77,293
111,dark,sv3,5,0.9633523877633666,273,11,57,341
111,dark,sv3,6,0.9494207560365086,209,12,70,291
111,dark,sv3,7,0.9010182680648618,177,11,59,247
111,dark,sv3,8,0.9552656100606955,250,7,75,332
111,dark,sv3,9,0.9527558710296243,270,10,60,340
112,dark,sv3,0,0.9630461839153625,267,12,72,351
112,dark,sv3,1,0.9726126267711942,213,6,139,358
112,dark,sv3,2,0.9343149698358638,278,9,67,354
112,dark,sv3,3,0.9524962954074315,243,10,63,316
112,dark,sv3,4,0.97064426972773,246,12,65,323
112,dark,sv3,5,0.9506036515916656,267,9,62,338
112,dark,sv3,6,0.9403143745060957,217,10,57,284
112,dark,sv3,7,0.9101059058960389,203,10,67,280
112,dark,sv3,8,0.9600559883732869,257,10,54,321
112,dark,sv3,9,0.9627073963039078,256,11,70,337
113,dark,sv3,0,0.9660822602704536,268,14,48,330
113,dark,sv3,1,0.9154860683196665,243,11,42,296
113,dark,sv3,2,0.9616886633337031,269,9,49,327
113,dark,sv3,3,0.9458561834746946,220,9,52,281
113,dark,sv3,4,0.9694178183363601,244,9,55,308
113,dark,sv3,5,0.973322909165806,268,9,50,327
113,dark,sv3,6,0.9399003751828742,237,11,52,300
113,dark,sv3,7,0.9003384699077636,194,10,53,257
113,dark,sv3,8,0.9567179416686644,253,11,52,316
113,dark,sv3,9,0.9515151790985142,251,12,57,320
114,dark,sv3,0,0.9626582336317456,259,12,38,309
114,dark,sv3,1,0.9296913813296607,239,9,42,290
114,dark,sv3,2,0.952076002422312,266,10,36,312
114,dark,sv3,3,0.9369549545721452,244,11,35,290
114,dark,sv3,4,0.933801270091509,258,14,50,322
114,dark,sv3,5,0.9616106221615752,214,13,49,276
114,dark,sv3,6,0.9271645569985345,227,10,51,288
114,dark,sv3,7,0.9095590975890482,209,10,49,268
114,dark,sv3,8,0.9530113345330442,246,10,45,301
114,dark,sv3,9,0.9453383181842819,239,10,40,289
115,dark,sv3,0,0.9362863545700794,259,12,31,302
115,dark,sv3,1,0.911589163877956,243,12,29,284
115,dark,sv3,2,0.946199000430167,274,10,26,310
115,dark,sv3,3,0.9489784710754756,241,14,32,287
115,dark,sv3,4,0.9466521033733224,254,12,43,309
115,dark,sv3,5,0.9701891656619968,253,11,35,299
115,dark,sv3,6,0.9359542371454093,231,11,31,273
115,dark,sv3,7,0.9018672232940973,212,10,41,263
115,dark,sv3,8,0.882616340748265,134,5,16,155
115,dark,sv3,9,0.9218092618191916,260,11,24,295
116,dark,sv3,0,0.9414955720411571,267,13,34,314
116,dark,sv3,1,0.9573009371080392,253,12,29,294
116,dark,sv3,2,0.927908718485902,283,12,20,315
116,dark,sv3,3,0.955178411312868,248,14,28,290
116,dark,sv3,4,0.8893893845201426,249,15,23,287
116,dark,sv3,5,0.9373339201589933,260,11,30,301
116,dark,sv3,6,0.9226942520359127,225,10,17,252
116,dark,sv3,7,0.9534389363227791,202,11,27,240
116,dark,sv3,8,0.9549359624429623,262,12,21,295
116,dark,sv3,9,0.9585182501312222,248,12,31,291
117,dark,sv3,0,0.9327715225012769,238,12,22,272
117,dark,sv3,1,0.9431021075359488,223,11,26,260
117,dark,sv3,2,0.9623431005507009,263,13,14,290
117,dark,sv3,3,0.8981602295135013,222,12,22,256
117,dark,sv3,4,0.9197414383523961,233,14,26,273
117,dark,sv3,5,0.9571444378942214,258,11,24,293
117,dark,sv3,6,0.9399997490058842,199,14,29,242
117,dark,sv3,7,0.9318250724156543,180,11,34,225
117,dark,sv3,8,0.9127446975173111,233,14,30,277
117,dark,sv3,9,0.9501158558630175,239,13,27,279
118,dark,sv3,0,0.9727438195820299,246,16,20,282
118,dark,sv3,1,0.9564082820393818,224,11,20,255
118,dark,sv3,2,0.9488638104520947,245,10,21,276
118,dark,sv3,3,0.9169409702984004,216,15,24,255
118,dark,sv3,4,0.9501743931059727,233,13,23,269
118,dark,sv3,5,0.8895396962566108,124,4,10,138
118,dark,sv3,6,0.9345039370277207,207,15,18,240
118,dark,sv3,7,0.9443020475705641,177,12,23,212
118,dark,sv3,8,0.96571603470404,226,14,24,264
118,dark,sv3,9,0.9242911669709689,234,15,22,271
119,dark,sv3,0,0.9682874207011529,251,14,26,291
119,dark,sv3,1,0.9380478372647425,228,12,15,255
119,dark,sv3,2,0.9554439821019937,261,15,16,292
119,dark,sv3,3,0.8987827194026503,175,10,10,195
119,dark,sv3,4,0.9654811322395116,242,10,19,271
119,dark,sv3,5,0.93917885726456,254,11,14,279
119,dark,sv3,6,0.9447434568567713,207,11,19,237
119,dark,sv3,7,0.9157245973079466,171,13,21,205
119,dark,sv3,8,0.9470302247412018,256,13,30,299
119,dark,sv3,9,0.9204072223608543,250,15,23,288
120,bright,sv3,0,0.9544601137304242,365,20,2,387
120,bright,sv3,1,0.9589238563241175,329,22,3,354
120,bright,sv3,2,0.9625931461652237,346,37,3,386
120,bright,sv3,3,0.9517410028336563,330,23,8,361
120,bright,sv3,4,0.9597566402746325,324,30,3,357
120,bright,sv3,5,0.9335204979217749,343,35,3,381
120,bright,sv3,6,0.9369645732869047,315,19,1,335
120,bright,sv3,7,0.9443823093783819,250,42,3,295
120,bright,sv3,8,0.953722293827528,304,56,7,367
120,bright,sv3,9,0.9538787003261331,352,20,6,378
121,bright,sv3,0,0.9640439631638705,343,39,5,387
121,bright,sv3,1,0.9514037847335644,282,46,5,333
121,bright,sv3,2,0.9499012725199588,296,69,4,369
121,bright,sv3,3,0.9618533514502465,275,51,4,330
121,bright,sv3,4,0.9649420026876074,293,64,3,360
121,bright,sv3,5,0.9684578041709082,287,64,2,353
121,bright,sv3,6,0.9346032700951883,262,53,6,321
121,bright,sv3,7,0.9175965827941736,191,72,5,268
121,bright,sv3,8,0.9765535767170026,277,71,3,351
121,bright,sv3,9,0.9545112537434615,323,49,2,374
122,bright,sv3,0,0.969924777958478,298,85,4,387
122,bright,sv3,1,0.9668301031060564,258,85,4,347
122,bright,sv3,2,0.9623124741243104,259,98,8,365
122,bright,sv3,3,0.935154690035748,242,78,3,323
122,bright,sv3,4,0.9493649513472779,256,83,5,344
122,bright,sv3,5,0.9432106271405993,281,89,3,373
122,bright,sv3,6,0.9394274347095085,232,81,6,319
122,bright,sv3,7,0.9534058045380094,189,80,4,273
122,bright,sv3,8,0.9359466330719713,232,90,3,325
122,bright,sv3,9,0.9665697574804591,299,63,6,368
123,bright,sv3,0,0.9394702412783779,284,92,5,381
123,bright,sv3,1,0.9521990584427653,215,91,4,310
123,bright,sv3,2,0.9598350663152635,248,112,4,364
123,bright,sv3,3,0.9662615360755803,244,78,2,324
123,bright,sv3,4,0.9688887478008951,237,109,2,348
123,bright,sv3,5,0.9588504824948751,229,113,6,348
123,bright,sv3,6,0.9623825898182606,206,109,2,317
123,bright,sv3,7,0.9230011807900179,179,85,5,269
123,bright,sv3,8,0.9558164645748864,225,94,4,323
123,bright,sv3,9,0.9442993676734708,242,103,2,347
124,bright,sv3,0,0.9386179319156533,232,113,7,352
124,bright,sv3,1,0.972749378047552,199,96,6,301
124,bright,sv3,2,0.9820711196412496,225,127,5,357
124,bright,sv3,3,0.9726564312718745,199,109,1,309
124,bright,sv3,4,0.9643852046296593,204,121,8,333
124,bright,sv3,5,0.9740889255073956,209,132,3,344
124,bright,sv3,6,0.9686415545837576,181,113,7,301
124,bright,sv3,7,0.9421186610252069,154,89,6,249
124,bright,sv3,8,0.9340984395209414,201,131,3,335
124,bright,sv3,9,0.9543063994222977,241,95,5,341
125,bright,sv3,0,0.9649565005981499,224,129,2,355
125,bright,sv3,1,0.9510330964059628,205,113,2,320
125,bright,sv3,2,0.952435870388393,195,152,1,348
125,bright,sv3,3,0.933285422418625,161,96,3,260
125,bright,sv3,4,0.9643865618052212,216,113,9,338
125,bright,sv3,5,0.9499688500624047,202,133,4,339
125,bright,sv3,6,0.9423391916481264,187,121,2,310
125,bright,sv3,7,0.9375210892561906,153,92,1,246
125,bright,sv3,8,0.9528620153631081,183,145,4,332
125,bright,sv3,9,0.9563750965153038,224,115,2,341
126,bright,sv3,0,0.9670203138438068,217,119,4,340
126,bright,sv3,1,0.9274547151770008,190,109,1,300
126,bright,sv3,2,0.9577815657258962,199,153,4,356
126,bright,sv3,3,0.932311487707116,209,102,4,315
126,bright,sv3,4,0.9576132247630224,201,125,3,329
126,bright,sv3,5,0.9617590879799214,201,119,5,325
126,bright,sv3,6,0.9269947085557604,201,107,4,312
126,bright,sv3,7,0.9263270640499454,136,122,5,263
126,bright,sv3,8,0.9051998325021142,151,111,6,268
126,bright,sv3,9,0.9503672958506175,226,123,1,350
127,bright,sv3,0,0.9706852304822571,267,126,6,399
127,bright,sv3,1,0.9335060185183822,219,126,7,352
127,bright,sv3,2,0.9766716743065401,242,145,3,390
127,bright,sv3,3,0.9592616155552662,228,126,3,357
127,bright,sv3,4,0.955666306157385,235,141,7,383
127,bright,sv3,5,0.9448284086368295,251,136,5,392
127,bright,sv3,6,0.9708187953916605,206,94,3,303
127,bright,sv3,7,0.9284069647335788,197,121,5,323
127,bright,sv3,8,0.9794580383566022,243,129,3,375
127,bright,sv3,9,0.9678898917891899,257,123,3,383
128,bright,sv3,0,0.9691452858994993,261,128,2,391
128,bright,sv3,1,0.9361252711540955,215,118,5,338
128,bright,sv3,2,0.957463040480233,245,125,4,374
128,bright,sv3,3,0.9294158162419969,198,113,3,314
128,bright,sv3,4,0.9695240471309976,246,127,4,377
128,bright,sv3,5,0.9809005184198216,249,132,4,385
128,bright,sv3,6,0.9342888239985644,225,112,3,340
128,bright,sv3,7,0.956352475258366,196,115,4,315
128,bright,sv3,8,0.9716872334358113,224,143,6,373
128,bright,sv3,9,0.9741543439033995,266,115,4,385
129,bright,sv3,0,0.9395949844936238,252,121,3,376
129,bright,sv3,1,0.9573289744185616,241,125,2,368
129,bright,sv3,2,0.9713892436602725,235,131,6,372
129,bright,sv3,3,0.9665079660202927,241,113,7,361
129,bright,sv3,4,0.94850848079574,246,122,5,373
129,bright,sv3,5,0.9429519212729279,245,140,2,387
129,bright,sv3,6,0.9592508990492915,224,124,3,351
129,bright,sv3,7,0.9460824218878707,199,122,0,321
129,bright,sv3,8,0.9492669425354182,243,125,3,371
129,bright,sv3,9,0.9570866647222996,280,112,2,394
131,backup,sv3,0,0.9254174577317249,24,251,1,276
131,backup,sv3,1,0.8918959965301287,21,209,3,233
131,backup,sv3,2,0.9119929838744197,10,272,1,283
131,backup,sv3,3,0.9583229838967058,5,242,2,249
131,backup,sv3,4,0.9109762951945258,9,231,3,243
131,backup,sv3,5,0.9053780781148769,11,243,0,254
131,backup,sv3,6,0.8860167509637284,10,213,1,224
131,backup,sv3,7,0.9209525163385733,11,175,1,187
131,backup,sv3,8,0.9508367413243681,16,236,3,255
131,backup,sv3,9,0.9557300361263112,18,236,3,257
132,backup,sv3,0,0.9237763662998568,11,197,1,209
132,backup,sv3,1,0.9102655058122602,11,184,1,196
132,backup,sv3,2,0.9153337268435112,7,204,0,211
132,backup,sv3,3,0.9193775372344021,6,156,2,164
132,backup,sv3,4,0.9063654395426219,7,124,0,131
132,backup,sv3,5,0.8911457659504219,2,168,1,171
132,backup,sv3,6,0.9136657173272872,3,157,1,161
132,backup,sv3,7,0.8940375893183837,5,154,2,161
132,backup,sv3,8,0.8850384480577456,18,165,1,184
132,backup,sv3,9,0.8937465047352435,13,183,0,196
133,backup,sv3,0,0.9586978697098252,22,262,1,285
133,backup,sv3,1,0.932061160628701,24,224,2,250
133,backup,sv3,2,0.9324868962287451,12,276,0,288
133,backup,sv3,3,0.9254686371179291,8,203,1,212
133,backup,sv3,4,0.9177428378652388,6,223,3,232
133,backup,sv3,5,0.9579125336556978,10,236,1,247
133,backup,sv3,6,0.8987718168634783,7,214,2,223
133,backup,sv3,7,0.9272017654825708,7,181,3,191
133,backup,sv3,8,0.9471592864134206,15,238,2,255
133,backup,sv3,9,0.9121187212801338,16,235,1,252
136,dark,sv3,0,0.9406805132066407,218,12,84,314
136,dark,sv3,1,0.9477199464040821,234,13,97,344
136,dark,sv3,2,0.9751090558219472,228,19,114,361
136,dark,sv3,3,0.9619019700362256,231,18,90,339
136,dark,sv3,4,0.9426448980931498,213,13,94,320
136,dark,sv3,5,0.9711403919140961,258,15,88,361
136,dark,sv3,6,0.9548165566199012,196,14,89,299
136,dark,sv3,7,0.9211493142894273,202,12,76,290
136,dark,sv3,8,0.9450243099333563,241,19,89,349
136,dark,sv3,9,0.9699045096561025,235,17,86,338
137,dark,sv3,0,0.9636739546464139,244,18,70,332
137,dark,sv3,1,0.9401475198818625,238,8,56,302
137,dark,sv3,2,0.949481385794982,256,10,76,342
137,dark,sv3,3,0.9333083398713664,206,14,71,291
137,dark,sv3,4,0.9651882921986842,227,12,74,313
137,dark,sv3,5,0.9402850842723877,239,12,69,320
137,dark,sv3,6,0.9402979217784282,210,11,62,283
137,dark,sv3,7,0.9302300571895527,214,12,48,274
137,dark,sv3,8,0.9166135824024582,236,10,62,308
137,dark,sv3,9,0.9318955181898994,253,11,73,337
138,dark,sv3,0,0.9542476097749467,265,12,68,345
138,dark,sv3,1,0.9533518966802453,234,11,52,297
138,dark,sv3,2,0.9527259668478812,240,11,71,322
138,dark,sv3,3,0.9593273567346434,223,13,63,299
138,dark,sv3,4,0.9697458237194544,240,11,70,321
138,dark,sv3,5,0.9565547240511661,250,6,67,323
138,dark,sv3,6,0.9483501541165322,216,11,64,291
138,dark,sv3,7,0.9564721456554376,219,10,37,266
138,dark,sv3,8,0.9591813240195883,252,13,62,327
138,dark,sv3,9,0.9654548446045707,250,12,74,336
139,dark,sv3,0,0.948397572614921,252,13,58,323
139,dark,sv3,1,0.949818206195679,237,10,59,306
139,dark,sv3,2,0.9419571585875685,249,12,72,333
139,dark,sv3,3,0.9545871650310301,237,9,53,299
139,dark,sv3,4,0.9691306632514952,254,6,61,321
139,dark,sv3,5,0.9652180400565744,270,6,67,343
139,dark,sv3,6,0.9253572981734912,213,10,54,277
139,dark,sv3,7,0.9285607719077831,204,9,40,253
139,dark,sv3,8,0.9685334969884569,253,8,58,319
139,dark,sv3,9,0.9487533855736038,258,9,67,334
140,dark,sv3,0,0.9626231923705517,280,12,48,340
140,dark,sv3,1,0.9294007477831002,234,10,42,286
140,dark,sv3,2,0.9740306120412001,261,9,58,328
140,dark,sv3,3,0.911172341993857,225,9,44,278
140,dark,sv3,4,0.9693739281538919,233,8,59,300
140,dark,sv3,5,0.9297231090337739,283,8,51,342
140,dark,sv3,6,0.9772563746321423,231,11,46,288
140,dark,sv3,7,0.9195965219788537,211,7,34,252
140,dark,sv3,8,0.902763183640808,257,8,56,321
140,dark,sv3,9,0.9500562900513552,243,10,60,313
141,dark,sv3,0,0.9526104434095972,265,12,43,320
141,dark,sv3,1,0.9411575034327033,241,9,39,289
141,dark,sv3,2,0.9204094763673543,256,12,34,302
141,dark,sv3,3,0.937602185735288,225,10,38,273
141,dark,sv3,4,0.9245252568673118,245,10,39,294
141,dark,sv3,5,0.9683236890563985,274,8,29,311
141,dark,sv3,6,0.9294090067196126,231,11,38,280
141,dark,sv3,7,0.9233438212513575,209,10,28,247
141,dark,sv3,8,0.9471601318618298,272,10,39,321
141,dark,sv3,9,0.9325332393589179,262,12,50,324
142,dark,sv3,0,0.9335284094475131,283,11,21,315
142,dark,sv3,1,0.9461929218633485,240,13,21,274
142,dark,sv3,2,0.9523744672583905,242,10,37,289
142,dark,sv3,3,0.9167301356092177,197,15,20,232
142,dark,sv3,4,0.8814021856683677,187,8,20,215
142,dark,sv3,5,0.9496574844733507,286,10,32,328
142,dark,sv3,6,0.9020649535445299,230,11,19,260
142,dark,sv3,7,0.9663436581235154,14,57,238,309
142,dark,sv3,8,0.8921122437039448,237,10,25,272
142,dark,sv3,9,0.9294796864795676,261,12,29,302
143,dark,sv3,0,0.9558311249595848,269,15,20,304
143,dark,sv3,1,0.9595791803228529,241,10,31,282
143,dark,sv3,2,0.9720070823827938,240,15,37,292
143,dark,sv3,3,0.9507458708131192,214,12,27,253
143,dark,sv3,4,0.9615173943070779,251,10,19,280
143,dark,sv3,5,0.9340329321646949,249,14,24,287
143,dark,sv3,6,0.9353922855842892,233,13,7,253
143,dark,sv3,7,0.9576725514436413,207,11,23,241
143,dark,sv3,8,0.9656042159819128,244,13,20,277
143,dark,sv3,9,0.9438717598847863,236,12,25,273
144,dark,sv3,0,0.9375625974143936,234,16,16,266
144,dark,sv3,1,0.9768476050083003,224,12,20,256
144,dark,sv3,2,0.9396200861053403,237,16,13,266
144,dark,sv3,3,0.940533985814816,207,11,21,239
144,dark,sv3,4,0.9109272512067809,225,11,18,254
144,dark,sv3,5,0.9775631505145664,260,13,15,288
144,dark,sv3,6,0.938764122012455,208,16,10,234
144,dark,sv3,7,0.9254923105054688,205,11,23,239
144,dark,sv3,8,0.9812721679585923,258,17,22,297
144,dark,sv3,9,0.9462255085769481,241,17,19,277
145,dark,sv3,0,0.9122126170621536,228,14,18,260
145,dark,sv3,1,0.8922061233851849,219,14,8,241
145,dark,sv3,2,0.9253993939555416,230,12,30,272
145,dark,sv3,3,0.9298879280624712,201,16,28,245
145,dark,sv3,4,0.9375210892561908,216,15,15,246
145,dark,sv3,5,0.8394582542438982,112,9,9,130
145,dark,sv3,6,0.9445912359075923,204,19,4,227
145,dark,sv3,7,0.9329770360573024,202,13,11,226
145,dark,sv3,8,0.9437010237457961,247,16,16,279
145,dark,sv3,9,0.9293867604968239,239,12,18,269
146,dark,sv3,0,0.967645724914299,238,16,15,269
146,dark,sv3,1,0.9572078894207672,212,14,16,242
146,dark,sv3,2,0.9366182974603916,214,19,20,253
146,dark,sv3,3,0.9402637826164653,170,13,7,190
146,dark,sv3,4,0.9427496685640027,199,13,15,227
146,dark,sv3,5,0.9272118691548561,224,15,15,254
146,dark,sv3,6,0.9323294757894856,186,15,10,211
146,dark,sv3,7,0.9019400474261903,182,12,21,215
146,dark,sv3,8,0.9476408195193993,238,11,18,267
146,dark,sv3,9,0.9399997490058842,205,14,23,242
147,bright,sv3,0,0.9430386142508369,347,38,5,390
147,bright,sv3,1,0.9301690659735408,332,29,4,365
147,bright,sv3,2,0.960083015674388,326,62,0,388
147,bright,sv3,3,0.9550215475137568,284,64,2,350
147,bright,sv3,4,0.9594418941696982,290,60,2,352
147,bright,sv3,5,0.9689179123563728,341,45,1,387
147,bright,sv3,6,0.951239000438957,304,25,1,330
147,bright,sv3,7,0.9671490064756744,255,42,4,301
147,bright,sv3,8,0.9588175014942233,328,44,3,375
147,bright,sv3,9,0.9586463940919678,332,45,3,380
148,bright,sv3,0,0.9473716415222588,300,89,0,389
148,bright,sv3,1,0.9456028616467774,282,57,3,342
148,bright,sv3,2,0.9368731575709082,261,109,1,371
148,bright,sv3,3,0.9457901441508977,237,106,1,344
148,bright,sv3,4,0.9431958673221394,241,111,2,354
148,bright,sv3,5,0.9372904280128338,258,105,2,365
148,bright,sv3,6,0.9713279025226457,242,69,2,313
148,bright,sv3,7,0.9635351498857996,211,80,3,294
148,bright,sv3,8,0.9698654917745478,250,97,5,352
148,bright,sv3,9,0.9638885913394296,289,92,3,384
149,bright,sv3,0,0.9553373894042312,246,144,4,394
149,bright,sv3,1,0.9623012951728998,254,102,4,360
149,bright,sv3,2,0.9582264863755385,223,157,1,381
149,bright,sv3,3,0.952379290899426,173,139,6,318
149,bright,sv3,4,0.9728438970164964,185,134,2,321
149,bright,sv3,5,0.9593999177440313,213,119,1,333
149,bright,sv3,6,0.9668764879131014,203,121,3,327
149,bright,sv3,7,0.9649688088864784,196,91,4,291
149,bright,sv3,8,0.9599159330442231,226,135,2,363
149,bright,sv3,9,0.9601701470466023,247,100,5,352
150,bright,sv3,0,0.9775166814414074,207,190,3,400
150,bright,sv3,1,0.9461978028345556,210,146,1,357
150,bright,sv3,2,0.951387007657528,180,216,3,399
150,bright,sv3,3,0.9422160311585638,179,145,2,326
150,bright,sv3,4,0.9651423197346579,185,158,3,346
150,bright,sv3,5,0.9564502038018872,204,170,2,376
150,bright,sv3,6,0.9636837721152475,150,175,2,327
150,bright,sv3,7,0.943204981852764,153,127,2,282
150,bright,sv3,8,0.9517289101885281,189,174,4,367
150,bright,sv3,9,0.9571054538876949,198,180,3,381
151,bright,sv3,0,0.9659505467104232,172,206,5,383
151,bright,sv3,1,0.9646503135120462,177,158,7,342
151,bright,sv3,2,0.9643268877458534,155,226,2,383
151,bright,sv3,3,0.9520321913752345,149,174,3,326
151,bright,sv3,4,0.9277714093893992,137,209,1,347
151,bright,sv3,5,0.9546616340265267,176,188,1,365
151,bright,sv3,6,0.951104412503399,139,180,3,322
151,bright,sv3,7,0.9343275796408969,137,139,1,277
151,bright,sv3,8,0.9464521159900668,163,191,3,357
151,bright,sv3,9,0.954802242204612,185,177,3,365
152,bright,sv3,0,0.9645555176582785,161,223,1,385
152,bright,sv3,1,0.9116367671586513,144,193,2,339
152,bright,sv3,2,0.9761145324988747,153,227,3,383
152,bright,sv3,3,0.9325441485834111,127,188,2,317
152,bright,sv3,4,0.9626746785437181,149,192,3,344
152,bright,sv3,5,0.8651627531853999,83,88,2,173
152,bright,sv3,6,0.9517772626874932,137,183,4,324
152,bright,sv3,7,0.9470095051487409,147,136,2,285
152,bright,sv3,8,0.9631946110857685,165,195,0,360
152,bright,sv3,9,0.9592950921267217,163,201,3,367
153,bright,sv3,0,0.9654336506778087,190,199,4,393
153,bright,sv3,1,0.9592887606875221,125,215,3,343
153,bright,sv3,2,0.958597634387643,163,206,2,371
153,bright,sv3,3,0.9717508886524551,131,140,2,273
153,bright,sv3,4,0.9557294816502301,156,182,2,340
153,bright,sv3,5,0.9565566135034084,165,197,1,363
153,bright,sv3,6,0.9408190777957574,137,176,0,313
153,bright,sv3,7,0.940265197625558,128,145,3,276
153,bright,sv3,8,0.9485290943090576,149,229,2,380
153,bright,sv3,9,0.9571256108555188,154,204,1,359
154,bright,sv3,0,0.9570969912770746,174,216,1,391
154,bright,sv3,1,0.9683853224375152,180,164,3,347
154,bright,sv3,2,0.9522989298399163,186,198,1,385
154,bright,sv3,3,0.9674728655439172,137,174,2,313
154,bright,sv3,4,0.9477224024283617,140,193,2,335
154,bright,sv3,5,0.975490759408215,166,191,2,359
154,bright,sv3,6,0.9659704335141628,160,162,3,325
154,bright,sv3,7,0.927658961091773,115,154,4,273
154,bright,sv3,8,0.9295737312871223,136,172,1,309
154,bright,sv3,9,0.9757107354156642,176,172,2,350
155,bright,sv3,0,0.9420561309417039,217,199,2,418
155,bright,sv3,1,0.9640952206813762,202,184,3,389
155,bright,sv3,2,0.9547269791699557,212,204,0,416
155,bright,sv3,3,0.9411545144906212,168,189,4,361
155,bright,sv3,4,0.9501182789964507,182,209,2,393
155,bright,sv3,5,0.9575533993730614,199,202,2,403
155,bright,sv3,6,0.9584344340288043,153,169,1,323
155,bright,sv3,7,0.9409165081508462,178,175,2,355
155,bright,sv3,8,0.9674663397167171,186,227,3,416
155,bright,sv3,9,0.9746231581815097,199,217,4,420
156,bright,sv3,0,0.9627720275273687,220,201,4,425
156,bright,sv3,1,0.9763650896164026,194,195,3,392
156,bright,sv3,2,0.9464348100677714,210,198,1,409
156,bright,sv3,3,0.9589167009684021,182,189,2,373
156,bright,sv3,4,0.9411757628082124,174,212,1,387
156,bright,sv3,5,0.9708872286964043,187,209,2,398
156,bright,sv3,6,0.9365955061460037,181,175,2,358
156,bright,sv3,7,0.9665969482055206,164,181,4,349
156,bright,sv3,8,0.9714410192764688,195,223,1,419
156,bright,sv3,9,0.963588902220626,196,205,3,404
158,backup,sv3,0,0.977337318615477,1,354,0,355
158,backup,sv3,1,0.9468532964252616,0,303,2,305
158,backup,sv3,2,0.955620834607082,3,339,0,342
158,backup,sv3,3,0.9501296874903837,4,298,0,302
158,backup,sv3,4,0.9676786487448755,2,304,0,306
158,backup,sv3,5,0.9630680711293003,4,327,0,331
158,backup,sv3,6,0.9653799847093575,17,293,2,312
158,backup,sv3,7,0.9105755635450216,1,244,0,245
158,backup,sv3,8,0.9308632321162287,2,346,1,349
158,backup,sv3,9,0.9478268400633346,4,329,0,333
163,dark,sv3,0,0.9490923880498084,261,12,73,346
163,dark,sv3,1,0.9589616997694639,200,13,80,293
163,dark,sv3,2,0.9549809384448383,255,14,82,351
163,dark,sv3,3,0.9399771137557099,219,11,77,307
163,dark,sv3,4,0.9310289162886705,231,9,77,317
163,dark,sv3,5,0.949902964104911,225,11,99,335
163,dark,sv3,6,0.9393395745043378,196,11,90,297
163,dark,sv3,7,0.9276573622990513,181,11,70,262
163,dark,sv3,8,0.9670793103721647,253,9,82,344
163,dark,sv3,9,0.9339267446186177,232,26,71,329
164,dark,sv3,0,0.9575389878315778,269,14,70,353
164,dark,sv3,1,0.9382529806604976,224,7,60,291
164,dark,sv3,2,0.9592487505947227,268,9,67,344
164,dark,sv3,3,0.8980406795953245,215,8,61,284
164,dark,sv3,4,0.9669576300798773,220,10,70,300
164,dark,sv3,5,0.9485368294160644,242,16,71,329
164,dark,sv3,6,0.956859280234868,200,12,73,285
164,dark,sv3,7,0.9469169406677207,191,9,62,262
164,dark,sv3,8,0.928946776738107,232,8,63,303
164,dark,sv3,9,0.9519952829416379,264,8,50,322
165,dark,sv3,0,0.9300061585216751,266,10,69,345
165,dark,sv3,1,0.9735336769008108,233,10,56,299
165,dark,sv3,2,0.9459801692998742,266,12,54,332
165,dark,sv3,3,0.9412980480973052,231,14,57,302
165,dark,sv3,4,0.967902777155102,236,12,71,319
165,dark,sv3,5,0.9643806847782137,251,12,68,331
165,dark,sv3,6,0.9130335136332177,203,12,61,276
165,dark,sv3,7,0.9123639180253262,205,11,50,266
165,dark,sv3,8,0.9601973946597311,242,9,60,311
165,dark,sv3,9,0.9353227929562808,258,10,51,319
166,dark,sv3,0,0.9805166724122458,291,10,59,360
166,dark,sv3,1,0.9139511710626691,264,9,61,334
166,dark,sv3,2,0.9646923180882754,272,11,57,340
166,dark,sv3,3,0.9696806623272131,222,10,47,279
166,dark,sv3,4,0.9546793489444255,247,9,62,318
166,dark,sv3,5,0.944652656259566,256,12,68,336
166,dark,sv3,6,0.926758897111459,220,10,58,288
166,dark,sv3,7,0.9097142651934037,200,13,52,265
166,dark,sv3,8,0.9729869007089795,258,12,61,331
166,dark,sv3,9,0.9538146778461873,273,8,54,335
167,dark,sv3,0,0.9598673044609597,283,10,49,342
167,dark,sv3,1,0.9603085063896798,266,9,52,327
167,dark,sv3,2,0.9631033194507213,254,9,56,319
167,dark,sv3,3,0.9468570841007125,234,9,41,284
167,dark,sv3,4,0.9431430383381219,246,10,61,317
167,dark,sv3,5,0.9680308005890704,261,11,64,336
167,dark,sv3,6,0.9559591326108113,225,9,48,282
167,dark,sv3,7,0.9366259346878782,210,10,49,269
167,dark,sv3,8,0.9615304791333571,277,9,40,326
167,dark,sv3,9,0.9173462545791817,275,8,41,324
168,dark,sv3,0,0.9438645031211861,256,12,33,301
168,dark,sv3,1,0.9780444770155529,244,14,41,299
168,dark,sv3,2,0.9517931311541025,260,13,40,313
168,dark,sv3,3,0.9589478444488784,240,10,30,280
168,dark,sv3,4,0.9402651593259923,196,7,42,245
168,dark,sv3,5,0.9452671937378183,247,10,39,296
168,dark,sv3,6,0.9249902139652497,217,11,46,274
168,dark,sv3,7,0.9422788493026885,205,9,47,261
168,dark,sv3,8,0.9351266872598221,280,11,40,331
168,dark,sv3,9,0.9578094684371616,262,10,44,316
169,dark,sv3,0,0.9624545988790164,303,11,28,342
169,dark,sv3,1,0.9652755847689026,234,11,43,288
169,dark,sv3,2,0.9549585936579141,282,9,25,316
169,dark,sv3,3,0.9619583055502275,259,10,29,298
169,dark,sv3,4,0.9580498559341306,246,12,42,300
169,dark,sv3,5,0.9544055226183199,263,14,29,306
169,dark,sv3,6,0.8853585721769959,224,12,28,264
169,dark,sv3,7,0.9651168772789837,207,10,33,250
169,dark,sv3,8,0.9578595730144611,269,11,32,312
169,dark,sv3,9,0.9512546768887382,250,11,28,289
170,dark,sv3,0,0.9589090604239372,280,13,33,326
170,dark,sv3,1,0.951096496622874,249,12,35,296
170,dark,sv3,2,0.9622114083212049,275,11,37,323
170,dark,sv3,3,0.9165823994805756,236,14,33,283
170,dark,sv3,4,0.9557640016317205,258,11,21,290
170,dark,sv3,5,0.9161232618934362,257,13,24,294
170,dark,sv3,6,0.9348442733400469,238,13,17,268
170,dark,sv3,7,0.914846312456663,220,12,24,256
170,dark,sv3,8,0.9478061695183266,285,13,20,318
170,dark,sv3,9,0.9711892691666546,268,15,20,303
171,dark,sv3,0,0.9472859705721164,274,16,17,307
171,dark,sv3,1,0.9173460013201215,248,9,26,283
171,dark,sv3,2,0.9674622629124944,257,14,15,286
171,dark,sv3,3,0.9388589141018399,234,12,14,260
171,dark,sv3,4,0.9514194904154705,220,14,24,258
171,dark,sv3,5,0.9182168300712252,249,15,26,290
171,dark,sv3,6,0.9178416794739659,205,9,20,234
171,dark,sv3,7,0.9425166488064505,209,10,21,240
171,dark,sv3,8,0.9233947299651054,270,14,28,312
171,dark,sv3,9,0.9000492443361685,240,12,25,277
172,dark,sv3,0,0.976991233175759,302,16,19,337
172,dark,sv3,1,0.9539192002601243,282,17,21,320
172,dark,sv3,2,0.9770125456163554,304,21,23,348
172,dark,sv3,3,0.9549583324567851,242,10,24,276
172,dark,sv3,4,0.9620109159080396,274,12,25,311
172,dark,sv3,5,0.967097012346504,294,14,25,333
172,dark,sv3,6,0.9694184491733696,247,12,8,267
172,dark,sv3,7,0.937596105954657,250,12,21,283
172,dark,sv3,8,0.9391675019796935,317,13,17,347
172,dark,sv3,9,0.9442379361713867,295,20,19,334
173,dark,sv3,0,0.9315989042835258,317,12,29,358
173,dark,sv3,1,0.9679332456369747,290,13,24,327
173,dark,sv3,2,0.9548605494196372,291,16,21,328
173,dark,sv3,3,0.9435023371521227,260,13,19,292
173,dark,sv3,4,0.9564790939858352,275,13,18,306
173,dark,sv3,5,0.913325389904019,286,11,28,325
173,dark,sv3,6,0.9556319059491962,244,12,15,271
173,dark,sv3,7,0.9231471519872627,253,12,22,287
173,dark,sv3,8,0.9303198305703315,315,11,29,355
173,dark,sv3,9,0.9676016095488431,292,16,23,331
174,bright,sv3,0,0.9361389264159276,288,100,2,390
174,bright,sv3,1,0.955387670281597,277,82,6,365
174,bright,sv3,2,0.9558469716488014,329,52,4,385
174,bright,sv3,3,0.9488524551672279,287,51,6,344
174,bright,sv3,4,0.9422172571159009,292,59,4,355
174,bright,sv3,5,0.9623440229866624,307,71,5,383
174,bright,sv3,6,0.8856831902073903,269,59,5,333
174,bright,sv3,7,0.9662511449339195,229,62,1,292
174,bright,sv3,8,0.9661758937063724,312,65,6,383
174,bright,sv3,9,0.9695917670279001,277,81,4,362
175,bright,sv3,0,0.9508080421522116,240,118,2,360
175,bright,sv3,1,0.9418933456254365,226,71,2,299
175,bright,sv3,2,0.9466805178762691,285,79,8,372
175,bright,sv3,3,0.9268795004338151,242,71,4,317
175,bright,sv3,4,0.94499563406833,225,93,6,324
175,bright,sv3,5,0.9299964406012503,245,88,5,338
175,bright,sv3,6,0.9444740341622916,195,107,0,302
175,bright,sv3,7,0.9358896062489576,182,83,4,269
175,bright,sv3,8,0.9536960824601222,228,102,3,333
175,bright,sv3,9,0.9426002349994378,199,120,3,322
176,bright,sv3,0,0.9510193189283885,171,125,3,299
176,bright,sv3,1,0.9217464418590295,157,114,3,274
176,bright,sv3,2,0.9776655311723097,231,107,5,343
176,bright,sv3,3,0.9457212967257795,180,105,0,285
176,bright,sv3,4,0.9080572682253911,158,120,3,281
176,bright,sv3,5,0.9296075087526704,173,136,5,314
176,bright,sv3,6,0.9503126711608885,154,115,2,271
176,bright,sv3,7,0.9455833308284525,156,107,3,266
176,bright,sv3,8,0.9502357574429539,183,110,2,295
176,bright,sv3,9,0.9396866992536814,185,117,4,306
177,bright,sv3,0,0.9328089406377976,181,194,5,380
177,bright,sv3,1,0.9752401124257213,174,150,3,327
177,bright,sv3,2,0.9559036754088323,216,152,5,373
177,bright,sv3,3,0.9437668154079566,195,127,1,323
177,bright,sv3,4,0.9446741147744857,172,138,3,313
177,bright,sv3,5,0.9537567840416336,193,164,3,360
177,bright,sv3,6,0.9511977543318232,173,142,4,319
177,bright,sv3,7,0.9420575703450482,130,128,2,260
177,bright,sv3,8,0.9372979479477435,183,170,3,356
177,bright,sv3,9,0.916947420357437,144,186,2,332
178,bright,sv3,0,0.9523702882840083,179,186,2,367
178,bright,sv3,1,0.950090443056839,152,164,5,321
178,bright,sv3,2,0.9423399978708332,198,161,5,364
178,bright,sv3,3,0.9284665695381409,181,123,0,304
178,bright,sv3,4,0.944614856959549,183,159,4,346
178,bright,sv3,5,0.9485082893984019,156,199,5,360
178,bright,sv3,6,0.9115823505014202,171,145,3,319
178,bright,sv3,7,0.9611871130740368,123,149,2,274
178,bright,sv3,8,0.9693388311196667,159,185,3,347
178,bright,sv3,9,0.9610531771922896,164,177,4,345
179,bright,sv3,0,0.9627735388536995,168,183,4,355
179,bright,sv3,1,0.9466989558405088,146,151,3,300
179,bright,sv3,2,0.9630098022382854,189,171,5,365
179,bright,sv3,3,0.956753870573646,161,151,2,314
179,bright,sv3,4,0.950427875274093,153,182,5,340
179,bright,sv3,5,0.9080842563273058,93,91,2,186
179,bright,sv3,6,0.9416851509985646,153,151,0,304
179,bright,sv3,7,0.9280342530170376,129,122,8,259
179,bright,sv3,8,0.9550842954098734,179,161,3,343
179,bright,sv3,9,0.9569524122805252,161,153,4,318
180,bright,sv3,0,0.9431998220458435,134,160,0,294
180,bright,sv3,1,0.9291525637699147,147,167,4,318
180,bright,sv3,2,0.9624555409374046,194,175,2,371
180,bright,sv3,3,0.9321545679574412,170,134,3,307
180,bright,sv3,4,0.9591080646257861,179,148,3,330
180,bright,sv3,5,0.9691420162619659,166,182,3,351
180,bright,sv3,6,0.9457478914537402,141,162,0,303
180,bright,sv3,7,0.9644350230959525,117,157,3,277
180,bright,sv3,8,0.9529735937406378,163,175,5,343
180,bright,sv3,9,0.9634115085195961,156,165,3,324
181,bright,sv3,0,0.9556567048463868,184,169,5,358
181,bright,sv3,1,0.9625448300237437,176,136,7,319
181,bright,sv3,2,0.9255893659268245,216,155,2,373
181,bright,sv3,3,0.9600559883732869,189,130,2,321
181,bright,sv3,4,0.9621973445380743,165,166,3,334
181,bright,sv3,5,0.9578172153133487,172,171,4,347
181,bright,sv3,6,0.9369571792594772,160,143,2,305
181,bright,sv3,7,0.8999335125611853,142,127,1,270
181,bright,sv3,8,0.9534809612792712,127,138,8,273
181,bright,sv3,9,0.9469048091299659,154,173,4,331
182,bright,sv3,0,0.9614376619458262,202,186,4,392
182,bright,sv3,1,0.9549034330888753,194,161,2,357
182,bright,sv3,2,0.9733859594947721,241,165,3,409
182,bright,sv3,3,0.9585195117186849,200,170,2,372
182,bright,sv3,4,0.9727387845443581,196,171,4,371
182,bright,sv3,5,0.9711091492238159,197,189,2,388
182,bright,sv3,6,0.9588908033277345,151,156,1,308
182,bright,sv3,7,0.9625216699706526,170,169,1,340
182,bright,sv3,8,0.961082653454282,208,183,2,393
182,bright,sv3,9,0.9642897347679067,205,171,5,381
183,bright,sv3,0,0.9357461297295104,218,171,6,395
183,bright,sv3,1,0.9530618302997306,219,141,0,360
183,bright,sv3,2,0.9614878844817197,246,157,6,409
183,bright,sv3,3,0.9529718841142168,241,136,4,381
183,bright,sv3,4,0.9598062426333409,211,165,5,381
183,bright,sv3,5,0.9670440926801972,202,174,6,382
183,bright,sv3,6,0.9414486434133091,188,161,1,350
183,bright,sv3,7,0.9406751537481601,166,162,3,331
183,bright,sv3,8,0.9610183802921188,213,168,2,383
183,bright,sv3,9,0.9536419321096985,175,188,7,370
184,bright,sv3,0,0.9610091214189171,185,197,3,385
184,bright,sv3,1,0.9564940652774399,200,165,4,369
184,bright,sv3,2,0.9408347502540182,219,190,4,413
184,bright,sv3,3,0.9523107024321167,196,165,2,363
184,bright,sv3,4,0.9706854959111046,202,169,4,375
184,bright,sv3,5,0.9687095352512527,209,174,3,386
184,bright,sv3,6,0.9476725140142168,184,149,2,335
184,bright,sv3,7,0.9646495870949066,178,152,1,331
184,bright,sv3,8,0.9675446730549973,207,173,1,381
184,bright,sv3,9,0.9643847331878445,187,176,9,372
185,backup,sv3,0,0.952110806379922,1,319,0,320
185,backup,sv3,1,0.9363544563301829,6,269,2,277
185,backup,sv3,2,0.969071142057548,5,310,0,315
185,backup,sv3,3,0.9238940072525442,3,221,0,224
185,backup,sv3,4,0.9507041048191923,2,254,1,257
185,backup,sv3,5,0.9556192422624302,3,292,0,295
185,backup,sv3,6,0.9599798718781873,8,258,0,266
185,backup,sv3,7,0.9153094340723232,5,219,1,225
185,backup,sv3,8,0.9537913889734932,3,297,0,300
185,backup,sv3,9,0.937917330410867,2,255,1,258
186,backup,sv3,0,0.9321528124275698,3,209,1,213
186,backup,sv3,1,0.9072985866761313,1,198,1,200
186,backup,sv3,2,0.9404317048682526,2,227,2,231
186,backup,sv3,3,0.8949833698653423,4,203,0,207
186,backup,sv3,4,0.908161297249586,5,211,1,217
186,backup,sv3,5,0.9261515507462231,5,196,3,204
186,backup,sv3,6,0.9305923160782544,0,191,1,192
186,backup,sv3,7,0.92708924790404,1,190,2,193
186,backup,sv3,8,0.9201209684206371,5,200,4,209
186,backup,sv3,9,0.9007518201152354,1,217,3,221
187,backup,sv3,0,0.9267784294020619,1,290,0,291
187,backup,sv3,1,0.9331362667107375,11,252,3,266
187,backup,sv3,2,0.9418474895406728,9,271,3,283
187,backup,sv3,3,0.8981383471471553,11,242,1,254
187,backup,sv3,4,0.932061160628701,5,243,1,249
187,backup,sv3,5,0.959272236389654,17,262,0,279
187,backup,sv3,6,0.9336677666230813,1,249,4,254
187,backup,sv3,7,0.9451804621554941,5,223,1,229
187,backup,sv3,8,0.9449221892074862,4,268,1,273
187,backup,sv3,9,0.9676976889542017,3,269,2,274
190,dark,sv3,0,0.954833284730451,267,10,86,363
190,dark,sv3,1,0.9823019558809906,231,7,75,313
190,dark,sv3,2,0.9718162891357386,240,13,97,350
190,dark,sv3,3,0.9673222693712931,227,12,82,321
190,dark,sv3,4,0.9427728462057866,211,15,109,335
190,dark,sv3,5,0.9630564498497665,270,9,66,345
190,dark,sv3,6,0.9579398744894727,204,9,86,299
190,dark,sv3,7,0.958020190978731,193,9,77,279
190,dark,sv3,8,0.9532335016514221,242,16,101,359
190,dark,sv3,9,0.9424216182320172,261,10,74,345
191,dark,sv3,0,0.9692645198444224,290,9,68,367
191,dark,sv3,1,0.9743167231188727,240,13,74,327
191,dark,sv3,2,0.9692645198444224,268,12,84,364
191,dark,sv3,3,0.9444086288796398,246,11,63,320
191,dark,sv3,4,0.9435013977290012,237,9,80,326
191,dark,sv3,5,0.9661920837099832,262,14,71,347
191,dark,sv3,6,0.9419977186989043,236,12,50,298
191,dark,sv3,7,0.9376131278861666,221,12,72,305
191,dark,sv3,8,0.9390431334620615,242,15,74,331
191,dark,sv3,9,0.9297036111476331,284,10,63,357
192,dark,sv3,0,0.9659086345318517,288,11,65,364
192,dark,sv3,1,0.9192061283166936,231,11,54,296
192,dark,sv3,2,0.9339709813049742,245,10,81,336
192,dark,sv3,3,0.9260102593061297,235,8,51,294
192,dark,sv3,4,0.9396920125012568,233,11,64,308
192,dark,sv3,5,0.9651689108370965,269,8,66,343
192,dark,sv3,6,0.9595925465021852,223,11,45,279
192,dark,sv3,7,0.9423807238957618,205,10,58,273
192,dark,sv3,8,0.9361048172723171,246,8,72,326
192,dark,sv3,9,0.9419571585875682,270,8,55,333
193,dark,sv3,0,0.9715254597584035,306,10,52,368
193,dark,sv3,1,0.9268624819746674,241,11,68,320
193,dark,sv3,2,0.9622518204149995,270,8,69,347
193,dark,sv3,3,0.9578732407299224,226,7,53,286
193,dark,sv3,4,0.9673442877281248,236,9,74,319
193,dark,sv3,5,0.9631072378280002,291,7,59,357
193,dark,sv3,6,0.9360465381924122,221,10,51,282
193,dark,sv3,7,0.9246939849817004,216,10,52,278
193,dark,sv3,8,0.9535031328025863,262,10,67,339
193,dark,sv3,9,0.9483150570255418,266,12,55,333
194,dark,sv3,0,0.951189261825564,288,10,45,343
194,dark,sv3,1,0.9285735637039861,260,11,40,311
194,dark,sv3,2,0.9516585403858623,284,8,58,350
194,dark,sv3,3,0.9356102543864359,224,11,51,286
194,dark,sv3,4,0.9516287839329638,242,10,60,312
194,dark,sv3,5,0.9305309821530625,273,10,45,328
194,dark,sv3,6,0.9388674287361324,234,10,42,286
194,dark,sv3,7,0.9212189844957884,204,10,50,264
194,dark,sv3,8,0.9442306377563512,270,11,53,334
194,dark,sv3,9,0.9334912145391533,261,10,48,319
195,dark,sv3,0,0.9597269493210636,289,12,31,332
195,dark,sv3,1,0.9687245057223409,256,11,29,296
195,dark,sv3,2,0.9491091790874769,266,10,45,321
195,dark,sv3,3,0.946844236150407,242,10,37,289
195,dark,sv3,4,0.9451210365684761,240,11,48,299
195,dark,sv3,5,0.9634018861803804,266,13,39,318
195,dark,sv3,6,0.9609195533178775,231,10,45,286
195,dark,sv3,7,0.9473795653893982,216,10,48,274
195,dark,sv3,8,0.9515593864393622,270,11,40,321
195,dark,sv3,9,0.9357190421777751,282,11,26,319
196,dark,sv3,0,0.9520025915874678,303,8,17,328
196,dark,sv3,1,0.9606104659063459,255,11,31,297
196,dark,sv3,2,0.9251361256430626,264,10,33,307
196,dark,sv3,3,0.952294232120315,222,11,31,264
196,dark,sv3,4,0.929790265334312,249,12,30,291
196,dark,sv3,5,0.9558164645748864,290,9,24,323
196,dark,sv3,6,0.9526259809130659,242,10,30,282
196,dark,sv3,7,0.9110823671216919,218,10,29,257
196,dark,sv3,8,0.9230990476500415,256,10,30,296
196,dark,sv3,9,0.9354255165170509,255,8,35,298
197,dark,sv3,0,0.9582752001167747,302,16,25,343
197,dark,sv3,1,0.9664747268526036,255,13,23,291
197,dark,sv3,2,0.9488047030447679,261,13,33,307
197,dark,sv3,3,0.9424648130255745,235,10,27,272
197,dark,sv3,4,0.9633457877953979,249,11,37,297
197,dark,sv3,5,0.9782508094341662,267,10,27,304
197,dark,sv3,6,0.938202242224217,234,10,21,265
197,dark,sv3,7,0.9483539665649626,201,10,24,235
197,dark,sv3,8,0.9434351832595779,265,13,19,297
197,dark,sv3,9,0.9475991552112154,283,11,24,318
198,dark,sv3,0,0.9341142616797784,280,13,24,317
198,dark,sv3,1,0.956921892130147,236,16,18,270
198,dark,sv3,2,0.9211259819997242,258,13,23,294
198,dark,sv3,3,0.9488638104520947,235,14,28,277
198,dark,sv3,4,0.9395616812642578,262,11,12,285
198,dark,sv3,5,0.9538803852245157,262,9,20,291
198,dark,sv3,6,0.9416790448069009,218,11,19,248
198,dark,sv3,7,0.9381421217329143,217,9,32,258
198,dark,sv3,8,0.9750772623522985,259,12,30,301
198,dark,sv3,9,0.9522282794786328,257,10,25,292
199,dark,sv3,0,0.9283669218874161,260,15,18,293
199,dark,sv3,1,0.9429595082918171,231,14,17,262
199,dark,sv3,2,0.9378404875663868,254,10,20,284
199,dark,sv3,3,0.953118253929576,200,12,20,232
199,dark,sv3,4,0.9287267275376689,228,13,27,268
199,dark,sv3,5,0.9483626520207825,239,14,17,270
199,dark,sv3,6,0.9018110939373564,202,11,16,229
199,dark,sv3,7,0.9289870937167547,202,12,19,233
199,dark,sv3,8,0.932540474723081,213,12,14,239
199,dark,sv3,9,0.9591318018960706,255,15,20,290
200,dark,sv3,0,0.9492220871324568,300,13,29,342
200,dark,sv3,1,0.8955570990366789,282,15,22,319
200,dark,sv3,2,0.9655389983377511,302,15,22,339
200,dark,sv3,3,0.9314070854562964,271,14,14,299
200,dark,sv3,4,0.9512040809531584,262,11,28,301
200,dark,sv3,5,0.966701918571329,276,15,25,316
200,dark,sv3,6,0.9644672766451349,204,13,22,239
200,dark,sv3,7,0.9418455048045188,256,11,29,296
200,dark,sv3,8,0.9545630990610252,305,15,24,344
200,dark,sv3,9,0.9333683709799215,286,16,33,335
201,bright,sv3,0,0.9589403089306721,342,53,4,399
201,bright,sv3,1,0.9436070693537831,316,42,3,361
201,bright,sv3,2,0.9664702436446961,324,61,5,390
201,bright,sv3,3,0.95758088465694,308,27,5,340
201,bright,sv3,4,0.9671283873575517,278,65,5,348
201,bright,sv3,5,0.946861713383173,306,60,4,370
201,bright,sv3,6,0.9655778122390549,283,48,3,334
201,bright,sv3,7,0.9535458946705055,250,44,3,297
201,bright,sv3,8,0.9532607354154229,327,55,5,387
201,bright,sv3,9,0.966286342117981,330,34,1,365
202,bright,sv3,0,0.9577735080120974,277,96,4,377
202,bright,sv3,1,0.9789794234032467,286,65,1,352
202,bright,sv3,2,0.966230115290607,280,84,5,369
202,bright,sv3,3,0.950404557445078,252,61,2,315
202,bright,sv3,4,0.9416762299933034,256,85,6,347
202,bright,sv3,5,0.967605641431747,257,106,7,370
202,bright,sv3,6,0.9433580055650923,213,81,3,297
202,bright,sv3,7,0.9423566455164043,210,74,5,289
202,bright,sv3,8,0.9497556042922757,258,100,3,361
202,bright,sv3,9,0.9568523784491935,298,72,4,374
203,bright,sv3,0,0.9213165887966517,210,122,5,337
203,bright,sv3,1,0.9734590574844553,220,101,0,321
203,bright,sv3,2,0.9547507544333682,242,106,3,351
203,bright,sv3,3,0.9321091977876654,191,97,2,290
203,bright,sv3,4,0.9338622606784427,210,113,2,325
203,bright,sv3,5,0.968184526033931,213,127,2,342
203,bright,sv3,6,0.9406391652238504,178,99,2,279
203,bright,sv3,7,0.9273841748627771,179,94,4,277
203,bright,sv3,8,0.9211811235503322,202,117,3,322
203,bright,sv3,9,0.9663030706755308,251,93,5,349
204,bright,sv3,0,0.9523744672583903,121,164,3,288
204,bright,sv3,1,0.9390960047395973,166,112,1,279
204,bright,sv3,2,0.8196196616873358,59,35,2,96
204,bright,sv3,3,0.9567957127353507,167,114,2,283
204,bright,sv3,4,0.9661018654378605,152,120,2,274
204,bright,sv3,5,0.9343789417913432,158,129,2,289
204,bright,sv3,6,0.9025893587243151,130,113,3,246
204,bright,sv3,7,0.9266615090817404,132,96,2,230
204,bright,sv3,8,0.9398471680026002,150,114,0,264
204,bright,sv3,9,0.9655841314314996,171,136,3,310
205,bright,sv3,0,0.96023443232572,173,189,5,367
205,bright,sv3,1,0.9297760947250442,189,148,2,339
205,bright,sv3,2,0.953137295241044,206,170,5,381
205,bright,sv3,3,0.9528646234379559,168,136,4,308
205,bright,sv3,4,0.9544168094080191,171,155,2,328
205,bright,sv3,5,0.9476611575827909,188,136,3,327
205,bright,sv3,6,0.9531915729544342,168,148,1,317
205,bright,sv3,7,0.9641147129834212,139,134,6,279
205,bright,sv3,8,0.9335233417052935,180,170,3,353
205,bright,sv3,9,0.9663251463393923,199,160,5,364
206,bright,sv3,0,0.9644471490136625,182,185,9,376
206,bright,sv3,1,0.9317601033210511,162,158,5,325
206,bright,sv3,2,0.9403245557577702,183,179,2,364
206,bright,sv3,3,0.9185530686726603,178,148,3,329
206,bright,sv3,4,0.9542484281279318,154,169,3,326
206,bright,sv3,5,0.9652716162228574,195,159,1,355
206,bright,sv3,6,0.9489791592749409,159,140,2,301
206,bright,sv3,7,0.9369790865896738,135,129,2,266
206,bright,sv3,8,0.9665283542030046,191,172,1,364
206,bright,sv3,9,0.9336436253577272,192,153,6,351
207,bright,sv3,0,0.9769612972123181,148,141,6,295
207,bright,sv3,1,0.9301063966449183,161,177,1,339
207,bright,sv3,2,0.9449303307625334,194,173,1,368
207,bright,sv3,3,0.9481218626446408,165,153,3,321
207,bright,sv3,4,0.9370831641209068,173,161,4,338
207,bright,sv3,5,0.938232147670925,196,143,8,347
207,bright,sv3,6,0.9387398298552353,172,142,2,316
207,bright,sv3,7,0.9501158558630176,143,130,6,279
207,bright,sv3,8,0.9561435135897832,175,167,4,346
207,bright,sv3,9,0.9448489702473631,194,137,2,333
208,bright,sv3,0,0.9672373204504372,184,183,5,372
208,bright,sv3,1,0.9748124774286944,162,158,3,323
208,bright,sv3,2,0.9620565638509659,199,161,2,362
208,bright,sv3,3,0.9455114687607598,186,133,2,321
208,bright,sv3,4,0.9311740692752324,174,153,4,331
208,bright,sv3,5,0.952849739445162,166,171,2,339
208,bright,sv3,6,0.9429611196047315,175,124,3,302
208,bright,sv3,7,0.929855055031317,129,139,2,270
208,bright,sv3,8,0.9679730296574436,180,174,1,355
208,bright,sv3,9,0.9555866367808356,196,147,7,350
209,bright,sv3,0,0.9759234867423412,201,159,3,363
209,bright,sv3,1,0.966766476284977,174,139,5,318
209,bright,sv3,2,0.9449971012309464,207,158,6,371
209,bright,sv3,3,0.959630610781352,182,138,5,325
209,bright,sv3,4,0.9544499224424775,184,146,4,334
209,bright,sv3,5,0.9651689108370965,187,144,9,340
209,bright,sv3,6,0.9546493720546549,169,135,2,306
209,bright,sv3,7,0.9668750994922891,134,118,4,256
209,bright,sv3,8,0.9156382741726605,127,113,3,243
209,bright,sv3,9,0.9712669980196564,195,166,2,363
210,bright,sv3,0,0.962908398331347,194,164,7,365
210,bright,sv3,1,0.9674743714166605,189,141,2,332
210,bright,sv3,2,0.9696859443289425,211,149,4,364
210,bright,sv3,3,0.9358467181070581,200,128,3,331
210,bright,sv3,4,0.9631662460956133,203,132,4,339
210,bright,sv3,5,0.9520062434008281,190,151,3,344
210,bright,sv3,6,0.9410371819723145,172,127,7,306
210,bright,sv3,7,0.9305702574840544,145,112,3,260
210,bright,sv3,8,0.9442993676734708,195,148,3,346
210,bright,sv3,9,0.9291600186821639,196,147,2,345
211,bright,sv3,0,0.924210187876221,169,146,3,318
211,bright,sv3,1,0.9393292519744032,196,137,5,338
211,bright,sv3,2,0.9604695609307495,218,152,2,372
211,bright,sv3,3,0.971209378475575,176,132,4,312
211,bright,sv3,4,0.9616660984977784,185,146,4,335
211,bright,sv3,5,0.9562664494721558,197,140,5,342
211,bright,sv3,6,0.9577359665133978,167,137,1,305
211,bright,sv3,7,0.9386414835737661,150,124,2,276
211,bright,sv3,8,0.9472218355506127,186,151,1,338
211,bright,sv3,9,0.9667919299497236,203,151,2,356
212,backup,sv3,0,0.9530700853213683,4,333,0,337
212,backup,sv3,1,0.9619376539145607,1,302,2,305
212,backup,sv3,2,0.9553363607317625,4,312,4,320
212,backup,sv3,3,0.951250045825342,3,280,1,284
212,backup,sv3,4,0.9586978697098252,3,281,0,284
212,backup,sv3,5,0.9607086424208514,6,283,0,289
212,backup,sv3,6,0.9431588601773708,6,264,0,270
212,backup,sv3,7,0.929678941451282,4,229,0,233
212,backup,sv3,8,0.9414595813821048,1,309,0,310
212,backup,sv3,9,0.9545348881316703,1,316,0,317
213,backup,sv3,0,0.9271844345548776,6,287,1,294
213,backup,sv3,1,0.9497612443635751,2,263,1,266
213,backup,sv3,2,0.9669576300798776,2,299,2,303
213,backup,sv3,3,0.9283204155783257,8,261,0,269
213,backup,sv3,4,0.9436033113938831,5,257,3,265
213,backup,sv3,5,0.9673670930538805,5,284,0,289
213,backup,sv3,6,0.9076919746724394,5,248,0,253
213,backup,sv3,7,0.8822531325829027,3,207,1,211
213,backup,sv3,8,0.9323880122240937,4,284,3,291
213,backup,sv3,9,0.9538511637831395,2,301,1,304
214,backup,sv3,0,0.9573238673230439,5,298,3,306
214,backup,sv3,1,0.93731418024586,4,260,0,264
214,backup,sv3,2,0.9535442128013362,4,276,1,281
214,backup,sv3,3,0.9600405818371521,3,254,1,258
214,backup,sv3,4,0.9414054172933299,6,261,0,267
214,backup,sv3,5,0.8920343054109755,9,261,1,271
214,backup,sv3,6,0.954228175828987,3,247,0,250
214,backup,sv3,7,0.9306451488746027,1,201,1,203
214,backup,sv3,8,0.9459139994943125,5,272,1,278
214,backup,sv3,9,0.8958048553727176,5,291,1,297
215,backup,sv3,0,0.9131932276113881,6,295,1,302
215,backup,sv3,1,0.941226785090584,2,253,0,255
215,backup,sv3,2,0.9499398908840047,9,294,2,305
215,backup,sv3,3,0.9594605594407395,7,248,1,256
215,backup,sv3,4,0.9608445919131083,5,273,1,279
215,backup,sv3,5,0.9055827638290703,10,259,1,270
215,backup,sv3,6,0.9385770559277017,5,239,0,244
215,backup,sv3,7,0.8818849590919977,3,198,1,202
215,backup,sv3,8,0.9097553513221479,1,191,0,192
215,backup,sv3,9,0.9570486117500195,4,282,0,286
217,dark,sv3,0,0.9485318812224799,214,11,86,311
217,dark,sv3,1,0.945185174797243,197,14,60,271
217,dark,sv3,2,0.9712673672596988,217,18,82,317
217,dark,sv3,3,0.9677361473727373,200,12,81,293
217,dark,sv3,4,0.9612484248276317,186,9,100,295
217,dark,sv3,5,0.966170466836235,239,17,77,333
217,dark,sv3,6,0.9243210430090575,180,13,87,280
217,dark,sv3,7,0.9297191423248328,176,11,63,250
217,dark,sv3,8,0.9638881452009801,225,10,82,317
217,dark,sv3,9,0.945625813913006,219,15,75,309
218,dark,sv3,0,0.9684217712036984,264,14,59,337
218,dark,sv3,1,0.9469354532512276,185,14,83,282
218,dark,sv3,2,0.966592421689746,255,9,77,341
218,dark,sv3,3,0.9392232833689543,227,12,64,303
218,dark,sv3,4,0.9040648206741624,227,15,81,323
218,dark,sv3,5,0.949084049180316,248,16,58,322
218,dark,sv3,6,0.9234210191416824,230,10,54,294
218,dark,sv3,7,0.9405960237222907,208,11,53,272
218,dark,sv3,8,0.9474510399955487,222,11,54,287
218,dark,sv3,9,0.96008960927079,242,17,72,331
219,dark,sv3,0,0.9533745849307552,263,10,66,339
219,dark,sv3,1,0.941517243036481,209,10,59,278
219,dark,sv3,2,0.9558839425517074,257,8,67,332
219,dark,sv3,3,0.9559828454958295,242,11,45,298
219,dark,sv3,4,0.967206745933009,249,10,63,322
219,dark,sv3,5,0.9604030144410027,267,10,44,321
219,dark,sv3,6,0.9386414835737659,216,8,52,276
219,dark,sv3,7,0.9363233183035347,201,11,42,254
219,dark,sv3,8,0.9484368893516815,259,11,48,318
219,dark,sv3,9,0.9562435369094762,246,10,68,324
220,dark,sv3,0,0.930652209972679,261,11,55,327
220,dark,sv3,1,0.9618429739261227,235,9,59,303
220,dark,sv3,2,0.9736547259016033,283,10,48,341
220,dark,sv3,3,0.9289583531756147,200,13,52,265
220,dark,sv3,4,0.9313165369752818,240,12,63,315
220,dark,sv3,5,0.9010627376288529,253,11,57,321
220,dark,sv3,6,0.9482231902270324,218,11,48,277
220,dark,sv3,7,0.9377542621815264,212,13,46,271
220,dark,sv3,8,0.9518185034873596,247,10,54,311
220,dark,sv3,9,0.9319586644475338,258,10,50,318
221,dark,sv3,0,0.9327251512263526,241,15,59,315
221,dark,sv3,1,0.9758573167927473,239,12,52,303
221,dark,sv3,2,0.9369728091517553,254,10,54,318
221,dark,sv3,3,0.9306542959330905,224,9,43,276
221,dark,sv3,4,0.9339130157564776,235,8,54,297
221,dark,sv3,5,0.9450526273958451,267,7,37,311
221,dark,sv3,6,0.9242058037634319,218,10,43,271
221,dark,sv3,7,0.9100750992021197,190,10,38,238
221,dark,sv3,8,0.9515319102287788,253,9,47,309
221,dark,sv3,9,0.947501265451512,238,10,59,307
222,dark,sv3,0,0.9199161866420664,278,10,42,330
222,dark,sv3,1,0.9401868468746031,246,13,40,299
222,dark,sv3,2,0.9459124071715866,267,10,34,311
222,dark,sv3,3,0.955440695360129,242,8,35,285
222,dark,sv3,4,0.9434055133274011,230,10,50,290
222,dark,sv3,5,0.928646521137295,273,13,32,318
222,dark,sv3,6,0.9498479208512284,224,9,32,265
222,dark,sv3,7,0.9627890488847705,189,10,43,242
222,dark,sv3,8,0.9583917480171189,257,10,43,310
222,dark,sv3,9,0.9049877096746087,250,10,30,290
223,dark,sv3,0,0.938354836396363,267,10,20,297
223,dark,sv3,1,0.9364348833663388,239,9,36,284
223,dark,sv3,2,0.9364348833663388,239,9,36,284
223,dark,sv3,3,0.9566485670981416,255,12,32,299
223,dark,sv3,4,0.953706287045862,237,9,33,279
223,dark,sv3,5,0.9660711987379742,277,12,27,316
223,dark,sv3,6,0.9489753889057395,243,9,20,272
223,dark,sv3,7,0.9281818499378611,194,10,24,228
223,dark,sv3,8,0.9363544563301827,240,10,28,278
223,dark,sv3,9,0.9112564752363358,243,11,33,287
224,dark,sv3,0,0.9538633731383878,244,10,32,286
224,dark,sv3,1,0.9398471680025999,223,12,32,267
224,dark,sv3,2,0.9506690865698857,258,9,21,288
224,dark,sv3,3,0.9726185097254355,253,10,25,288
224,dark,sv3,4,0.9424422469319741,255,14,30,299
224,dark,sv3,5,0.9439117519322052,255,10,23,288
224,dark,sv3,6,0.9370641716003647,223,11,10,244
224,dark,sv3,7,0.9159629420894339,195,9,22,226
224,dark,sv3,8,0.9221187547294127,218,12,20,250
224,dark,sv3,9,0.9636048170911394,234,8,24,266
225,dark,sv3,0,0.9277769384082866,225,13,15,253
225,dark,sv3,1,0.8908509359047916,217,16,16,249
225,dark,sv3,2,0.9385846312363262,259,11,14,284
225,dark,sv3,3,0.9097656022622086,218,11,18,247
225,dark,sv3,4,0.9083426529240809,232,12,19,263
225,dark,sv3,5,0.8792660451984251,115,5,6,126
225,dark,sv3,6,0.9185837287259236,205,10,16,231
225,dark,sv3,7,0.9407169458044061,184,12,18,214
225,dark,sv3,8,0.9632658302099918,237,14,26,277
225,dark,sv3,9,0.9430092293957939,211,17,19,247
226,dark,sv3,0,0.963488992996496,223,19,9,251
226,dark,sv3,1,0.9445938240355228,192,15,15,222
226,dark,sv3,2,0.9384836069584497,234,14,16,264
226,dark,sv3,3,0.9141233127950154,188,18,25,231
226,dark,sv3,4,0.9372226192020976,209,10,19,238
226,dark,sv3,5,0.9234780855354086,224,14,16,254
226,dark,sv3,6,0.9113418947998284,170,13,8,191
226,dark,sv3,7,0.8899420074314784,156,10,11,177
226,dark,sv3,8,0.9386607885814277,194,13,8,215
226,dark,sv3,9,0.9226059668385796,203,19,13,235
227,dark,sv3,0,0.96785658791014,251,18,27,296
227,dark,sv3,1,0.9414469848994591,217,20,21,258
227,dark,sv3,2,0.9540586209432155,248,19,21,288
227,dark,sv3,3,0.9386240123680566,235,16,16,267
227,dark,sv3,4,0.9696806623272133,248,15,13,276
227,dark,sv3,5,0.9612622698152986,247,18,10,275
227,dark,sv3,6,0.9083395412018301,186,10,15,211
227,dark,sv3,7,0.9096444607965853,230,21,17,268
227,dark,sv3,8,0.9430171431487598,268,17,22,307
227,dark,sv3,9,0.9546274343696743,206,20,29,255
228,bright,sv3,0,0.936598184356623,347,56,5,408
228,bright,sv3,1,0.9584709823943764,315,60,2,377
228,bright,sv3,2,0.9768210082357549,344,54,5,403
228,bright,sv3,3,0.965823976372261,334,32,0,366
228,bright,sv3,4,0.9682007059707607,338,31,5,374
228,bright,sv3,5,0.9701893358193104,367,20,10,397
228,bright,sv3,6,0.9579743255027378,323,14,6,343
228,bright,sv3,7,0.944917677219283,297,32,5,334
228,bright,sv3,8,0.9617395356995154,359,41,2,402
228,bright,sv3,9,0.9754157165929139,347,45,4,396
229,bright,sv3,0,0.9536384790349905,281,125,1,407
229,bright,sv3,1,0.9758601836895611,247,109,4,360
229,bright,sv3,2,0.9479536098533657,264,133,3,400
229,bright,sv3,3,0.9517577017997172,296,54,1,351
229,bright,sv3,4,0.9487782501872233,311,61,1,373
229,bright,sv3,5,0.9703952782709693,327,64,3,394
229,bright,sv3,6,0.9274135095059357,284,48,3,335
229,bright,sv3,7,0.9086843027320314,248,49,2,299
229,bright,sv3,8,0.9423345843787759,269,101,9,379
229,bright,sv3,9,0.9760428126140306,297,84,3,384
230,bright,sv3,0,0.9781149758439779,206,193,2,401
230,bright,sv3,1,0.9394455801743414,180,164,4,348
230,bright,sv3,2,0.9654888594724474,192,194,1,387
230,bright,sv3,3,0.9339637708226503,211,126,2,339
230,bright,sv3,4,0.9606104822414491,270,89,3,362
230,bright,sv3,5,0.9794458228437846,262,117,2,381
230,bright,sv3,6,0.9384068026554414,240,93,1,334
230,bright,sv3,7,0.946779694498392,198,99,1,298
230,bright,sv3,8,0.9437874255204429,236,148,4,388
230,bright,sv3,9,0.9591318729791241,258,109,5,372
231,bright,sv3,0,0.9566432186176554,152,237,1,390
231,bright,sv3,1,0.9457095789110176,149,206,4,359
231,bright,sv3,2,0.962675215497937,172,214,5,391
231,bright,sv3,3,0.9664786798554925,189,140,5,334
231,bright,sv3,4,0.9450531509633,222,135,3,360
231,bright,sv3,5,0.9703017678063776,214,161,2,377
231,bright,sv3,6,0.9504568029045046,172,157,2,331
231,bright,sv3,7,0.9613615634227725,172,122,2,296
231,bright,sv3,8,0.9613210303698362,165,197,5,367
231,bright,sv3,9,0.9564656726104221,161,207,2,370
232,bright,sv3,0,0.9740668349943621,143,249,1,393
232,bright,sv3,1,0.9641137743148376,122,218,1,341
232,bright,sv3,2,0.9728762776576336,128,266,0,394
232,bright,sv3,3,0.9461960634067237,158,177,4,339
232,bright,sv3,4,0.9719895572405223,169,186,2,357
232,bright,sv3,5,0.8601502975027013,93,97,0,190
232,bright,sv3,6,0.9557722572340385,128,194,1,323
232,bright,sv3,7,0.9575643257312598,137,159,1,297
232,bright,sv3,8,0.9562650934538416,116,248,6,370
232,bright,sv3,9,0.9549019378841256,146,226,2,374
233,bright,sv3,0,0.9563611104478575,110,284,1,395
233,bright,sv3,1,0.9638235139178929,103,244,1,348
233,bright,sv3,2,0.9460673823210085,139,251,1,391
233,bright,sv3,3,0.9279840519522523,100,173,2,275
233,bright,sv3,4,0.96421853128221,163,190,3,356
233,bright,sv3,5,0.9638564975686186,160,205,7,372
233,bright,sv3,6,0.957854704134639,124,193,1,318
233,bright,sv3,7,0.9427469198758892,127,153,4,284
233,bright,sv3,8,0.950696986761134,136,243,2,381
233,bright,sv3,9,0.9641445056690254,128,229,5,362
234,bright,sv3,0,0.9447443231243547,131,256,0,387
234,bright,sv3,1,0.9445556157634954,99,247,1,347
234,bright,sv3,2,0.9550835994762609,123,259,2,384
234,bright,sv3,3,0.9437779489811036,137,192,2,331
234,bright,sv3,4,0.9477720058423637,169,181,2,352
234,bright,sv3,5,0.957085924719985,155,199,2,356
234,bright,sv3,6,0.9513283395627944,136,185,2,323
234,bright,sv3,7,0.9573984597615699,116,171,3,290
234,bright,sv3,8,0.9638728869532626,97,213,2,312
234,bright,sv3,9,0.9202205331815606,105,265,2,372
235,bright,sv3,0,0.9595709484856029,146,273,2,421
235,bright,sv3,1,0.9613122988082055,123,261,1,385
235,bright,sv3,2,0.9582360429621469,142,282,1,425
235,bright,sv3,3,0.9718725516343453,176,207,1,384
235,bright,sv3,4,0.9711293750825426,166,229,4,399
235,bright,sv3,5,0.974296450939249,162,248,3,413
235,bright,sv3,6,0.9575005537553134,126,202,0,328
235,bright,sv3,7,0.9655219735521922,113,238,3,354
235,bright,sv3,8,0.9464272153073404,134,283,3,420
235,bright,sv3,9,0.9570975771798009,146,277,4,427
236,bright,sv3,0,0.9741322654073468,150,267,2,419
236,bright,sv3,1,0.9487947946603142,127,254,2,383
236,bright,sv3,2,0.964441795022545,157,252,2,411
236,bright,sv3,3,0.9459457932723093,147,176,4,327
236,bright,sv3,4,0.973417199455266,162,237,7,406
236,bright,sv3,5,0.9584642538135393,174,227,2,403
236,bright,sv3,6,0.9480246962070166,144,221,1,366
236,bright,sv3,7,0.946003045546557,151,211,1,363
236,bright,sv3,8,0.9545620750986584,148,264,2,414
236,bright,sv3,9,0.9602189608620738,153,270,4,427
237,bright,sv3,0,0.9516921503896776,173,249,0,422
237,bright,sv3,1,0.9625194651719002,130,258,4,392
237,bright,sv3,2,0.9630198380504725,159,258,2,419
237,bright,sv3,3,0.9683211997641438,184,208,2,394
237,bright,sv3,4,0.963092479984506,175,216,3,394
237,bright,sv3,5,0.9521644049425786,190,224,3,417
237,bright,sv3,6,0.9684038655051016,155,205,1,361
237,bright,sv3,7,0.9425595976441945,130,222,4,356
237,bright,sv3,8,0.9390666673040018,152,263,5,420
237,bright,sv3,9,0.9298828497121413,177,243,1,421
238,bright,sv3,0,0.9558557602314574,170,261,4,435
238,bright,sv3,1,0.9719740815222386,138,251,2,391
238,bright,sv3,2,0.9512066912193117,168,256,1,425
238,bright,sv3,3,0.9571924324864567,180,206,2,388
238,bright,sv3,4,0.9636496768493091,186,208,5,399
238,bright,sv3,5,0.9686477037838702,211,201,4,416
238,bright,sv3,6,0.9648991478910453,164,201,4,369
238,bright,sv3,7,0.95115200346372,137,211,2,350
238,bright,sv3,8,0.9570814326802636,166,252,4,422
238,bright,sv3,9,0.9723015189645244,178,234,4,416
244,dark,sv3,0,0.9812209861399553,228,20,88,336
244,dark,sv3,1,0.9484580135377247,223,13,79,315
244,dark,sv3,2,0.9513311887445995,263,14,76,353
244,dark,sv3,3,0.9367720699882023,203,15,84,302
244,dark,sv3,4,0.9652414022813366,223,12,92,327
244,dark,sv3,5,0.9768068451780736,241,10,98,349
244,dark,sv3,6,0.9613610881646855,199,14,74,287
244,dark,sv3,7,0.9497223447711072,180,13,64,257
244,dark,sv3,8,0.946411199432901,240,17,77,334
244,dark,sv3,9,0.957572558229001,217,16,94,327
245,dark,sv3,0,0.9667887993272469,259,15,61,335
245,dark,sv3,1,0.9491139801540843,228,8,53,289
245,dark,sv3,2,0.9694896202141773,260,17,62,339
245,dark,sv3,3,0.9073483142279921,216,12,64,292
245,dark,sv3,4,0.9709383933673801,209,11,63,283
245,dark,sv3,5,0.9459728708848391,248,12,73,333
245,dark,sv3,6,0.9526259809130659,227,11,44,282
245,dark,sv3,7,0.9383310505390037,187,10,50,247
245,dark,sv3,8,0.9148060686942153,221,10,59,290
245,dark,sv3,9,0.9389796606116229,242,14,69,325
246,dark,sv3,0,0.955698645306545,246,14,59,319
246,dark,sv3,1,0.9375207795994579,224,12,50,286
246,dark,sv3,2,0.9280932849781123,283,11,32,326
246,dark,sv3,3,0.9661707346012421,236,9,54,299
246,dark,sv3,4,0.9709170412301114,237,10,62,309
246,dark,sv3,5,0.9516559077272982,238,11,58,307
246,dark,sv3,6,0.9240445721698669,198,13,61,272
246,dark,sv3,7,0.8966634256745504,187,9,52,248
246,dark,sv3,8,0.9533454544017151,228,13,64,305
246,dark,sv3,9,0.95030241249972,239,12,71,322
247,dark,sv3,0,0.9543386254714477,271,9,55,335
247,dark,sv3,1,0.9044026072466888,243,8,35,286
247,dark,sv3,2,0.9439359983769601,257,12,48,317
247,dark,sv3,3,0.9615827567920144,236,10,52,298
247,dark,sv3,4,0.9531915729544342,240,11,65,316
247,dark,sv3,5,0.9433831575694295,256,10,57,323
247,dark,sv3,6,0.9531648028073426,215,10,47,272
247,dark,sv3,7,0.9207645756896853,199,11,49,259
247,dark,sv3,8,0.9700833833315504,247,7,55,309
247,dark,sv3,9,0.956536379447011,249,14,54,317
248,dark,sv3,0,0.9567179416686644,266,12,38,316
248,dark,sv3,1,0.9468840675718595,241,9,48,298
248,dark,sv3,2,0.9538036768218401,276,10,37,323
248,dark,sv3,3,0.934019074488438,197,9,48,254
248,dark,sv3,4,0.9264312172122914,235,10,50,295
248,dark,sv3,5,0.9519108112715543,256,8,54,318
248,dark,sv3,6,0.9226942520359123,209,12,33,254
248,dark,sv3,7,0.9468079785480639,193,11,48,252
248,dark,sv3,8,0.9480757872684586,229,10,54,293
248,dark,sv3,9,0.9563368343410087,239,9,59,307
249,dark,sv3,0,0.9428046288722816,279,11,33,323
249,dark,sv3,1,0.9457675767940875,273,8,38,319
249,dark,sv3,2,0.9690227153832479,283,10,28,321
249,dark,sv3,3,0.9415134677648035,247,11,33,291
249,dark,sv3,4,0.9435845232570935,265,10,43,318
249,dark,sv3,5,0.9488612660700326,295,9,37,341
249,dark,sv3,6,0.9431374890340153,234,9,32,275
249,dark,sv3,7,0.9547243535820154,201,8,49,258
249,dark,sv3,8,0.9232581770407613,274,12,52,338
249,dark,sv3,9,0.9555360852622005,275,13,51,339
250,dark,sv3,0,0.9364132648420732,273,10,27,310
250,dark,sv3,1,0.9590090281048556,249,10,25,284
250,dark,sv3,2,0.9738508136355616,269,10,31,310
250,dark,sv3,3,0.9628835600979072,252,11,20,283
250,dark,sv3,4,0.9160533243703178,251,11,32,294
250,dark,sv3,5,0.9622280684165889,270,10,26,306
250,dark,sv3,6,0.9363849922245245,244,10,32,286
250,dark,sv3,7,0.9020043441737174,208,8,35,251
250,dark,sv3,8,0.9766470392668752,292,11,24,327
250,dark,sv3,9,0.9589060451272478,262,11,29,302
251,dark,sv3,0,0.9495128271950417,229,12,26,267
251,dark,sv3,1,0.9401365970677021,257,10,23,290
251,dark,sv3,2,0.9439530393884297,259,13,21,293
251,dark,sv3,3,0.9544355354632047,240,12,22,274
251,dark,sv3,4,0.9403342345434287,241,12,16,269
251,dark,sv3,5,0.9499269946413127,264,9,17,290
251,dark,sv3,6,0.9353039303443896,237,11,8,256
251,dark,sv3,7,0.9353760682020741,214,9,21,244
251,dark,sv3,8,0.9564837316548246,252,10,12,274
251,dark,sv3,9,0.9403570721140506,254,13,26,293
252,dark,sv3,0,0.9519256689740405,242,24,13,279
252,dark,sv3,1,0.9270200570102738,217,10,22,249
252,dark,sv3,2,0.9365405553894133,242,20,15,277
252,dark,sv3,3,0.932032949116588,215,13,17,245
252,dark,sv3,4,0.9294436612652442,248,13,14,275
252,dark,sv3,5,0.9600949243379745,260,14,13,287
252,dark,sv3,6,0.9297989189904836,209,15,14,238
252,dark,sv3,7,0.9262808364356109,217,12,25,254
252,dark,sv3,8,0.9330876809732056,226,16,30,272
252,dark,sv3,9,0.9303560105305742,244,13,26,283
253,dark,sv3,0,0.926898023596414,235,14,14,263
253,dark,sv3,1,0.9742853342547314,221,12,16,249
253,dark,sv3,2,0.9389788699839875,219,21,15,255
253,dark,sv3,3,0.9587696942641754,199,13,10,222
253,dark,sv3,4,0.9517677740436132,213,14,26,253
253,dark,sv3,5,0.9471695756277797,227,12,12,251
253,dark,sv3,6,0.9189564730746719,203,15,8,226
253,dark,sv3,7,0.8630959878955322,186,9,18,213
253,dark,sv3,8,0.9601211191630834,251,17,8,276
253,dark,sv3,9,0.9396661103103076,214,20,11,245
254,dark,sv3,0,0.952924813267588,210,17,21,248
254,dark,sv3,1,0.923005627084093,189,17,16,222
254,dark,sv3,2,0.927271412594466,204,21,9,234
254,dark,sv3,3,0.9558569088813167,183,15,16,214
254,dark,sv3,4,0.9570638154730821,200,17,9,226
254,dark,sv3,5,0.9345420704246229,202,18,12,232
254,dark,sv3,6,0.9067180438146449,174,15,7,196
254,dark,sv3,7,0.9091388291404231,179,12,16,207
254,dark,sv3,8,0.9277929019440734,193,15,22,230
254,dark,sv3,9,0.936799987323693,205,18,12,235
255,bright,sv3,0,0.9622851107249956,337,50,1,388
255,bright,sv3,1,0.9404857050972596,292,31,4,327
255,bright,sv3,2,0.9808482866746769,345,19,2,366
255,bright,sv3,3,0.9507952604273384,303,24,3,330
255,bright,sv3,4,0.9833510205662116,295,45,4,344
255,bright,sv3,5,0.9600672691668907,320,46,4,370
255,bright,sv3,6,0.9466698686482016,277,36,6,319
255,bright,sv3,7,0.9459051984644169,247,27,2,276
255,bright,sv3,8,0.9380487904293631,284,38,3,325
255,bright,sv3,9,0.9646214841405848,302,68,4,374
256,bright,sv3,0,0.9561895016131491,297,99,2,398
256,bright,sv3,1,0.9401452065362893,311,47,2,360
256,bright,sv3,2,0.9747981878827904,345,45,4,394
256,bright,sv3,3,0.9536778319750341,264,52,3,319
256,bright,sv3,4,0.9498910679551387,275,84,4,363
256,bright,sv3,5,0.9582678923555848,288,94,4,386
256,bright,sv3,6,0.933692289078051,236,74,3,313
256,bright,sv3,7,0.9578595730144609,234,76,3,313
256,bright,sv3,8,0.9700077644260823,286,91,3,380
256,bright,sv3,9,0.9674889293110551,277,106,5,388
257,bright,sv3,0,0.9734068068937245,235,171,3,409
257,bright,sv3,1,0.942349140395812,229,129,4,362
257,bright,sv3,2,0.9629189955896496,261,91,2,354
257,bright,sv3,3,0.9341201188763972,264,81,3,348
257,bright,sv3,4,0.9763620864195997,226,133,5,364
257,bright,sv3,5,0.9490800775253847,237,142,3,382
257,bright,sv3,6,0.9172514642055957,194,130,1,325
257,bright,sv3,7,0.9459124071715864,198,108,3,309
257,bright,sv3,8,0.9559798004019742,234,148,2,384
257,bright,sv3,9,0.9475985278519682,218,164,8,390
258,bright,sv3,0,0.9717402487597226,161,234,4,399
258,bright,sv3,1,0.9590052786848648,195,165,1,361
258,bright,sv3,2,0.9533213930798534,230,155,8,393
258,bright,sv3,3,0.9507126690767427,206,130,5,341
258,bright,sv3,4,0.9385467273620974,188,170,4,362
258,bright,sv3,5,0.9487716755841488,202,168,1,371
258,bright,sv3,6,0.9691735754670595,146,186,0,332
258,bright,sv3,7,0.9638490185168261,165,122,3,290
258,bright,sv3,8,0.945721167230123,159,220,4,383
258,bright,sv3,9,0.9629859938125231,137,217,4,358
259,bright,sv3,0,0.9537619698525771,130,261,0,391
259,bright,sv3,1,0.9561846004124537,168,174,3,345
259,bright,sv3,2,0.9644758603790219,181,207,2,390
259,bright,sv3,3,0.96538663354811,167,171,3,341
259,bright,sv3,4,0.9609528491735657,150,193,3,346
259,bright,sv3,5,0.9069601170993089,127,242,4,373
259,bright,sv3,6,0.9545990356218692,104,225,0,329
259,bright,sv3,7,0.9136108957097198,117,182,3,302
259,bright,sv3,8,0.967871260652895,139,230,4,373
259,bright,sv3,9,0.962947202552758,141,220,4,365
260,bright,sv3,0,0.9676557815938992,126,275,3,404
260,bright,sv3,1,0.9477434942237738,124,248,2,374
260,bright,sv3,2,0.9678656645869558,169,233,1,403
260,bright,sv3,3,0.9501250403201261,139,208,5,352
260,bright,sv3,4,0.9654805603802995,106,258,1,365
260,bright,sv3,5,0.9640009015853455,122,259,3,384
260,bright,sv3,6,0.9282796424463057,106,213,3,322
260,bright,sv3,7,0.9769891734873506,129,181,1,311
260,bright,sv3,8,0.9547645576947488,145,236,3,384
260,bright,sv3,9,0.9569895385747523,94,280,1,375
261,bright,sv3,0,0.9491598182776582,107,283,0,390
261,bright,sv3,1,0.9477724196869184,109,242,1,352
261,bright,sv3,2,0.9679000889500587,124,267,0,391
261,bright,sv3,3,0.9701669323988992,129,203,4,336
261,bright,sv3,4,0.9545009468392853,110,234,5,349
261,bright,sv3,5,0.9735867165070345,111,253,1,365
261,bright,sv3,6,0.9533423737289933,104,218,5,327
261,bright,sv3,7,0.9427406179957019,93,203,0,296
261,bright,sv3,8,0.949561630330107,102,266,2,370
261,bright,sv3,9,0.9407929758975646,106,261,3,370
262,bright,sv3,0,0.9719985551015224,124,270,0,394
262,bright,sv3,1,0.9650647769024463,116,239,2,357
262,bright,sv3,2,0.9512918807265024,130,255,6,391
262,bright,sv3,3,0.964632371639888,132,207,3,342
262,bright,sv3,4,0.939223547167707,116,235,4,355
262,bright,sv3,5,0.9661196103891874,115,251,6,372
262,bright,sv3,6,0.9759940129734086,114,217,1,332
262,bright,sv3,7,0.9384213674389258,88,201,3,292
262,bright,sv3,8,0.9617829960658199,95,270,2,367
262,bright,sv3,9,0.9437184689298188,99,272,7,378
263,bright,sv3,0,0.9747041017835691,138,253,1,392
263,bright,sv3,1,0.9406276250248019,113,226,4,343
263,bright,sv3,2,0.9605013837286211,124,255,3,382
263,bright,sv3,3,0.9218532433585426,112,168,0,280
263,bright,sv3,4,0.9535074965776139,130,218,2,350
263,bright,sv3,5,0.9465604489947164,126,241,3,370
263,bright,sv3,6,0.9508538733806449,125,198,4,327
263,bright,sv3,7,0.9530886353002992,110,175,0,285
263,bright,sv3,8,0.9721851899057534,146,229,6,381
263,bright,sv3,9,0.9546294794721478,123,244,0,367
264,bright,sv3,0,0.9579581150490265,157,276,2,435
264,bright,sv3,1,0.9543811180402528,144,246,3,393
264,bright,sv3,2,0.9772172378135895,173,251,5,429
264,bright,sv3,3,0.9728762776576336,175,215,3,393
264,bright,sv3,4,0.9445377060985478,152,245,2,399
264,bright,sv3,5,0.9788934715059973,160,256,1,417
264,bright,sv3,6,0.9511557212955019,150,208,4,362
264,bright,sv3,7,0.9587605473629313,116,246,1,363
264,bright,sv3,8,0.9503205440516354,139,274,4,417
264,bright,sv3,9,0.9748202520665016,150,272,2,424
265,bright,sv3,0,0.9722334944910007,157,276,0,433
265,bright,sv3,1,0.9658843503092027,164,237,1,402
265,bright,sv3,2,0.9577639060903963,183,235,4,422
265,bright,sv3,3,0.9539809646078133,166,228,4,398
265,bright,sv3,4,0.9699100238905316,187,218,3,408
265,bright,sv3,5,0.9650277952044487,160,255,2,417
265,bright,sv3,6,0.9714504824830708,142,230,2,374
265,bright,sv3,7,0.9514396928413342,143,217,0,360
265,bright,sv3,8,0.9434477089397981,152,270,3,425
265,bright,sv3,9,0.9756107044109998,157,265,5,427
271,dark,sv3,0,0.9644286386718112,241,11,86,338
271,dark,sv3,1,0.9410233437486675,239,11,70,320
271,dark,sv3,2,0.955488204002755,232,16,84,332
271,dark,sv3,3,0.9313018150197936,223,13,71,307
271,dark,sv3,4,0.9476668887086779,221,19,81,321
271,dark,sv3,5,0.9533052146422618,229,18,98,345
271,dark,sv3,6,0.9616722465597155,200,12,75,287
271,dark,sv3,7,0.9246399617283109,158,13,88,259
271,dark,sv3,8,0.951239000438957,224,18,88,330
271,dark,sv3,9,0.9608934399576488,231,21,82,334
272,dark,sv3,0,0.957698732921242,256,12,79,347
272,dark,sv3,1,0.9674433454980005,229,14,57,300
272,dark,sv3,2,0.9523035783135234,259,14,72,345
272,dark,sv3,3,0.953867523726161,217,14,69,300
272,dark,sv3,4,0.9595676670105454,236,13,76,325
272,dark,sv3,5,0.9454083728448494,259,14,74,347
272,dark,sv3,6,0.9269775145499959,200,12,58,270
272,dark,sv3,7,0.9556319059491962,196,9,64,269
272,dark,sv3,8,0.9462306843855585,217,12,62,291
272,dark,sv3,9,0.9702974761045353,249,16,67,332
273,dark,sv3,0,0.9680498665240964,289,10,64,363
273,dark,sv3,1,0.9533818083080381,238,9,54,301
273,dark,sv3,2,0.9712743491079281,259,13,61,333
273,dark,sv3,3,0.9446652614162326,251,11,59,321
273,dark,sv3,4,0.9755828006675906,262,10,53,325
273,dark,sv3,5,0.9654259063228599,254,10,62,326
273,dark,sv3,6,0.9222505630592608,207,9,67,283
273,dark,sv3,7,0.9207319037318433,200,13,47,260
273,dark,sv3,8,0.9554004262813445,250,15,59,324
273,dark,sv3,9,0.9429242034093386,260,14,64,338
274,dark,sv3,0,0.9640467032232014,270,10,62,342
274,dark,sv3,1,0.9631829776850294,224,6,49,279
274,dark,sv3,2,0.9442653956078529,247,10,52,309
274,dark,sv3,3,0.9243223163408312,217,7,55,279
274,dark,sv3,4,0.9417710551975516,227,13,51,291
274,dark,sv3,5,0.9356976765254276,235,7,59,301
274,dark,sv3,6,0.9396823459831832,212,9,53,274
274,dark,sv3,7,0.9013162045354984,185,12,45,242
274,dark,sv3,8,0.9630570358586358,240,12,58,310
274,dark,sv3,9,0.9707937977605581,239,9,59,307
275,dark,sv3,0,0.9698090917399178,269,11,48,328
275,dark,sv3,1,0.9769432211198903,253,9,47,309
275,dark,sv3,2,0.9592954034148938,274,8,45,327
275,dark,sv3,3,0.9507506193104173,217,9,46,272
275,dark,sv3,4,0.959371611366866,253,11,47,311
275,dark,sv3,5,0.9547842524345449,279,10,46,335
275,dark,sv3,6,0.9497680811466296,219,8,41,268
275,dark,sv3,7,0.943442437030513,213,9,38,260
275,dark,sv3,8,0.9238239381605216,254,12,48,314
275,dark,sv3,9,0.9660822602704536,269,10,50,329
276,dark,sv3,0,0.9693649882614499,284,10,32,326
276,dark,sv3,1,0.9762432863587217,263,11,38,312
276,dark,sv3,2,0.9785910124239208,286,10,30,326
276,dark,sv3,3,0.9382630619609006,213,11,32,256
276,dark,sv3,4,0.9268962853415541,247,10,40,297
276,dark,sv3,5,0.9515615445584766,276,11,49,336
276,dark,sv3,6,0.9754789974902291,231,11,30,272
276,dark,sv3,7,0.9346945160014672,209,11,45,265
276,dark,sv3,8,0.9485538938596871,261,11,46,318
276,dark,sv3,9,0.9447797250577462,258,10,39,307
277,dark,sv3,0,0.9291896581870237,280,9,18,307
277,dark,sv3,1,0.92961931410043,245,8,26,279
277,dark,sv3,2,0.9124690864305277,235,12,21,268
277,dark,sv3,3,0.9160736781851729,211,10,25,246
277,dark,sv3,4,0.9494340348236037,252,11,31,294
277,dark,sv3,5,0.9564752145498169,253,10,36,299
277,dark,sv3,6,0.9437482149844745,199,11,28,238
277,dark,sv3,7,0.9429971429964707,193,10,36,239
277,dark,sv3,8,0.9171683184689937,237,16,33,286
277,dark,sv3,9,0.9456722400235753,266,9,34,309
278,dark,sv3,0,0.959437867967715,286,8,17,311
278,dark,sv3,1,0.9387370522843546,244,12,30,286
278,dark,sv3,2,0.9382641315493084,259,14,29,302
278,dark,sv3,3,0.9310828127557303,224,14,19,257
278,dark,sv3,4,0.9714721305040287,246,17,24,287
278,dark,sv3,5,0.9233943904489083,238,14,21,273
278,dark,sv3,6,0.9365158872953179,191,14,18,223
278,dark,sv3,7,0.9314290526401614,190,10,25,225
278,dark,sv3,8,0.9501142584504089,249,14,23,286
278,dark,sv3,9,0.9662511449339197,256,12,24,292
279,dark,sv3,0,0.9783475609929086,285,16,16,317
279,dark,sv3,1,0.9199091523735923,236,15,13,264
279,dark,sv3,2,0.9457738528746197,228,13,9,250
279,dark,sv3,3,0.9167666267291484,221,14,9,244
279,dark,sv3,4,0.9244746753915389,213,13,16,242
279,dark,sv3,5,0.9033325141088157,175,6,13,194
279,dark,sv3,6,0.9430171742588049,190,11,21,222
279,dark,sv3,7,0.9473412643089415,191,17,24,232
279,dark,sv3,8,0.9524904323509353,227,13,23,263
279,dark,sv3,9,0.9573982766866337,250,12,19,281
280,dark,sv3,1,0.9215618183247758,216,18,12,246
280,dark,sv3,2,0.9517412637981445,231,11,24,266
280,dark,sv3,3,0.9039144439950704,213,9,25,247
280,dark,sv3,4,0.9327650438727966,238,17,13,268
280,dark,sv3,5,0.9436514565516242,238,13,23,274
280,dark,sv3,6,0.9136897203398577,190,17,14,221
280,dark,sv3,7,0.889482234671143,172,18,14,204
280,dark,sv3,8,0.9588048936333867,248,14,12,274
280,dark,sv3,9,0.8906675969506052,223,13,6,242
281,dark,sv3,0,0.9063281599957622,233,18,18,269
281,dark,sv3,1,0.9629997134536633,227,16,15,258
281,dark,sv3,2,0.9197588931453893,231,18,10,259
281,dark,sv3,3,0.9139633221689081,192,13,12,217
281,dark,sv3,4,0.9569920220984592,225,17,17,259
281,dark,sv3,5,0.8376082783879822,103,9,8,120
281,dark,sv3,6,0.8991090187726937,191,15,12,218
281,dark,sv3,7,0.924893401480106,165,16,18,199
281,dark,sv3,8,0.94442821419484,224,15,7,246
281,dark,sv3,9,0.8836786511901461,209,13,16,238
282,bright,sv3,0,0.972762697525742,364,35,3,402
282,bright,sv3,1,0.9540287302628967,312,24,6,342
282,bright,sv3,2,0.9539323946296551,351,41,3,395
282,bright,sv3,3,0.9049757740611831,259,50,2,311
282,bright,sv3,4,0.9517170927307987,321,23,5,349
282,bright,sv3,5,0.9697180464228815,355,27,5,387
282,bright,sv3,6,0.9502451493870624,283,24,2,309
282,bright,sv3,7,0.9530550398996873,262,37,5,304
282,bright,sv3,8,0.9485697196185385,323,46,6,375
282,bright,sv3,9,0.9724071743622233,352,36,1,389
283,bright,sv3,0,0.9504109644718135,315,81,3,399
283,bright,sv3,1,0.9454396657858117,300,54,6,360
283,bright,sv3,2,0.9582107431061879,287,98,3,388
283,bright,sv3,3,0.93690316473002,232,97,3,332
283,bright,sv3,4,0.945701735554235,296,63,3,362
283,bright,sv3,5,0.9255232357550703,321,64,5,390
283,bright,sv3,6,0.9668597198652932,257,59,4,320
283,bright,sv3,7,0.926657653949228,225,62,5,292
283,bright,sv3,8,0.955319173767682,272,108,4,384
283,bright,sv3,9,0.9428802552482325,309,73,6,388
284,bright,sv3,0,0.9704115918157609,254,140,4,398
284,bright,sv3,1,0.9393461847925576,241,112,2,355
284,bright,sv3,2,0.9665719244460754,243,145,5,393
284,bright,sv3,3,0.9586933284260639,200,146,1,347
284,bright,sv3,4,0.9723599103345694,243,122,2,367
284,bright,sv3,5,0.9594546571966706,272,105,3,380
284,bright,sv3,6,0.933545171294216,213,111,5,329
284,bright,sv3,7,0.9544367549298919,205,86,2,293
284,bright,sv3,8,0.9614895743341204,239,150,4,393
284,bright,sv3,9,0.982270965738415,239,133,3,375
285,bright,sv3,0,0.9536919388627515,181,208,4,393
285,bright,sv3,1,0.9573528467798859,181,161,4,346
285,bright,sv3,2,0.9653556517247874,175,203,7,385
285,bright,sv3,3,0.9490348759228909,182,152,2,336
285,bright,sv3,4,0.9588960110257938,207,154,1,362
285,bright,sv3,5,0.9231888965640671,233,134,1,368
285,bright,sv3,6,0.9337745011243146,180,147,0,327
285,bright,sv3,7,0.957071956677272,153,143,1,297
285,bright,sv3,8,0.9834495232694607,140,232,2,374
285,bright,sv3,9,0.9526453301726103,171,198,3,372
286,bright,sv3,0,0.9644188771823492,193,211,0,404
286,bright,sv3,1,0.9548306954310962,161,189,2,352
286,bright,sv3,2,0.9699244765946969,145,246,1,392
286,bright,sv3,3,0.9459292314009389,134,205,1,340
286,bright,sv3,4,0.9336132558260203,155,200,4,359
286,bright,sv3,5,0.9492583935347412,177,194,4,375
286,bright,sv3,6,0.9595165313860468,116,209,2,327
286,bright,sv3,7,0.9672598457826849,100,196,3,299
286,bright,sv3,8,0.9566095771397897,140,241,1,382
286,bright,sv3,9,0.9614394515601263,156,216,1,373
287,bright,sv3,0,0.9642897347679067,119,257,5,381
287,bright,sv3,1,0.9405827176623697,126,219,3,348
287,bright,sv3,2,0.9590676474276066,128,257,1,386
287,bright,sv3,3,0.9483810426067876,116,211,3,330
287,bright,sv3,4,0.961940385383411,146,203,3,352
287,bright,sv3,5,0.9581577026195004,156,211,3,370
287,bright,sv3,6,0.945087778293722,130,183,2,315
287,bright,sv3,7,0.943783211768481,117,172,2,291
287,bright,sv3,8,0.9653232064548664,122,242,1,365
287,bright,sv3,9,0.9463830081600496,120,246,2,368
288,bright,sv3,0,0.9665456592066698,117,272,4,393
288,bright,sv3,1,0.9525354504589486,124,227,0,351
288,bright,sv3,2,0.9449441654165995,135,251,4,390
288,bright,sv3,3,0.9567422201690352,122,208,2,332
288,bright,sv3,4,0.95578135289697,148,198,3,349
288,bright,sv3,5,0.9516207058294883,147,222,3,372
288,bright,sv3,6,0.9570367418418554,144,171,0,315
288,bright,sv3,7,0.9437832117684808,114,173,2,289
288,bright,sv3,8,0.9507451436441086,102,258,0,360
288,bright,sv3,9,0.9492515023794819,109,256,2,367
289,bright,sv3,0,0.9622732107910105,159,232,3,394
289,bright,sv3,1,0.9710677013137355,141,203,3,347
289,bright,sv3,2,0.9689901874877844,140,238,5,383
289,bright,sv3,3,0.9709221683715856,120,202,4,326
289,bright,sv3,4,0.9699442484943858,121,226,2,349
289,bright,sv3,5,0.947562204655595,130,223,2,355
289,bright,sv3,6,0.9637043535823421,130,180,1,311
289,bright,sv3,7,0.9306542959330902,86,188,3,277
289,bright,sv3,8,0.971610773790855,100,210,5,315
289,bright,sv3,9,0.9607978019286418,129,235,2,366
290,bright,sv3,0,0.9486780970225137,157,270,2,429
290,bright,sv3,1,0.9458002172921611,153,234,5,392
290,bright,sv3,2,0.9672018442948155,175,247,3,425
290,bright,sv3,3,0.9670887486109777,138,247,1,386
290,bright,sv3,4,0.9604754028477281,168,212,7,387
290,bright,sv3,5,0.9540272075881052,153,253,1,407
290,bright,sv3,6,0.967399697080314,148,163,4,315
290,bright,sv3,7,0.9332585879502897,145,209,7,361
290,bright,sv3,8,0.9742150603742545,165,248,4,417
290,bright,sv3,9,0.9744812259990075,183,230,4,417
291,bright,sv3,0,0.9676866266549708,177,250,4,431
291,bright,sv3,1,0.9604906999067535,178,208,2,388
291,bright,sv3,2,0.9765408176827507,191,238,3,432
291,bright,sv3,3,0.958993744645183,167,215,4,386
291,bright,sv3,4,0.9372013226667011,198,203,1,402
291,bright,sv3,5,0.9604586560613254,216,195,2,413
291,bright,sv3,6,0.9676953971797841,164,194,1,359
291,bright,sv3,7,0.9704301351400842,144,212,3,359
291,bright,sv3,8,0.9594111567467704,160,245,6,411
291,bright,sv3,9,0.9695807327913,186,240,1,427
298,dark,sv3,0,0.9434692312715942,254,11,83,348
298,dark,sv3,1,0.9311908762076279,235,15,70,320
298,dark,sv3,2,0.9476754983575277,249,14,86,349
298,dark,sv3,3,0.9479963649492491,237,12,76,325
298,dark,sv3,4,0.9429734907582529,249,19,69,337
298,dark,sv3,5,0.9510135436907795,228,14,100,342
298,dark,sv3,6,0.9492896294705059,203,11,73,287
298,dark,sv3,7,0.9140890890910565,205,10,56,271
298,dark,sv3,8,0.9731535711986269,241,19,85,345
298,dark,sv3,9,0.9698199221340517,249,12,77,338
299,dark,sv3,0,0.9292952168797133,258,12,72,342
299,dark,sv3,1,0.9736323951145299,237,11,52,300
299,dark,sv3,2,0.9669742803103357,266,11,71,348
299,dark,sv3,3,0.9552362562112618,245,9,47,301
299,dark,sv3,4,0.9572567273008502,234,11,60,305
299,dark,sv3,5,0.939544439217514,232,12,74,318
299,dark,sv3,6,0.9304913268231778,228,10,58,296
299,dark,sv3,7,0.9456700073161056,209,11,45,265
299,dark,sv3,8,0.9539704863526901,236,7,58,301
299,dark,sv3,9,0.949222087132457,278,11,52,341
300,dark,sv3,0,0.9682476435089746,278,10,68,356
300,dark,sv3,1,0.9424485763127481,230,12,59,301
300,dark,sv3,2,0.9653570574199387,277,13,56,346
300,dark,sv3,3,0.9502143399923855,269,10,49,328
300,dark,sv3,4,0.9569650872668911,268,7,51,326
300,dark,sv3,5,0.9473994979617837,249,13,68,330
300,dark,sv3,6,0.9453383181842819,231,8,52,291
300,dark,sv3,7,0.9364169110362277,223,9,35,267
300,dark,sv3,8,0.9723185449085824,267,10,67,344
300,dark,sv3,9,0.9595460855074178,284,10,52,346
301,dark,sv3,0,0.9415343915698355,268,7,71,346
301,dark,sv3,1,0.9478270752406738,262,10,50,322
301,dark,sv3,2,0.9304047621603488,253,7,65,325
301,dark,sv3,3,0.9382169372259709,249,10,42,301
301,dark,sv3,4,0.9418897329599912,250,12,54,316
301,dark,sv3,5,0.9461302973138327,246,11,67,324
301,dark,sv3,6,0.946937569410676,210,10,64,284
301,dark,sv3,7,0.933713782720962,215,10,37,262
301,dark,sv3,8,0.943637983159171,259,10,64,333
301,dark,sv3,9,0.9598204879708256,280,10,56,346
302,dark,sv3,0,0.9736166276170298,271,11,57,339
302,dark,sv3,1,0.9315540526600238,249,12,51,312
302,dark,sv3,2,0.9741556567539024,287,10,51,348
302,dark,sv3,3,0.9332124564030697,227,12,43,282
302,dark,sv3,4,0.9294959046012016,258,7,52,317
302,dark,sv3,5,0.9319802695428716,244,13,52,309
302,dark,sv3,6,0.9695588545829761,204,10,52,266
302,dark,sv3,7,0.9120720453141002,218,8,28,254
302,dark,sv3,8,0.9182150556495334,268,9,51,328
302,dark,sv3,9,0.9787058206902535,274,10,49,333
303,dark,sv3,0,0.9344877466569043,272,11,37,320
303,dark,sv3,1,0.9390168066980497,237,10,44,291
303,dark,sv3,2,0.959459484632636,266,14,39,319
303,dark,sv3,3,0.9531648028073425,230,12,33,275
303,dark,sv3,4,0.9587350351809276,255,11,36,302
303,dark,sv3,5,0.950790929609838,265,13,47,325
303,dark,sv3,6,0.9429261180894035,225,8,41,274
303,dark,sv3,7,0.9489278979059552,224,10,29,263
303,dark,sv3,8,0.9457883844471225,280,12,44,336
303,dark,sv3,9,0.9518476873337112,273,10,43,326
304,dark,sv3,0,0.957106488055585,265,13,29,307
304,dark,sv3,1,0.9474316904629354,237,9,29,275
304,dark,sv3,2,0.9371930057449962,241,11,21,273
304,dark,sv3,3,0.9142907298295194,206,8,28,242
304,dark,sv3,4,0.9523032501417722,232,15,28,275
304,dark,sv3,5,0.941179783202207,244,11,43,298
304,dark,sv3,6,0.9196186304195353,190,11,31,232
304,dark,sv3,7,0.9655603421478267,224,10,27,261
304,dark,sv3,8,0.9420036399978488,263,12,31,306
304,dark,sv3,9,0.9259343616984126,273,13,29,315
305,dark,sv3,0,0.9581951108291284,255,14,37,306
305,dark,sv3,1,0.9130650076298426,235,13,28,276
305,dark,sv3,2,0.9762432863587217,276,14,24,314
305,dark,sv3,3,0.940825264283081,240,17,21,278
305,dark,sv3,4,0.9403143745060956,240,14,31,285
305,dark,sv3,5,0.9252015849098612,243,9,21,273
305,dark,sv3,6,0.9024954591960243,213,10,23,246
305,dark,sv3,7,0.9198737149264854,212,11,22,245
305,dark,sv3,8,0.9521377669833994,261,14,23,298
305,dark,sv3,9,0.9479459833743203,279,13,6,298
306,dark,sv3,0,0.9232199309533755,248,12,23,283
306,dark,sv3,1,0.9357153888649323,226,10,26,262
306,dark,sv3,2,0.9202816213425602,257,13,17,287
306,dark,sv3,3,0.9261046269445583,253,11,16,280
306,dark,sv3,4,0.9452671735422173,225,10,14,249
306,dark,sv3,5,0.9600765342436671,234,12,22,268
306,dark,sv3,6,0.9371882863581696,234,10,18,262
306,dark,sv3,7,0.9364178629789192,210,8,17,235
306,dark,sv3,8,0.9380478372647423,224,12,18,254
306,dark,sv3,9,0.9298109187814174,234,12,15,261
307,dark,sv3,0,0.9415796649561106,277,12,20,309
307,dark,sv3,1,0.9179383401702986,229,14,23,266
307,dark,sv3,2,0.9501382468272562,262,17,14,293
307,dark,sv3,3,0.9379268118536368,245,15,17,277
307,dark,sv3,4,0.9157312388384695,228,14,25,267
307,dark,sv3,5,0.909794886559529,234,9,35,278
307,dark,sv3,6,0.9644513228563611,229,11,21,261
307,dark,sv3,7,0.9050383459410856,201,13,12,226
307,dark,sv3,8,0.948829004611045,252,18,24,294
307,dark,sv3,9,0.9652405793044421,261,10,14,285
308,dark,sv3,0,0.951762218225186,266,13,20,299
308,dark,sv3,1,0.9410865808740478,255,12,24,291
308,dark,sv3,2,0.9580296125606081,256,13,13,282
308,dark,sv3,3,0.9116298669374945,216,17,19,252
308,dark,sv3,4,0.9183141813942515,226,14,14,254
308,dark,sv3,5,0.9355030554414598,218,16,13,247
308,dark,sv3,6,0.9347602459432598,225,13,11,249
308,dark,sv3,7,0.9091733422328651,201,13,15,229
308,dark,sv3,8,0.9615300860634727,266,13,11,290
308,dark,sv3,9,0.9158978976178721,259,13,19,291
309,bright,sv3,0,0.9453942994249283,384,19,1,404
309,bright,sv3,1,0.9429734907582528,287,48,4,339
309,bright,sv3,2,0.9399496537008254,359,29,3,391
309,bright,sv3,3,0.9389797278505756,293,38,3,334
309,bright,sv3,4,0.9480142000769649,330,34,1,365
309,bright,sv3,5,0.9597394726506668,327,31,4,362
309,bright,sv3,6,0.9489052320270727,290,21,3,314
309,bright,sv3,7,0.9476748076895751,270,23,4,297
309,bright,sv3,8,0.9731425829096176,323,20,5,348
309,bright,sv3,9,0.9396189352482069,359,20,6,385
310,bright,sv3,0,0.9741740788488653,313,82,2,397
310,bright,sv3,1,0.9746099732903528,260,105,3,368
310,bright,sv3,2,0.9437049438175324,334,61,4,399
310,bright,sv3,3,0.9559460256096326,277,66,6,349
310,bright,sv3,4,0.9658244403140102,294,61,4,359
310,bright,sv3,5,0.9568462089553958,290,99,3,392
310,bright,sv3,6,0.9501617591542753,259,60,3,322
310,bright,sv3,7,0.9427656217031107,251,60,3,314
310,bright,sv3,8,0.9745757522286729,311,71,3,385
310,bright,sv3,9,0.9624617091305028,346,57,6,409
311,bright,sv3,0,0.9566737191090998,292,109,1,402
311,bright,sv3,1,0.9547276699837672,228,119,1,348
311,bright,sv3,2,0.9626935240532831,279,117,1,397
311,bright,sv3,3,0.9606065172544533,212,137,5,354
311,bright,sv3,4,0.9562322562406896,262,101,3,366
311,bright,sv3,5,0.9570445381347354,267,118,4,389
311,bright,sv3,6,0.9601568088410246,226,106,4,336
311,bright,sv3,7,0.9534116880779366,239,68,4,311
311,bright,sv3,8,0.957942171895029,265,119,1,385
311,bright,sv3,9,0.9648843001936686,299,91,4,394
312,bright,sv3,0,0.9652779696865265,234,161,1,396
312,bright,sv3,1,0.9488381934550754,171,183,0,354
312,bright,sv3,2,0.968301033420511,208,177,3,388
312,bright,sv3,3,0.9570603276964307,177,146,3,326
312,bright,sv3,4,0.9242871862962991,204,146,5,355
312,bright,sv3,5,0.9535741443414241,214,158,4,376
312,bright,sv3,6,0.9419706465003723,192,137,1,330
312,bright,sv3,7,0.9483783023747379,187,102,5,294
312,bright,sv3,8,0.9541940712592145,209,165,6,380
312,bright,sv3,9,0.9583439995887426,228,142,2,372
313,bright,sv3,0,0.9418766427035019,211,183,3,397
313,bright,sv3,1,0.9660847148673429,170,176,0,346
313,bright,sv3,2,0.9659813329858923,189,193,1,383
313,bright,sv3,3,0.9468341449285379,162,178,3,343
313,bright,sv3,4,0.9356703302749845,173,166,2,341
313,bright,sv3,5,0.9570830452132317,176,186,6,368
313,bright,sv3,6,0.9267600424556779,216,83,12,311
313,bright,sv3,7,0.9321512166854474,149,150,4,303
313,bright,sv3,8,0.9606373598874874,144,200,0,344
313,bright,sv3,9,0.9606373598874874,144,200,0,344
314,bright,sv3,0,0.9786251868485701,175,219,3,397
314,bright,sv3,1,0.9560609307477935,128,204,4,336
314,bright,sv3,2,0.9709589636449423,150,211,1,362
314,bright,sv3,3,0.9728232808810714,132,195,1,328
314,bright,sv3,4,0.96144500372771,142,193,1,336
314,bright,sv3,5,0.9570277100301049,174,189,6,369
314,bright,sv3,6,0.9366236334182712,109,211,2,322
314,bright,sv3,7,0.9098529987496913,152,135,1,288
314,bright,sv3,8,0.9627939125741166,181,191,2,374
314,bright,sv3,9,0.9466583545198841,196,166,1,363
315,bright,sv3,0,0.9489753889057395,109,164,1,274
315,bright,sv3,1,0.9260985989064372,99,134,2,235
315,bright,sv3,2,0.6809059167651474,18,28,1,47
315,bright,sv3,3,0.961554801526749,152,181,2,335
315,bright,sv3,4,0.9729139469106912,136,198,3,337
315,bright,sv3,5,0.788309488969269,38,40,0,78
315,bright,sv3,6,0.9600635639433236,116,204,1,321
315,bright,sv3,7,0.949341545617058,162,136,2,300
315,bright,sv3,8,0.9591547042310841,126,128,1,255
315,bright,sv3,9,0.96070631188349,192,174,6,372
316,bright,sv3,0,0.9696209917598996,172,216,2,390
316,bright,sv3,1,0.9538755115890506,131,205,3,339
316,bright,sv3,2,0.9662801113191872,178,207,3,388
316,bright,sv3,3,0.9271435758300863,126,195,3,324
316,bright,sv3,4,0.9581397454233436,144,199,3,346
316,bright,sv3,5,0.9526294461661157,139,225,1,365
316,bright,sv3,6,0.9314223788370599,121,200,1,322
316,bright,sv3,7,0.9457244457807545,112,174,5,291
316,bright,sv3,8,0.9517137656865183,129,228,2,359
316,bright,sv3,9,0.9764129493862089,168,193,2,363
317,bright,sv3,0,0.9605644859228598,183,197,2,382
317,bright,sv3,1,0.959655882182729,138,199,2,339
317,bright,sv3,2,0.9751341085385236,173,205,3,381
317,bright,sv3,3,0.9809876867891664,157,170,2,329
317,bright,sv3,4,0.9787153358450394,145,199,2,346
317,bright,sv3,5,0.9465387321524437,176,188,1,365
317,bright,sv3,6,0.9548366100683222,144,177,6,327
317,bright,sv3,7,0.9454675372527142,133,147,2,282
317,bright,sv3,8,0.9620156091692618,169,197,2,368
317,bright,sv3,9,0.9467226503499018,173,192,4,369
318,bright,sv3,0,0.9334320557868,157,170,2,329
318,bright,sv3,1,0.9544610257693975,137,198,1,336
318,bright,sv3,2,0.9662355829257305,176,193,5,374
318,bright,sv3,3,0.950370126801662,164,163,2,329
318,bright,sv3,4,0.9544685585424821,161,193,1,355
318,bright,sv3,5,0.9642992080962776,163,201,1,365
318,bright,sv3,6,0.9159219928301178,145,176,3,324
318,bright,sv3,7,0.9555989526818474,113,163,2,278
318,bright,sv3,8,0.9701320056566494,145,204,0,349
318,bright,sv3,9,0.9593776039992231,149,221,1,371
319,bright,sv3,0,0.9589820522976097,196,199,2,397
319,bright,sv3,1,0.9374134660407811,155,180,4,339
319,bright,sv3,2,0.9641708712269734,179,203,2,384
319,bright,sv3,3,0.9498568315839024,154,176,1,331
319,bright,sv3,4,0.9755635873223191,169,174,5,348
319,bright,sv3,5,0.9633077643418035,171,192,2,365
319,bright,sv3,6,0.9518350964096421,144,176,2,322
319,bright,sv3,7,0.9588786516530778,123,160,3,286
319,bright,sv3,8,0.9665486465342346,184,185,3,372
319,bright,sv3,9,0.9375524419506124,181,182,5,368
320,backup,sv3,0,0.930698770779897,6,373,0,379
320,backup,sv3,1,0.9373035099971131,1,336,0,337
320,backup,sv3,2,0.957534053366213,8,347,1,356
320,backup,sv3,3,0.9139161446072955,2,261,0,263
320,backup,sv3,4,0.9644513228563611,23,237,0,260
320,backup,sv3,5,0.9654233394399085,25,322,0,347
320,backup,sv3,6,0.951104929162804,6,304,1,311
320,backup,sv3,7,0.9628626675724982,4,274,1,279
320,backup,sv3,8,0.9658869761075246,2,361,1,364
320,backup,sv3,9,0.9438827072508222,1,283,1,285
321,backup,sv3,0,0.904861304580806,10,305,1,316
321,backup,sv3,1,0.933743655917515,7,282,1,290
321,backup,sv3,2,0.9606464647898245,5,325,0,330
321,backup,sv3,3,0.9316980787956461,4,275,0,279
321,backup,sv3,4,0.9254401506984536,5,273,0,278
321,backup,sv3,5,0.8053020458638229,7,122,0,129
321,backup,sv3,6,0.9624862403971888,4,279,0,283
321,backup,sv3,7,0.9277299171464147,8,233,0,241
321,backup,sv3,8,0.9107475411112513,2,211,0,213
321,backup,sv3,9,0.956352475258366,3,311,1,315
325,dark,sv3,0,0.9712576673837906,254,20,70,344
325,dark,sv3,1,0.9565109273615533,203,10,104,317
325,dark,sv3,2,0.9565109273615533,203,10,104,317
325,dark,sv3,3,0.97462995103706,211,11,84,306
325,dark,sv3,4,0.9570810140845654,237,15,68,320
325,dark,sv3,5,0.9544789760952355,227,17,86,330
325,dark,sv3,6,0.9502950403936615,206,13,65,284
325,dark,sv3,7,0.9323534101224344,201,10,61,272
325,dark,sv3,8,0.9535479357707239,236,15,77,328
325,dark,sv3,9,0.9501323230232297,230,10,84,324
326,dark,sv3,0,0.9659436818467341,271,21,57,349
326,dark,sv3,1,0.9394146597647512,233,8,60,301
326,dark,sv3,2,0.9451936351595689,255,20,69,344
326,dark,sv3,3,0.9407682197641397,223,12,45,280
326,dark,sv3,4,0.9394054192426764,238,14,56,308
326,dark,sv3,5,0.9645712221419669,241,11,70,322
326,dark,sv3,6,0.934691330382444,233,16,51,300
326,dark,sv3,7,0.917090058476896,202,10,46,258
326,dark,sv3,8,0.9381408024733028,228,11,63,302
326,dark,sv3,9,0.8974349574164755,250,10,72,332
327,dark,sv3,0,0.9571486743964684,273,13,63,349
327,dark,sv3,1,0.9104483954298397,213,8,54,275
327,dark,sv3,2,0.962661892856676,262,11,75,348
327,dark,sv3,3,0.9457890622102908,227,11,57,295
327,dark,sv3,4,0.9519385870613651,245,10,55,310
327,dark,sv3,5,0.9649184894115993,251,16,63,330
327,dark,sv3,6,0.9178669135076735,238,7,37,282
327,dark,sv3,7,0.9652417827603467,189,8,53,250
327,dark,sv3,8,0.9761701178951185,244,12,57,313
327,dark,sv3,9,0.9481620300250063,246,10,69,325
328,dark,sv3,0,0.9611715763639407,274,14,65,353
328,dark,sv3,1,0.9343034965941616,251,10,56,317
328,dark,sv3,2,0.9635648282654439,251,10,61,322
328,dark,sv3,3,0.9314392095647895,233,12,55,300
328,dark,sv3,4,0.9401728205403882,242,10,57,309
328,dark,sv3,5,0.9439650147362035,266,11,57,334
328,dark,sv3,6,0.9273635010173491,221,11,41,273
328,dark,sv3,7,0.9358639427140572,217,9,41,267
328,dark,sv3,8,0.954239573324116,265,10,47,322
328,dark,sv3,9,0.9465224964039306,249,10,74,333
329,dark,sv3,0,0.9654192016485736,286,19,45,350
329,dark,sv3,1,0.957627906215508,262,8,49,319
329,dark,sv3,2,0.9712743491079283,274,10,50,334
329,dark,sv3,3,0.9243049839584465,229,10,45,284
329,dark,sv3,4,0.959180239919147,260,9,50,319
329,dark,sv3,5,0.9321445405551981,271,11,53,335
329,dark,sv3,6,0.9177453672343134,239,12,24,275
329,dark,sv3,7,0.939918854856314,215,10,45,270
329,dark,sv3,8,0.9492708887160362,263,12,48,323
329,dark,sv3,9,0.9650602637939485,269,11,61,341
330,dark,sv3,0,0.9755328404228886,284,13,32,329
330,dark,sv3,1,0.9389784381767012,262,8,41,311
330,dark,sv3,2,0.9584820984003173,274,10,46,330
330,dark,sv3,3,0.9204140992827202,233,11,37,281
330,dark,sv3,4,0.9601180968523586,250,11,38,299
330,dark,sv3,5,0.9238631004781045,272,15,39,326
330,dark,sv3,6,0.9271152232785841,242,11,25,278
330,dark,sv3,7,0.9441127616154532,222,9,43,274
330,dark,sv3,8,0.9492699233733783,277,13,35,325
330,dark,sv3,9,0.9660935569067566,227,13,56,296
331,dark,sv3,0,0.915908541987305,236,13,23,272
331,dark,sv3,1,0.9705244563693346,258,10,32,300
331,dark,sv3,2,0.9426010272289245,229,11,35,275
331,dark,sv3,3,0.9051813229337092,205,13,29,247
331,dark,sv3,4,0.9261321294518539,230,12,34,276
331,dark,sv3,5,0.9587242936431598,264,13,32,309
331,dark,sv3,6,0.9279144848855696,220,11,24,255
331,dark,sv3,7,0.9720051658520631,233,9,25,267
331,dark,sv3,8,0.9324449824594689,258,14,33,305
331,dark,sv3,9,0.9364438578931307,227,13,41,281
332,dark,sv3,0,0.9589652754552762,272,15,25,312
332,dark,sv3,1,0.9443676258673921,260,13,31,304
332,dark,sv3,2,0.9330304076040111,277,11,29,317
332,dark,sv3,3,0.921103553798856,243,10,23,276
332,dark,sv3,4,0.9236677094651602,244,14,33,291
332,dark,sv3,5,0.9605871711959281,262,13,30,305
332,dark,sv3,6,0.9500963380197616,234,19,13,266
332,dark,sv3,7,0.9055671758313694,219,10,21,250
332,dark,sv3,8,0.9338437922770441,240,12,28,280
332,dark,sv3,9,0.9598931953905343,222,14,28,264
333,dark,sv3,0,0.9287961918773684,256,16,21,293
333,dark,sv3,1,0.9719477409700377,231,12,20,263
333,dark,sv3,2,0.9622551519375635,263,11,20,294
333,dark,sv3,3,0.9069628985845293,225,13,13,251
333,dark,sv3,4,0.935265359927708,234,10,18,262
333,dark,sv3,5,0.9174202763738339,237,16,22,275
333,dark,sv3,6,0.9096628968641073,201,13,16,230
333,dark,sv3,7,0.8638946851648187,198,10,22,230
333,dark,sv3,8,0.9125453819102937,224,16,28,268
333,dark,sv3,9,0.9559511971181651,194,10,35,239
334,dark,sv3,0,0.9417148196070259,263,18,12,293
334,dark,sv3,1,0.9430747675600609,219,9,20,248
334,dark,sv3,2,0.9387787873967619,260,14,26,300
334,dark,sv3,3,0.9324342268500598,219,14,26,259
334,dark,sv3,4,0.940110593280976,225,17,28,270
334,dark,sv3,5,0.9444378524759325,233,15,27,275
334,dark,sv3,6,0.9618106755187837,209,17,14,240
334,dark,sv3,7,0.9190638521661515,213,15,9,237
334,dark,sv3,8,0.8987330491514537,227,11,23,261
334,dark,sv3,9,0.9447321517214995,222,13,19,254
335,dark,sv3,0,0.8805180079736848,226,17,19,262
335,dark,sv3,1,0.9418375531490122,254,13,11,278
335,dark,sv3,2,0.9468932999359204,258,15,22,295
335,dark,sv3,3,0.9524904323509356,234,15,14,263
335,dark,sv3,4,0.9466197853142405,251,14,15,280
335,dark,sv3,5,0.942152963981053,242,19,25,286
335,dark,sv3,6,0.9607899076819373,230,15,4,249
335,dark,sv3,7,0.9198523275306572,196,16,11,223
335,dark,sv3,8,0.9333079843063679,245,13,15,273
335,dark,sv3,9,0.9286260099450112,252,11,24,287
336,bright,sv3,0,0.9605754766810687,329,64,2,395
336,bright,sv3,1,0.9474573040622108,271,78,3,352
336,bright,sv3,2,0.9509886363286826,300,75,6,381
336,bright,sv3,3,0.9529897253561833,279,66,2,347
336,bright,sv3,4,0.9336387829350865,291,64,6,361
336,bright,sv3,5,0.9096628968641073,193,34,2,229
336,bright,sv3,6,0.9702796893228902,257,61,2,320
336,bright,sv3,7,0.960014439028011,240,42,3,285
336,bright,sv3,8,0.9579051038198674,327,26,1,354
336,bright,sv3,9,0.960763982419829,349,32,4,385
337,bright,sv3,0,0.9768923265734067,255,130,6,391
337,bright,sv3,1,0.9385293889156079,234,124,3,361
337,bright,sv3,2,0.9557660173695772,263,129,3,395
337,bright,sv3,3,0.953931624603065,205,114,0,319
337,bright,sv3,4,0.9526360958331481,270,93,2,365
337,bright,sv3,5,0.92014498398164,263,116,11,390
337,bright,sv3,6,0.955698645306545,199,117,2,318
337,bright,sv3,7,0.9556192422624302,199,89,6,294
337,bright,sv3,8,0.9521787462259064,307,81,0,388
337,bright,sv3,9,0.9500765346480898,266,113,2,381
338,bright,sv3,0,0.9755448465523802,220,174,3,397
338,bright,sv3,1,0.9531729459547758,186,155,1,342
338,bright,sv3,2,0.9441194288864081,200,156,2,358
338,bright,sv3,3,0.9561634906426023,150,170,0,320
338,bright,sv3,4,0.9504328696959863,189,157,1,347
338,bright,sv3,5,0.9365005142201802,163,181,5,349
338,bright,sv3,6,0.9445410956299072,173,156,2,331
338,bright,sv3,7,0.9692505990778861,195,102,4,301
338,bright,sv3,8,0.9418676333038334,254,114,1,369
338,bright,sv3,9,0.9781570031799601,216,155,4,375
339,bright,sv3,0,0.9266006208268278,161,222,4,387
339,bright,sv3,1,0.9576076432958215,152,193,6,351
339,bright,sv3,2,0.9682399714162876,154,210,7,371
339,bright,sv3,3,0.9521152625951766,132,198,1,331
339,bright,sv3,4,0.9388560073340744,183,164,2,349
339,bright,sv3,5,0.9681396818379971,160,203,6,369
339,bright,sv3,6,0.9517143189166863,124,201,2,327
339,bright,sv3,7,0.978158373223633,143,157,2,302
339,bright,sv3,8,0.9594449907367941,212,166,4,382
339,bright,sv3,9,0.9378805110240299,196,172,2,370
340,bright,sv3,0,0.9704127910965488,136,253,1,390
340,bright,sv3,1,0.9354904696248346,134,201,4,339
340,bright,sv3,2,0.9589167009684021,157,215,1,373
340,bright,sv3,3,0.9792248032272081,112,211,3,326
340,bright,sv3,4,0.9454422511070898,139,208,2,349
340,bright,sv3,5,0.9329248087460855,133,235,2,370
340,bright,sv3,6,0.9330497296201813,94,224,1,319
340,bright,sv3,7,0.9258089133051133,128,157,5,290
340,bright,sv3,8,0.9420387110515911,180,192,2,374
340,bright,sv3,9,0.960370361456571,138,233,3,374
341,bright,sv3,0,0.9558963329118835,131,252,2,385
341,bright,sv3,1,0.9668711899287269,113,229,2,344
341,bright,sv3,2,0.956450203801887,129,247,0,376
341,bright,sv3,3,0.9561109963813342,122,204,2,328
341,bright,sv3,4,0.9549845818270427,129,227,1,357
341,bright,sv3,5,0.9608856165798662,136,231,4,371
341,bright,sv3,6,0.9520590234690373,101,219,0,320
341,bright,sv3,7,0.9475225937951894,131,165,2,298
341,bright,sv3,8,0.9408018676490558,172,206,2,380
341,bright,sv3,9,0.9311569889734483,139,230,3,372
342,bright,sv3,0,0.9309353118536733,135,236,3,374
342,bright,sv3,1,0.9640467032232014,108,232,2,342
342,bright,sv3,2,0.96781652693915,131,238,5,374
342,bright,sv3,3,0.9445050748842366,111,211,1,323
342,bright,sv3,4,0.9411953749522379,135,216,0,351
342,bright,sv3,5,0.9527368620232043,130,230,3,363
342,bright,sv3,6,0.9749993169644144,106,216,1,323
342,bright,sv3,7,0.9239252968979087,106,181,2,289
342,bright,sv3,8,0.9814151647708721,148,207,1,356
342,bright,sv3,9,0.9620498394685736,151,205,4,360
343,bright,sv3,0,0.9645835234892045,136,239,0,375
343,bright,sv3,1,0.9767120631875625,130,212,2,344
343,bright,sv3,2,0.9325984575749179,155,213,2,370
343,bright,sv3,3,0.9670465594010133,131,187,4,322
343,bright,sv3,4,0.9633986137902885,136,215,0,351
343,bright,sv3,5,0.9504041888832105,143,212,6,361
343,bright,sv3,6,0.9520760024223116,116,195,2,313
343,bright,sv3,7,0.9383211734612349,105,170,1,276
343,bright,sv3,8,0.9585331544874868,159,202,1,362
343,bright,sv3,9,0.9696303764512103,132,225,1,358
344,bright,sv3,0,0.9590632354111416,144,172,1,317
344,bright,sv3,1,0.9589258384119358,125,197,6,328
344,bright,sv3,2,0.9629549741042422,144,232,1,377
344,bright,sv3,3,0.9348789800654681,133,184,4,321
344,bright,sv3,4,0.9613771245506323,140,195,2,337
344,bright,sv3,5,0.9508896707275261,137,221,1,359
344,bright,sv3,6,0.9454161016742215,116,201,1,318
344,bright,sv3,7,0.9226173670020924,104,174,2,280
344,bright,sv3,8,0.9591975931496135,166,191,1,358
344,bright,sv3,9,0.9486108326750808,165,196,2,363
345,bright,sv3,0,0.967231123677698,165,212,2,379
345,bright,sv3,1,0.975487758411438,131,209,1,341
345,bright,sv3,2,0.9400503098351433,154,215,3,372
345,bright,sv3,3,0.9626169425987572,133,195,1,329
345,bright,sv3,4,0.9533603484842685,150,196,4,350
345,bright,sv3,5,0.9670005694976967,151,216,5,372
345,bright,sv3,6,0.9380419303777086,128,185,2,315
345,bright,sv3,7,0.9546880021182907,96,183,5,284
345,bright,sv3,8,0.9650512447863041,160,216,3,379
345,bright,sv3,9,0.975962720409143,169,191,5,365
346,bright,sv3,0,0.9778919839674535,186,236,1,423
346,bright,sv3,1,0.970940950099288,154,231,3,388
346,bright,sv3,2,0.9619185381051552,187,232,3,422
346,bright,sv3,3,0.942875837579181,162,218,3,383
346,bright,sv3,4,0.9716580779794362,180,223,4,407
346,bright,sv3,5,0.9650656812386686,162,238,2,402
346,bright,sv3,6,0.9575899881951598,147,205,3,355
346,bright,sv3,7,0.9473555832201274,152,204,0,356
346,bright,sv3,8,0.9611402032419756,210,205,1,416
346,bright,sv3,9,0.9635492723229832,181,238,5,424
347,backup,sv3,0,0.9592294287725469,1,388,0,389
347,backup,sv3,1,0.9297052243173354,3,326,2,331
347,backup,sv3,2,0.9546388609901431,3,333,1,337
347,backup,sv3,3,0.9266906151453428,0,179,0,179
347,backup,sv3,4,0.9661444269576701,2,326,0,328
347,backup,sv3,5,0.9625090323208907,4,359,1,364
347,backup,sv3,6,0.9613456677901265,5,315,0,320
347,backup,sv3,7,0.9485868273704817,4,279,1,284
347,backup,sv3,8,0.959711603934262,1,365,0,366
347,backup,sv3,9,0.9650077671874505,4,379,1,384
352,dark,sv3,0,0.9645057297774272,248,17,93,358
352,dark,sv3,1,0.945067737751676,216,14,82,312
352,dark,sv3,2,0.9724050452544589,255,15,93,363
352,dark,sv3,3,0.9509185096183349,231,8,78,317
352,dark,sv3,4,0.944541095629907,234,13,82,329
352,dark,sv3,5,0.9337518561766383,242,14,84,340
352,dark,sv3,6,0.8932467621564573,172,9,94,275
352,dark,sv3,7,0.9045700082829252,207,11,62,280
352,dark,sv3,8,0.9590158585360586,246,13,87,346
352,dark,sv3,9,0.940978969401177,226,16,102,344
353,dark,sv3,0,0.92653994886866,260,14,87,361
353,dark,sv3,1,0.9483460387887207,240,8,58,306
353,dark,sv3,2,0.9291365217879332,264,11,73,348
353,dark,sv3,3,0.9606787244112827,252,11,60,323
353,dark,sv3,4,0.9670970123465044,256,11,67,334
353,dark,sv3,5,0.960962235108707,267,13,59,339
353,dark,sv3,6,0.9600702560314408,223,17,58,298
353,dark,sv3,7,0.9635181406034865,208,12,47,267
353,dark,sv3,8,0.9275549943687978,251,10,58,319
353,dark,sv3,9,0.9515344767421181,248,17,85,350
354,dark,sv3,0,0.9566970965925035,265,13,69,347
354,dark,sv3,1,0.9564752145498171,223,8,65,296
354,dark,sv3,2,0.9560558514043912,273,12,58,343
354,dark,sv3,3,0.9448917022606232,236,8,56,300
354,dark,sv3,4,0.9601180968523586,230,11,58,299
354,dark,sv3,5,0.912674338865767,262,10,44,316
354,dark,sv3,6,0.9529880190232387,230,11,47,288
354,dark,sv3,7,0.9011098616056806,205,11,40,256
354,dark,sv3,8,0.9428759449697176,250,12,60,322
354,dark,sv3,9,0.942769964931526,240,13,76,329
355,dark,sv3,0,0.9621794343278213,272,11,76,359
355,dark,sv3,1,0.9688882127357691,241,11,50,302
355,dark,sv3,2,0.9560243202784915,259,11,59,329
355,dark,sv3,3,0.9625856229408108,252,10,42,304
355,dark,sv3,4,0.941899595361276,225,12,54,291
355,dark,sv3,5,0.9727614802115624,277,13,47,337
355,dark,sv3,6,0.9385478275306709,198,13,64,275
355,dark,sv3,7,0.9305166024663447,221,10,35,266
355,dark,sv3,8,0.9720775652316483,243,11,61,315
355,dark,sv3,9,0.9756243913972665,257,10,66,333
356,dark,sv3,0,0.9662816073810051,271,11,49,331
356,dark,sv3,1,0.9667266420898851,270,12,39,321
356,dark,sv3,2,0.970408773075565,278,13,42,333
356,dark,sv3,3,0.9230871431838,231,16,35,282
356,dark,sv3,4,0.9174012879335592,262,10,39,311
356,dark,sv3,5,0.9522901002901024,285,11,32,328
356,dark,sv3,6,0.9492091441605426,226,11,47,284
356,dark,sv3,7,0.9432303106422733,241,9,34,284
356,dark,sv3,8,0.956844515794002,258,9,44,311
356,dark,sv3,9,0.9718375031399733,249,14,60,323
357,dark,sv3,0,0.9404630380639449,256,11,45,312
357,dark,sv3,1,0.931905578292819,236,10,37,283
357,dark,sv3,2,0.965848926813695,264,13,29,306
357,dark,sv3,3,0.9246441010744055,199,8,32,239
357,dark,sv3,4,0.9661128711468474,255,14,35,304
357,dark,sv3,5,0.9594519833566911,254,12,38,304
357,dark,sv3,6,0.951932673821417,225,12,33,270
357,dark,sv3,7,0.9349581987943558,214,9,35,258
357,dark,sv3,8,0.9287858463595481,268,12,50,330
357,dark,sv3,9,0.9613025678092999,204,13,42,259
358,dark,sv3,0,0.9587783550197887,235,18,31,284
358,dark,sv3,1,0.913410285671093,242,13,28,283
358,dark,sv3,2,0.9631175762711632,246,10,24,280
358,dark,sv3,3,0.9256243342571138,213,17,20,250
358,dark,sv3,4,0.9562942099981074,255,13,24,292
358,dark,sv3,5,0.9387659761246661,263,14,34,311
358,dark,sv3,6,0.941492093780983,224,17,25,266
358,dark,sv3,7,0.8993546783541655,225,11,28,264
358,dark,sv3,8,0.9530300020979829,245,16,31,292
358,dark,sv3,9,0.9550142120498714,237,15,42,294
359,dark,sv3,0,0.9171282882596803,237,10,23,270
359,dark,sv3,1,0.9608887884113808,226,12,23,261
359,dark,sv3,2,0.9389230129551632,212,17,30,259
359,dark,sv3,3,0.9426758185530547,204,12,17,233
359,dark,sv3,4,0.9567073185954654,232,9,30,271
359,dark,sv3,5,0.9512481649096023,221,12,30,263
359,dark,sv3,6,0.9287082905124012,212,13,18,243
359,dark,sv3,7,0.9372091692738828,205,12,25,242
359,dark,sv3,8,0.9653909004116853,196,13,17,226
359,dark,sv3,9,0.9473392207374708,171,14,24,209
360,dark,sv3,0,0.9137097819515956,242,19,31,292
360,dark,sv3,1,0.9362546157727472,243,16,25,284
360,dark,sv3,2,0.949504430677157,247,16,15,278
360,dark,sv3,3,0.9389591060242432,229,13,22,264
360,dark,sv3,4,0.9519256689740405,241,16,20,277
360,dark,sv3,5,0.9314913409323545,235,10,20,265
360,dark,sv3,6,0.9489506516415959,227,16,22,265
360,dark,sv3,7,0.9340620000874359,203,13,14,230
360,dark,sv3,8,0.9230520661439036,264,13,24,301
360,dark,sv3,9,0.9339524468547317,240,16,31,287
361,dark,sv3,0,0.9645178756209147,239,17,23,279
361,dark,sv3,1,0.9180761116632536,229,12,14,255
361,dark,sv3,2,0.941345242420643,264,19,18,301
361,dark,sv3,3,0.956921892130147,236,13,21,270
361,dark,sv3,4,0.9489753889057397,238,16,19,273
361,dark,sv3,5,0.946442572155211,246,15,16,277
361,dark,sv3,6,0.9566462905484256,228,17,14,259
361,dark,sv3,7,0.9310835638242979,195,10,17,222
361,dark,sv3,8,0.909039489927295,221,14,21,256
361,dark,sv3,9,0.9382081541616232,205,12,8,225
362,dark,sv3,0,0.9405579427597665,266,18,21,305
362,dark,sv3,1,0.9448702166317567,250,10,16,276
362,dark,sv3,2,0.9264043263369591,246,10,29,285
362,dark,sv3,3,0.9358744532164701,233,12,13,258
362,dark,sv3,4,0.9519591384641287,230,18,19,267
362,dark,sv3,5,0.9274637301449566,232,13,13,258
362,dark,sv3,6,0.9433726789904726,202,18,19,239
362,dark,sv3,7,0.9253956200401696,215,12,6,233
362,dark,sv3,8,0.9350510523909217,245,12,22,279
362,dark,sv3,9,0.9440634891940749,250,16,19,285
363,bright,sv3,0,0.9750636414971469,365,40,1,406
363,bright,sv3,1,0.9376519699562801,318,18,1,337
363,bright,sv3,2,0.9395056925065554,340,29,5,374
363,bright,sv3,3,0.9492220871324568,293,45,5,343
363,bright,sv3,4,0.9495724412287698,317,29,2,348
363,bright,sv3,5,0.9385586886955939,336,39,0,375
363,bright,sv3,6,0.9450000688407074,296,20,2,318
363,bright,sv3,7,0.9559482633319194,274,28,1,303
363,bright,sv3,8,0.956951577923372,332,37,4,373
363,bright,sv3,9,0.9608238195716388,336,44,2,382
364,bright,sv3,0,0.976427163989413,299,107,7,413
364,bright,sv3,1,0.9567810368776783,306,44,2,352
364,bright,sv3,2,0.9667300171454991,304,92,0,396
364,bright,sv3,3,0.9629622217578325,252,71,3,326
364,bright,sv3,4,0.9814546816613051,290,59,5,354
364,bright,sv3,5,0.9779728101230599,299,72,5,376
364,bright,sv3,6,0.9729173834551731,254,59,5,318
364,bright,sv3,7,0.933937724822928,249,53,3,305
364,bright,sv3,8,0.9646827229633831,282,85,5,372
364,bright,sv3,9,0.9654643364223948,294,85,3,382
365,bright,sv3,0,0.9641587459192265,247,144,4,395
365,bright,sv3,1,0.9452542403271853,252,99,5,356
365,bright,sv3,2,0.9574717719585053,284,106,1,391
365,bright,sv3,3,0.9444082216898773,171,102,2,275
365,bright,sv3,4,0.9520093924397947,240,114,6,360
365,bright,sv3,5,0.9548321140072729,222,151,5,378
365,bright,sv3,6,0.9755391459185032,204,119,3,326
365,bright,sv3,7,0.9445055627558645,220,85,6,311
365,bright,sv3,8,0.92797495639299,244,127,2,373
365,bright,sv3,9,0.9718803274991213,173,113,6,292
366,bright,sv3,0,0.964093248521359,148,220,6,374
366,bright,sv3,1,0.952928767681915,209,149,1,359
366,bright,sv3,2,0.9734768443508991,172,202,1,375
366,bright,sv3,3,0.9439313954690456,177,144,3,324
366,bright,sv3,4,0.9527216428283738,215,154,4,373
366,bright,sv3,5,0.9588446725052993,219,165,2,386
366,bright,sv3,6,0.9689886935558817,173,160,4,337
366,bright,sv3,7,0.9380459272796509,164,134,5,303
366,bright,sv3,8,0.9403482996106818,189,184,2,375
366,bright,sv3,9,0.9701551936842332,182,211,2,395
367,bright,sv3,0,0.9747615862625251,164,220,3,387
367,bright,sv3,1,0.9457345008338636,195,154,3,352
367,bright,sv3,2,0.962112432874714,173,209,5,387
367,bright,sv3,3,0.9252232503232976,148,188,2,338
367,bright,sv3,4,0.9687281898743888,153,187,1,341
367,bright,sv3,5,0.9589611667288356,141,230,1,372
367,bright,sv3,6,0.9656311317399104,115,211,3,329
367,bright,sv3,7,0.9551295369650988,149,135,3,287
367,bright,sv3,8,0.9732448427693176,157,219,1,377
367,bright,sv3,9,0.9562477404185246,133,234,1,368
368,bright,sv3,0,0.9647551998510703,132,256,3,391
368,bright,sv3,1,0.9340356362859162,151,194,2,347
368,bright,sv3,2,0.948795974173567,140,246,1,387
368,bright,sv3,3,0.9278334585752016,115,214,3,332
368,bright,sv3,4,0.9638544756523123,136,201,3,340
368,bright,sv3,5,0.9461979225804951,138,218,5,361
368,bright,sv3,6,0.9552467728175507,111,200,3,314
368,bright,sv3,7,0.9407270567495082,127,169,3,299
368,bright,sv3,8,0.9621281254763291,138,236,1,375
368,bright,sv3,9,0.9711346016081326,139,210,3,352
369,bright,sv3,0,0.9780997524372982,119,281,0,400
369,bright,sv3,1,0.9479951684703297,136,223,1,360
369,bright,sv3,2,0.9790830762274331,124,264,3,391
369,bright,sv3,3,0.9390954671290044,141,195,7,343
369,bright,sv3,4,0.9544949905781811,139,216,2,357
369,bright,sv3,5,0.9681080116056352,138,235,0,373
369,bright,sv3,6,0.9559116492707825,126,203,1,330
369,bright,sv3,7,0.9487278525576117,118,170,2,290
369,bright,sv3,8,0.9724275015185827,131,245,3,379
369,bright,sv3,9,0.9538560596025394,121,255,3,379
370,bright,sv3,0,0.9508818673289103,144,233,2,379
370,bright,sv3,1,0.9591824685747526,159,186,1,346
370,bright,sv3,2,0.9625563842712556,149,234,1,384
370,bright,sv3,3,0.9481626446105873,136,190,2,328
370,bright,sv3,4,0.9681926359362013,135,214,1,350
370,bright,sv3,5,0.9725627181484457,146,216,4,366
370,bright,sv3,6,0.9544901140300426,105,212,2,319
370,bright,sv3,7,0.9715099197567723,104,177,0,281
370,bright,sv3,8,0.9657564336080017,139,215,8,362
370,bright,sv3,9,0.9641445056690254,126,235,1,362
371,bright,sv3,0,0.9595877602225835,162,228,0,390
371,bright,sv3,1,0.9566343951778292,151,187,2,340
371,bright,sv3,2,0.9596752687812194,150,232,2,384
371,bright,sv3,3,0.9486063846222058,138,190,0,328
371,bright,sv3,4,0.943674931709876,139,203,8,350
371,bright,sv3,5,0.9421854594204363,153,215,0,368
371,bright,sv3,6,0.9268445423373041,145,180,1,326
371,bright,sv3,7,0.9186305153472196,108,172,1,281
371,bright,sv3,8,0.9358460257411881,143,210,4,357
371,bright,sv3,9,0.9504494610482458,160,204,2,366
372,bright,sv3,0,0.9615255782508936,174,218,3,395
372,bright,sv3,1,0.9617949286474605,150,199,4,353
372,bright,sv3,2,0.9616324657026847,171,212,0,383
372,bright,sv3,3,0.9397126599888053,149,179,0,328
372,bright,sv3,4,0.9403756511941656,145,203,4,352
372,bright,sv3,5,0.9558143852441501,158,210,2,370
372,bright,sv3,6,0.9641117824615208,152,173,4,329
372,bright,sv3,7,0.9509441471852498,95,187,1,283
372,bright,sv3,8,0.98141207291423,162,218,4,384
372,bright,sv3,9,0.9548168790942578,153,213,2,368
373,bright,sv3,0,0.9517945268524358,192,234,3,429
373,bright,sv3,1,0.9468239383357874,204,190,1,395
373,bright,sv3,2,0.9627349657463192,218,211,2,431
373,bright,sv3,3,0.9240988751938419,168,223,1,392
373,bright,sv3,4,0.9799466279058151,180,220,4,404
373,bright,sv3,5,0.9647809039745083,180,237,1,418
373,bright,sv3,6,0.9558514502420852,156,207,0,363
373,bright,sv3,7,0.9610147400551272,131,225,6,362
373,bright,sv3,8,0.9418537162223488,179,239,2,420
373,bright,sv3,9,0.9743607088091918,162,257,1,420
374,backup,sv3,0,0.9628287748574427,5,399,1,405
374,backup,sv3,1,0.9462639425838014,6,331,2,339
374,backup,sv3,2,0.9538511769991166,4,384,0,388
374,backup,sv3,3,0.9333096523174996,4,313,1,318
374,backup,sv3,4,0.9468743777070509,1,342,1,344
374,backup,sv3,5,0.9717916314297692,1,395,0,396
374,backup,sv3,6,0.944982741921828,3,335,2,340
374,backup,sv3,7,0.952135146939846,1,304,1,306
374,backup,sv3,8,0.9527428812364579,3,381,0,384
374,backup,sv3,9,0.9631167933772663,10,395,0,405
375,backup,sv3,0,0.9615037981543176,2,360,0,362
375,backup,sv3,1,0.9415459305328546,1,315,1,317
375,backup,sv3,2,0.9610028635398882,8,363,0,371
375,backup,sv3,3,0.9663504434514628,3,315,0,318
375,backup,sv3,4,0.9472767754652641,1,330,2,333
375,backup,sv3,5,0.9448476598652648,3,359,1,363
375,backup,sv3,6,0.9535279668515604,1,320,1,322
375,backup,sv3,7,0.9402644833642818,2,281,1,284
375,backup,sv3,8,0.8804244585084671,2,241,0,243
375,backup,sv3,9,0.932237323679613,1,356,1,358
379,dark,sv3,0,0.968070390072745,242,17,92,351
379,dark,sv3,1,0.9461979453261548,213,18,89,320
379,dark,sv3,2,0.950723776606284,237,26,92,355
379,dark,sv3,3,0.971867862427042,232,11,72,315
379,dark,sv3,4,0.961853174582306,223,15,76,314
379,dark,sv3,5,0.9460142993280396,241,15,92,348
379,dark,sv3,6,0.9150675294445705,207,15,71,293
379,dark,sv3,7,0.9486926685003599,185,18,66,269
379,dark,sv3,8,0.9497982253239833,241,15,83,339
379,dark,sv3,9,0.9348081197208962,218,17,86,321
380,dark,sv3,0,0.9196470104449457,257,12,91,360
380,dark,sv3,1,0.9477446348281636,227,18,60,305
380,dark,sv3,2,0.947171712619746,257,15,75,347
380,dark,sv3,3,0.9587101439990844,249,11,60,320
380,dark,sv3,4,0.9371095972717807,233,11,72,316
380,dark,sv3,5,0.9482949483860782,258,15,54,327
380,dark,sv3,6,0.9279957123513382,224,15,64,303
380,dark,sv3,7,0.9564837316548248,192,13,67,272
380,dark,sv3,8,0.9137384093295142,250,8,60,318
380,dark,sv3,9,0.9549859571897437,263,12,72,347
381,dark,sv3,0,0.9146566642109268,250,13,88,351
381,dark,sv3,1,0.9149130603432973,259,12,53,324
381,dark,sv3,2,0.9582203005856896,261,12,76,349
381,dark,sv3,3,0.9153431898275111,233,11,73,317
381,dark,sv3,4,0.9616692544097218,263,8,42,313
381,dark,sv3,5,0.9300145986405431,271,12,54,337
381,dark,sv3,6,0.9177835244926905,206,15,72,293
381,dark,sv3,7,0.9204225939664306,198,8,55,261
381,dark,sv3,8,0.866958588082569,262,12,54,328
381,dark,sv3,9,0.9562315554862151,257,8,72,337
382,dark,sv3,0,0.9762821642349274,264,12,71,347
382,dark,sv3,1,0.9772757667459312,231,11,67,309
382,dark,sv3,2,0.9650832180809902,261,9,57,327
382,dark,sv3,3,0.9177350192159269,228,9,58,295
382,dark,sv3,4,0.9430758382608551,259,11,42,312
382,dark,sv3,5,0.9413446802749036,267,11,51,329
382,dark,sv3,6,0.9567957127353507,221,11,50,282
382,dark,sv3,7,0.9552129989989624,201,12,61,274
382,dark,sv3,8,0.9516694077537123,267,8,58,333
382,dark,sv3,9,0.9702083732254543,244,13,66,323
383,dark,sv3,0,0.9685769269948873,265,12,71,348
383,dark,sv3,1,0.9294012220899271,238,11,46,295
383,dark,sv3,2,0.9406153524685119,265,15,67,347
383,dark,sv3,3,0.9611871130740368,219,8,46,273
383,dark,sv3,4,0.9414492811626681,257,9,41,307
383,dark,sv3,5,0.9591801136443738,282,12,46,340
383,dark,sv3,6,0.9545576256665134,229,11,45,285
383,dark,sv3,7,0.975692331806941,218,8,53,279
383,dark,sv3,8,0.938408138347389,263,15,40,318
383,dark,sv3,9,0.960189488389439,255,12,66,333
384,dark,sv3,0,0.9606603432164089,258,14,46,318
384,dark,sv3,1,0.9271603761546748,259,8,35,302
384,dark,sv3,2,0.9479425986789578,273,11,38,322
384,dark,sv3,3,0.9183029650575611,184,14,26,224
384,dark,sv3,4,0.939730609655137,239,22,32,293
384,dark,sv3,5,0.9484677234770466,248,12,44,304
384,dark,sv3,6,0.9439384813333649,232,9,36,277
384,dark,sv3,7,0.936655344438719,210,6,41,257
384,dark,sv3,8,0.9398755239642015,246,14,45,305
384,dark,sv3,9,0.9269602258148271,197,14,27,238
385,dark,sv3,0,0.9427406179957016,261,13,22,296
385,dark,sv3,1,0.9524028831066006,245,15,18,278
385,dark,sv3,2,0.9306536469455842,254,17,21,292
385,dark,sv3,3,0.9370870983486006,227,12,26,265
385,dark,sv3,4,0.9377679690593733,246,19,25,290
385,dark,sv3,5,0.9672079612039489,265,20,32,317
385,dark,sv3,6,0.9375236492161432,247,11,20,278
385,dark,sv3,7,0.9186654892596082,204,10,40,254
385,dark,sv3,8,0.9542851918244929,256,18,26,300
385,dark,sv3,9,0.9460422304760663,260,15,28,303
386,dark,sv3,0,0.9475157795927477,234,16,25,275
386,dark,sv3,1,0.9488638104520947,240,13,23,276
386,dark,sv3,2,0.9485543904454442,231,12,26,269
386,dark,sv3,3,0.9350440809700677,221,19,22,262
386,dark,sv3,4,0.9306476530835149,221,18,19,258
386,dark,sv3,5,0.9513790160793867,226,30,13,269
386,dark,sv3,6,0.9055098354387031,224,16,19,259
386,dark,sv3,7,0.9294918046270283,221,10,23,254
386,dark,sv3,8,0.925701650374246,212,22,22,256
386,dark,sv3,9,0.9456631844407449,216,19,18,253
387,dark,sv3,0,0.9568044525250363,257,21,22,300
387,dark,sv3,1,0.9421544839989223,244,16,21,281
387,dark,sv3,2,0.9209842024186351,216,22,25,263
387,dark,sv3,3,0.9595912895576952,248,9,16,273
387,dark,sv3,4,0.9560529667959157,226,21,14,261
387,dark,sv3,5,0.9451518693157269,243,21,17,281
387,dark,sv3,6,0.9030549222990712,232,18,13,263
387,dark,sv3,7,0.8987704122251149,196,11,21,228
387,dark,sv3,8,0.9352288986831888,241,14,20,275
387,dark,sv3,9,0.946893162950649,226,14,27,267
388,dark,sv3,0,0.9487676093137344,256,14,14,284
388,dark,sv3,1,0.9452380896446213,236,17,15,268
388,dark,sv3,2,0.9189461832842067,254,13,15,282
388,dark,sv3,3,0.9429824073682996,211,25,14,250
388,dark,sv3,4,0.9193624172849031,211,20,19,250
388,dark,sv3,5,0.9399448875130271,247,15,17,279
388,dark,sv3,6,0.9458471989938861,219,15,12,246
388,dark,sv3,7,0.9240749308817108,197,12,22,231
388,dark,sv3,8,0.9449934363725812,234,18,17,269
388,dark,sv3,9,0.9170633878698027,191,18,20,229
389,dark,sv3,0,0.9508132145629336,257,16,21,294
389,dark,sv3,1,0.9448470324662245,243,19,13,275
389,dark,sv3,2,0.9598969034831164,262,20,17,299
389,dark,sv3,3,0.9524753860651359,212,20,16,248
389,dark,sv3,4,0.9601211191630837,236,31,10,277
389,dark,sv3,5,0.945653469331736,227,30,13,270
389,dark,sv3,6,0.8942632489866199,211,20,14,245
389,dark,sv3,7,0.9395902039128659,203,14,10,227
389,dark,sv3,8,0.9500980976262069,233,15,23,271
389,dark,sv3,9,0.963488992996496,215,17,19,251
390,bright,sv3,0,0.9517598791980788,362,28,8,398
390,bright,sv3,1,0.9555691121615183,282,67,1,350
390,bright,sv3,2,0.961838168334595,320,48,2,370
390,bright,sv3,3,0.9380615888170576,269,56,3,328
390,bright,sv3,4,0.9554070264507093,293,58,2,353
390,bright,sv3,5,0.9539311882589753,299,82,2,383
390,bright,sv3,6,0.9425844690019051,243,61,2,306
390,bright,sv3,7,0.9428973069395641,232,58,3,293
390,bright,sv3,8,0.946244280902037,325,57,0,382
390,bright,sv3,9,0.9373965128739103,317,55,0,372
391,bright,sv3,0,0.9537303230561133,324,73,5,402
391,bright,sv3,1,0.9488352239077217,245,107,4,356
391,bright,sv3,2,0.9549282276518201,285,95,7,387
391,bright,sv3,3,0.9617325479687356,229,84,5,318
391,bright,sv3,4,0.9480014883080446,261,97,2,360
391,bright,sv3,5,0.9353891856613064,252,120,5,377
391,bright,sv3,6,0.9541410703767356,185,126,3,314
391,bright,sv3,7,0.9509097419308326,192,106,3,301
391,bright,sv3,8,0.9622838628291241,285,90,4,379
391,bright,sv3,9,0.9489944075765333,270,113,2,385
392,bright,sv3,0,0.9562412353927926,289,116,4,409
392,bright,sv3,1,0.9680224348779753,210,159,1,370
392,bright,sv3,2,0.9769512507857622,235,161,1,397
392,bright,sv3,3,0.9648268304485795,210,134,2,346
392,bright,sv3,4,0.9566144764540625,162,202,1,365
392,bright,sv3,5,0.9560028821465659,175,221,2,398
392,bright,sv3,6,0.9455005931827092,147,184,5,336
392,bright,sv3,7,0.9375858199539463,168,149,3,320
392,bright,sv3,8,0.9664702436446961,206,181,3,390
392,bright,sv3,9,0.939648032362272,228,162,2,392
393,bright,sv3,0,0.9626248319072495,201,202,2,405
393,bright,sv3,1,0.9587443621271492,132,211,5,348
393,bright,sv3,2,0.942405491432613,146,243,5,394
393,bright,sv3,3,0.9422868004606232,133,206,1,340
393,bright,sv3,4,0.9677277470832868,154,214,2,370
393,bright,sv3,5,0.9268025662196597,141,239,4,384
393,bright,sv3,6,0.9678938814069475,118,211,4,333
393,bright,sv3,7,0.970564191370682,129,178,2,309
393,bright,sv3,8,0.9604754028477281,151,232,2,385
393,bright,sv3,9,0.9283030486384,132,244,6,382
394,bright,sv3,0,0.9712400757216647,172,235,3,410
394,bright,sv3,1,0.9521197183027459,154,227,2,383
394,bright,sv3,2,0.981354981165035,125,275,1,401
394,bright,sv3,3,0.9602047689208606,98,257,2,357
394,bright,sv3,4,0.9654477095353495,114,257,3,374
394,bright,sv3,5,0.965757811332663,72,314,2,388
394,bright,sv3,6,0.9460794957939456,43,284,2,329
394,bright,sv3,7,0.9476864218952291,79,238,3,320
394,bright,sv3,8,0.9713360355535257,82,304,2,388
394,bright,sv3,9,0.984602286483624,137,247,2,386
395,bright,sv3,0,0.9571539850964371,102,291,2,395
395,bright,sv3,1,0.962715659524222,96,255,2,353
395,bright,sv3,2,0.9686886377495084,77,306,4,387
395,bright,sv3,3,0.9709400191158604,55,278,2,335
395,bright,sv3,4,0.9674321727007625,74,279,0,353
395,bright,sv3,5,0.9536369023184651,71,291,0,362
395,bright,sv3,6,0.9465532642344189,64,260,1,325
395,bright,sv3,7,0.9317744359948806,69,229,1,299
395,bright,sv3,8,0.9494827611714806,71,294,3,368
395,bright,sv3,9,0.9207939103686364,93,274,2,369
396,bright,sv3,0,0.9707305195948119,74,325,2,401
396,bright,sv3,1,0.9670591777465777,62,289,1,352
396,bright,sv3,2,0.9695259255971452,66,322,0,388
396,bright,sv3,3,0.9525266480076118,59,275,2,336
396,bright,sv3,4,0.9685108456535384,69,274,1,344
396,bright,sv3,5,0.8752240250826127,49,131,0,180
396,bright,sv3,6,0.9300213186667866,69,262,2,333
396,bright,sv3,7,0.9419222908959861,62,223,2,287
396,bright,sv3,8,0.9717029005930702,65,304,1,370
396,bright,sv3,9,0.9369904045309299,64,306,0,370
397,bright,sv3,0,0.9573893959902599,94,303,1,398
397,bright,sv3,1,0.9521170906285142,82,267,2,351
397,bright,sv3,2,0.9621917780326961,97,280,2,379
397,bright,sv3,3,0.9414143837028746,75,198,2,275
397,bright,sv3,4,0.9221574443708498,82,261,2,345
397,bright,sv3,5,0.9622769769535767,65,300,2,367
397,bright,sv3,6,0.9486817414329881,72,251,1,324
397,bright,sv3,7,0.9637201402224462,45,238,0,283
397,bright,sv3,8,0.9555053867960214,56,324,4,384
397,bright,sv3,9,0.97047458026954,80,284,3,367
398,bright,sv3,0,0.9661049925230862,104,291,2,397
398,bright,sv3,1,0.9407546425648257,99,241,3,343
398,bright,sv3,2,0.970784216990223,91,292,1,384
398,bright,sv3,3,0.9505357724145878,75,260,1,336
398,bright,sv3,4,0.9388449718696988,80,265,1,346
398,bright,sv3,5,0.9725075885311383,77,284,0,361
398,bright,sv3,6,0.9644556987036831,68,253,2,323
398,bright,sv3,7,0.9351687195396281,48,238,0,286
398,bright,sv3,8,0.9351687195396281,48,238,0,286
398,bright,sv3,9,0.9532115264432163,112,262,0,374
399,bright,sv3,1,0.9479380227651073,99,298,3,400
399,bright,sv3,2,0.9661336683641464,116,298,5,419
399,bright,sv3,3,0.9693719522858592,116,278,4,398
399,bright,sv3,4,0.9594795510567063,113,292,1,406
399,bright,sv3,5,0.9645752474927682,112,303,4,419
399,bright,sv3,6,0.9563974915563412,86,274,0,360
399,bright,sv3,7,0.9709589636449423,91,269,2,362
399,bright,sv3,8,0.9408191240691827,85,338,1,424
399,bright,sv3,9,0.972412262243822,110,318,0,428
400,bright,sv3,0,0.9644489539059746,127,304,2,433
400,bright,sv3,1,0.9641869474865786,136,259,1,396
400,bright,sv3,2,0.9655884734732957,147,278,3,428
400,bright,sv3,3,0.9643674601160911,132,264,0,396
400,bright,sv3,4,0.9568964393194828,107,295,4,406
400,bright,sv3,5,0.9647069308253515,122,295,2,419
400,bright,sv3,6,0.9603358362326582,85,280,0,365
400,bright,sv3,7,0.9577991012001865,104,253,1,358
400,bright,sv3,8,0.9600530715500868,112,307,1,420
400,bright,sv3,9,0.9777232111969225,152,276,2,430
401,backup,sv3,0,0.9613787277743783,4,402,0,406
401,backup,sv3,1,0.9373459779815928,1,366,0,367
401,backup,sv3,2,0.9685457470595265,2,390,0,392
401,backup,sv3,3,0.9690474021978484,4,352,0,356
401,backup,sv3,4,0.9719422532046318,3,365,0,368
401,backup,sv3,5,0.9684152858633647,2,393,0,395
401,backup,sv3,6,0.949144831966559,1,337,0,338
401,backup,sv3,7,0.9603174782337368,2,308,0,310
401,backup,sv3,8,0.9287899302977243,0,263,0,263
401,backup,sv3,9,0.9630339219946015,1,389,0,390
402,backup,sv3,0,0.955905913691743,2,401,0,403
402,backup,sv3,1,0.9525232438800165,1,371,0,372
402,backup,sv3,2,0.9677692892827857,1,397,0,398
402,backup,sv3,3,0.9750075680650591,5,334,0,339
402,backup,sv3,4,0.9653232064548666,0,363,1,364
402,backup,sv3,5,0.955979800401974,2,385,0,387
402,backup,sv3,6,0.9596458692591716,5,325,0,330
402,backup,sv3,7,0.940489053227526,2,300,0,302
402,backup,sv3,8,0.9722750147851995,1,391,0,392
402,backup,sv3,9,0.9653394083380764,2,383,0,385
406,dark,sv3,0,0.9653294955523352,242,20,92,354
406,dark,sv3,1,0.9663492956297084,226,14,84,324
406,dark,sv3,2,0.9752993997624222,240,22,90,352
406,dark,sv3,3,0.9555483301746431,231,19,71,321
406,dark,sv3,4,0.9673222693712931,227,11,83,321
406,dark,sv3,5,0.9620763516963695,227,14,80,321
406,dark,sv3,6,0.8629530269661596,213,17,56,286
406,dark,sv3,7,0.9180704580947927,187,13,75,275
406,dark,sv3,8,0.9360203341084997,242,18,82,342
406,dark,sv3,9,0.9565546469237651,235,14,89,338
407,dark,sv3,0,0.960801888729722,283,16,70,369
407,dark,sv3,1,0.9406250827819602,221,12,73,306
407,dark,sv3,2,0.9551686956071019,264,10,77,351
407,dark,sv3,3,0.9510884225165472,246,12,61,319
407,dark,sv3,4,0.9388173469469364,246,11,72,329
407,dark,sv3,5,0.9472555255701146,257,9,60,326
407,dark,sv3,6,0.8990521419536048,216,14,63,293
407,dark,sv3,7,0.9123006478699262,183,15,64,262
407,dark,sv3,8,0.9644934129488771,248,14,55,317
407,dark,sv3,9,0.9497846819642215,260,16,73,349
408,dark,sv3,0,0.9655372418187932,280,11,65,356
408,dark,sv3,1,0.9613176458168728,242,11,57,310
408,dark,sv3,2,0.9673095350759123,282,13,60,355
408,dark,sv3,3,0.9564709993054364,247,9,56,312
408,dark,sv3,4,0.9609658714270096,254,12,63,329
408,dark,sv3,5,0.9496314895684843,260,9,59,328
408,dark,sv3,6,0.9474298264692596,226,12,52,290
408,dark,sv3,7,0.9207003911613626,204,15,60,279
408,dark,sv3,8,0.9538036768218401,251,10,60,321
408,dark,sv3,9,0.9642069654258892,261,14,72,347
409,dark,sv3,0,0.9236672407494151,277,9,55,341
409,dark,sv3,1,0.9510434684451,237,11,65,313
409,dark,sv3,2,0.9610468226307581,269,11,57,337
409,dark,sv3,3,0.9283669218874161,235,11,46,292
409,dark,sv3,4,0.9724346949812188,242,9,55,306
409,dark,sv3,5,0.9240694388562299,197,5,54,256
409,dark,sv3,6,0.944597098347007,220,11,44,275
409,dark,sv3,7,0.9664622800945956,192,9,61,262
409,dark,sv3,8,0.9287179422704591,228,12,52,292
409,dark,sv3,9,0.9359726269234232,276,13,56,345
410,dark,sv3,0,0.9482085265617095,280,8,53,341
410,dark,sv3,1,0.9581051547585383,244,11,53,308
410,dark,sv3,2,0.9569270257102296,273,10,55,338
410,dark,sv3,3,0.9597465177640895,208,13,47,268
410,dark,sv3,4,0.9542142388403392,247,12,55,314
410,dark,sv3,5,0.9618461024407283,257,14,62,333
410,dark,sv3,6,0.9369790865896738,212,11,43,266
410,dark,sv3,7,0.9190783073997862,219,12,39,270
410,dark,sv3,8,0.9477180538141987,247,12,49,308
410,dark,sv3,9,0.9641772870157775,247,16,45,308
411,dark,sv3,0,0.9354023441013672,284,16,32,332
411,dark,sv3,1,0.9629652118616381,229,12,42,283
411,dark,sv3,2,0.9253369463853806,278,14,40,332
411,dark,sv3,3,0.8860682636023316,183,11,28,222
411,dark,sv3,4,0.9604414292756145,230,9,40,279
411,dark,sv3,5,0.9544912166122977,237,10,36,283
411,dark,sv3,6,0.9540586209432155,242,10,38,290
411,dark,sv3,7,0.9559472698497338,219,12,42,273
411,dark,sv3,8,0.9600169537723089,274,11,39,324
411,dark,sv3,9,0.9458475960994192,186,13,34,233
412,dark,sv3,0,0.9515614527711622,245,15,28,288
412,dark,sv3,1,0.9357390863296093,199,12,33,244
412,dark,sv3,2,0.9497779938525605,256,17,26,299
412,dark,sv3,3,0.9217795867052572,202,10,28,240
412,dark,sv3,4,0.9376809165744219,258,9,29,296
412,dark,sv3,5,0.919761175468961,225,13,33,271
412,dark,sv3,6,0.9274542306206247,223,11,22,256
412,dark,sv3,7,0.9194131615953557,206,12,41,259
412,dark,sv3,8,0.9585946205608006,272,13,35,320
412,dark,sv3,9,0.9291530414221947,231,11,25,267
413,dark,sv3,0,0.9572519086097245,223,15,30,268
413,dark,sv3,1,0.9409911955810629,212,12,22,246
413,dark,sv3,2,0.9195113049253976,215,16,32,263
413,dark,sv3,3,0.9157524855534334,189,15,32,236
413,dark,sv3,4,0.9540265971583932,237,19,23,279
413,dark,sv3,5,0.9214944229738313,188,14,30,232
413,dark,sv3,6,0.9180917119999039,213,15,18,246
413,dark,sv3,7,0.9542048832578642,205,12,21,238
413,dark,sv3,8,0.93687965568769,227,20,22,269
413,dark,sv3,9,0.9157524855534334,195,15,28,238
414,dark,sv3,0,0.9440237271674046,260,16,22,298
414,dark,sv3,1,0.9502257279530291,210,13,25,248
414,dark,sv3,2,0.9359142722268406,251,13,17,281
414,dark,sv3,3,0.9596945365822791,206,19,20,245
414,dark,sv3,4,0.909870681423619,216,18,28,262
414,dark,sv3,5,0.9451078317626593,226,15,24,265
414,dark,sv3,6,0.9009289953480119,210,16,13,239
414,dark,sv3,7,0.920810166026452,196,18,25,239
414,dark,sv3,8,0.9212727134177423,228,22,17,267
414,dark,sv3,9,0.940625532901126,232,20,32,284
415,dark,sv3,0,0.9201300851694407,260,20,17,297
415,dark,sv3,1,0.9340541122155263,226,19,16,261
415,dark,sv3,2,0.9561586407943453,226,19,28,273
415,dark,sv3,3,0.9758506049095823,226,18,19,263
415,dark,sv3,4,0.9648279727256831,224,16,25,265
415,dark,sv3,5,0.9716769550744828,244,22,24,290
415,dark,sv3,6,0.923865473002707,211,14,16,241
415,dark,sv3,7,0.9441496759306153,187,16,28,231
415,dark,sv3,8,0.9484729381891784,210,25,14,249
415,dark,sv3,9,0.9400186152348118,215,23,12,250
416,dark,sv3,0,0.9349331474630632,267,15,16,298
416,dark,sv3,1,0.9134948983623332,220,19,19,258
416,dark,sv3,2,0.9437335543233055,255,21,21,297
416,dark,sv3,3,0.9359460189168365,227,17,16,260
416,dark,sv3,4,0.9138973506663944,237,16,15,268
416,dark,sv3,5,0.9081990083292392,251,13,24,288
416,dark,sv3,6,0.9497487931657578,199,21,13,233
416,dark,sv3,7,0.9276312436050349,192,13,16,221
416,dark,sv3,8,0.9391980092516297,236,18,20,274
416,dark,sv3,9,0.956921892130147,233,21,17,271
417,bright,sv3,0,0.9578910300976619,314,80,4,398
417,bright,sv3,1,0.9537278556488599,276,60,6,342
417,bright,sv3,2,0.9641645283282141,321,45,3,369
417,bright,sv3,3,0.9681425654618193,266,56,2,324
417,bright,sv3,4,0.9670283053745843,270,58,4,332
417,bright,sv3,5,0.9565824727247263,301,70,2,373
417,bright,sv3,6,0.9335536236431684,245,65,1,311
417,bright,sv3,7,0.9477732721621792,243,48,1,292
417,bright,sv3,8,0.9609409517629931,330,38,1,369
417,bright,sv3,9,0.9619676349506576,308,73,1,382
418,bright,sv3,0,0.9499809708167609,276,117,5,398
418,bright,sv3,1,0.9578172153133487,229,109,6,344
418,bright,sv3,2,0.9649390981137366,307,78,5,390
418,bright,sv3,3,0.9375997726000641,230,78,0,308
418,bright,sv3,4,0.956817684317675,236,126,3,365
418,bright,sv3,5,0.9507082424261719,229,142,7,378
418,bright,sv3,6,0.9283101138011816,210,100,4,314
418,bright,sv3,7,0.9604192452898139,218,94,1,313
418,bright,sv3,8,0.9806803603673944,284,92,5,381
418,bright,sv3,9,0.9666992569723478,228,148,6,382
419,bright,sv3,0,0.970306398057868,220,184,5,409
419,bright,sv3,1,0.9670394423094066,223,133,2,358
419,bright,sv3,2,0.9707871967313519,244,139,5,388
419,bright,sv3,3,0.9503753976494609,181,166,8,355
419,bright,sv3,4,0.9714593743569819,187,174,3,364
419,bright,sv3,5,0.9399039403203998,164,224,3,391
419,bright,sv3,6,0.9476038070422967,160,174,1,335
419,bright,sv3,7,0.9540486291110707,180,133,3,316
419,bright,sv3,8,0.9718320899885877,214,176,5,395
419,bright,sv3,9,0.9666583766931499,184,208,5,397
420,bright,sv3,0,0.966658614942192,125,279,4,408
420,bright,sv3,1,0.9520576447352418,138,210,5,353
420,bright,sv3,2,0.9537619698525771,147,235,8,390
420,bright,sv3,3,0.9612671685069644,140,196,2,338
420,bright,sv3,4,0.9510762195045179,136,231,2,369
420,bright,sv3,5,0.9609430628362302,133,235,6,374
420,bright,sv3,6,0.9440018201152636,108,213,4,325
420,bright,sv3,7,0.9535082774268688,123,170,1,294
420,bright,sv3,8,0.95611786574515,170,207,0,377
420,bright,sv3,9,0.9431303341687826,106,274,3,383
421,bright,sv3,0,0.956509037845873,105,296,2,403
421,bright,sv3,1,0.9656674302881424,121,231,3,355
421,bright,sv3,2,0.9710006125156914,142,249,6,397
421,bright,sv3,3,0.9657058786590227,124,217,1,342
421,bright,sv3,4,0.9659436818467338,96,251,3,350
421,bright,sv3,5,0.9529583937811141,72,299,4,375
421,bright,sv3,6,0.9642058470832879,61,268,2,331
421,bright,sv3,7,0.929825605220866,79,215,2,296
421,bright,sv3,8,0.9703698030295056,83,304,1,388
421,bright,sv3,9,0.9726126583047542,70,303,2,375
422,bright,sv3,0,0.939771216065409,77,319,3,399
422,bright,sv3,1,0.9561576845941585,68,285,1,354
422,bright,sv3,2,0.9618677170231493,92,295,1,388
422,bright,sv3,3,0.9473317915942803,73,262,1,336
422,bright,sv3,4,0.9488126358455562,78,268,3,349
422,bright,sv3,5,0.9719787181022965,70,302,1,373
422,bright,sv3,6,0.9413992403716095,49,276,0,325
422,bright,sv3,7,0.9422361357626534,76,205,0,281
422,bright,sv3,8,0.9708435219554592,95,287,2,384
422,bright,sv3,9,0.9790019202463647,70,299,2,371
423,bright,sv3,0,0.9479337958207871,61,334,1,396
423,bright,sv3,1,0.9617949286474605,53,300,0,353
423,bright,sv3,2,0.9532959514638752,63,313,0,376
423,bright,sv3,3,0.9373414932780821,91,239,4,334
423,bright,sv3,4,0.9567408945796669,74,275,3,352
423,bright,sv3,5,0.9013456735939489,46,165,2,213
423,bright,sv3,6,0.9691753263452072,51,271,1,323
423,bright,sv3,7,0.9481227299481564,77,211,1,289
423,bright,sv3,8,0.9536600941917371,62,302,3,367
423,bright,sv3,9,0.967716356154059,50,312,5,367
424,bright,sv3,0,0.975895949154657,73,315,0,388
424,bright,sv3,1,0.9671214284036809,80,269,1,350
424,bright,sv3,2,0.9575313452802584,111,269,0,380
424,bright,sv3,3,0.9728497202856448,120,210,1,331
424,bright,sv3,4,0.958114905006636,92,263,0,355
424,bright,sv3,5,0.9583338120550869,55,302,1,358
424,bright,sv3,6,0.9521199509293626,68,256,2,326
424,bright,sv3,7,0.9445253036970535,66,222,2,290
424,bright,sv3,8,0.9813949105302513,64,302,1,367
424,bright,sv3,9,0.9658800923127915,71,297,1,369
425,bright,sv3,0,0.9604183536164035,106,291,0,397
425,bright,sv3,1,0.973820074897514,91,260,2,353
425,bright,sv3,2,0.9515806438099118,107,276,2,385
425,bright,sv3,3,0.9556427469540898,98,226,4,328
425,bright,sv3,4,0.9533603484842688,80,270,1,351
425,bright,sv3,5,0.954244460886612,73,294,4,371
425,bright,sv3,6,0.9635641263858634,77,241,0,318
425,bright,sv3,7,0.9430987374449769,54,235,2,291
425,bright,sv3,8,0.9662175168006314,100,277,2,379
425,bright,sv3,9,0.9664110950556728,82,287,3,372
426,bright,sv3,0,0.9412630518244501,117,307,1,425
426,bright,sv3,1,0.9519001186535885,109,282,1,392
426,bright,sv3,2,0.9656074970613312,118,296,4,418
426,bright,sv3,3,0.9533508815845574,135,249,1,385
426,bright,sv3,4,0.9707236503429404,114,280,1,395
426,bright,sv3,5,0.9560926272809775,103,309,2,414
426,bright,sv3,6,0.9417571344752653,76,283,1,360
426,bright,sv3,7,0.9704525670992623,96,264,1,361
426,bright,sv3,8,0.9523536509121601,100,328,1,429
426,bright,sv3,9,0.9622847355350737,103,319,1,423
427,bright,sv3,0,0.9559897700916152,133,308,2,443
427,bright,sv3,1,0.9672316512529013,122,276,1,399
427,bright,sv3,2,0.968133214046915,137,286,3,426
427,bright,sv3,3,0.9283031842945513,142,246,2,390
427,bright,sv3,4,0.9473601538684207,140,256,3,399
427,bright,sv3,5,0.9626926418967371,105,303,3,411
427,bright,sv3,6,0.9431399130320017,103,258,0,361
427,bright,sv3,7,0.9517254208939621,108,252,1,361
427,bright,sv3,8,0.9568811415668793,120,306,0,426
427,bright,sv3,9,0.9480226539808284,123,300,2,425
428,backup,sv3,0,0.9813778604114983,1,378,0,379
428,backup,sv3,1,0.9380028548471826,1,331,1,333
428,backup,sv3,2,0.939829189737195,2,375,0,377
428,backup,sv3,3,0.9363394417798502,2,262,1,265
428,backup,sv3,4,0.9611740585417581,3,315,1,319
428,backup,sv3,5,0.9326616203311043,3,372,0,375
428,backup,sv3,6,0.9311011466950481,1,318,0,319
428,backup,sv3,7,0.9141348993242978,2,287,1,290
428,backup,sv3,8,0.9518435461103352,4,359,0,363
428,backup,sv3,9,0.9197526853369699,0,305,0,305
429,backup,sv3,0,0.9619921262295364,6,406,1,413
429,backup,sv3,1,0.9288946334705087,4,380,2,386
429,backup,sv3,2,0.9561457584733457,5,398,1,404
429,backup,sv3,3,0.9372909427525912,7,347,0,354
429,backup,sv3,4,0.9604688231336379,1,367,1,369
429,backup,sv3,5,0.9678201927850844,11,384,0,395
429,backup,sv3,6,0.9633680001436563,4,332,0,336
429,backup,sv3,7,0.9407336484778462,1,316,0,317
429,backup,sv3,8,0.9408901309071271,2,393,0,395
429,backup,sv3,9,0.954150291870644,3,399,0,402
433,dark,sv3,0,0.9330611504161189,265,16,33,314
433,dark,sv3,1,0.9209128835949962,230,15,26,271
433,dark,sv3,2,0.9625678921609199,253,11,19,283
433,dark,sv3,3,0.9577729133207081,229,13,14,256
433,dark,sv3,4,0.9370942292223714,225,13,30,268
433,dark,sv3,5,0.9342535281458301,244,13,21,278
433,dark,sv3,6,0.9370641716003649,217,16,14,247
433,dark,sv3,7,0.9162728984949379,189,13,5,207
433,dark,sv3,8,0.9171099599785184,233,12,31,276
433,dark,sv3,9,0.9419194188319329,230,15,28,273
436,dark,sv3,0,0.9490047648336518,251,21,20,292
436,dark,sv3,1,0.9477326987989865,235,20,13,268
436,dark,sv3,2,0.9641557943992501,255,20,14,289
436,dark,sv3,3,0.9588746007989181,205,30,12,247
436,dark,sv3,4,0.9565616965620944,216,35,29,280
436,dark,sv3,5,0.9323698628368363,250,23,34,307
436,dark,sv3,6,0.9083890384573645,216,16,24,256
436,dark,sv3,7,0.9352146231763855,194,15,15,224
436,dark,sv3,8,0.9510467850109652,249,13,27,289
436,dark,sv3,9,0.9617193854002882,211,24,17,252
437,dark,sv3,0,0.9603903668849698,253,21,31,305
437,dark,sv3,1,0.9278478377489028,234,20,19,273
437,dark,sv3,2,0.9459124071715864,263,14,31,308
437,dark,sv3,3,0.9476797839516079,231,25,13,269
437,dark,sv3,4,0.9230322442061293,213,29,16,258
437,dark,sv3,5,0.9112073631992816,251,39,11,301
437,dark,sv3,6,0.9259295285702539,208,21,23,252
437,dark,sv3,7,0.8991751703385175,190,16,15,221
437,dark,sv3,8,0.9646620330040543,251,21,18,290
437,dark,sv3,9,0.9552100222750621,249,13,22,284
439,dark,sv3,0,0.955684474432102,253,15,29,297
439,dark,sv3,1,0.9695964542372388,225,15,20,260
439,dark,sv3,2,0.8970851598139832,241,22,24,287
439,dark,sv3,3,0.9366259346878785,241,14,16,271
439,dark,sv3,4,0.934283256887806,238,13,23,274
439,dark,sv3,5,0.9641365279131131,243,20,36,299
439,dark,sv3,6,0.9346586209535588,205,18,20,243
439,dark,sv3,7,0.9143553303572854,186,19,18,223
439,dark,sv3,8,0.9447360055784562,242,22,15,279
439,dark,sv3,9,0.9215359673876022,224,21,14,259
440,dark,sv3,0,0.9586824041870671,277,14,23,314
440,dark,sv3,1,0.9714721305040287,246,16,22,284
440,dark,sv3,2,0.9664856871501728,273,18,22,313
440,dark,sv3,3,0.9534673132744086,229,18,23,270
440,dark,sv3,4,0.9453383181842817,260,15,16,291
440,dark,sv3,5,0.9269304247253621,251,18,23,292
440,dark,sv3,6,0.9378183716627148,217,15,10,242
440,dark,sv3,7,0.8797805916764195,188,16,14,218
440,dark,sv3,8,0.9322942245147995,242,26,14,282
440,dark,sv3,9,0.9697444019288859,259,19,24,302
442,dark,sv3,0,0.9581617482407531,319,16,15,350
442,dark,sv3,1,0.9624233777640857,285,17,18,320
442,dark,sv3,2,0.9835246714288218,314,19,12,345
442,dark,sv3,3,0.9443506819139547,228,10,19,257
442,dark,sv3,4,0.952849739445162,293,15,29,337
442,dark,sv3,5,0.9712667836976845,284,14,43,341
442,dark,sv3,6,0.9388259817200995,261,11,28,300
442,dark,sv3,7,0.9556539243095936,272,9,22,303
442,dark,sv3,8,0.9512492082739512,308,14,21,343
442,dark,sv3,9,0.9625128527381891,312,14,11,337
445,dark,sv3,0,0.9411312916169146,295,12,16,323
445,dark,sv3,1,0.9405651879801942,274,16,11,301
445,dark,sv3,2,0.9560142754528795,310,17,13,340
445,dark,sv3,3,0.9562316826480646,278,11,30,319
445,dark,sv3,4,0.9397854472427125,270,16,34,320
445,dark,sv3,5,0.9397854472427123,280,14,26,320
445,dark,sv3,6,0.9330072121525048,241,12,30,283
445,dark,sv3,7,0.9340243286890942,231,17,17,265
445,dark,sv3,8,0.9452195786117492,303,21,13,337
445,dark,sv3,9,0.9611147018078356,301,16,20,337
448,dark,sv3,0,0.9616096317998045,303,15,23,341
448,dark,sv3,1,0.9651111979980642,278,16,17,311
448,dark,sv3,2,0.9132011656197204,307,17,25,349
448,dark,sv3,3,0.9605581191248568,269,16,23,308
448,dark,sv3,4,0.9647122362066913,306,16,13,335
448,dark,sv3,5,0.9603153957859151,283,19,28,330
448,dark,sv3,6,0.9194164812699183,255,9,16,280
448,dark,sv3,7,0.9431588601773713,229,15,24,268
448,dark,sv3,8,0.9650598128197765,302,18,28,348
448,dark,sv3,9,0.9647589405916854,282,14,43,339
451,dark,sv3,0,0.9750817118923456,294,12,25,331
451,dark,sv3,1,0.9541049581691031,273,17,20,310
451,dark,sv3,2,0.952262491490853,300,14,31,345
451,dark,sv3,3,0.9724758985362012,280,13,26,319
451,dark,sv3,4,0.9559472043612431,295,12,35,342
451,dark,sv3,5,0.9492440755601919,312,12,34,358
451,dark,sv3,6,0.9219010780439475,233,10,34,277
451,dark,sv3,7,0.9529641402097067,268,15,18,301
451,dark,sv3,8,0.9749842841377144,313,12,27,352
451,dark,sv3,9,0.9461398294687031,306,15,21,342
452,dark,sv3,0,0.9458042788309139,319,11,32,362
452,dark,sv3,1,0.9606538533087493,279,11,40,330
452,dark,sv3,2,0.9552568309535189,324,15,42,381
452,dark,sv3,3,0.9222744817634627,302,14,22,338
452,dark,sv3,4,0.9744817405717434,291,15,22,328
452,dark,sv3,5,0.9590569453587293,310,16,20,346
452,dark,sv3,6,0.9448917022606232,269,11,20,300
452,dark,sv3,7,0.9443111116488484,269,18,16,303
452,dark,sv3,8,0.957609094869911,314,9,23,346
452,dark,sv3,9,0.9602981519253612,317,17,24,358
454,dark,sv3,0,0.9290122088228983,255,15,12,282
454,dark,sv3,1,0.9529248132675878,218,15,18,251
454,dark,sv3,2,0.9571713082053013,257,11,8,276
454,dark,sv3,3,0.9764875512210339,220,13,18,251
454,dark,sv3,4,0.9436023015534822,225,12,43,280
454,dark,sv3,5,0.9313854320418155,244,12,38,294
454,dark,sv3,6,0.9534623676098671,209,13,36,258
454,dark,sv3,7,0.9185818596386662,179,10,18,207
454,dark,sv3,8,0.9118057368125966,209,8,17,234
454,dark,sv3,9,0.926155822903538,242,13,13,268
457,dark,sv3,0,0.934019074488438,218,19,15,252
457,dark,sv3,1,0.9253395548206409,198,12,15,225
457,dark,sv3,2,0.9350277919307132,212,14,17,243
457,dark,sv3,3,0.9151116110419529,210,20,16,246
457,dark,sv3,4,0.9129243754902525,219,21,16,256
457,dark,sv3,5,0.9228074528840822,216,15,28,259
457,dark,sv3,6,0.9118693210746727,206,17,18,241
457,dark,sv3,7,0.8806916348909016,168,9,14,191
457,dark,sv3,8,0.928316837403018,211,13,20,244
457,dark,sv3,9,0.9432549907607597,217,16,7,240
460,dark,sv3,0,0.9555935957347066,309,17,25,351
460,dark,sv3,1,0.9243119272623547,276,11,18,305
460,dark,sv3,2,0.9537524534991315,316,16,24,356
460,dark,sv3,3,0.9507605971768904,279,11,23,313
460,dark,sv3,4,0.9635648282654439,274,13,33,320
460,dark,sv3,5,0.9603585115874829,283,15,31,329
460,dark,sv3,6,0.9412194887959621,242,16,29,287
460,dark,sv3,7,0.9422772938023558,254,11,23,288
460,dark,sv3,8,0.963411508519596,286,11,27,324
460,dark,sv3,9,0.9544453399284144,283,19,17,319
463,dark,sv3,0,0.9419477186143641,301,18,18,337
463,dark,sv3,1,0.9390836322823718,286,13,17,316
463,dark,sv3,2,0.9687352469189975,296,20,19,335
463,dark,sv3,3,0.918352044449044,221,13,23,257
463,dark,sv3,4,0.9402504646221906,293,14,24,331
463,dark,sv3,5,0.9716000639799132,280,11,34,325
463,dark,sv3,6,0.9720225957908649,243,14,49,306
463,dark,sv3,7,0.9167083962361412,269,12,17,298
463,dark,sv3,8,0.9603488170177028,315,16,29,360
463,dark,sv3,9,0.9565787442759345,293,13,20,326
466,dark,sv3,0,0.9445205334417527,252,15,15,282
466,dark,sv3,1,0.9598318809716267,237,16,17,270
466,dark,sv3,2,0.9267571928710184,273,18,24,315
466,dark,sv3,3,0.962110485074588,255,15,31,301
466,dark,sv3,4,0.9429775929609557,243,16,26,285
466,dark,sv3,5,0.9111052713613392,270,13,29,312
466,dark,sv3,6,0.9093052928794789,223,16,17,256
466,dark,sv3,7,0.9294233829964818,211,15,10,236
466,dark,sv3,8,0.9322543578265614,259,17,20,296
466,dark,sv3,9,0.9544272829757818,234,18,16,268
469,dark,sv3,0,0.9317970134332187,250,22,33,305
469,dark,sv3,1,0.9384258938893244,238,17,29,284
469,dark,sv3,2,0.9466197853142405,240,20,20,280
469,dark,sv3,3,0.9663748312248025,241,13,18,272
469,dark,sv3,4,0.9600405818371521,228,19,12,259
469,dark,sv3,5,0.9554647416285467,248,16,12,276
469,dark,sv3,6,0.8911174367360261,193,17,7,217
469,dark,sv3,7,0.9233324860131652,206,14,9,229
469,dark,sv3,8,0.949365539121041,278,17,13,308
469,dark,sv3,9,0.9379117738916439,232,15,35,282
472,dark,sv3,0,0.9370010759887526,224,17,16,257
472,dark,sv3,1,0.9051656568936867,205,17,10,232
472,dark,sv3,2,0.9134135331431138,211,15,21,247
472,dark,sv3,3,0.9510767535026059,197,15,12,224
472,dark,sv3,4,0.8971412498482435,204,14,17,235
472,dark,sv3,5,0.920299137709567,213,18,22,253
472,dark,sv3,6,0.9204020206427688,186,12,28,226
472,dark,sv3,7,0.9071131050624742,158,18,30,206
472,dark,sv3,8,0.9671213592724432,222,10,22,254
472,dark,sv3,9,0.9460661410030288,188,15,19,222
475,dark,sv3,0,0.9229391982148681,244,11,15,270
475,dark,sv3,1,0.9251176549247114,222,14,15,251
475,dark,sv3,2,0.9111806809971166,261,12,17,290
475,dark,sv3,3,0.9517677740436133,218,13,23,254
475,dark,sv3,4,0.9190160998901756,227,16,30,273
475,dark,sv3,5,0.9363544563301827,217,17,44,278
475,dark,sv3,6,0.9590051334121775,219,12,35,266
475,dark,sv3,7,0.9016487951803545,187,12,25,224
475,dark,sv3,8,0.9458469587324818,226,14,16,256
475,dark,sv3,9,0.9586321765118913,246,16,18,280
478,dark,sv3,0,0.9740632756875967,274,17,18,309
478,dark,sv3,1,0.9167059773044796,229,17,20,266
478,dark,sv3,2,0.9348942901308859,239,13,31,283
478,dark,sv3,3,0.9198483212675711,216,12,29,257
478,dark,sv3,4,0.9627829365903783,234,16,24,274
478,dark,sv3,5,0.9511240417530034,248,12,34,294
478,dark,sv3,6,0.9406281774535276,209,16,20,245
478,dark,sv3,7,0.9167085202479802,183,12,11,206
478,dark,sv3,8,0.9496803234462934,210,13,22,245
478,dark,sv3,9,0.9534623676098674,223,14,20,257
481,dark,sv3,0,0.9460784078855957,265,14,99,378
481,dark,sv3,1,0.9447937951188968,229,16,82,327
481,dark,sv3,2,0.9678006142639133,260,13,93,366
481,dark,sv3,3,0.9358325536766658,229,12,84,325
481,dark,sv3,4,0.9631002137440904,243,11,86,340
481,dark,sv3,5,0.9503022032085108,253,11,85,349
481,dark,sv3,6,0.9598138892599041,217,12,86,315
481,dark,sv3,7,0.9627284565191977,192,13,72,277
481,dark,sv3,8,0.9658781705479264,249,16,84,349
481,dark,sv3,9,0.9487104737505913,246,16,91,353
482,dark,sv3,0,0.9722818953944841,274,13,82,369
482,dark,sv3,1,0.9667200923553269,244,13,76,333
482,dark,sv3,2,0.9524306396894269,267,10,78,355
482,dark,sv3,3,0.9321398357384887,241,10,63,314
482,dark,sv3,4,0.9529307223350277,257,12,65,334
482,dark,sv3,5,0.9356418501487044,138,8,24,170
482,dark,sv3,6,0.934252809287659,216,14,72,302
482,dark,sv3,7,0.9434888766569484,199,12,58,269
482,dark,sv3,8,0.9487299425246335,264,11,62,337
482,dark,sv3,9,0.9608137939400708,254,13,75,342
483,dark,sv3,0,0.9384632005636505,263,11,70,344
483,dark,sv3,1,0.9717141433752187,254,11,61,326
483,dark,sv3,2,0.9670012984171003,278,11,63,352
483,dark,sv3,3,0.9098590343312666,209,8,51,268
483,dark,sv3,4,0.9643919581762839,254,10,58,322
483,dark,sv3,5,0.9398497290372264,254,11,76,341
483,dark,sv3,6,0.940098689333843,231,12,66,309
483,dark,sv3,7,0.9124137004369907,193,9,51,253
483,dark,sv3,8,0.9551509454485584,274,11,73,358
483,dark,sv3,9,0.952093600526394,256,12,70,338
484,dark,sv3,0,0.9677995148627466,289,10,57,356
484,dark,sv3,1,0.9496126116152479,254,11,62,327
484,dark,sv3,2,0.9704038747463147,264,10,69,343
484,dark,sv3,3,0.9514182447754923,229,10,53,292
484,dark,sv3,4,0.9525443291493348,221,11,49,281
484,dark,sv3,5,0.9491157440811697,272,10,65,347
484,dark,sv3,6,0.9501142584504089,210,10,67,287
484,dark,sv3,7,0.9272275116992523,190,10,50,250
484,dark,sv3,8,0.9264039162875666,234,11,53,298
484,dark,sv3,9,0.9440018201152633,262,10,53,325
485,dark,sv3,0,0.9572350455068723,307,14,70,391
485,dark,sv3,1,0.9604522812805437,300,11,46,357
485,dark,sv3,2,0.9427025424449552,290,13,68,371
485,dark,sv3,3,0.9437457846707505,284,11,52,347
485,dark,sv3,4,0.9300151459129693,295,9,52,356
485,dark,sv3,5,0.9512152825377892,299,11,58,368
485,dark,sv3,6,0.9638496913346825,244,9,49,302
485,dark,sv3,7,0.9362052912531191,262,10,49,321
485,dark,sv3,8,0.9638102742086991,314,10,59,383
485,dark,sv3,9,0.96617478010748,294,13,64,371
486,dark,sv3,0,0.9869665173430604,308,12,40,360
486,dark,sv3,1,0.9545803381017613,306,12,37,355
486,dark,sv3,2,0.9606669083005215,305,13,41,359
486,dark,sv3,3,0.9418905798296325,266,9,19,294
486,dark,sv3,4,0.9419320958858499,291,14,43,348
486,dark,sv3,5,0.9638165549640222,289,10,50,349
486,dark,sv3,6,0.9568946626206732,267,13,46,326
486,dark,sv3,7,0.9470326583287282,248,11,50,309
486,dark,sv3,8,0.9432388475246549,316,10,46,372
486,dark,sv3,9,0.9335095472848335,299,12,45,356
487,dark,sv3,0,0.9542997960697388,328,11,29,368
487,dark,sv3,1,0.9500181374113189,302,12,22,336
487,dark,sv3,2,0.9679032234039334,314,13,32,359
487,dark,sv3,3,0.9549336437904961,296,12,32,340
487,dark,sv3,4,0.9559080289124734,316,15,29,360
487,dark,sv3,5,0.9632088607872383,292,10,39,341
487,dark,sv3,6,0.9391558626887493,272,10,37,319
487,dark,sv3,7,0.9474076552604422,273,10,22,305
487,dark,sv3,8,0.964714609812163,323,11,29,363
487,dark,sv3,9,0.9578403455244943,302,16,34,352
488,dark,sv3,0,0.9672985592732357,325,12,36,373
488,dark,sv3,1,0.9595409347067984,306,11,26,343
488,dark,sv3,2,0.9689668407211696,329,14,19,362
488,dark,sv3,3,0.9664633750250137,290,13,23,326
488,dark,sv3,4,0.9627859565004202,321,11,16,348
488,dark,sv3,5,0.971746807532479,306,14,25,345
488,dark,sv3,6,0.9503747359800155,263,11,25,299
488,dark,sv3,7,0.9425924988401729,249,13,26,288
488,dark,sv3,8,0.9111877041438692,327,12,21,360
488,dark,sv3,9,0.9387623746422842,304,15,25,344
489,dark,sv3,0,0.9371259090731796,263,11,32,306
489,dark,sv3,1,0.9447395108999992,285,14,15,314
489,dark,sv3,2,0.9351546580683382,295,12,20,327
489,dark,sv3,3,0.9583631179313686,299,12,11,322
489,dark,sv3,4,0.9244705714402144,304,11,12,327
489,dark,sv3,5,0.9501685766115678,302,12,28,342
489,dark,sv3,6,0.958340501091262,247,12,20,279
489,dark,sv3,7,0.9515689792910013,238,14,23,275
489,dark,sv3,8,0.9569607649319906,302,13,28,343
489,dark,sv3,9,0.9752627803255316,294,13,30,337
490,dark,sv3,0,0.9536130888462542,297,14,27,338
490,dark,sv3,1,0.9441116478201744,271,12,20,303
490,dark,sv3,2,0.9716650412666425,265,18,21,304
490,dark,sv3,3,0.9414492811626683,277,11,16,304
490,dark,sv3,4,0.9208628705698882,294,10,11,315
490,dark,sv3,5,0.9437743909779933,286,12,23,321
490,dark,sv3,6,0.963837664992079,261,13,19,293
490,dark,sv3,7,0.9378976458097122,247,12,16,275
490,dark,sv3,8,0.9462731578308579,292,11,15,318
490,dark,sv3,9,0.9535233769322081,301,11,23,335
491,dark,sv3,0,0.9344388986362758,308,19,23,350
491,dark,sv3,1,0.9713843717677042,282,12,24,318
491,dark,sv3,2,0.9608089287759422,282,18,25,325
491,dark,sv3,3,0.9343761383636647,276,14,13,303
491,dark,sv3,4,0.9589647645437045,283,12,9,304
491,dark,sv3,5,0.9619955723249745,310,15,19,344
491,dark,sv3,6,0.9622566766139551,269,14,16,299
491,dark,sv3,7,0.9498560720826572,248,15,28,291
491,dark,sv3,8,0.9706211688326105,307,12,23,342
491,dark,sv3,9,0.9690428548481111,298,14,36,348
495,bright,sv3,0,0.9582278222682692,368,35,1,404
495,bright,sv3,1,0.971386755823729,302,49,2,353
495,bright,sv3,2,0.9652005897897213,348,43,5,396
495,bright,sv3,3,0.9515122643214863,258,28,3,289
495,bright,sv3,4,0.9441190197446325,336,16,4,356
495,bright,sv3,5,0.9716310403643093,330,47,4,381
495,bright,sv3,6,0.9295229981034852,299,26,4,329
495,bright,sv3,7,0.914134899324298,272,15,3,290
495,bright,sv3,8,0.9614083656674101,334,40,11,385
495,bright,sv3,9,0.9758701042793543,351,22,4,377
496,bright,sv3,0,0.9399024993734191,301,78,1,380
496,bright,sv3,1,0.9351580949505707,257,87,7,351
496,bright,sv3,2,0.97068178570577,286,93,4,383
496,bright,sv3,3,0.9724853361961202,269,61,3,333
496,bright,sv3,4,0.9682881452821509,300,49,5,354
496,bright,sv3,5,0.9617829960658199,281,80,4,365
496,bright,sv3,6,0.9302407965803677,234,60,2,296
496,bright,sv3,7,0.9421438758682465,230,58,8,296
496,bright,sv3,8,0.9390439668594709,303,73,6,382
496,bright,sv3,9,0.9396111900555731,314,57,6,377
497,bright,sv3,0,0.9627837988121044,289,117,8,414
497,bright,sv3,1,0.9577239517915406,247,114,7,368
497,bright,sv3,2,0.9604906999067537,252,133,6,391
497,bright,sv3,3,0.9811803124184248,228,93,1,322
497,bright,sv3,4,0.9567269291878037,304,82,1,387
497,bright,sv3,5,0.9742550071928041,264,124,4,392
497,bright,sv3,6,0.9614830761449249,249,92,6,347
497,bright,sv3,7,0.9575393087054284,262,79,2,343
497,bright,sv3,8,0.9507319609615468,277,119,7,403
497,bright,sv3,9,0.9840561934855059,321,86,2,409
498,bright,sv3,0,0.9587043525209102,257,142,7,406
498,bright,sv3,1,0.9456941461933511,198,164,5,367
498,bright,sv3,2,0.9318580959100196,239,159,4,402
498,bright,sv3,3,0.9752252137094577,278,98,6,382
498,bright,sv3,4,0.9764811669344032,277,105,7,389
498,bright,sv3,5,0.971739604557081,243,144,13,400
498,bright,sv3,6,0.969984857563304,208,138,5,351
498,bright,sv3,7,0.9337494968818215,231,118,6,355
498,bright,sv3,8,0.9549890140994174,263,128,9,400
498,bright,sv3,9,0.9802207784993108,286,118,3,407
499,bright,sv3,0,0.9224835217193866,257,149,5,411
499,bright,sv3,1,0.9622670202358669,200,162,4,366
499,bright,sv3,2,0.9512648361917825,220,169,1,390
499,bright,sv3,3,0.9578564382310436,227,141,2,370
499,bright,sv3,4,0.9512918807265026,243,142,3,388
499,bright,sv3,5,0.9514030210740234,220,161,10,391
499,bright,sv3,6,0.9605892322409005,197,145,3,345
499,bright,sv3,7,0.9593313478221371,218,124,4,346
499,bright,sv3,8,0.9685449294492992,225,168,4,397
499,bright,sv3,9,0.9499166619822982,291,102,8,401
500,bright,sv3,0,0.9607910650300278,231,176,1,408
500,bright,sv3,1,0.9565324430788356,201,166,4,371
500,bright,sv3,2,0.9652614256528285,224,162,2,388
500,bright,sv3,3,0.9563555983722944,218,153,2,373
500,bright,sv3,4,0.9438461127256247,242,144,5,391
500,bright,sv3,5,0.9696209917598996,224,158,9,391
500,bright,sv3,6,0.9542442175112261,220,124,4,348
500,bright,sv3,7,0.9346987742804667,199,137,6,342
500,bright,sv3,8,0.9614957441282743,224,163,5,392
500,bright,sv3,9,0.972727279735385,242,159,4,405
501,bright,sv3,0,0.9585815894583378,230,173,9,412
501,bright,sv3,1,0.970559000918448,194,175,7,376
501,bright,sv3,2,0.9756607344097359,228,172,6,406
501,bright,sv3,3,0.9624698280497431,222,145,0,367
501,bright,sv3,4,0.9747235101203617,248,138,2,388
501,bright,sv3,5,0.9689179123563727,227,155,4,386
501,bright,sv3,6,0.9792207912011727,204,138,5,347
501,bright,sv3,7,0.9723219202199437,205,132,5,342
501,bright,sv3,8,0.9598151302267871,238,157,6,401
501,bright,sv3,9,0.9823297674870362,253,155,3,411
502,bright,sv3,0,0.9724687519996389,262,149,3,414
502,bright,sv3,1,0.9823485862705753,214,158,1,373
502,bright,sv3,2,0.9559324824825115,247,144,4,395
502,bright,sv3,3,0.9417933740152589,225,134,5,364
502,bright,sv3,4,0.9733772846366929,256,135,4,395
502,bright,sv3,5,0.9402105611014832,233,157,2,392
502,bright,sv3,6,0.9154770367164672,211,126,3,340
502,bright,sv3,7,0.9748605140432397,202,136,2,340
502,bright,sv3,8,0.9725447527028963,226,175,3,404
502,bright,sv3,9,0.9473812127329698,266,142,5,413
503,bright,sv3,0,0.9671840666113445,257,155,3,415
503,bright,sv3,1,0.9606632213500359,225,144,1,370
503,bright,sv3,2,0.9444254714891559,249,134,5,388
503,bright,sv3,3,0.9708699920648014,240,134,3,377
503,bright,sv3,4,0.967925644571455,241,141,3,385
503,bright,sv3,5,0.9658405715576474,251,137,5,393
503,bright,sv3,6,0.9574019428575398,224,122,2,348
503,bright,sv3,7,0.9672861011163435,214,128,6,348
503,bright,sv3,8,0.9533062518531799,222,174,6,402
503,bright,sv3,9,0.9505574211274211,281,121,3,405
504,bright,sv3,0,0.9661969103471101,240,156,4,400
504,bright,sv3,1,0.9420682124604142,214,150,5,369
504,bright,sv3,2,0.9563611104478573,247,143,4,394
504,bright,sv3,3,0.9532353711230428,243,133,2,378
504,bright,sv3,4,0.9678133343255392,261,118,8,387
504,bright,sv3,5,0.9524546806588441,230,150,4,384
504,bright,sv3,6,0.9423386892289919,220,114,2,336
504,bright,sv3,7,0.9426963221178083,214,124,5,343
504,bright,sv3,8,0.9398368245137547,265,136,5,406
504,bright,sv3,9,0.9575181228081423,264,135,4,403
506,backup,sv3,0,0.9464598985743976,4,294,4,302
506,backup,sv3,1,0.9600405818371521,2,255,0,257
506,backup,sv3,2,0.955631905949196,0,271,0,271
506,backup,sv3,3,0.9402651593259923,2,241,1,244
506,backup,sv3,4,0.8718537707723819,3,241,2,246
506,backup,sv3,5,0.9266200536654547,2,260,2,264
506,backup,sv3,6,0.902518417788816,2,251,1,254
506,backup,sv3,7,0.8877721737130871,1,217,1,219
506,backup,sv3,8,0.9204034482224391,2,281,1,284
506,backup,sv3,9,0.9358034196727048,5,254,2,261
511,dark,sv3,0,0.9576090948699107,250,16,81,347
511,dark,sv3,1,0.9425434515063998,209,12,79,300
511,dark,sv3,2,0.9526791147067406,233,17,87,337
511,dark,sv3,3,0.9336267353643993,205,17,83,305
511,dark,sv3,4,0.9671627255064711,227,13,77,317
511,dark,sv3,5,0.9256563703102157,234,13,80,327
511,dark,sv3,6,0.9236667168874076,201,20,73,294
511,dark,sv3,7,0.906547030088804,186,18,53,257
511,dark,sv3,8,0.9475982138119841,253,16,56,325
511,dark,sv3,9,0.9457915425916041,239,12,77,328
512,dark,sv3,0,0.9732609400412674,270,14,60,344
512,dark,sv3,1,0.9486145884207737,225,12,77,314
512,dark,sv3,2,0.9537889999523558,253,13,69,335
512,dark,sv3,3,0.9302407965803678,215,19,64,298
512,dark,sv3,4,0.9502588599429725,234,13,59,306
512,dark,sv3,5,0.8470256456323835,122,6,33,161
512,dark,sv3,6,0.9401030622845352,221,11,63,295
512,dark,sv3,7,0.9486155579854093,201,15,49,265
512,dark,sv3,8,0.9653622294232176,260,13,57,330
512,dark,sv3,9,0.9626473048234808,244,13,64,321
513,dark,sv3,0,0.9351962424659632,276,12,43,331
513,dark,sv3,1,0.962997722131165,240,9,55,304
513,dark,sv3,2,0.9571256771782775,247,12,62,321
513,dark,sv3,3,0.9369520040143293,208,13,53,274
513,dark,sv3,4,0.9364096836460853,240,10,52,302
513,dark,sv3,5,0.96784600244991,251,13,65,329
513,dark,sv3,6,0.9383539581512594,226,11,47,284
513,dark,sv3,7,0.957019621335307,197,11,40,248
513,dark,sv3,8,0.9622353692743554,251,15,63,329
513,dark,sv3,9,0.9674380759263999,266,10,60,336
514,dark,sv3,0,0.9239385149370557,287,9,48,344
514,dark,sv3,1,0.9417110981820548,264,11,62,337
514,dark,sv3,2,0.9695014050907631,272,15,62,349
514,dark,sv3,3,0.9439650147362035,271,10,54,335
514,dark,sv3,4,0.9492988550042627,256,9,50,315
514,dark,sv3,5,0.9696798927405862,283,10,59,352
514,dark,sv3,6,0.9010801957660215,216,12,46,274
514,dark,sv3,7,0.9465294799243037,260,12,42,314
514,dark,sv3,8,0.9466467857264141,297,13,56,366
514,dark,sv3,9,0.969403582997807,273,12,54,339
515,dark,sv3,0,0.9549514099468244,314,12,36,362
515,dark,sv3,1,0.9698669069243887,273,12,55,340
515,dark,sv3,2,0.9506228357660412,274,12,59,345
515,dark,sv3,3,0.9668644578049058,277,14,40,331
515,dark,sv3,4,0.965089156197869,270,14,51,335
515,dark,sv3,5,0.9652314444863098,291,10,50,351
515,dark,sv3,6,0.9382516331823146,262,14,38,314
515,dark,sv3,7,0.9368388543844105,245,11,36,292
515,dark,sv3,8,0.9757010617424938,302,11,49,362
515,dark,sv3,9,0.9807477888360631,285,12,44,341
516,dark,sv3,0,0.9379569761550709,236,8,16,260
516,dark,sv3,1,0.9653799847093575,268,10,37,315
516,dark,sv3,2,0.944723370472679,266,15,43,324
516,dark,sv3,3,0.9167139613094968,273,13,33,319
516,dark,sv3,4,0.9423307562831136,266,9,44,319
516,dark,sv3,5,0.9662863518589017,268,12,47,327
516,dark,sv3,6,0.9644625702816744,241,12,37,290
516,dark,sv3,7,0.9520333332353295,238,11,35,284
516,dark,sv3,8,0.9663243538063743,281,14,38,333
516,dark,sv3,9,0.9681595044270954,300,10,25,335
517,dark,sv3,0,0.9665101678080902,274,14,22,310
517,dark,sv3,1,0.9384996170458351,252,13,27,292
517,dark,sv3,2,0.9413452424206428,263,14,26,303
517,dark,sv3,3,0.9689837784038977,283,17,28,328
517,dark,sv3,4,0.9669308022060168,260,11,29,300
517,dark,sv3,5,0.9384411833952445,294,12,29,335
517,dark,sv3,6,0.9669809654574079,237,16,35,288
517,dark,sv3,7,0.9131557057309693,239,12,22,273
517,dark,sv3,8,0.9343000036109966,269,13,18,300
517,dark,sv3,9,0.940312631309407,297,13,20,330
518,dark,sv3,0,0.9711944319672369,293,13,18,324
518,dark,sv3,1,0.9636889667806784,276,11,28,315
518,dark,sv3,2,0.962911086133334,270,18,36,324
518,dark,sv3,3,0.9631232242442599,260,18,35,313
518,dark,sv3,4,0.960793295315559,284,10,18,312
518,dark,sv3,5,0.9477838109852463,285,14,35,334
518,dark,sv3,6,0.9607701494987454,260,17,17,294
518,dark,sv3,7,0.9352596530271615,240,12,17,269
518,dark,sv3,8,0.9481121402900946,301,12,18,331
518,dark,sv3,9,0.9768276887363467,310,13,20,343
519,dark,sv3,0,0.9179374099901486,273,19,11,303
519,dark,sv3,1,0.9219529238986169,262,14,10,286
519,dark,sv3,2,0.9121719312030447,252,16,23,291
519,dark,sv3,3,0.9683899456572477,278,16,14,308
519,dark,sv3,4,0.8793142870584961,177,4,9,190
519,dark,sv3,5,0.9445519888664335,272,14,24,310
519,dark,sv3,6,0.9389591060242429,232,13,19,264
519,dark,sv3,7,0.9331713558321398,229,14,26,269
519,dark,sv3,8,0.9265617279843278,272,14,21,307
519,dark,sv3,9,0.9641440303570084,270,13,19,302
520,dark,sv3,0,0.9551510781196995,277,14,17,308
520,dark,sv3,1,0.9611439584670001,246,17,28,291
520,dark,sv3,2,0.9212575781275941,263,16,24,303
520,dark,sv3,3,0.9262633338818608,271,14,20,305
520,dark,sv3,4,0.9394020539733108,253,14,16,283
520,dark,sv3,5,0.9716103113212781,269,15,24,308
520,dark,sv3,6,0.9466197853142405,247,20,14,281
520,dark,sv3,7,0.8935500212193506,227,11,12,250
520,dark,sv3,8,0.9594378679677152,281,14,15,310
520,dark,sv3,9,0.9533518966802451,263,16,18,297
521,dark,sv3,0,0.9388877594290258,253,20,16,289
521,dark,sv3,1,0.9511601341018298,234,14,13,261
521,dark,sv3,2,0.9390482106793848,247,17,22,286
521,dark,sv3,3,0.951688211386472,253,15,11,279
521,dark,sv3,4,0.9455320739822559,232,15,13,260
521,dark,sv3,5,0.9737945999278911,262,16,15,293
521,dark,sv3,6,0.9478983205197119,206,22,16,244
521,dark,sv3,7,0.8988409628778686,220,19,13,252
521,dark,sv3,8,0.9504897672724697,256,18,21,295
521,dark,sv3,9,0.927420178533547,242,17,23,282
525,bright,sv3,0,0.9596011643922496,348,52,1,401
525,bright,sv3,1,0.9537694316003718,294,44,5,343
525,bright,sv3,2,0.9608782443568681,351,42,6,399
525,bright,sv3,3,0.953332508064165,299,34,5,338
525,bright,sv3,4,0.9389679190775878,308,49,4,361
525,bright,sv3,5,0.9400731653810713,359,16,2,377
525,bright,sv3,6,0.9459728708848388,307,23,3,333
525,bright,sv3,7,0.9417930692139346,275,17,0,292
525,bright,sv3,8,0.9533811590784727,346,22,3,371
525,bright,sv3,9,0.9538936120748727,346,29,3,378
526,bright,sv3,0,0.9879002743885303,276,117,5,398
526,bright,sv3,1,0.9654170729588079,266,85,3,354
526,bright,sv3,2,0.9473249453148469,280,107,5,392
526,bright,sv3,3,0.9527749876709027,236,106,3,345
526,bright,sv3,4,0.9676953971797841,262,90,5,357
526,bright,sv3,5,0.9132238314126208,127,50,1,178
526,bright,sv3,6,0.946245350755638,263,68,5,336
526,bright,sv3,7,0.9115091909885203,267,23,1,291
526,bright,sv3,8,0.9687354466990398,299,69,5,373
526,bright,sv3,9,0.9687354466990398,299,69,5,373
527,bright,sv3,0,0.9574997553962918,238,147,7,392
527,bright,sv3,1,0.9714497172328401,201,152,2,355
527,bright,sv3,2,0.9394340934762144,208,179,3,390
527,bright,sv3,3,0.9616577053327217,180,154,3,337
527,bright,sv3,4,0.9226809571645572,204,155,1,360
527,bright,sv3,5,0.9654397648910636,275,92,3,370
527,bright,sv3,6,0.9443417485193557,224,102,5,331
527,bright,sv3,7,0.9368388543844103,253,40,1,294
527,bright,sv3,8,0.9535279668515604,202,119,2,323
527,bright,sv3,9,0.9242985684523518,285,82,9,376
528,bright,sv3,0,0.9775230355167764,184,245,2,431
528,bright,sv3,1,0.9609100185471935,157,235,1,393
528,bright,sv3,2,0.968981682611089,172,247,0,419
528,bright,sv3,3,0.9655477854431966,176,205,4,385
528,bright,sv3,4,0.9370919237454436,197,196,2,395
528,bright,sv3,5,0.9553274731799495,243,171,2,416
528,bright,sv3,6,0.9664901449221444,175,148,2,325
528,bright,sv3,7,0.9692115720431034,246,113,2,361
528,bright,sv3,8,0.9606344745342498,222,194,3,419
528,bright,sv3,9,0.926764428877817,229,197,1,427
529,bright,sv3,0,0.9519807209154726,175,247,1,423
529,bright,sv3,1,0.959233122242839,144,246,2,392
529,bright,sv3,2,0.9463246242173213,158,259,3,420
529,bright,sv3,3,0.9367315812865185,120,200,0,320
529,bright,sv3,4,0.962357873843288,135,228,0,363
529,bright,sv3,5,0.9626708774588116,205,206,6,417
529,bright,sv3,6,0.9557489069654063,181,177,2,360
529,bright,sv3,7,0.9588282137537583,229,136,1,366
529,bright,sv3,8,0.9609834351259108,209,209,1,419
529,bright,sv3,9,0.9705401343819475,254,167,7,428
530,bright,sv3,0,0.9675140916764319,150,277,2,429
530,bright,sv3,1,0.9691515199623421,138,246,4,388
530,bright,sv3,2,0.9790282764062016,142,280,5,427
530,bright,sv3,3,0.9336814360679814,130,257,1,388
530,bright,sv3,4,0.9622732107910105,150,241,1,392
530,bright,sv3,5,0.9598588330927743,185,220,2,407
530,bright,sv3,6,0.9567621046014436,153,208,0,361
530,bright,sv3,7,0.9493141020650088,205,158,1,364
530,bright,sv3,8,0.9654357471808244,160,256,1,417
530,bright,sv3,9,0.9701637462057779,173,250,2,425
531,bright,sv3,0,0.9687219271759921,153,267,5,425
531,bright,sv3,1,0.9678852681468393,134,252,5,391
531,bright,sv3,2,0.9575307837589764,153,255,1,409
531,bright,sv3,3,0.9633558744870656,148,235,5,388
531,bright,sv3,4,0.9677165704119873,153,247,2,402
531,bright,sv3,5,0.9645752474927682,185,232,2,419
531,bright,sv3,6,0.925042317503319,143,222,1,366
531,bright,sv3,7,0.965081194369843,180,184,1,365
531,bright,sv3,8,0.9719452677900577,175,251,1,427
531,bright,sv3,9,0.953562167829274,154,274,0,428
532,bright,sv3,0,0.9539933354431864,188,240,2,430
532,bright,sv3,1,0.9660593399376046,154,229,4,387
532,bright,sv3,2,0.9555447504390274,169,245,3,417
532,bright,sv3,3,0.9757857299533796,150,227,3,380
532,bright,sv3,4,0.973615992354091,144,242,3,389
532,bright,sv3,5,0.952905872637713,159,248,2,409
532,bright,sv3,6,0.9407526299093224,142,220,3,365
532,bright,sv3,7,0.9499465173619315,163,189,6,358
532,bright,sv3,8,0.9467530829917481,148,256,2,406
532,bright,sv3,9,0.9624920244605569,177,246,1,424
533,bright,sv3,0,0.9802429408542344,206,220,2,428
533,bright,sv3,1,0.9579681576383401,165,223,3,391
533,bright,sv3,2,0.9784783051144118,161,244,4,409
533,bright,sv3,3,0.976271557215065,146,232,4,382
533,bright,sv3,4,0.9469024871436548,168,223,3,394
533,bright,sv3,5,0.9672334342747223,203,209,1,413
533,bright,sv3,6,0.944847659865265,161,197,2,360
533,bright,sv3,7,0.9079840214130934,181,180,1,362
533,bright,sv3,8,0.9734281842773334,185,232,2,419
533,bright,sv3,9,0.9566553805709775,176,237,3,416
534,bright,sv3,0,0.9632465850733588,180,245,3,428
534,bright,sv3,1,0.9592230192520474,146,238,3,387
534,bright,sv3,2,0.9641634216039231,169,239,4,412
534,bright,sv3,3,0.9697757058185942,157,224,3,384
534,bright,sv3,4,0.9322261283076354,125,148,1,274
534,bright,sv3,5,0.9535420518939953,173,231,5,409
534,bright,sv3,6,0.945006781812332,174,184,4,362
534,bright,sv3,7,0.9540148651477195,162,190,0,352
534,bright,sv3,8,0.9709697215506029,185,219,3,407
534,bright,sv3,9,0.9735317713973527,200,218,1,419
541,dark,sv3,0,0.9495585631187001,276,16,87,379
541,dark,sv3,1,0.9505386477801798,241,14,80,335
541,dark,sv3,2,0.9575393087054284,234,16,91,341
541,dark,sv3,3,0.9366533566686839,218,13,81,312
541,dark,sv3,4,0.9405810891263929,236,13,80,329
541,dark,sv3,5,0.8991771905449631,112,6,52,170
541,dark,sv3,6,0.940489053227526,212,21,68,301
541,dark,sv3,7,0.9609511407375038,173,24,73,270
541,dark,sv3,8,0.9539854676327186,237,27,74,338
541,dark,sv3,9,0.9612268280548998,254,13,78,345
542,dark,sv3,0,0.9379479722127816,260,17,75,352
542,dark,sv3,1,0.9330630106152291,254,10,57,321
542,dark,sv3,2,0.9390118866012634,270,14,57,341
542,dark,sv3,3,0.9129243754902525,190,10,57,257
542,dark,sv3,4,0.9302482228585041,244,11,65,320
542,dark,sv3,5,0.9591516249270609,229,19,82,330
542,dark,sv3,6,0.9401475198818623,210,16,75,301
542,dark,sv3,7,0.9481046396726948,189,20,54,263
542,dark,sv3,8,0.9714813838801298,268,15,66,349
542,dark,sv3,9,0.9507964866286517,255,14,75,344
543,dark,sv3,0,0.9633547501876836,273,12,71,356
543,dark,sv3,1,0.9678703018661678,254,12,61,327
543,dark,sv3,2,0.9771349213162813,280,14,52,346
543,dark,sv3,3,0.9124959671851268,223,12,61,296
543,dark,sv3,4,0.956114959573624,247,12,56,315
543,dark,sv3,5,0.9532048866235378,253,17,76,346
543,dark,sv3,6,0.9700228724309053,220,15,59,294
543,dark,sv3,7,0.9212301704288122,177,21,56,254
543,dark,sv3,8,0.9396884821340106,184,11,37,232
543,dark,sv3,9,0.9670638049154575,259,11,59,329
544,dark,sv3,0,0.9543346797867068,307,14,61,382
544,dark,sv3,1,0.9675038252098406,294,11,57,362
544,dark,sv3,2,0.9522101802715125,306,15,52,373
544,dark,sv3,3,0.955058233649331,270,18,67,355
544,dark,sv3,4,0.9609495679452835,299,18,56,373
544,dark,sv3,5,0.9452106708013854,305,15,62,382
544,dark,sv3,6,0.9349945035037521,245,17,59,321
544,dark,sv3,7,0.9328830332863971,251,21,57,329
544,dark,sv3,8,0.9666426305529708,335,17,46,398
544,dark,sv3,9,0.9736307043385406,305,14,63,382
545,dark,sv3,0,0.9756636445157044,302,18,54,374
545,dark,sv3,1,0.9591975931496135,280,12,66,358
545,dark,sv3,2,0.963055197244297,322,15,43,380
545,dark,sv3,3,0.9550072854555831,269,15,49,333
545,dark,sv3,4,0.9532459734462084,285,13,47,345
545,dark,sv3,5,0.9457171323559455,305,14,56,375
545,dark,sv3,6,0.9577674906499608,252,16,55,323
545,dark,sv3,7,0.9617518699849058,238,20,59,317
545,dark,sv3,8,0.9319394189176159,330,13,41,384
545,dark,sv3,9,0.9502512513314388,279,15,65,359
546,dark,sv3,0,0.9542890049208662,235,10,26,271
546,dark,sv3,1,0.9555312330808434,279,12,43,334
546,dark,sv3,2,0.9449255792293348,304,14,39,357
546,dark,sv3,3,0.9606998123659104,286,15,35,336
546,dark,sv3,4,0.9635246108417034,299,12,42,353
546,dark,sv3,5,0.9541603218836696,287,17,48,352
546,dark,sv3,6,0.9440988859232782,244,20,46,310
546,dark,sv3,7,0.9513915224213844,237,19,52,308
546,dark,sv3,8,0.9649163583001384,298,17,37,352
546,dark,sv3,9,0.9566881874845659,309,14,38,361
547,dark,sv3,0,0.9632742535123687,307,18,27,352
547,dark,sv3,1,0.9364976499405601,290,17,29,336
547,dark,sv3,2,0.9636811308938691,265,18,33,316
547,dark,sv3,3,0.9576503862005082,282,15,35,332
547,dark,sv3,4,0.938733761470618,297,12,42,351
547,dark,sv3,5,0.9381430963895184,241,17,29,287
547,dark,sv3,6,0.9362613972644306,247,22,23,292
547,dark,sv3,7,0.9684261346586132,236,19,42,297
547,dark,sv3,8,0.9603934292733339,293,16,28,337
547,dark,sv3,9,0.9464610691183474,286,14,31,331
548,dark,sv3,0,0.9679554234848798,290,21,35,346
548,dark,sv3,1,0.9724758985362012,268,15,33,316
548,dark,sv3,2,0.9404006077106715,281,16,25,322
548,dark,sv3,3,0.9517037969644431,275,17,26,318
548,dark,sv3,4,0.9542699184995276,301,16,16,333
548,dark,sv3,5,0.9625742645292515,289,19,27,335
548,dark,sv3,6,0.9545742524320221,271,13,22,306
548,dark,sv3,7,0.9174038155839969,231,30,30,291
548,dark,sv3,8,0.9679076784788415,316,20,26,362
548,dark,sv3,9,0.9696378758512071,270,10,42,322
549,dark,sv3,0,0.9506874287132872,274,18,23,315
549,dark,sv3,1,0.9530547848344089,276,15,25,316
549,dark,sv3,2,0.9527657382362713,287,22,20,329
549,dark,sv3,3,0.9720690169611548,258,18,20,296
549,dark,sv3,4,0.9431456883394955,192,14,18,224
549,dark,sv3,5,0.9706443201190734,267,21,29,317
549,dark,sv3,6,0.945199276569008,232,25,29,286
549,dark,sv3,7,0.9084264324976148,237,23,30,290
549,dark,sv3,8,0.9507885349016572,308,19,25,352
549,dark,sv3,9,0.9430361315017136,275,18,29,322
550,dark,sv3,0,0.9463475870438379,260,18,28,306
550,dark,sv3,1,0.9448126793636025,214,12,87,313
550,dark,sv3,2,0.9482746491461984,276,13,30,319
550,dark,sv3,3,0.9447921560144447,274,16,20,310
550,dark,sv3,4,0.9318869189533738,224,15,16,255
550,dark,sv3,5,0.9688275470949141,283,20,27,330
550,dark,sv3,6,0.9583349460998045,224,23,17,264
550,dark,sv3,7,0.9670532919201916,228,35,20,283
550,dark,sv3,8,0.9541688832568714,269,22,22,313
550,dark,sv3,9,0.9675582168464124,261,18,20,299
551,dark,sv3,0,0.9732863256971557,296,18,25,339
551,dark,sv3,1,0.9659767366109824,261,21,16,298
551,dark,sv3,2,0.9668696622244295,306,19,16,341
551,dark,sv3,3,0.9696586099213211,258,22,26,306
551,dark,sv3,4,0.9089595613294452,232,16,9,257
551,dark,sv3,5,0.9568510078715858,279,20,27,326
551,dark,sv3,6,0.9610499297696552,244,17,24,285
551,dark,sv3,7,0.9311756989849355,218,25,32,275
551,dark,sv3,8,0.9460798830203161,289,26,28,343
551,dark,sv3,9,0.9566260401486022,275,13,34,322
555,bright,sv3,0,0.9635873428905581,366,29,6,401
555,bright,sv3,1,0.9548748180771124,311,37,3,351
555,bright,sv3,2,0.96003158962929,316,61,5,382
555,bright,sv3,3,0.9702548861054257,289,43,2,334
555,bright,sv3,4,0.9440276377507208,282,65,6,353
555,bright,sv3,5,0.8740621677785397,158,26,3,187
555,bright,sv3,6,0.960428066793624,292,35,1,328
555,bright,sv3,7,0.9404838269977236,254,36,2,292
555,bright,sv3,8,0.9547397278378815,315,46,7,368
555,bright,sv3,9,0.9662175168006314,362,13,4,379
556,bright,sv3,0,0.9692867924184043,291,109,4,404
556,bright,sv3,1,0.9473766056216334,270,78,7,355
556,bright,sv3,2,0.9642372947270942,272,115,5,392
556,bright,sv3,3,0.9612246578515037,257,74,5,336
556,bright,sv3,4,0.922059779611054,238,121,4,363
556,bright,sv3,5,0.9494094854979689,272,99,6,377
556,bright,sv3,6,0.9563627778013256,258,68,5,331
556,bright,sv3,7,0.9362613972644308,235,57,3,295
556,bright,sv3,8,0.968030883343026,278,95,7,380
556,bright,sv3,9,0.9410136953554665,321,51,3,375
557,bright,sv3,0,0.96712185665154,243,181,4,428
557,bright,sv3,1,0.9684369648300245,228,176,1,405
557,bright,sv3,2,0.9688201173945775,204,229,1,434
557,bright,sv3,3,0.9702383579091783,182,205,4,391
557,bright,sv3,4,0.9679648559866646,167,235,4,406
557,bright,sv3,5,0.971544606396488,239,174,5,418
557,bright,sv3,6,0.9491821638192506,184,139,4,327
557,bright,sv3,7,0.9554645308748964,194,167,1,362
557,bright,sv3,8,0.9738193508141518,226,190,4,420
557,bright,sv3,9,0.9560911489599909,259,164,7,430
558,bright,sv3,0,0.9610956208801635,184,243,4,431
558,bright,sv3,1,0.962780016384056,140,254,1,395
558,bright,sv3,2,0.9581665459673147,155,265,3,423
558,bright,sv3,3,0.9425590351051983,166,169,1,336
558,bright,sv3,4,0.9699263571216399,152,250,5,407
558,bright,sv3,5,0.9566828116417055,176,243,3,422
558,bright,sv3,6,0.9356283586094424,137,229,1,367
558,bright,sv3,7,0.9447511720256166,133,235,2,370
558,bright,sv3,8,0.9705068477366339,151,275,2,428
558,bright,sv3,9,0.9623785136972564,206,224,6,436
559,bright,sv3,0,0.9651968361480839,127,308,5,440
559,bright,sv3,1,0.9576042630262387,143,259,0,402
559,bright,sv3,2,0.9619650534487766,125,305,1,431
559,bright,sv3,3,0.9410844942618072,96,299,2,397
559,bright,sv3,4,0.9582384689756278,94,316,4,414
559,bright,sv3,5,0.954985484201245,111,311,4,426
559,bright,sv3,6,0.9729162253790247,98,271,2,371
559,bright,sv3,7,0.962385569939889,115,248,4,367
559,bright,sv3,8,0.9532429475118503,142,284,2,428
559,bright,sv3,9,0.9670701807780241,184,243,3,430
560,bright,sv3,0,0.968430155545072,97,342,0,439
560,bright,sv3,1,0.9676396084487232,77,323,3,403
560,bright,sv3,2,0.9731911525605352,88,319,3,410
560,bright,sv3,3,0.9690565727329593,72,263,1,336
560,bright,sv3,4,0.9832380649209969,69,329,4,402
560,bright,sv3,5,0.9653132352240144,99,312,8,419
560,bright,sv3,6,0.9798323407879045,90,280,3,373
560,bright,sv3,7,0.9687356340211425,98,271,1,370
560,bright,sv3,8,0.9713231296288559,84,344,2,430
560,bright,sv3,9,0.95173198373019,116,313,3,432
561,bright,sv3,0,0.9775770557777435,85,352,1,438
561,bright,sv3,1,0.9710459138942343,70,333,2,405
561,bright,sv3,2,0.9540049245594309,97,338,0,435
561,bright,sv3,3,0.9651669296714993,96,297,1,394
561,bright,sv3,4,0.9595557434003377,79,325,3,407
561,bright,sv3,5,0.9821586091050886,79,329,10,418
561,bright,sv3,6,0.9507365773146661,70,300,1,371
561,bright,sv3,7,0.9395024998552336,61,305,3,369
561,bright,sv3,8,0.9672687087170083,68,355,1,424
561,bright,sv3,9,0.961336679041552,101,333,2,436
562,bright,sv3,0,0.9449192326961608,93,251,3,347
562,bright,sv3,1,0.9450182220139303,86,313,0,399
562,bright,sv3,2,0.9498046835729316,98,333,1,432
562,bright,sv3,3,0.9803519413546132,90,308,3,401
562,bright,sv3,4,0.9566528879931742,81,326,1,408
562,bright,sv3,5,0.9707744500754522,77,343,2,422
562,bright,sv3,6,0.9147357278997538,70,301,1,372
562,bright,sv3,7,0.9538629020056133,58,304,3,365
562,bright,sv3,8,0.9643544210649819,89,336,2,427
562,bright,sv3,9,0.9647706171990958,103,332,1,436
563,bright,sv3,0,0.9695134072017755,97,340,1,438
563,bright,sv3,1,0.9310861084832375,81,310,2,393
563,bright,sv3,2,0.9673446090396277,105,317,0,422
563,bright,sv3,3,0.9421228619547826,83,308,1,392
563,bright,sv3,4,0.9575985815559693,77,323,2,402
563,bright,sv3,5,0.9614594088051447,84,257,2,343
563,bright,sv3,6,0.9473932748292463,79,286,2,367
563,bright,sv3,7,0.9454962444561997,73,288,2,363
563,bright,sv3,8,0.9617319307881873,92,335,1,428
563,bright,sv3,9,0.9476746405429811,109,315,1,425
564,bright,sv3,0,0.9523205737052944,129,310,0,439
564,bright,sv3,1,0.9569350518122515,97,300,3,400
564,bright,sv3,2,0.9710138980379582,122,299,3,424
564,bright,sv3,3,0.9552429881202315,129,268,1,398
564,bright,sv3,4,0.973017985077046,98,301,3,402
564,bright,sv3,5,0.977102791611099,100,318,0,418
564,bright,sv3,6,0.9561858286416297,83,286,1,370
564,bright,sv3,7,0.9479529325175879,75,293,0,368
564,bright,sv3,8,0.978052999217334,104,318,1,423
564,bright,sv3,9,0.9687814052136436,128,297,6,431
565,bright,sv3,0,0.9294493413432736,137,300,5,442
565,bright,sv3,1,0.9754644503522377,124,273,4,401
565,bright,sv3,2,0.969400944661777,116,316,1,433
565,bright,sv3,3,0.9470336148450287,131,259,0,390
565,bright,sv3,4,0.9606753001729323,112,289,4,405
565,bright,sv3,5,0.9602115407934319,118,297,2,417
565,bright,sv3,6,0.9637025643806951,95,276,1,372
565,bright,sv3,7,0.9570068359233772,87,273,2,362
565,bright,sv3,8,0.9837656572870708,128,296,3,427
565,bright,sv3,9,0.9646581086506945,143,288,2,433
571,dark,sv3,0,0.964446759484097,288,14,80,382
571,dark,sv3,1,0.946278842904497,216,17,95,328
571,dark,sv3,2,0.9783972329762252,256,12,110,378
571,dark,sv3,3,0.9142593357517437,226,12,81,319
571,dark,sv3,4,0.9687148760872049,246,14,70,330
571,dark,sv3,5,0.8997084365852586,129,7,35,171
571,dark,sv3,6,0.9336737072171742,221,18,70,309
571,dark,sv3,7,0.9656870685068755,199,11,66,276
571,dark,sv3,8,0.9598229472702413,240,18,93,351
571,dark,sv3,9,0.9647142052674857,256,14,90,360
572,dark,sv3,0,0.9772545550541598,284,15,70,369
572,dark,sv3,1,0.9377013433922302,235,12,75,322
572,dark,sv3,2,0.9413117103090929,258,13,86,357
572,dark,sv3,3,0.9209697330747046,191,7,57,255
572,dark,sv3,4,0.9335016109929414,261,12,56,329
572,dark,sv3,5,0.9589495765160888,243,12,89,344
572,dark,sv3,6,0.9315804380046205,223,15,61,299
572,dark,sv3,7,0.9226692220275917,201,11,55,267
572,dark,sv3,8,0.963889461042584,264,14,78,356
572,dark,sv3,9,0.9519596231077531,273,12,67,352
573,dark,sv3,0,0.9536768399390849,306,10,49,365
573,dark,sv3,1,0.9332032040358811,240,14,70,324
573,dark,sv3,2,0.9620704620392866,270,16,78,364
573,dark,sv3,3,0.9336011103205155,249,10,54,313
573,dark,sv3,4,0.9554515619058431,263,11,51,325
573,dark,sv3,5,0.9616353979537532,251,8,72,331
573,dark,sv3,6,0.9487590670879266,226,14,54,294
573,dark,sv3,7,0.9238923776621351,197,14,55,266
573,dark,sv3,8,0.9495068181678152,231,12,55,298
573,dark,sv3,9,0.9356904867980742,270,9,52,331
574,dark,sv3,0,0.9606335588635166,318,10,67,395
574,dark,sv3,1,0.9592235553974231,261,15,70,346
574,dark,sv3,2,0.976885642625631,289,13,78,380
574,dark,sv3,3,0.9514755928473954,275,10,62,347
574,dark,sv3,4,0.9816148641412114,307,11,47,365
574,dark,sv3,5,0.9674351397978882,284,13,68,365
574,dark,sv3,6,0.9637944028708902,224,10,45,279
574,dark,sv3,7,0.9444536707773895,272,11,50,333
574,dark,sv3,8,0.9590976086055917,315,14,62,391
574,dark,sv3,9,0.9491327737429381,318,11,61,390
575,dark,sv3,0,0.9653485100611707,303,14,56,373
575,dark,sv3,1,0.9483663028243355,261,10,69,340
575,dark,sv3,2,0.9521282761989849,281,13,71,365
575,dark,sv3,3,0.9425827963463704,176,4,38,218
575,dark,sv3,4,0.980188858850344,245,7,36,288
575,dark,sv3,5,0.9453408225358575,286,10,62,358
575,dark,sv3,6,0.971561793169693,272,12,37,321
575,dark,sv3,7,0.9640449321085678,266,10,45,321
575,dark,sv3,8,0.9671988344673982,316,11,66,393
575,dark,sv3,9,0.9397472624859784,315,12,49,376
576,dark,sv3,0,0.9674877761863488,302,11,37,350
576,dark,sv3,1,0.9336406793851001,281,15,41,337
576,dark,sv3,2,0.9527863114567006,301,16,37,354
576,dark,sv3,3,0.9604403529935159,287,11,48,346
576,dark,sv3,4,0.9643886031849718,295,14,40,349
576,dark,sv3,5,0.9673977587474143,298,10,65,373
576,dark,sv3,6,0.9583176168105737,264,15,32,311
576,dark,sv3,7,0.934962338740005,260,13,40,313
576,dark,sv3,8,0.9792141091453579,314,11,56,381
576,dark,sv3,9,0.9337344732789177,313,13,48,374
577,dark,sv3,0,0.9417956857041059,300,14,25,339
577,dark,sv3,1,0.9578047122496265,285,18,30,333
577,dark,sv3,2,0.952369720556896,310,13,33,356
577,dark,sv3,3,0.9649720759855678,296,14,28,338
577,dark,sv3,4,0.9571709343750376,306,10,26,342
577,dark,sv3,5,0.9568936938403542,293,10,40,343
577,dark,sv3,6,0.9694697852108016,265,15,24,304
577,dark,sv3,7,0.9050183135827522,261,11,29,301
577,dark,sv3,8,0.9655016766679585,314,13,43,370
577,dark,sv3,9,0.934914832434159,321,13,37,371
578,dark,sv3,0,0.9724058619760056,315,13,23,351
578,dark,sv3,1,0.9312621923050637,271,14,37,322
578,dark,sv3,2,0.9420063006835191,313,19,37,369
578,dark,sv3,3,0.9410757779582106,282,17,30,329
578,dark,sv3,4,0.9342454671550241,312,10,10,332
578,dark,sv3,5,0.9571381090946053,308,15,22,345
578,dark,sv3,6,0.9635397857856578,266,19,13,298
578,dark,sv3,7,0.9493720234678661,282,13,18,313
578,dark,sv3,8,0.9680102217555204,319,15,29,363
578,dark,sv3,9,0.9702713724059276,322,12,32,366
579,dark,sv3,0,0.910380789235506,238,15,16,269
579,dark,sv3,1,0.952791095566535,268,15,24,307
579,dark,sv3,2,0.9620119260798933,301,16,19,336
579,dark,sv3,3,0.9518350964096421,284,16,21,321
579,dark,sv3,4,0.9618006417260897,285,12,23,320
579,dark,sv3,5,0.9703650754055847,287,11,19,317
579,dark,sv3,6,0.9348942901308859,246,14,21,281
579,dark,sv3,7,0.946585696508132,264,13,22,299
579,dark,sv3,8,0.9445847770824882,288,17,33,338
579,dark,sv3,9,0.9272822692407104,312,14,20,346
580,dark,sv3,0,0.9461814054202152,301,14,27,342
580,dark,sv3,1,0.9583176168105737,272,14,23,309
580,dark,sv3,2,0.9497509925591598,271,15,35,321
580,dark,sv3,3,0.971264856613455,281,20,23,324
580,dark,sv3,4,0.950151463260804,283,17,16,316
580,dark,sv3,5,0.9725370592974596,228,12,18,258
580,dark,sv3,6,0.9556934130414464,252,20,12,284
580,dark,sv3,7,0.9390640219531707,248,15,19,282
580,dark,sv3,8,0.9489699131131806,308,16,16,340
580,dark,sv3,9,0.9392879408698329,303,16,16,335
581,dark,sv3,0,0.9579238101204504,319,21,20,360
581,dark,sv3,1,0.9449552947390794,280,14,22,316
581,dark,sv3,2,0.9607538474916835,299,16,25,340
581,dark,sv3,3,0.9220696260811369,270,15,19,304
581,dark,sv3,4,0.9384787881694072,282,17,27,326
581,dark,sv3,5,0.9221945339547777,281,12,18,311
581,dark,sv3,6,0.9175197418918171,265,18,17,300
581,dark,sv3,7,0.9434411724040144,244,15,28,287
581,dark,sv3,8,0.9622037705979397,304,18,35,357
581,dark,sv3,9,0.9142972753821297,311,14,25,350
585,bright,sv3,0,0.9637000183635275,333,69,2,404
585,bright,sv3,1,0.9638497749070499,314,38,6,358
585,bright,sv3,2,0.9374581303521863,343,38,4,385
585,bright,sv3,3,0.9449340413270672,295,41,5,341
585,bright,sv3,4,0.9773617162739888,301,53,4,358
585,bright,sv3,5,0.9476359173393766,320,52,5,377
585,bright,sv3,6,0.9554057425719477,240,87,3,330
585,bright,sv3,7,0.9526812431408145,251,39,1,291
585,bright,sv3,8,0.9528820811253506,307,65,2,374
585,bright,sv3,9,0.9542745027907212,321,51,3,375
586,bright,sv3,0,0.9533234199418964,276,123,5,404
586,bright,sv3,1,0.9612588407652458,254,103,1,358
586,bright,sv3,2,0.9591625649271223,275,116,7,398
586,bright,sv3,3,0.9614594088051447,277,62,2,341
586,bright,sv3,4,0.9344770369205467,235,123,1,359
586,bright,sv3,5,0.894700655835758,138,49,2,189
586,bright,sv3,6,0.9759940129734086,189,139,5,333
586,bright,sv3,7,0.969182551758095,199,97,4,300
586,bright,sv3,8,0.9450664190911232,247,118,9,374
586,bright,sv3,9,0.9532571669792873,274,106,3,383
587,bright,sv3,0,0.973884461409906,196,197,0,393
587,bright,sv3,1,0.9515699618680222,220,134,2,356
587,bright,sv3,2,0.9648874039897752,217,161,2,380
587,bright,sv3,3,0.9416000955614436,154,119,6,279
587,bright,sv3,4,0.9261914558337719,177,171,2,350
587,bright,sv3,5,0.9583270437866275,206,157,2,365
587,bright,sv3,6,0.9653094816182468,137,181,3,321
587,bright,sv3,7,0.951952847925366,147,137,1,285
587,bright,sv3,8,0.9611781711556295,220,156,2,378
587,bright,sv3,9,0.9574032303381209,216,157,3,376
588,bright,sv3,0,0.9634876946540206,176,209,5,390
588,bright,sv3,1,0.963636752941299,157,185,1,343
588,bright,sv3,2,0.9717171798099047,194,184,9,387
588,bright,sv3,3,0.9452106221566507,177,152,2,331
588,bright,sv3,4,0.9410301739983205,148,185,1,334
588,bright,sv3,5,0.9684554697331239,169,184,5,358
588,bright,sv3,6,0.9616692544097218,112,197,3,312
588,bright,sv3,7,0.9678392578428906,114,168,1,283
588,bright,sv3,8,0.9345151202506568,134,178,2,314
588,bright,sv3,9,0.971625749336694,155,209,4,368
589,bright,sv3,0,0.9558639585614711,182,228,2,412
589,bright,sv3,1,0.9459741636487674,174,212,1,387
589,bright,sv3,2,0.9634538358038477,165,234,4,403
589,bright,sv3,3,0.9671329908645322,177,197,4,378
589,bright,sv3,4,0.9677682687831036,141,248,1,390
589,bright,sv3,5,0.9481167120347259,160,236,6,402
589,bright,sv3,6,0.9601995362812668,109,204,4,317
589,bright,sv3,7,0.953411796030747,137,213,1,351
589,bright,sv3,8,0.9633682574695137,184,222,3,409
589,bright,sv3,9,0.9626248319072495,179,224,1,404
590,bright,sv3,0,0.9567376789443406,147,261,3,411
590,bright,sv3,1,0.9779329454407469,152,235,1,388
590,bright,sv3,2,0.955838980833801,183,220,9,412
590,bright,sv3,3,0.9582509533561333,128,182,8,318
590,bright,sv3,4,0.9753932809610707,160,230,4,394
590,bright,sv3,5,0.9633346042537873,180,222,3,405
590,bright,sv3,6,0.9214531429548068,118,227,2,347
590,bright,sv3,7,0.9571828324653432,118,235,3,356
590,bright,sv3,8,0.9536584739873994,148,256,6,410
590,bright,sv3,9,0.9659225510517593,166,249,1,416
591,bright,sv3,0,0.9634143260207044,170,242,5,417
591,bright,sv3,1,0.9721802880325138,167,221,2,390
591,bright,sv3,2,0.9515259643544558,179,222,8,409
591,bright,sv3,3,0.9633464637855023,190,189,2,381
591,bright,sv3,4,0.9601890521870962,165,221,3,389
591,bright,sv3,5,0.9545695240747671,144,258,5,407
591,bright,sv3,6,0.9566763997540582,130,209,2,341
591,bright,sv3,7,0.9505452506224846,134,219,3,356
591,bright,sv3,8,0.9684606030891529,140,263,6,409
591,bright,sv3,9,0.9609351038747449,179,232,3,414
592,bright,sv3,0,0.9845531933290004,190,221,1,412
592,bright,sv3,1,0.955671931270356,173,217,3,393
592,bright,sv3,2,0.967534953510651,206,212,3,421
592,bright,sv3,3,0.9315536645029648,172,202,5,379
592,bright,sv3,4,0.9631380360461832,150,245,1,396
592,bright,sv3,5,0.9765121252891635,166,238,0,404
592,bright,sv3,6,0.9463852375583622,127,215,3,345
592,bright,sv3,7,0.9493238645246077,127,216,1,344
592,bright,sv3,8,0.9778904014378778,177,228,2,407
592,bright,sv3,9,0.9604244170424336,173,238,3,414
593,bright,sv3,0,0.9428841431768163,150,182,0,332
593,bright,sv3,1,0.9561497700436024,168,216,1,385
593,bright,sv3,2,0.9735741296377639,197,224,4,425
593,bright,sv3,3,0.9768837111564209,162,213,3,378
593,bright,sv3,4,0.9469889745049531,166,219,1,386
593,bright,sv3,5,0.9510716256240936,173,221,5,399
593,bright,sv3,6,0.9510388922309919,132,215,5,352
593,bright,sv3,7,0.9394210966011529,148,201,2,351
593,bright,sv3,8,0.9712986485700252,168,236,3,407
593,bright,sv3,9,0.963640774655556,185,230,2,417
594,bright,sv3,0,0.9781891708835739,190,232,1,423
594,bright,sv3,1,0.952421706740382,170,213,5,388
594,bright,sv3,2,0.9515161376169939,202,195,2,399
594,bright,sv3,3,0.9415229579606282,187,191,2,380
594,bright,sv3,4,0.9712347353279283,157,232,2,391
594,bright,sv3,5,0.9590231398192424,148,174,2,324
594,bright,sv3,6,0.9353439605208234,144,192,5,341
594,bright,sv3,7,0.9575899881951598,154,198,1,353
594,bright,sv3,8,0.9730014303288806,199,199,7,405
594,bright,sv3,9,0.9676605144247638,191,220,2,413
595,bright,sv3,0,0.969985835967088,189,227,2,418
595,bright,sv3,1,0.9677336527529187,200,195,1,396
595,bright,sv3,2,0.9690117655509541,200,209,5,414
595,bright,sv3,3,0.9558307282620903,189,190,5,384
595,bright,sv3,4,0.9624035758294411,146,232,2,380
595,bright,sv3,5,0.9624613829894523,181,211,2,394
595,bright,sv3,6,0.9701320056566495,152,194,4,350
595,bright,sv3,7,0.9437698291369429,138,202,3,343
595,bright,sv3,8,0.9471874114174579,188,219,4,411
595,bright,sv3,9,0.9629720017394547,196,203,1,400
596,backup,sv3,0,0.9555990740947866,6,352,0,358
596,backup,sv3,1,0.9466363213702658,6,332,1,339
596,backup,sv3,2,0.9265032766397797,0,345,3,348
596,backup,sv3,3,0.9613810728488693,5,314,0,319
596,backup,sv3,4,0.9490315182478821,6,323,1,330
596,backup,sv3,5,0.9580731524923445,3,345,0,348
596,backup,sv3,6,0.9279957123513384,3,299,0,302
596,backup,sv3,7,0.9355256260048603,1,279,0,280
596,backup,sv3,8,0.9203568053261397,0,352,2,354
596,backup,sv3,9,0.9392711852637884,3,340,0,343
1000,dark,main,0,0.9588837140261062,248,18,88,354
1000,dark,main,1,0.9610540331130822,229,25,82,336
1000,dark,main,2,0.9757719714661883,258,23,98,379
1000,dark,main,3,0.9445312156884138,221,26,93,340
1000,dark,main,4,0.9564135521063832,172,12,55,239
1000,dark,main,5,0.956101273038295,267,24,87,378
1000,dark,main,6,0.9168888419534883,210,24,80,314
1000,dark,main,7,0.9187766466358581,224,24,72,320
1000,dark,main,8,0.9714158725813222,243,23,82,348
1000,dark,main,9,0.9497878094759965,231,43,71,345
1001,dark,main,0,0.9633839997897923,276,28,77,381
1001,dark,main,1,0.9670050284451819,232,29,77,338
1001,dark,main,2,0.9614123763992007,255,40,82,377
1001,dark,main,3,0.9579051038198674,257,21,76,354
1001,dark,main,4,0.9401578175347651,242,25,82,349
1001,dark,main,5,0.948570585215524,248,26,84,358
1001,dark,main,6,0.9619609269293548,243,25,57,325
1001,dark,main,7,0.9566241791362707,202,24,82,308
1001,dark,main,8,0.9490275899238566,252,23,95,370
1001,dark,main,9,0.9644525400437398,277,21,65,363
1007,dark,main,0,0.9655374754543972,290,18,86,394
1007,dark,main,1,0.9836543283650322,255,15,71,341
1007,dark,main,2,0.9585851487409911,285,11,95,391
1007,dark,main,3,0.9599551732681221,257,19,84,360
1007,dark,main,4,0.9431982050498097,275,12,81,368
1007,dark,main,5,0.9597276269770386,258,14,98,370
1007,dark,main,6,0.9470406657842383,218,15,84,317
1007,dark,main,7,0.973699543037291,237,13,78,328
1007,dark,main,8,0.9641649157133804,291,20,83,394
1007,dark,main,9,0.9753758862951816,289,16,82,387
1010,dark,main,0,0.9600766439692955,300,14,90,404
1010,dark,main,1,0.9548785883471033,233,15,98,346
1010,dark,main,2,0.9666988739460046,264,15,104,383
1010,dark,main,3,0.9507054988755327,247,17,97,361
1010,dark,main,4,0.9437772804213863,230,29,95,354
1010,dark,main,5,0.9764192502594529,278,17,75,370
1010,dark,main,6,0.9389926291415692,249,13,67,329
1010,dark,main,7,0.9552421227440393,234,11,83,328
1010,dark,main,8,0.96809245256241,280,12,84,376
1010,dark,main,9,0.9658095551565873,283,18,80,381
1030,dark,main,0,0.9621718621310144,289,22,72,383
1030,dark,main,1,0.932565619892297,247,19,73,339
1030,dark,main,2,0.9413335928975828,258,21,90,369
1030,dark,main,3,0.9621131425213538,259,21,81,361
1030,dark,main,4,0.9487932139711748,245,14,86,345
1030,dark,main,5,0.9550788552572186,275,22,66,363
1030,dark,main,6,0.9760057108409376,238,16,66,320
1030,dark,main,7,0.9538581991085264,216,15,82,313
1030,dark,main,8,0.9655469090095279,252,30,92,374
1030,dark,main,9,0.9555722822103196,290,14,73,377
1078,dark,main,0,0.9795809150477786,285,21,64,370
1078,dark,main,1,0.9668926435157981,242,27,79,348
1078,dark,main,2,0.9661291742835177,238,27,92,357
1078,dark,main,3,0.9260597165113653,237,21,75,333
1078,dark,main,4,0.9656891092100846,228,30,77,335
1078,dark,main,5,0.9518174742277051,260,28,71,359
1078,dark,main,6,0.9332897557966778,215,28,62,305
1078,dark,main,7,0.9677537683675081,206,33,67,306
1078,dark,main,8,0.9527384158907385,269,23,81,373
1078,dark,main,9,0.964856950678297,261,27,71,359
1080,dark,main,0,0.9646012426754309,254,20,79,353
1080,dark,main,1,0.9626429715011718,228,15,89,332
1080,dark,main,2,0.928540153659474,241,23,80,344
1080,dark,main,3,0.9496755553860545,205,21,98,324
1080,dark,main,4,0.9598032870597725,224,16,78,318
1080,dark,main,5,0.975090561836134,245,13,88,346
1080,dark,main,6,0.9586103342327423,197,20,66,283
1080,dark,main,7,0.9285426821100228,200,21,72,293
1080,dark,main,8,0.9737220532700253,253,16,86,355
1080,dark,main,9,0.9670200691761113,234,17,94,345
1081,dark,main,0,0.962243456733474,255,20,83,358
1081,dark,main,1,0.9511523243361146,244,18,67,329
1081,dark,main,2,0.9409361531381041,264,27,67,358
1081,dark,main,3,0.952093600526394,243,23,72,338
1081,dark,main,4,0.9085590597470877,173,13,44,230
1081,dark,main,5,0.9711626041202511,243,17,88,348
1081,dark,main,6,0.9726381387416844,228,18,70,316
1081,dark,main,7,0.9510807518771526,221,19,63,303
1081,dark,main,8,0.9641302260937569,253,14,88,355
1081,dark,main,9,0.9425077567432465,258,21,74,353
1082,dark,main,0,0.9478356419785853,255,17,89,361
1082,dark,main,1,0.9748364345268543,227,18,82,327
1082,dark,main,2,0.9658884627196631,252,17,88,357
1082,dark,main,3,0.9442884264619932,245,18,77,340
1082,dark,main,4,0.9504273508091501,247,13,73,333
1082,dark,main,5,0.9709490025741709,273,17,65,355
1082,dark,main,6,0.9548644848611191,211,14,83,308
1082,dark,main,7,0.973414190844872,208,22,70,300
1082,dark,main,8,0.9569754153829697,240,31,87,358
1082,dark,main,9,0.9594387166647775,236,33,77,346
1083,dark,main,0,0.9510527734741457,260,18,82,360
1083,dark,main,1,0.9642766057615529,240,27,69,336
1083,dark,main,2,0.9363391171646577,259,23,89,371
1083,dark,main,3,0.9671034647150595,248,21,89,358
1083,dark,main,4,0.9132930932452863,215,22,90,327
1083,dark,main,5,0.9552656100606955,230,14,88,332
1083,dark,main,6,0.9289939710614449,226,17,57,300
1083,dark,main,7,0.9744146561576642,225,21,58,304
1083,dark,main,8,0.94755160038447,265,26,82,373
1083,dark,main,9,0.9653395952090639,260,16,100,376
1084,dark,main,0,0.9399493024389329,224,17,93,334
1084,dark,main,1,0.9433775089499825,221,27,68,316
1084,dark,main,2,0.9515155207835728,237,21,76,334
1084,dark,main,3,0.9533924995270922,208,24,72,304
1084,dark,main,4,0.9468648887049986,219,19,84,322
1084,dark,main,5,0.9555288747798764,240,18,79,337
1084,dark,main,6,0.927540113711892,176,21,90,287
1084,dark,main,7,0.9449873395909406,217,18,57,292
1084,dark,main,8,0.9358051527663425,237,20,97,354
1084,dark,main,9,0.959851594500443,232,18,73,323
1085,dark,main,0,0.960852279065039,240,20,77,337
1085,dark,main,1,0.9218954045471001,210,23,80,313
1085,dark,main,2,0.9356703302749849,224,28,91,343
1085,dark,main,3,0.9831276966811191,208,26,83,317
1085,dark,main,4,0.9537694316003718,225,23,94,342
1085,dark,main,5,0.9628136811517106,242,21,91,354
1085,dark,main,6,0.9245951943904301,189,24,80,293
1085,dark,main,7,0.929631955984904,200,29,74,303
1085,dark,main,8,0.9599426088283673,241,29,83,353
1085,dark,main,9,0.9476678935923512,242,24,80,346
1086,dark,main,0,0.9670012984170998,237,21,94,352
1086,dark,main,1,0.9646508276498069,233,13,89,335
1086,dark,main,2,0.9532799885827847,234,23,102,359
1086,dark,main,3,0.9508660743344621,243,15,78,336
1086,dark,main,4,0.9413148158413877,242,18,80,340
1086,dark,main,5,0.9431964917023903,244,19,100,363
1086,dark,main,6,0.9747050706596927,213,17,75,305
1086,dark,main,7,0.9408506529858518,224,23,70,317
1086,dark,main,8,0.9575557348453584,249,13,113,375
1086,dark,main,9,0.97059435059984,266,21,75,362
1087,dark,main,0,0.9403110528657486,256,19,87,362
1087,dark,main,1,0.9526585356129146,229,17,71,317
1087,dark,main,2,0.9574000751282812,254,24,83,361
1087,dark,main,3,0.9409631069505018,239,14,75,328
1087,dark,main,4,0.9385546777809197,242,21,82,345
1087,dark,main,5,0.9656133055099636,220,16,109,345
1087,dark,main,6,0.9313711622449985,209,20,74,303
1087,dark,main,7,0.9474109629611666,210,22,69,301
1087,dark,main,8,0.9515930290870548,233,20,97,350
1087,dark,main,9,0.9350109468572256,245,19,86,350
1088,dark,main,0,0.951182137182315,258,18,66,342
1088,dark,main,1,0.9592813223579659,234,20,79,333
1088,dark,main,2,0.9404649801619598,242,19,78,339
1088,dark,main,3,0.9681149047666027,214,20,94,328
1088,dark,main,4,0.9624130229275047,250,19,74,343
1088,dark,main,5,0.9417884202865219,221,18,91,330
1088,dark,main,6,0.9638381568493856,203,18,78,299
1088,dark,main,7,0.9577845873580427,203,15,71,289
1088,dark,main,8,0.9399316025752089,253,22,81,356
1088,dark,main,9,0.9389452441343445,240,20,82,342
1089,dark,main,0,0.9428019259031792,187,23,55,265
1089,dark,main,1,0.9461226115955133,236,20,75,331
1089,dark,main,2,0.960018476320902,231,30,102,363
1089,dark,main,3,0.9695911382434247,245,18,66,329
1089,dark,main,4,0.9467854443337773,252,14,77,343
1089,dark,main,5,0.9803132915322044,256,21,78,355
1089,dark,main,6,0.9332612012397384,213,20,74,307
1089,dark,main,7,0.9503210638861805,218,19,65,302
1089,dark,main,8,0.9482141012023989,259,24,86,369
1089,dark,main,9,0.9272822692407104,236,24,85,345
1090,dark,main,0,0.9324801380923023,270,23,90,383
1090,dark,main,1,0.939022317849685,236,17,82,335
1090,dark,main,2,0.9578441146633994,284,18,79,381
1090,dark,main,3,0.9586580040862521,246,17,99,362
1090,dark,main,4,0.9378126895797143,167,7,58,232
1090,dark,main,5,0.9502111560541292,237,22,98,357
1090,dark,main,6,0.9306851138615337,215,21,80,316
1090,dark,main,7,0.9457266892937437,236,19,60,315
1090,dark,main,8,0.9477353959792754,253,24,92,369
1090,dark,main,9,0.9706319341949732,257,23,85,365
1091,dark,main,0,0.9813728520561877,280,17,70,367
1091,dark,main,1,0.9503263528741938,224,22,97,343
1091,dark,main,2,0.960920158242117,243,15,80,338
1091,dark,main,3,0.9589968807800433,241,16,76,333
1091,dark,main,4,0.9626429715011716,235,14,84,333
1091,dark,main,5,0.9464528634218489,240,17,103,360
1091,dark,main,6,0.9813960469093719,217,22,69,308
1091,dark,main,7,0.9673996970803141,235,15,65,315
1091,dark,main,8,0.9353038800949058,250,20,85,355
1091,dark,main,9,0.9593065886771869,260,20,83,363
1092,dark,main,0,0.9516834563000852,251,21,95,367
1092,dark,main,1,0.9579717086426447,222,18,79,319
1092,dark,main,2,0.9630331426524542,221,33,89,343
1092,dark,main,3,0.9769635875617663,226,20,88,334
1092,dark,main,4,0.9608078208804506,236,23,75,334
1092,dark,main,5,0.951696230212228,243,16,100,359
1092,dark,main,6,0.8973121696238748,223,13,80,316
1092,dark,main,7,0.9685100292312534,208,15,85,308
1092,dark,main,8,0.9653560370409191,266,26,78,370
1092,dark,main,9,0.9586858097822125,255,20,75,350
1093,dark,main,0,0.9485483730159633,224,26,75,325
1093,dark,main,1,0.9736565988550105,214,18,77,309
1093,dark,main,2,0.9436428115969192,236,15,90,341
1093,dark,main,3,0.9465058979221365,213,15,80,308
1093,dark,main,4,0.957572558229001,231,19,77,327
1093,dark,main,5,0.9665845128673503,268,16,72,356
1093,dark,main,6,0.9320118945007292,200,16,76,292
1093,dark,main,7,0.9594519833566911,209,35,61,305
1093,dark,main,8,0.9517013580650805,278,14,71,363
1093,dark,main,9,0.969636166032362,239,17,90,346
1094,dark,main,0,0.9778784713672946,241,19,91,351
1094,dark,main,1,0.9613863831415125,238,15,62,315
1094,dark,main,2,0.9577409091732719,255,17,99,371
1094,dark,main,3,0.9554882040027549,224,28,80,332
1094,dark,main,4,0.9620750063246601,232,15,79,326
1094,dark,main,5,0.9637137800192924,252,23,90,365
1094,dark,main,6,0.9459117766861913,204,17,76,297
1094,dark,main,7,0.9576034522143186,206,16,72,294
1094,dark,main,8,0.9762538078158539,253,25,75,353
1094,dark,main,9,0.9496785615964956,255,15,79,349
1095,dark,main,0,0.9664050181989366,255,25,83,363
1095,dark,main,1,0.9608137939400708,262,16,65,343
1095,dark,main,2,0.9567364059126501,262,23,88,373
1095,dark,main,3,0.9642550930724764,239,24,83,346
1095,dark,main,4,0.9599364629648184,252,17,68,337
1095,dark,main,5,0.9661999316455785,271,18,71,360
1095,dark,main,6,0.958688667760786,237,15,80,332
1095,dark,main,7,0.9329322012724557,215,16,76,307
1095,dark,main,8,0.9517987295253364,233,30,87,350
1095,dark,main,9,0.9601944433841744,249,20,87,356
1096,dark,main,0,0.9652068579274845,235,21,99,355
1096,dark,main,1,0.9364911602632742,236,16,74,326
1096,dark,main,2,0.9477973077561704,250,29,89,368
1096,dark,main,3,0.9433342089694852,233,19,79,331
1096,dark,main,4,0.9282176235494789,227,19,98,344
1096,dark,main,5,0.9500558937013107,239,24,88,351
1096,dark,main,6,0.9533056735553699,213,27,61,301
1096,dark,main,7,0.9562713292768412,202,16,93,311
1096,dark,main,8,0.9592146907439408,265,19,90,374
1096,dark,main,9,0.9580975818197245,252,22,79,353
1097,dark,main,0,0.958323575222607,280,16,84,380
1097,dark,main,1,0.9504349999173419,247,16,77,340
1097,dark,main,2,0.9704287263313606,250,18,97,365
1097,dark,main,3,0.9652434822469873,231,18,86,335
1097,dark,main,4,0.9549121697229254,249,23,91,363
1097,dark,main,5,0.9632742535123687,253,18,81,352
1097,dark,main,6,0.945806711917591,225,18,79,322
1097,dark,main,7,0.9549112319997435,195,28,83,306
1097,dark,main,8,0.9497488799098835,245,24,94,363
1097,dark,main,9,0.928000385228699,234,36,88,358
1098,dark,main,0,0.9773719344451525,242,26,80,348
1098,dark,main,1,0.97904703744873,229,37,76,342
1098,dark,main,2,0.9509014700265199,259,24,83,366
1098,dark,main,3,0.9479287668185988,240,26,82,348
1098,dark,main,4,0.9601753771451673,242,26,80,348
1098,dark,main,5,0.9618402673211179,272,23,80,375
1098,dark,main,6,0.9124676541049459,214,27,69,310
1098,dark,main,7,0.965968849427054,216,21,83,320
1098,dark,main,8,0.970286331321588,259,28,72,359
1098,dark,main,9,0.9684604441754895,240,34,86,360
1099,dark,main,0,0.9488231491191818,276,25,75,376
1099,dark,main,1,0.9766090657385731,268,19,66,353
1099,dark,main,2,0.967889751774434,271,23,82,376
1099,dark,main,3,0.9544974859722973,236,15,98,349
1099,dark,main,4,0.970803215291454,247,13,88,348
1099,dark,main,5,0.9545918983235393,239,19,100,358
1099,dark,main,6,0.9175262433645052,222,26,68,316
1099,dark,main,7,0.9784328282235748,243,16,68,327
1099,dark,main,8,0.964984875863187,257,18,105,380
1099,dark,main,9,0.9296093147248936,247,21,85,353
1100,dark,main,0,0.9501594575612766,261,16,83,360
1100,dark,main,1,0.9537287167199502,228,23,75,326
1100,dark,main,2,0.9635471557254046,260,28,80,368
1100,dark,main,3,0.9449607062973715,248,14,70,332
1100,dark,main,4,0.9647122362066917,251,15,66,332
1100,dark,main,5,0.9725737841750293,236,28,88,352
1100,dark,main,6,0.9307132111934857,229,14,71,314
1100,dark,main,7,0.9106307075824563,206,20,88,314
1100,dark,main,8,0.9632869109427238,269,18,95,382
1100,dark,main,9,0.9632869109427238,269,18,95,382
1101,dark,main,0,0.9490133667287756,280,16,83,379
1101,dark,main,1,0.9409709663934159,254,15,83,352
1101,dark,main,2,0.9585624062046187,268,22,75,365
1101,dark,main,3,0.9668711899287269,243,16,85,344
1101,dark,main,4,0.9091346690165605,238,23,89,350
1101,dark,main,5,0.9673616371645855,263,18,82,363
1101,dark,main,6,0.9299087723608247,229,15,77,321
1101,dark,main,7,0.9541660952149255,228,14,74,316
1101,dark,main,8,0.9759799076475164,275,18,87,380
1101,dark,main,9,0.9759799076475164,275,18,87,380
1102,dark,main,0,0.9531981157133995,298,17,86,401
1102,dark,main,1,0.9673095350759123,252,24,78,354
1102,dark,main,2,0.9489123136738788,299,17,79,395
1102,dark,main,3,0.9686592108911326,241,20,99,360
1102,dark,main,4,0.9434231389426618,257,21,91,369
1102,dark,main,5,0.95262958213391,248,20,102,370
1102,dark,main,6,0.9707718204519877,237,16,88,341
1102,dark,main,7,0.9559116492707825,245,16,67,328
1102,dark,main,8,0.9491643772181612,263,19,102,384
1102,dark,main,9,0.9753942310082794,273,21,103,397
1103,dark,main,0,0.9534554740493113,247,18,96,361
1103,dark,main,1,0.9192908468193614,238,15,86,339
1103,dark,main,2,0.9530131274948591,274,15,84,373
1103,dark,main,3,0.9614192014172225,231,23,82,336
1103,dark,main,4,0.9591923467043548,241,19,90,350
1103,dark,main,5,0.9656847534750539,261,22,69,352
1103,dark,main,6,0.9578142174309937,207,22,86,315
1103,dark,main,7,0.9358700447501207,199,19,81,299
1103,dark,main,8,0.9547035389357684,263,21,88,372
1103,dark,main,9,0.9548722142773843,257,21,93,371
1104,dark,main,0,0.9524848918756333,257,23,95,375
1104,dark,main,1,0.968596381940963,265,20,70,355
1104,dark,main,2,0.9599298205551695,258,19,87,364
1104,dark,main,3,0.9649720759855677,249,12,78,339
1104,dark,main,4,0.9092726505680464,251,15,84,350
1104,dark,main,5,0.9523706883337449,250,18,99,367
1104,dark,main,6,0.9551792983101914,223,17,87,327
1104,dark,main,7,0.9497002503195427,227,15,71,313
1104,dark,main,8,0.9738740336006165,265,12,96,373
1104,dark,main,9,0.9738740336006165,265,12,96,373
1105,dark,main,0,0.9409939507077307,263,29,79,371
1105,dark,main,1,0.9629410792452382,200,34,83,317
1105,dark,main,2,0.9663194650333766,242,38,78,358
1105,dark,main,3,0.9628403529760505,222,23,70,315
1105,dark,main,4,0.957650386200508,239,22,71,332
1105,dark,main,5,0.9537351135948967,244,27,76,347
1105,dark,main,6,0.9611772580094782,226,17,67,310
1105,dark,main,7,0.9440772113653642,215,22,70,307
1105,dark,main,8,0.9402205576899189,261,26,82,369
1105,dark,main,9,0.9662797788978426,243,30,83,356
1106,dark,main,0,0.982813656720299,264,18,76,358
1106,dark,main,1,0.9718723275755646,229,14,82,325
1106,dark,main,2,0.9481820352796697,249,21,80,350
1106,dark,main,3,0.9521338532745844,244,12,79,335
1106,dark,main,4,0.9200034629445901,158,11,60,229
1106,dark,main,5,0.8974745570334028,238,20,88,346
1106,dark,main,6,0.9592111536101194,204,21,66,291
1106,dark,main,7,0.9624506746042152,207,24,68,299
1106,dark,main,8,0.9608865671535959,253,24,67,344
1106,dark,main,9,0.9444820315211445,227,26,86,339
1107,dark,main,0,0.9641759437928191,233,16,101,350
1107,dark,main,1,0.9269893662083547,217,20,63,300
1107,dark,main,2,0.9221985311935202,242,23,82,347
1107,dark,main,3,0.9477732721621794,203,25,66,294
1107,dark,main,4,0.9405256703998182,215,14,79,308
1107,dark,main,5,0.9452140746788823,232,18,63,313
1107,dark,main,6,0.9356764607743956,198,16,77,291
1107,dark,main,7,0.952105068725514,190,28,64,282
1107,dark,main,8,0.9533599099431866,244,19,79,342
1107,dark,main,9,0.9449784738922141,246,23,77,346
1108,dark,main,0,0.9707618085668681,271,14,90,375
1108,dark,main,1,0.951964732996084,259,19,68,346
1108,dark,main,2,0.9487911721911685,260,16,76,352
1108,dark,main,3,0.95042581637092,219,32,86,337
1108,dark,main,4,0.9635524997484786,265,22,75,362
1108,dark,main,5,0.9551961412687581,239,18,103,360
1108,dark,main,6,0.9479459833743203,204,24,71,299
1108,dark,main,7,0.9309728150525108,208,15,84,307
1108,dark,main,8,0.9683116659146274,263,18,76,357
1108,dark,main,9,0.9669093996703112,273,20,78,371
1109,dark,main,0,0.9702043574039456,277,16,108,401
1109,dark,main,1,0.962086653173343,236,26,79,341
1109,dark,main,2,0.9420682124604142,284,16,70,370
1109,dark,main,3,0.9690008699391454,232,24,78,334
1109,dark,main,4,0.9670200691761113,228,21,96,345
1109,dark,main,5,0.9505463287474212,276,18,86,380
1109,dark,main,6,0.9532790334540311,239,19,71,329
1109,dark,main,7,0.963050411060514,245,18,53,316
1109,dark,main,8,0.9632842691383434,271,19,79,369
1109,dark,main,9,0.9618435351285264,243,25,83,351
1110,dark,main,0,0.9312225325356942,246,17,83,346
1110,dark,main,1,0.944515079334274,241,16,76,333
1110,dark,main,2,0.9606963980217037,268,13,84,365
1110,dark,main,3,0.951182137182315,244,16,81,341
1110,dark,main,4,0.9445146402552953,241,16,76,333
1110,dark,main,5,0.9585107190719211,249,16,90,355
1110,dark,main,6,0.9645038784516976,199,19,80,298
1110,dark,main,7,0.9604936456105715,209,18,72,299
1110,dark,main,8,0.9339031021278966,237,18,84,339
1110,dark,main,9,0.9457255398535948,270,19,80,369
1111,dark,main,0,0.9417393615683314,256,17,79,352
1111,dark,main,1,0.9561924012849775,227,20,80,327
1111,dark,main,2,0.9770625712901283,236,21,115,372
1111,dark,main,3,0.9332908937627714,216,19,78,313
1111,dark,main,4,0.936485123103473,252,18,76,346
1111,dark,main,5,0.9665472062441914,245,19,98,362
1111,dark,main,6,0.9655841314314996,220,17,71,308
1111,dark,main,7,0.9496980847470817,211,15,85,311
1111,dark,main,8,0.9433413240580899,260,17,78,355
1111,dark,main,9,0.9437371381233749,243,18,94,355
1114,dark,main,0,0.954104914090637,262,16,86,364
1114,dark,main,1,0.9485764722673828,226,19,95,340
1114,dark,main,2,0.9459857071000677,253,14,94,361
1114,dark,main,3,0.939306065196769,224,20,97,341
1114,dark,main,4,0.953987154311385,244,21,78,343
1114,dark,main,5,0.9544754375083774,240,18,96,354
1114,dark,main,6,0.9538036768218403,241,14,67,322
1114,dark,main,7,0.9526521613859206,210,20,78,308
1114,dark,main,8,0.9539311882589754,277,20,85,382
1114,dark,main,9,0.9704918073231611,244,16,100,360
1116,dark,main,0,0.9718068130390859,275,19,82,376
1116,dark,main,1,0.9245383311533991,209,18,102,329
1116,dark,main,2,0.9612422161514499,248,23,98,369
1116,dark,main,3,0.949224702525761,230,15,76,321
1116,dark,main,4,0.9573218938343588,248,16,88,352
1116,dark,main,5,0.9797917202647816,255,19,84,358
1116,dark,main,6,0.9593424801246305,212,21,84,317
1116,dark,main,7,0.9163269891438776,225,15,69,309
1116,dark,main,8,0.9644080113592624,275,19,81,375
1116,dark,main,9,0.9644080113592624,275,19,81,375
1117,dark,main,0,0.9664300072696309,276,18,87,381
1117,dark,main,1,0.9260141201305141,221,18,92,331
1117,dark,main,2,0.9638372424002939,249,21,94,364
1117,dark,main,3,0.9397557757903726,247,18,63,328
1117,dark,main,4,0.9731763696534879,238,14,86,338
1117,dark,main,5,0.944674742664542,238,16,87,341
1117,dark,main,6,0.9400416022066189,221,16,78,315
1117,dark,main,7,0.9484395027444503,211,15,82,308
1117,dark,main,8,0.9415765816454693,255,18,79,352
1117,dark,main,9,0.9486335196983817,271,15,78,364
1120,dark,main,0,0.9443453471875096,288,26,82,396
1120,dark,main,1,0.9628958683591327,273,17,79,369
1120,dark,main,2,0.9760265692273195,291,13,83,387
1120,dark,main,3,0.9395995697667104,266,23,72,361
1120,dark,main,4,0.955730657394006,254,25,91,370
1120,dark,main,5,0.9607097606684872,267,18,93,378
1120,dark,main,6,0.9614866919886484,253,19,80,352
1120,dark,main,7,0.9531800413650364,241,19,79,339
1120,dark,main,8,0.9485861013279003,274,14,86,374
1120,dark,main,9,0.9453874977983366,290,23,80,393
1124,dark,main,0,0.977775909500221,284,16,84,384
1124,dark,main,1,0.9640467032232014,251,15,74,340
1124,dark,main,2,0.9486500728989795,253,42,67,362
1124,dark,main,3,0.9423386892289917,235,17,87,339
1124,dark,main,4,0.9700351506633053,246,17,91,354
1124,dark,main,5,0.969774180269707,237,14,105,356
1124,dark,main,6,0.9516519938027848,204,17,87,308
1124,dark,main,7,0.9637401543763812,203,21,70,294
1124,dark,main,8,0.9498241212635825,261,14,93,368
1124,dark,main,9,0.9655890140040062,272,14,79,365
1125,dark,main,0,0.9607675507062883,261,14,98,373
1125,dark,main,1,0.9721533267284083,238,14,90,342
1125,dark,main,2,0.9481520378440638,264,20,92,376
1125,dark,main,3,0.9636287978017584,249,19,81,349
1125,dark,main,4,0.9634187725933363,252,15,91,358
1125,dark,main,5,0.9627494468136829,262,18,95,375
1125,dark,main,6,0.9657418246675987,244,12,68,324
1125,dark,main,7,0.947715104013326,258,13,63,334
1125,dark,main,8,0.9714744749823487,265,13,98,376
1125,dark,main,9,0.9714744749823487,265,13,98,376
1126,dark,main,0,0.9676433646839112,268,20,96,384
1126,dark,main,1,0.9613369982063841,241,18,89,348
1126,dark,main,2,0.9554816614908428,271,17,94,382
1126,dark,main,3,0.9351794787222865,251,13,94,358
1126,dark,main,4,0.9429683291039046,253,16,83,352
1126,dark,main,5,0.9476202219123253,250,23,85,358
1126,dark,main,6,0.9526622263204819,229,20,72,321
1126,dark,main,7,0.9253205286878516,239,18,72,329
1126,dark,main,8,0.9614815687630117,273,15,81,369
1126,dark,main,9,0.9614815687630117,273,15,81,369
1128,dark,main,0,0.9583439995887426,276,14,85,375
1128,dark,main,1,0.9603724998677001,249,15,92,356
1128,dark,main,2,0.9513288261317794,288,14,84,386
1128,dark,main,3,0.942659711948659,251,14,81,346
1128,dark,main,4,0.9569181937731456,274,14,70,358
1128,dark,main,5,0.951569571310884,272,12,93,377
1128,dark,main,6,0.9541780034817137,225,16,86,327
1128,dark,main,7,0.9304780995544227,226,15,77,318
1128,dark,main,8,0.9591926747683465,298,16,75,389
1128,dark,main,9,0.9591926747683465,298,16,75,389
1129,dark,main,0,0.9708610080410467,257,20,96,373
1129,dark,main,1,0.9698201848506417,254,19,76,349
1129,dark,main,2,0.9644471490136628,268,15,96,379
1129,dark,main,3,0.9534685569863347,250,14,79,343
1129,dark,main,4,0.9551686956071019,250,21,78,349
1129,dark,main,5,0.9516100571453316,259,19,79,357
1129,dark,main,6,0.9122661794512555,222,13,85,320
1129,dark,main,7,0.9399962466231515,242,17,54,313
1129,dark,main,8,0.9552404147648215,277,18,85,380
1129,dark,main,9,0.9552404147648215,277,18,85,380
1130,dark,main,0,0.9656949611343004,278,23,78,379
1130,dark,main,1,0.9536688315749271,259,19,67,345
1130,dark,main,2,0.9590159004425806,265,17,90,372
1130,dark,main,3,0.9743855478515563,248,23,82,353
1130,dark,main,4,0.9648196585943469,189,16,42,247
1130,dark,main,5,0.9455770093511704,256,19,106,381
1130,dark,main,6,0.955057738039475,210,31,86,327
1130,dark,main,7,0.9433587095290644,201,20,91,312
1130,dark,main,8,0.956192000458306,260,34,69,363
1130,dark,main,9,0.96680828430539,261,30,81,372
1134,dark,main,0,0.9601266246613235,280,15,83,378
1134,dark,main,1,0.949730258576997,228,12,92,332
1134,dark,main,2,0.9465775363738547,257,19,88,364
1134,dark,main,3,0.9320968824312829,255,15,91,361
1134,dark,main,4,0.9548568748010942,254,17,80,351
1134,dark,main,5,0.9531522745575739,257,19,91,367
1134,dark,main,6,0.9388647615503145,223,14,75,312
1134,dark,main,7,0.9680087459366881,223,19,81,323
1134,dark,main,8,0.9795046677882425,258,19,87,364
1134,dark,main,9,0.9795046677882425,258,19,87,364
1191,dark,main,0,0.9695078415690482,274,15,89,378
1191,dark,main,1,0.9527476911944005,248,21,79,348
1191,dark,main,2,0.9615578168017809,274,15,98,387
1191,dark,main,3,0.9463991281312287,246,14,82,342
1191,dark,main,4,0.9567307332227349,238,15,98,351
1191,dark,main,5,0.9718419636263415,258,15,95,368
1191,dark,main,6,0.9473259502163326,239,13,74,326
1191,dark,main,7,0.9419362866875014,228,16,81,325
1191,dark,main,8,0.967535310225976,262,15,97,374
1191,dark,main,9,0.967535310225976,262,15,97,374
1192,dark,main,0,0.9478890596821996,285,15,83,383
1192,dark,main,1,0.9684018201202272,249,15,77,341
1192,dark,main,2,0.9725936481798031,279,12,104,395
1192,dark,main,3,0.9487912736735508,263,16,85,364
1192,dark,main,4,0.9394634128346774,241,19,80,340
1192,dark,main,5,0.9507365773146662,265,14,89,368
1192,dark,main,6,0.951620573763359,244,16,71,331
1192,dark,main,7,0.9555300759463805,227,19,84,330
1192,dark,main,8,0.961175405008309,288,16,79,383
1192,dark,main,9,0.961175405008309,288,16,79,383
1193,dark,main,0,0.9592601601405029,276,25,85,386
1193,dark,main,1,0.9637521490599381,249,12,92,353
1193,dark,main,2,0.9358697012307512,273,18,89,380
1193,dark,main,3,0.9521581183541334,253,24,73,350
1193,dark,main,4,0.9397636685400448,264,16,88,368
1193,dark,main,5,0.9748643245000131,265,12,85,362
1193,dark,main,6,0.949520743427449,218,13,87,318
1193,dark,main,7,0.9557438810040225,231,16,72,319
1193,dark,main,8,0.9495176409893084,271,16,89,376
1193,dark,main,9,0.9520836800631518,278,17,94,389
1195,dark,main,0,0.9256594251348954,290,14,75,379
1195,dark,main,1,0.9563852228123934,241,22,92,355
1195,dark,main,2,0.9444214877569905,296,16,83,395
1195,dark,main,3,0.9322060700425389,231,13,106,350
1195,dark,main,4,0.953564939902095,256,16,95,367
1195,dark,main,5,0.9405785454543689,274,17,84,375
1195,dark,main,6,0.9492988550042629,203,16,95,314
1195,dark,main,7,0.9698320380640651,216,17,86,319
1195,dark,main,8,0.9471652438311382,273,15,99,387
1195,dark,main,9,0.9471652438311382,273,15,99,387
1196,dark,main,0,0.9593942722407911,283,17,104,404
1196,dark,main,1,0.9591975931496135,251,18,89,358
1196,dark,main,2,0.9584012504783246,260,25,103,388
1196,dark,main,3,0.9447408522242257,250,25,76,351
1196,dark,main,4,0.9610113284055628,264,17,78,359
1196,dark,main,5,0.9538274048348799,262,16,89,367
1196,dark,main,6,0.9569971863821531,237,13,67,317
1196,dark,main,7,0.955628585071955,240,11,75,326
1196,dark,main,8,0.9602347801526632,264,22,91,377
1196,dark,main,9,0.9383698130965796,286,15,76,377
1197,dark,main,0,0.9599909393758246,257,31,91,379
1197,dark,main,1,0.9534092498956659,239,15,98,352
1197,dark,main,2,0.965862717617341,286,21,84,391
1197,dark,main,3,0.9504332769789384,257,15,81,353
1197,dark,main,4,0.9634571661352249,247,16,86,349
1197,dark,main,5,0.9639251757166521,255,17,96,368
1197,dark,main,6,0.9522737749118547,222,21,75,318
1197,dark,main,7,0.9312379348150732,230,14,75,319
1197,dark,main,8,0.947821488343404,258,23,86,367
1197,dark,main,9,0.9582645592228329,272,13,91,376
1198,dark,main,0,0.950844314856577,271,18,87,376
1198,dark,main,1,0.9693017153533598,256,17,86,359
1198,dark,main,2,0.9683533191860434,288,17,75,380
1198,dark,main,3,0.9585947010334718,249,15,96,360
1198,dark,main,4,0.9596080057984347,244,16,82,342
1198,dark,main,5,0.9530354618436048,271,14,81,366
1198,dark,main,6,0.964630322000355,204,22,86,312
1198,dark,main,7,0.9509416329347725,235,14,78,327
1198,dark,main,8,0.9474842856126502,282,16,88,386
1198,dark,main,9,0.9619424784130972,292,14,84,390
1199,dark,main,0,0.9551222061021606,272,18,92,382
1199,dark,main,1,0.9400723720435776,248,16,92,356
1199,dark,main,2,0.9759305023681148,269,17,101,387
1199,dark,main,3,0.9471949659909623,248,14,81,343
1199,dark,main,4,0.964811457706754,249,17,88,354
1199,dark,main,5,0.9680426263489367,257,20,89,366
1199,dark,main,6,0.9502059664951232,218,23,82,323
1199,dark,main,7,0.9632848816723747,218,17,84,319
1199,dark,main,8,0.9683533191860434,272,16,93,381
1199,dark,main,9,0.9531014750683063,250,20,90,360
1200,dark,main,0,0.9612824992434029,292,9,89,390
1200,dark,main,1,0.9392337839996635,250,16,81,347
1200,dark,main,2,0.9537205943761411,274,20,88,382
1200,dark,main,3,0.9582603617425863,262,14,79,355
1200,dark,main,4,0.9574704401023358,272,18,69,359
1200,dark,main,5,0.9551456581965736,242,15,109,366
1200,dark,main,6,0.9598095378809134,215,15,75,305
1200,dark,main,7,0.91588296721166,229,11,81,321
1200,dark,main,8,0.9532282995055811,281,15,76,372
1200,dark,main,9,0.9559342941371712,285,11,71,367
1205,dark,main,0,0.9564271363571633,273,19,104,396
1205,dark,main,1,0.9573091008095491,256,14,89,359
1205,dark,main,2,0.9602633033277169,280,18,84,382
1205,dark,main,3,0.9356090099907578,237,17,90,344
1205,dark,main,4,0.9735836085329526,273,16,59,348
1205,dark,main,5,0.9577013851206032,249,22,91,362
1205,dark,main,6,0.9318773527730231,229,16,76,321
1205,dark,main,7,0.9632848816723747,217,17,84,318
1205,dark,main,8,0.9319465829005349,270,19,90,379
1205,dark,main,9,0.9653556517247874,273,20,91,384
1206,dark,main,0,0.9435022270321795,275,14,101,390
1206,dark,main,1,0.9465748462660128,241,16,86,343
1206,dark,main,2,0.9591322213536532,274,15,94,383
1206,dark,main,3,0.9762278837746667,228,18,93,339
1206,dark,main,4,0.9844701253575641,233,12,86,331
1206,dark,main,5,0.9535582902350629,274,16,77,367
1206,dark,main,6,0.9525117735785261,218,13,79,310
1206,dark,main,7,0.9330949653176589,226,40,51,317
1206,dark,main,8,0.9578373429115353,279,14,79,372
1206,dark,main,9,0.956092580576292,271,17,92,380
1207,dark,main,0,0.9458311229144288,278,12,91,381
1207,dark,main,1,0.9708687265902616,254,17,77,348
1207,dark,main,2,0.9594175042187241,255,20,105,380
1207,dark,main,3,0.9579660945607333,259,13,72,344
1207,dark,main,4,0.9647410186830359,247,13,81,341
1207,dark,main,5,0.9638948495730016,266,16,93,375
1207,dark,main,6,0.9505689046662167,217,18,80,315
1207,dark,main,7,0.9504136871029369,249,18,64,331
1207,dark,main,8,0.9590148849710909,273,19,86,378
1207,dark,main,9,0.9432186864332393,264,20,71,355
1208,dark,main,0,0.935806123513526,275,20,91,386
1208,dark,main,1,0.9474815062150176,253,22,78,353
1208,dark,main,2,0.9714635479815085,263,19,86,368
1208,dark,main,3,0.9576157757457364,239,17,104,360
1208,dark,main,4,0.9714091860649112,246,17,99,362
1208,dark,main,5,0.9478681434137842,230,19,109,358
1208,dark,main,6,0.9475513652703939,212,16,92,320
1208,dark,main,7,0.9596458692591716,224,22,82,328
1208,dark,main,8,0.9502175262019263,286,23,73,382
1208,dark,main,9,0.9509932707360841,254,20,100,374
1209,dark,main,0,0.9690511201040327,260,15,111,386
1209,dark,main,1,0.9529354483566641,242,22,86,350
1209,dark,main,2,0.9665874073297017,274,16,89,379
1209,dark,main,3,0.9500558937013107,236,22,93,351
1209,dark,main,4,0.9693716560817739,233,18,104,355
1209,dark,main,5,0.9645667504268397,265,14,93,372
1209,dark,main,6,0.9330013650864475,221,21,85,327
1209,dark,main,7,0.9682542522749683,226,18,74,318
1209,dark,main,8,0.967026646630333,257,24,87,368
1209,dark,main,9,0.9719163232293797,265,24,91,380
1210,dark,main,0,0.9623654029354347,266,27,85,378
1210,dark,main,1,0.967827572921493,261,14,80,355
1210,dark,main,2,0.9643633839398695,260,18,107,385
1210,dark,main,3,0.953991361684922,239,20,86,345
1210,dark,main,4,0.9019816410702295,137,15,58,210
1210,dark,main,5,0.9542610226147581,273,22,76,371
1210,dark,main,6,0.9790962085679427,230,20,72,322
1210,dark,main,7,0.9197830405123812,225,20,76,321
1210,dark,main,8,0.9659277638192484,246,26,111,383
1210,dark,main,9,0.9543487899621803,247,22,93,362
1211,dark,main,0,0.9677026696491474,272,21,91,384
1211,dark,main,1,0.9524328879695358,256,16,92,364
1211,dark,main,2,0.9645835234892043,268,19,86,373
1211,dark,main,3,0.9580931004912321,263,21,72,356
1211,dark,main,4,0.9680308005890704,235,19,83,337
1211,dark,main,5,0.975717995644306,254,17,92,363
1211,dark,main,6,0.9683999793452521,212,24,84,320
1211,dark,main,7,0.9343965962035863,221,17,75,313
1211,dark,main,8,0.9642992080962776,262,20,84,366
1211,dark,main,9,0.9678518121571947,269,26,83,378
1212,dark,main,0,0.9814455272000054,267,18,83,368
1212,dark,main,1,0.9644398162743628,273,20,74,367
1212,dark,main,2,0.9742906942880418,277,19,69,365
1212,dark,main,3,0.931853221510912,241,17,92,350
1212,dark,main,4,0.9409361531381039,243,24,91,358
1212,dark,main,5,0.9593980471426367,244,25,81,350
1212,dark,main,6,0.9653977912566446,220,20,70,310
1212,dark,main,7,0.9471115447594424,226,22,80,328
1212,dark,main,8,0.9682015936148922,268,21,79,368
1212,dark,main,9,0.959131674793893,276,25,69,370
1213,dark,main,0,0.9576298454122858,287,24,83,394
1213,dark,main,1,0.9694229593688372,263,20,74,357
1213,dark,main,2,0.9715339515172405,275,21,84,380
1213,dark,main,3,0.9359694937248496,253,22,75,350
1213,dark,main,4,0.9544084083695089,256,20,82,358
1213,dark,main,5,0.9231804599241029,242,32,76,350
1213,dark,main,6,0.9774390142705085,231,20,73,324
1213,dark,main,7,0.9446941553165318,222,22,71,315
1213,dark,main,8,0.979962819407282,271,20,90,381
1213,dark,main,9,0.9452337861751944,259,12,81,352
1218,dark,main,0,0.9587055440675695,277,17,90,384
1218,dark,main,1,0.9559476736810492,247,15,100,362
1218,dark,main,2,0.9698976225207232,255,26,91,372
1218,dark,main,3,0.9441377748426161,245,14,83,342
1218,dark,main,4,0.9681290743474901,228,21,98,347
1218,dark,main,5,0.9543844812411657,256,21,79,356
1218,dark,main,6,0.9677857726470965,231,21,67,319
1218,dark,main,7,0.9621933549038778,244,16,57,317
1218,dark,main,8,0.9588225084285182,293,20,73,386
1218,dark,main,9,0.9565954378437165,245,23,86,354
1219,dark,main,0,0.9682509860375238,279,21,85,385
1219,dark,main,1,0.9649352783052153,254,21,86,361
1219,dark,main,2,0.9563621034813478,237,43,94,374
1219,dark,main,3,0.9800629342028697,252,16,84,352
1219,dark,main,4,0.9696299943104477,248,15,101,364
1219,dark,main,5,0.9432601168267046,271,16,83,370
1219,dark,main,6,0.9639603756073577,208,23,86,317
1219,dark,main,7,0.9470136710753382,222,17,80,319
1219,dark,main,8,0.9672158705095022,285,16,80,381
1219,dark,main,9,0.9702019421202193,259,21,101,381
1220,dark,main,0,0.9598437786376308,290,19,73,382
1220,dark,main,1,0.9601015076760762,234,23,88,345
1220,dark,main,2,0.924748914010165,286,24,77,387
1220,dark,main,3,0.939577347324211,246,25,87,358
1220,dark,main,4,0.9615247553686477,240,27,82,349
1220,dark,main,5,0.9613683887652233,262,23,91,376
1220,dark,main,6,0.9434420666636302,222,18,77,317
1220,dark,main,7,0.9026413215458489,216,26,64,306
1220,dark,main,8,0.9796214805022119,264,18,82,364
1220,dark,main,9,0.9701343734734637,264,38,73,375
1221,dark,main,0,0.9586187638623533,262,12,88,362
1221,dark,main,1,0.9289890185947941,253,14,94,361
1221,dark,main,2,0.9601496525298232,261,15,101,377
1221,dark,main,3,0.9404123724052691,257,19,77,353
1221,dark,main,4,0.949106287815876,236,15,104,355
1221,dark,main,5,0.9706510092425632,270,15,101,386
1221,dark,main,6,0.9452804218841917,216,13,92,321
1221,dark,main,7,0.9572854079574092,238,18,65,321
1221,dark,main,8,0.9585717051097311,280,18,85,383
1221,dark,main,9,0.9485709200128544,257,16,91,364
1222,dark,main,0,0.9678726392907756,274,24,86,384
1222,dark,main,1,0.9262197907114147,256,18,81,355
1222,dark,main,2,0.9581577026195004,255,18,97,370
1222,dark,main,3,0.9510974969516751,249,23,86,358
1222,dark,main,4,0.9333084024205858,251,15,81,347
1222,dark,main,5,0.9651437940553703,257,19,88,364
1222,dark,main,6,0.9518185034873596,226,14,71,311
1222,dark,main,7,0.9464736552964348,231,16,73,320
1222,dark,main,8,0.9512390589571317,295,18,73,386
1222,dark,main,9,0.9771173050038733,262,24,88,374
1223,dark,main,0,0.9606116278553217,286,17,76,379
1223,dark,main,1,0.9578605070676702,270,20,71,361
1223,dark,main,2,0.9691209711882165,276,26,75,377
1223,dark,main,3,0.9594487767224419,247,15,100,362
1223,dark,main,4,0.962563323822376,226,19,109,354
1223,dark,main,5,0.9726126583047542,259,14,100,373
1223,dark,main,6,0.9389841855612996,222,14,71,307
1223,dark,main,7,0.9620175218034448,241,14,59,314
1223,dark,main,8,0.9388741345827495,280,15,97,392
1223,dark,main,9,0.9717656652156675,271,13,98,382
1224,dark,main,0,0.9642510736939539,271,16,99,386
1224,dark,main,1,0.9580678837427291,257,25,71,353
1224,dark,main,2,0.9467356429430169,270,19,86,375
1224,dark,main,3,0.9526172329165791,245,25,87,357
1224,dark,main,4,0.9790019202463647,266,23,81,370
1224,dark,main,5,0.9548696664796061,264,27,86,377
1224,dark,main,6,0.9634741165867579,236,17,65,318
1224,dark,main,7,0.9202826775420564,237,16,69,322
1224,dark,main,8,0.9569723723233119,270,20,86,376
1224,dark,main,9,0.9365876252172067,273,19,88,380
1225,dark,main,0,0.9734350603789114,270,13,93,376
1225,dark,main,1,0.9395317838265193,249,16,87,352
1225,dark,main,2,0.969858386461609,259,13,109,381
1225,dark,main,3,0.9621553559345339,247,15,87,349
1225,dark,main,4,0.9567307332227352,255,16,79,350
1225,dark,main,5,0.9568784438161633,272,16,92,380
1225,dark,main,6,0.975024438385051,239,18,76,333
1225,dark,main,7,0.9484263539965716,240,14,79,333
1225,dark,main,8,0.9585560929331987,279,15,90,384
1225,dark,main,9,0.9585560929331987,279,15,90,384
1226,dark,main,0,0.9689901874877846,276,18,88,382
1226,dark,main,1,0.9619360015539661,235,13,95,343
1226,dark,main,2,0.9499966190636051,275,16,94,385
1226,dark,main,3,0.9425447531757184,254,13,82,349
1226,dark,main,4,0.9592884424596893,247,14,104,365
1226,dark,main,5,0.9781995812119466,260,12,91,363
1226,dark,main,6,0.9715654182073874,209,17,87,313
1226,dark,main,7,0.9538427961152559,218,12,94,324
1226,dark,main,8,0.955319173767682,288,19,80,387
1226,dark,main,9,0.955319173767682,288,19,80,387
1230,dark,main,0,0.9483691329838926,298,17,77,392
1230,dark,main,1,0.9534740081910388,262,16,74,352
1230,dark,main,2,0.948774127876467,262,12,92,366
1230,dark,main,3,0.9729114418001392,272,14,74,360
1230,dark,main,4,0.9460368726835442,244,19,95,358
1230,dark,main,5,0.9680318722215775,270,15,91,376
1230,dark,main,6,0.9757076781178142,222,18,88,328
1230,dark,main,7,0.920078738064569,227,15,90,332
1230,dark,main,8,0.9323977878789277,282,13,68,363
1230,dark,main,9,0.9577937244509692,294,18,77,389
1232,dark,main,0,0.9493717270929335,264,14,103,381
1232,dark,main,1,0.9457112919904354,265,19,80,364
1232,dark,main,2,0.9635055706584981,295,17,80,392
1232,dark,main,3,0.9654648498446529,258,12,76,346
1232,dark,main,4,0.960461060518503,261,11,80,352
1232,dark,main,5,0.9676014013516743,284,14,81,379
1232,dark,main,6,0.96587072469008,226,14,70,310
1232,dark,main,7,0.9733008488161876,237,15,78,330
1232,dark,main,8,0.9716804179159365,297,12,76,385
1232,dark,main,9,0.9716804179159365,297,12,76,385
1233,dark,main,0,0.9722960340147025,289,15,86,390
1233,dark,main,1,0.9521686951285752,259,14,83,356
1233,dark,main,2,0.9590976086055917,280,14,95,389
1233,dark,main,3,0.9493649513472779,235,16,94,345
1233,dark,main,4,0.9709985595196086,276,17,79,372
1233,dark,main,5,0.9761769174179609,286,14,93,393
1233,dark,main,6,0.9101569456936129,240,11,72,323
1233,dark,main,7,0.9353637340552848,219,21,74,314
1233,dark,main,8,0.9333902359162625,283,21,80,384
1233,dark,main,9,0.9333902359162625,283,21,80,384
1234,dark,main,0,0.9734736796223503,273,12,95,380
1234,dark,main,1,0.9594451055092965,269,17,70,356
1234,dark,main,2,0.9619690581323485,247,19,99,365
1234,dark,main,3,0.9756345632267114,263,20,74,357
1234,dark,main,4,0.9655513470546435,258,18,84,360
1234,dark,main,5,0.9707238479154877,287,16,71,374
1234,dark,main,6,0.9441175605986134,237,16,65,318
1234,dark,main,7,0.9619474160720137,228,17,86,331
1234,dark,main,8,0.9719636442693316,264,15,93,372
1234,dark,main,9,0.951970922273552,274,20,73,367
1235,dark,main,0,0.9644459720106424,274,26,73,373
1235,dark,main,1,0.9699586961423567,239,23,82,344
1235,dark,main,2,0.9562095633966718,269,15,93,377
1235,dark,main,3,0.9586580040862521,250,20,91,361
1235,dark,main,4,0.9452955216704455,248,19,83,350
1235,dark,main,5,0.9435762250410573,264,21,85,370
1235,dark,main,6,0.9562713292768412,219,28,61,308
1235,dark,main,7,0.9490599364923068,223,17,76,316
1235,dark,main,8,0.9626162008858612,274,15,88,377
1235,dark,main,9,0.9462892951755272,261,19,88,368
1236,dark,main,0,0.9630679387656638,284,16,87,387
1236,dark,main,1,0.9486928859524508,233,19,95,347
1236,dark,main,2,0.9571791787169756,279,23,84,386
1236,dark,main,3,0.9566692573183986,257,14,81,352
1236,dark,main,4,0.9393219826397506,245,27,80,352
1236,dark,main,5,0.9437735882529342,265,18,91,374
1236,dark,main,6,0.9628070356026128,215,17,89,321
1236,dark,main,7,0.9472924541929774,234,17,66,317
1236,dark,main,8,0.9478080039974852,268,16,96,380
1236,dark,main,9,0.9582264863755388,260,20,102,382
1237,dark,main,0,0.957532867606882,276,23,79,378
1237,dark,main,1,0.9541603218836698,248,13,93,354
1237,dark,main,2,0.9657332030987682,264,17,100,381
1237,dark,main,3,0.9618689304623297,247,15,81,343
1237,dark,main,4,0.9615703755305819,264,15,79,358
1237,dark,main,5,0.9628406121047635,260,16,87,363
1237,dark,main,6,0.915526050876486,225,19,71,315
1237,dark,main,7,0.9357573570324751,225,13,77,315
1237,dark,main,8,0.9677108223559179,275,19,79,373
1237,dark,main,9,0.9677108223559179,275,19,79,373
1238,dark,main,0,0.9564685855859535,292,14,76,382
1238,dark,main,1,0.9364453367792537,252,12,99,363
1238,dark,main,2,0.9560629436786735,273,28,91,392
1238,dark,main,3,0.9491196798399651,223,21,87,331
1238,dark,main,4,0.94340830263814,268,18,76,362
1238,dark,main,5,0.9515988147884014,249,18,96,363
1238,dark,main,6,0.950531742645643,233,12,64,309
1238,dark,main,7,0.9405874472463915,228,14,79,321
1238,dark,main,8,0.9526522351158792,258,17,101,376
1238,dark,main,9,0.9758701042793543,277,14,87,378
1239,dark,main,0,0.9546716920404387,267,16,91,374
1239,dark,main,1,0.9772566201748994,257,17,79,353
1239,dark,main,2,0.9728745650953412,265,18,95,378
1239,dark,main,3,0.9759627269662399,260,16,85,361
1239,dark,main,4,0.9660659884572846,268,19,79,366
1239,dark,main,5,0.9535858288745186,278,18,77,373
1239,dark,main,6,0.9753267733154487,232,17,67,316
1239,dark,main,7,0.9633678537705087,229,20,77,326
1239,dark,main,8,0.9497514800645167,293,16,76,385
1239,dark,main,9,0.9626565157475707,269,21,81,371
1240,dark,main,0,0.9555137676504036,301,15,74,390
1240,dark,main,1,0.9593081024866285,259,13,84,356
1240,dark,main,2,0.9564002633061947,265,20,98,383
1240,dark,main,3,0.9586933284260639,253,15,77,345
1240,dark,main,4,0.9587382572901559,259,20,75,354
1240,dark,main,5,0.9450140586126777,271,15,84,370
1240,dark,main,6,0.9398345793860627,233,16,76,325
1240,dark,main,7,0.9359203132307937,228,20,76,324
1240,dark,main,8,0.9620936452195301,273,21,82,376
1240,dark,main,9,0.9288946334705085,279,16,92,387
1241,dark,main,0,0.96000515392443,256,15,118,389
1241,dark,main,1,0.9688061831277318,235,22,97,354
1241,dark,main,2,0.9581346846079252,284,18,83,385
1241,dark,main,3,0.9809767861137356,261,15,79,355
1241,dark,main,4,0.9524953979848,252,14,88,354
1241,dark,main,5,0.9544053686325683,262,13,88,363
1241,dark,main,6,0.9308615297975238,243,15,68,326
1241,dark,main,7,0.9619609269293548,240,18,66,324
1241,dark,main,8,0.9641316005257423,268,15,92,375
1241,dark,main,9,0.9690878819980011,266,15,103,384
1242,dark,main,0,0.9614012868488855,286,17,91,394
1242,dark,main,1,0.9718130393339124,259,15,86,360
1242,dark,main,2,0.9673881048934347,272,13,83,368
1242,dark,main,3,0.9654233394399085,242,11,91,344
1242,dark,main,4,0.9600973613133769,256,14,93,363
1242,dark,main,5,0.9792812183502635,254,17,102,373
1242,dark,main,6,0.9412320092671945,219,12,99,330
1242,dark,main,7,0.9567085149901784,217,16,82,315
1242,dark,main,8,0.9342380388818876,272,17,93,382
1242,dark,main,9,0.937552471845845,278,16,85,379
1243,dark,main,0,0.9655414857586395,274,17,96,387
1243,dark,main,1,0.9262213917159187,235,14,98,347
1243,dark,main,2,0.950794480434724,270,21,81,372
1243,dark,main,3,0.967039791609143,255,17,76,348
1243,dark,main,4,0.9483297970979743,215,15,64,294
1243,dark,main,5,0.9307371484580527,212,11,55,278
1243,dark,main,6,0.9431989714238678,214,20,74,308
1243,dark,main,7,0.9399326533923771,224,17,69,310
1243,dark,main,8,0.9535120527196996,242,27,92,361
1243,dark,main,9,0.9732685816415715,253,17,87,357
1244,dark,main,0,0.9569282997519539,257,16,99,372
1244,dark,main,1,0.9353984806354865,265,14,73,352
1244,dark,main,2,0.9600053573899957,268,22,80,370
1244,dark,main,3,0.9618350142227796,266,21,70,357
1244,dark,main,4,0.9601841049034908,249,17,78,344
1244,dark,main,5,0.9633666139537761,271,17,84,372
1244,dark,main,6,0.9620791379653716,225,18,88,331
1244,dark,main,7,0.9572854079574092,236,20,65,321
1244,dark,main,8,0.9683957147339095,277,18,82,377
1244,dark,main,9,0.9683957147339095,277,18,82,377
1245,dark,main,0,0.9450583658468845,263,25,89,377
1245,dark,main,1,0.9538839928422816,241,19,85,345
1245,dark,main,2,0.9562539381755553,263,15,100,378
1245,dark,main,3,0.9480815090216861,243,18,82,343
1245,dark,main,4,0.958467651964713,270,15,79,364
1245,dark,main,5,0.9665472062441914,245,24,93,362
1245,dark,main,6,0.952442066293842,228,16,89,333
1245,dark,main,7,0.9544901140300426,213,23,80,316
1245,dark,main,8,0.950610109613006,258,16,105,379
1245,dark,main,9,0.950610109613006,258,16,105,379
1246,dark,main,0,0.9637193374430598,278,16,81,375
1246,dark,main,1,0.9747986851037528,233,19,101,353
1246,dark,main,2,0.9471339827177976,273,25,85,383
1246,dark,main,3,0.9480730209297606,248,16,83,347
1246,dark,main,4,0.9396988486354123,258,17,76,351
1246,dark,main,5,0.9616644463617979,252,26,87,365
1246,dark,main,6,0.9326656650283423,233,15,61,309
1246,dark,main,7,0.9478908157680731,231,20,72,323
1246,dark,main,8,0.9639940490471804,272,19,81,372
1246,dark,main,9,0.9480075504099326,255,23,88,366
1247,dark,main,0,0.9702296009172899,268,18,101,387
1247,dark,main,1,0.9730046919512426,246,20,81,347
1247,dark,main,2,0.9605921058732118,280,21,82,383
1247,dark,main,3,0.9510566292624582,267,16,71,354
1247,dark,main,4,0.9621553559345339,231,18,102,351
1247,dark,main,5,0.9646923180882755,239,32,72,343
1247,dark,main,6,0.9151382553214567,241,17,71,329
1247,dark,main,7,0.9477613954166987,219,22,75,316
1247,dark,main,8,0.9537038438865936,265,28,78,371
1247,dark,main,9,0.9602063322001619,273,19,77,369
1248,dark,main,0,0.953774163542785,252,42,87,381
1248,dark,main,1,0.9556902586057869,251,21,72,344
1248,dark,main,2,0.9444734416126593,262,16,92,370
1248,dark,main,3,0.9450447559121844,235,27,85,347
1248,dark,main,4,0.9611150369467496,238,28,91,357
1248,dark,main,5,0.9760176962927055,268,24,79,371
1248,dark,main,6,0.9575767017462518,222,19,71,312
1248,dark,main,7,0.9612938848792416,225,19,78,322
1248,dark,main,8,0.951797341392811,273,18,88,379
1248,dark,main,9,0.9477175167622123,259,19,85,363
1249,dark,main,0,0.9748757711253232,269,19,87,375
1249,dark,main,1,0.9712667836976845,224,23,93,340
1249,dark,main,2,0.9650384450298312,276,24,80,380
1249,dark,main,3,0.9659257803289357,258,21,88,367
1249,dark,main,4,0.955652148079643,235,30,86,351
1249,dark,main,5,0.9638248861383618,267,20,81,368
1249,dark,main,6,0.9346794674717956,233,19,63,315
1249,dark,main,7,0.9420067113337192,240,21,65,326
1249,dark,main,8,0.9629493288351911,276,20,89,385
1249,dark,main,9,0.9629493288351911,276,20,89,385
1250,dark,main,0,0.9661795771833921,265,25,89,379
1250,dark,main,1,0.9527476911944005,245,24,80,349
1250,dark,main,2,0.9596490042487349,266,27,74,367
1250,dark,main,3,0.9395317838265193,259,20,74,353
1250,dark,main,4,0.9675598924052469,242,25,85,352
1250,dark,main,5,0.9420871327278477,240,26,93,359
1250,dark,main,6,0.9332868608748683,212,20,79,311
1250,dark,main,7,0.9299231787398528,222,23,79,324
1250,dark,main,8,0.9588412600683527,261,21,97,379
1250,dark,main,9,0.9505495292721732,254,26,96,376
1251,dark,main,0,0.9551061425475288,278,23,84,385
1251,dark,main,1,0.9755027358278499,243,16,95,354
1251,dark,main,2,0.9658685860370391,271,18,89,378
1251,dark,main,3,0.9709475385867721,235,24,83,342
1251,dark,main,4,0.9315745680134069,261,18,80,359
1251,dark,main,5,0.950282150405103,278,17,71,366
1251,dark,main,6,0.9597423978587196,206,20,80,306
1251,dark,main,7,0.9542586507578035,228,19,73,320
1251,dark,main,8,0.9733762077489387,276,19,88,383
1251,dark,main,9,0.943927365832344,250,16,100,366
1252,dark,main,0,0.9480015532757982,267,20,81,368
1252,dark,main,1,0.9485348963158713,226,21,96,343
1252,dark,main,2,0.9741042794443034,266,22,84,372
1252,dark,main,3,0.9772555808904073,239,21,80,340
1252,dark,main,4,0.9621973445380743,251,18,65,334
1252,dark,main,5,0.9178755560142254,252,23,87,362
1252,dark,main,6,0.9554194005930563,217,25,74,316
1252,dark,main,7,0.9478867982746768,227,20,81,328
1252,dark,main,8,0.960757335818994,277,25,76,378
1252,dark,main,9,0.9558496359775809,259,26,82,367
1253,dark,main,0,0.9331898559503302,251,20,101,372
1253,dark,main,1,0.9253452786032035,247,20,79,346
1253,dark,main,2,0.9627087805583264,238,23,94,355
1253,dark,main,3,0.98790079821891,231,18,93,342
1253,dark,main,4,0.9579672008594888,239,18,85,342
1253,dark,main,5,0.9713079232200911,265,15,89,369
1253,dark,main,6,0.9456953463877102,220,18,79,317
1253,dark,main,7,0.9688138365841125,229,23,55,307
1253,dark,main,8,0.9550442542896355,272,17,75,364
1253,dark,main,9,0.9550442542896355,272,17,75,364
1254,dark,main,0,0.9598007217662305,276,15,87,378
1254,dark,main,1,0.925441546402433,255,17,88,360
1254,dark,main,2,0.9602772757384428,265,21,86,372
1254,dark,main,3,0.9695287971897215,236,22,87,345
1254,dark,main,4,0.9706585029468249,255,21,77,353
1254,dark,main,5,0.9733948499857774,259,25,73,357
1254,dark,main,6,0.9497002503195429,206,24,83,313
1254,dark,main,7,0.9433831575694295,243,18,62,323
1254,dark,main,8,0.9597045743587833,268,19,87,374
1254,dark,main,9,0.9597045743587833,268,19,87,374
1256,dark,main,0,0.9699924576181399,269,22,85,376
1256,dark,main,1,0.9622142351753993,241,21,85,347
1256,dark,main,2,0.9580753796426887,259,22,103,384
1256,dark,main,3,0.9513682240047548,264,15,66,345
1256,dark,main,4,0.9583406128509153,261,15,81,357
1256,dark,main,5,0.9603956337439989,260,20,109,389
1256,dark,main,6,0.917751886591858,235,17,72,324
1256,dark,main,7,0.9731157009587342,246,22,68,336
1256,dark,main,8,0.9664055789054179,282,19,83,384
1256,dark,main,9,0.9608198604027052,256,18,91,365
1257,dark,main,0,0.9490746770663462,261,23,89,373
1257,dark,main,1,0.9445636883194323,272,15,75,362
1257,dark,main,2,0.9784174610377213,295,16,82,393
1257,dark,main,3,0.9605258188138759,248,15,90,353
1257,dark,main,4,0.9758770368975178,228,14,104,346
1257,dark,main,5,0.9535482191251764,264,12,93,369
1257,dark,main,6,0.9401450262230951,208,14,67,289
1257,dark,main,7,0.9421178251454193,227,18,62,307
1257,dark,main,8,0.9617007268219605,285,15,78,378
1257,dark,main,9,0.9634439356589138,269,18,94,381
1258,dark,main,0,0.9514584446621374,279,18,104,401
1258,dark,main,1,0.9727831940808207,247,24,77,348
1258,dark,main,2,0.9646784731825238,266,27,88,381
1258,dark,main,3,0.9524699391601411,257,18,73,348
1258,dark,main,4,0.9386492706387765,250,21,90,361
1258,dark,main,5,0.9205840706660081,239,27,79,345
1258,dark,main,6,0.9258592142919456,211,29,66,306
1258,dark,main,7,0.9336469334945836,212,19,83,314
1258,dark,main,8,0.9525536650944846,295,13,85,393
1258,dark,main,9,0.9689889707141448,275,18,82,375
1295,dark,main,0,0.972215469055037,245,42,85,372
1295,dark,main,1,0.9634370334352305,230,38,84,352
1295,dark,main,2,0.942903517255121,246,56,66,368
1295,dark,main,3,0.9668049079087568,214,38,93,345
1295,dark,main,4,0.9302842318656639,241,29,67,337
1295,dark,main,5,0.9469160332609753,236,35,83,354
1295,dark,main,6,0.9384793828660859,208,39,61,308
1295,dark,main,7,0.9289371683400416,189,30,68,287
1295,dark,main,8,0.959491650323302,247,36,83,366
1295,dark,main,9,0.9518571603632392,232,39,86,357
1299,dark,main,0,0.9671302228143904,269,28,92,389
1299,dark,main,1,0.9653294955523349,237,34,84,355
1299,dark,main,2,0.9657704532238729,244,28,105,377
1299,dark,main,3,0.9581900082365903,233,38,87,358
1299,dark,main,4,0.9620137266983574,234,34,77,345
1299,dark,main,5,0.943707412221384,253,32,81,366
1299,dark,main,6,0.9464736552964348,232,22,68,322
1299,dark,main,7,0.9651499112063132,248,25,64,337
1299,dark,main,8,0.9598677814941156,269,33,82,384
1299,dark,main,9,0.9415039703233121,274,16,83,373
1308,dark,main,0,0.955477013646203,269,20,102,391
1308,dark,main,1,0.9417604642193169,239,22,87,348
1308,dark,main,2,0.9556639798618413,261,31,85,377
1308,dark,main,3,0.9579670321246188,230,30,90,350
1308,dark,main,4,0.9601078611755024,233,20,105,358
1308,dark,main,5,0.9128672751557179,244,38,86,368
1308,dark,main,6,0.9693436871298148,175,60,74,309
1308,dark,main,7,0.9360646024593421,238,29,72,339
1308,dark,main,8,0.9658572625170415,283,31,73,387
1308,dark,main,9,0.9781814534332702,260,30,94,384
1310,dark,main,0,0.9608920194238335,267,25,97,389
1310,dark,main,1,0.9513069865917928,257,17,81,355
1310,dark,main,2,0.9653395952090638,268,24,85,377
1310,dark,main,3,0.9582357457452247,248,25,81,354
1310,dark,main,4,0.9581727843361134,256,22,76,354
1310,dark,main,5,0.9636511546733116,247,31,98,376
1310,dark,main,6,0.9459222353558748,222,17,83,322
1310,dark,main,7,0.9551990069424715,233,17,80,330
1310,dark,main,8,0.976885642625631,265,19,97,381
1310,dark,main,9,0.945139905953195,274,18,84,376
1311,dark,main,0,0.9543427703749883,260,22,104,386
1311,dark,main,1,0.9498130046732961,257,12,75,344
1311,dark,main,2,0.9509950030311604,269,23,88,380
1311,dark,main,3,0.9502427723464527,240,33,70,343
1311,dark,main,4,0.9366066345879062,251,18,80,349
1311,dark,main,5,0.9452298772487399,260,19,89,368
1311,dark,main,6,0.9278342390822867,218,30,71,319
1311,dark,main,7,0.9543227447862516,218,26,84,328
1311,dark,main,8,0.9505998979140655,265,27,89,381
1311,dark,main,9,0.9418264457403501,272,22,90,384
1384,dark,main,0,0.956253551030649,269,26,81,376
1384,dark,main,1,0.9612246578515037,231,27,79,337
1384,dark,main,2,0.9544384634494245,252,32,85,369
1384,dark,main,3,0.9432545053292127,226,31,81,338
1384,dark,main,4,0.9665005837584308,231,34,90,355
1384,dark,main,5,0.9583107294876392,250,21,91,362
1384,dark,main,6,0.9406072653679765,234,20,73,327
1384,dark,main,7,0.9495277916936508,197,39,68,304
1384,dark,main,8,0.9471160591303696,259,31,83,373
1384,dark,main,9,0.9476202219123253,252,32,75,359
1385,dark,main,0,0.9610924771437301,244,37,76,357
1385,dark,main,1,0.9473588685901672,234,30,91,355
1385,dark,main,2,0.9323585476550289,266,28,66,360
1385,dark,main,3,0.9197803045942778,242,32,77,351
1385,dark,main,4,0.9742730683697853,210,28,86,324
1385,dark,main,5,0.9235762566063064,237,35,81,353
1385,dark,main,6,0.9712995071419819,201,37,68,306
1385,dark,main,7,0.9438333619290291,212,29,65,306
1385,dark,main,8,0.944317816851242,272,29,69,370
1385,dark,main,9,0.9679429095394673,253,22,82,357
1386,dark,main,0,0.9637922913579494,241,29,85,355
1386,dark,main,1,0.9654317846293589,210,35,83,328
1386,dark,main,2,0.9738287285920582,235,53,77,365
1386,dark,main,3,0.9590655877519634,234,27,74,335
1386,dark,main,4,0.957430233037563,208,44,88,340
1386,dark,main,5,0.9606307194072603,223,38,94,355
1386,dark,main,6,0.9400987984440358,216,30,60,306
1386,dark,main,7,0.9509637453158121,210,38,69,317
1386,dark,main,8,0.959244080080976,238,54,66,358
1386,dark,main,9,0.9459648924651565,236,46,88,370
1387,dark,main,0,0.965081194369843,240,42,82,364
1387,dark,main,1,0.973343613813448,241,30,62,333
1387,dark,main,2,0.9701343734734637,256,35,84,375
1387,dark,main,3,0.9423623770359638,240,27,78,345
1387,dark,main,4,0.9770104953731189,239,32,85,356
1387,dark,main,5,0.9727063552467812,250,27,83,360
1387,dark,main,6,0.9500826180990277,215,28,88,331
1387,dark,main,7,0.9592954034148938,224,32,68,324
1387,dark,main,8,0.9588044182896422,228,45,91,364
1387,dark,main,9,0.958510719071921,247,39,69,355
1388,dark,main,0,0.9415991703792576,258,26,92,376
1388,dark,main,1,0.9580734634033738,247,21,77,345
1388,dark,main,2,0.9365840935032537,251,25,110,386
1388,dark,main,3,0.9531361847642883,235,29,94,358
1388,dark,main,4,0.9463802583839286,255,22,78,355
1388,dark,main,5,0.9347151660867334,237,22,86,345
1388,dark,main,6,0.9508845925050727,212,22,77,311
1388,dark,main,7,0.9267505526948473,213,20,71,304
1388,dark,main,8,0.9410705666961885,272,26,78,376
1388,dark,main,9,0.959409131953866,256,18,89,363
1389,dark,main,0,0.9549036461115502,255,37,75,367
1389,dark,main,1,0.9342507975532708,228,37,82,347
1389,dark,main,2,0.9528322539799922,231,42,93,366
1389,dark,main,3,0.9460211970436232,255,29,63,347
1389,dark,main,4,0.958627259203901,196,53,83,332
1389,dark,main,5,0.9404253863984567,228,34,84,346
1389,dark,main,6,0.9508183359042234,217,32,60,309
1389,dark,main,7,0.949180024994088,194,37,62,293
1389,dark,main,8,0.9441097192330049,230,31,93,354
1389,dark,main,9,0.9570176226258239,255,29,91,375
1390,dark,main,0,0.9737515301737317,263,35,72,370
1390,dark,main,1,0.9339695788876519,246,28,69,343
1390,dark,main,2,0.9605487109559852,284,19,90,393
1390,dark,main,3,0.9410382105972304,241,21,82,344
1390,dark,main,4,0.9711248253657102,226,25,85,336
1390,dark,main,5,0.9307478443834936,252,24,90,366
1390,dark,main,6,0.9384360876292901,128,22,49,199
1390,dark,main,7,0.9626503590260497,207,35,66,308
1390,dark,main,8,0.9608948583319588,227,46,90,363
1390,dark,main,9,0.9157538471338221,242,40,91,373
1391,dark,main,0,0.9535801561914219,263,45,77,385
1391,dark,main,1,0.959587595912162,229,39,79,347
1391,dark,main,2,0.9574342564331899,256,40,87,383
1391,dark,main,3,0.9551637064757362,209,45,84,338
1391,dark,main,4,0.9395691880323597,161,37,50,248
1391,dark,main,5,0.9708351420585857,261,41,65,367
1391,dark,main,6,0.9759430535367541,193,35,81,309
1391,dark,main,7,0.9525006810645067,209,35,63,307
1391,dark,main,8,0.9577636741837057,247,42,77,366
1391,dark,main,9,0.9654951000741904,247,41,80,368
1392,dark,main,0,0.9548953525992988,239,66,63,368
1392,dark,main,1,0.9648507385960606,225,50,64,339
1392,dark,main,2,0.9352806917992282,235,51,88,374
1392,dark,main,3,0.9683764185643707,203,62,64,329
1392,dark,main,4,0.9494751616606515,112,45,41,198
1392,dark,main,5,0.9718032059723544,219,65,89,373
1392,dark,main,6,0.9582156127462733,204,49,59,312
1392,dark,main,7,0.957984716192576,238,44,50,332
1392,dark,main,8,0.946488624036965,247,43,83,373
1392,dark,main,9,0.9524760073663117,244,66,73,383
1393,dark,main,0,0.9680245166405482,261,47,73,381
1393,dark,main,1,0.9499622603972644,222,53,79,354
1393,dark,main,2,0.9707932061620194,261,40,78,379
1393,dark,main,3,0.9595083960706494,241,39,84,364
1393,dark,main,4,0.9674960024933625,243,51,73,367
1393,dark,main,5,0.9395991652220332,211,75,76,362
1393,dark,main,6,0.9594352093281054,213,38,82,333
1393,dark,main,7,0.9592442677903952,217,49,61,327
1393,dark,main,8,0.9702503460100069,248,53,73,374
1393,dark,main,9,0.9715496819572493,225,55,93,373
1394,dark,main,0,0.9508818212881197,264,22,84,370
1394,dark,main,1,0.974950930032451,231,31,87,349
1394,dark,main,2,0.9755680200135906,256,43,85,384
1394,dark,main,3,0.945343089693235,243,39,69,351
1394,dark,main,4,0.9565180738305824,242,19,90,351
1394,dark,main,5,0.9630686241782374,272,30,70,372
1394,dark,main,6,0.9544001042309368,216,18,84,318
1394,dark,main,7,0.8647524727010688,92,16,38,146
1394,dark,main,8,0.9657866587858223,255,27,96,378
1394,dark,main,9,0.9540580940339554,248,29,85,362
1395,dark,main,0,0.9471544111347526,267,32,73,372
1395,dark,main,1,0.9751944991690378,229,43,80,352
1395,dark,main,2,0.9631613972757856,256,41,81,378
1395,dark,main,3,0.9627204452016129,245,28,76,349
1395,dark,main,4,0.961124555100034,231,37,87,355
1395,dark,main,5,0.9541996683305427,250,30,84,364
1395,dark,main,6,0.9383878199576255,227,26,67,320
1395,dark,main,7,0.9577410489673904,224,35,56,315
1395,dark,main,8,0.9597045743587833,261,35,78,374
1395,dark,main,9,0.9499462269151228,242,40,86,368
1396,dark,main,0,0.9596752687812194,260,32,94,386
1396,dark,main,1,0.9526056480349648,234,33,74,341
1396,dark,main,2,0.9607635109283263,259,26,83,368
1396,dark,main,3,0.9508628920714026,240,31,72,343
1396,dark,main,4,0.9782115488853664,228,30,81,339
1396,dark,main,5,0.9313453500189918,229,36,96,361
1396,dark,main,6,0.9376680866987581,223,26,70,319
1396,dark,main,7,0.9662426971098143,213,25,87,325
1396,dark,main,8,0.9568742395101459,261,26,89,376
1396,dark,main,9,0.9732538992173508,244,24,76,344
1397,dark,main,0,0.9723219202199437,230,27,84,341
1397,dark,main,1,0.9452347219822391,250,24,72,346
1397,dark,main,2,0.9535859695247828,263,28,90,381
1397,dark,main,3,0.953991361684922,241,36,69,346
1397,dark,main,4,0.9770290819566647,237,23,93,353
1397,dark,main,5,0.9560544126786189,237,35,87,359
1397,dark,main,6,0.9708258823407269,223,37,58,318
1397,dark,main,7,0.9606040714923174,210,23,75,308
1397,dark,main,8,0.9694853594380408,264,42,68,374
1397,dark,main,9,0.9639377480938999,239,41,75,355
1398,dark,main,0,0.9648391822848196,250,31,84,365
1398,dark,main,1,0.9701669323988992,223,30,85,338
1398,dark,main,2,0.9454846263543537,230,57,71,358
1398,dark,main,3,0.9544557302183847,231,40,73,344
1398,dark,main,4,0.9435450524780886,221,30,76,327
1398,dark,main,5,0.9406155350628977,242,37,91,370
1398,dark,main,6,0.9430171431487598,202,32,72,306
1398,dark,main,7,0.954695937120348,191,45,70,306
1398,dark,main,8,0.9656837682439121,258,35,73,366
1398,dark,main,9,0.9703202942185737,229,44,69,342
1399,dark,main,0,0.932342262061773,239,35,91,365
1399,dark,main,1,0.9500670542116687,235,30,75,340
1399,dark,main,2,0.9647604805113592,242,43,83,368
1399,dark,main,3,0.9500277423585768,246,30,68,344
1399,dark,main,4,0.9432814741093306,225,27,97,349
1399,dark,main,5,0.9141070670548885,227,32,96,355
1399,dark,main,6,0.9293641452571224,141,21,33,195
1399,dark,main,7,0.9639560357108989,223,28,73,324
1399,dark,main,8,0.9690834639170295,254,29,68,351
1399,dark,main,9,0.9549581343292164,237,27,96,360
1400,dark,main,0,0.9411470863832487,254,22,107,383
1400,dark,main,1,0.9496200092515591,255,24,71,350
1400,dark,main,2,0.9723248011635173,274,30,81,385
1400,dark,main,3,0.9471949659909625,223,35,85,343
1400,dark,main,4,0.9703618701700853,234,27,82,343
1400,dark,main,5,0.9539432340383349,226,30,88,344
1400,dark,main,6,0.9708311092634502,216,32,72,320
1400,dark,main,7,0.9339524258700587,221,24,64,309
1400,dark,main,8,0.9595209597682703,260,25,95,380
1400,dark,main,9,0.9596355734505879,259,29,91,379
1401,dark,main,0,0.978151349451053,283,21,79,383
1401,dark,main,1,0.9464977518005807,236,28,86,350
1401,dark,main,2,0.9799082506349039,273,32,79,384
1401,dark,main,3,0.9134670866881369,241,23,80,344
1401,dark,main,4,0.9531130702864266,254,31,79,364
1401,dark,main,5,0.9703496192779061,267,21,72,360
1401,dark,main,6,0.9733953169570564,218,28,77,323
1401,dark,main,7,0.9220003191742269,215,29,66,310
1401,dark,main,8,0.9404498782166919,258,28,90,376
1401,dark,main,9,0.965734452685752,256,33,79,368
1402,dark,main,0,0.9339750839117271,253,34,78,365
1402,dark,main,1,0.9735101473073758,246,29,69,344
1402,dark,main,2,0.9471564011778617,238,44,89,371
1402,dark,main,3,0.9339839140659516,250,34,68,352
1402,dark,main,4,0.9596949647548024,231,36,79,346
1402,dark,main,5,0.9531978457996213,247,26,73,346
1402,dark,main,6,0.9405379733248251,219,32,78,329
1402,dark,main,7,0.9562790140808863,217,37,69,323
1402,dark,main,8,0.9485252538581048,249,46,79,374
1402,dark,main,9,0.9535859695247828,246,41,95,382
1403,dark,main,0,0.9600970561009797,266,18,100,384
1403,dark,main,1,0.9488313144891799,235,24,95,354
1403,dark,main,2,0.9500501899022058,252,20,89,361
1403,dark,main,3,0.9599364629648183,242,19,77,338
1403,dark,main,4,0.935373864638125,255,20,78,353
1403,dark,main,5,0.9656538903313225,264,27,70,361
1403,dark,main,6,0.9350435482427923,218,22,78,318
1403,dark,main,7,0.9570694167885306,226,31,60,317
1403,dark,main,8,0.9656588971428749,269,30,82,381
1403,dark,main,9,0.9536266926302174,282,20,67,369
1404,dark,main,0,0.9276514272235439,262,35,84,381
1404,dark,main,1,0.9753473647314943,235,34,89,358
1404,dark,main,2,0.9679878845876,247,46,85,378
1404,dark,main,3,0.9582603617425863,231,32,89,352
1404,dark,main,4,0.9626335917210479,237,31,79,347
1404,dark,main,5,0.9698495516293434,241,30,82,353
1404,dark,main,6,0.9411006569347805,216,38,70,324
1404,dark,main,7,0.9484937136144967,227,36,65,328
1404,dark,main,8,0.9374203511646946,249,36,86,371
1404,dark,main,9,0.9558836605015789,251,35,93,379
1405,dark,main,0,0.9586458601078461,270,32,82,384
1405,dark,main,1,0.94046498016196,226,30,80,336
1405,dark,main,2,0.9303939322614806,251,22,92,365
1405,dark,main,3,0.9143775253829692,264,33,59,356
1405,dark,main,4,0.9340494185647267,176,17,50,243
1405,dark,main,5,0.9814575102157784,246,30,88,364
1405,dark,main,6,0.9573443224463295,223,25,82,330
1405,dark,main,7,0.9461669212434621,232,20,73,325
1405,dark,main,8,0.9404226622620333,276,30,76,382
1405,dark,main,9,0.9634464704935286,238,30,101,369
1406,dark,main,0,0.9589058221965804,258,37,72,367
1406,dark,main,1,0.9589390782432838,242,33,76,351
1406,dark,main,2,0.9475398406467864,264,29,97,390
1406,dark,main,3,0.9403223444028403,227,30,91,348
1406,dark,main,4,0.9248438463686935,173,28,42,243
1406,dark,main,5,0.9621026165936655,251,31,82,364
1406,dark,main,6,0.950828702533119,223,31,67,321
1406,dark,main,7,0.9570528468210194,210,42,72,324
1406,dark,main,8,0.9607063118834899,255,36,81,372
1406,dark,main,9,0.9603313344164899,264,44,88,396
1407,dark,main,0,0.9641544873441574,257,31,86,374
1407,dark,main,1,0.9679642697050188,263,18,67,348
1407,dark,main,2,0.9596492179171509,278,20,84,382
1407,dark,main,3,0.9153084432249319,236,25,79,340
1407,dark,main,4,0.9804214190819017,229,25,89,343
1407,dark,main,5,0.9565633378858003,241,32,87,360
1407,dark,main,6,0.9504116590716375,211,26,74,311
1407,dark,main,7,0.943215395467397,213,32,77,322
1407,dark,main,8,0.9654643364223948,262,22,98,382
1407,dark,main,9,0.9613594631114716,260,28,80,368
1408,dark,main,0,0.9619676871793519,266,23,83,372
1408,dark,main,1,0.9703223130750221,240,29,76,345
1408,dark,main,2,0.9664176001647262,246,36,92,374
1408,dark,main,3,0.949481385794982,233,35,73,341
1408,dark,main,4,0.9597963264101664,241,23,94,358
1408,dark,main,5,0.9624005438995143,239,30,83,352
1408,dark,main,6,0.9446843388499199,225,24,73,322
1408,dark,main,7,0.9464109558772329,235,14,66,315
1408,dark,main,8,0.9685412358047445,246,32,90,368
1408,dark,main,9,0.9716464795137552,234,19,91,344
1409,dark,main,0,0.938543437999318,282,25,69,376
1409,dark,main,1,0.966864457804906,233,28,67,328
1409,dark,main,2,0.9653924136187557,271,25,88,384
1409,dark,main,3,0.9333017210606841,246,29,83,358
1409,dark,main,4,0.9424516836724911,254,30,78,362
1409,dark,main,5,0.9638431956767035,246,28,89,363
1409,dark,main,6,0.9667394258102199,203,26,72,301
1409,dark,main,7,0.9475991552112154,222,18,78,318
1409,dark,main,8,0.9740911723635839,252,29,89,370
1409,dark,main,9,0.9208943253388197,235,30,96,361
1410,dark,main,0,0.9466223607716114,252,20,99,371
1410,dark,main,1,0.9503665876760163,247,25,73,345
1410,dark,main,2,0.9797917202647816,242,20,97,359
1410,dark,main,3,0.9679502938868131,245,19,77,341
1410,dark,main,4,0.9403770172240881,252,21,77,350
1410,dark,main,5,0.9623872605519702,270,17,69,356
1410,dark,main,6,0.9326602773388648,223,21,62,306
1410,dark,main,7,0.9379697925269825,215,24,63,302
1410,dark,main,8,0.9569274204518144,249,33,86,368
1410,dark,main,9,0.9569274204518144,249,33,86,368
1411,dark,main,0,0.9526224433541951,261,37,76,374
1411,dark,main,1,0.9675918065522144,216,44,85,345
1411,dark,main,2,0.951223516579771,257,52,63,372
1411,dark,main,3,0.9503497712313003,246,27,78,351
1411,dark,main,4,0.9450426883702152,224,32,85,341
1411,dark,main,5,0.9517092657784185,244,37,73,354
1411,dark,main,6,0.95332579975036,140,20,29,189
1411,dark,main,7,0.9335279418569122,201,46,66,313
1411,dark,main,8,0.9555516738740625,254,45,67,366
1411,dark,main,9,0.9715664550196143,247,49,77,373
1412,dark,main,0,0.9747204249718823,254,44,80,378
1412,dark,main,1,0.9615656733723393,226,43,77,346
1412,dark,main,2,0.9637052998525004,251,49,76,376
1412,dark,main,3,0.9677226723281086,230,43,79,352
1412,dark,main,4,0.888581710653155,154,35,52,241
1412,dark,main,5,0.9695771197560322,240,53,78,371
1412,dark,main,6,0.962701788386934,202,43,67,312
1412,dark,main,7,0.9589060451272478,193,39,70,302
1412,dark,main,8,0.9686427523339146,242,41,91,374
1412,dark,main,9,0.9462967200674205,238,50,76,364
1413,dark,main,0,0.958714881347665,232,48,89,369
1413,dark,main,1,0.9692133079036432,213,43,88,344
1413,dark,main,2,0.9482694363855256,224,59,86,369
1413,dark,main,3,0.9560172965715444,237,39,85,361
1413,dark,main,4,0.9132635153874531,176,28,49,253
1413,dark,main,5,0.9720595001646538,251,29,89,369
1413,dark,main,6,0.9613863831415127,189,43,82,314
1413,dark,main,7,0.9675075449270759,220,39,69,328
1413,dark,main,8,0.9462818169063272,253,38,89,380
1413,dark,main,9,0.9487342485300088,224,51,67,342
1414,dark,main,0,0.9487741278764672,250,45,72,367
1414,dark,main,1,0.9241784478196358,215,53,78,346
1414,dark,main,2,0.9536988984131481,238,45,82,365
1414,dark,main,3,0.9551990069424712,211,42,77,330
1414,dark,main,4,0.97067915164771,226,47,77,350
1414,dark,main,5,0.9346266557985395,233,44,74,351
1414,dark,main,6,0.9536101024579405,210,39,79,328
1414,dark,main,7,0.950404557445078,203,34,75,312
1414,dark,main,8,0.9594713169837455,260,38,71,369
1414,dark,main,9,0.9505381775723226,220,41,93,354
1415,dark,main,0,0.9763986162895107,269,23,93,385
1415,dark,main,1,0.9570961525023859,245,26,82,353
1415,dark,main,2,0.9585117692406095,257,30,94,381
1415,dark,main,3,0.9696909800333144,249,30,70,349
1415,dark,main,4,0.9793734072028916,237,24,80,341
1415,dark,main,5,0.9167788628299467,260,23,92,375
1415,dark,main,6,0.9454237774834884,214,18,82,314
1415,dark,main,7,0.9559778900200336,221,26,70,317
1415,dark,main,8,0.9487137389755997,267,24,92,383
1415,dark,main,9,0.9751341085385236,265,25,92,382
1416,dark,main,0,0.943794157232955,266,20,84,370
1416,dark,main,1,0.9617393242349496,216,27,102,345
1416,dark,main,2,0.9640951740474265,276,23,83,382
1416,dark,main,3,0.9418780321748496,249,29,86,364
1416,dark,main,4,0.9554219640681731,240,24,86,350
1416,dark,main,5,0.9649610596679399,262,22,84,368
1416,dark,main,6,0.9305535946368693,200,21,90,311
1416,dark,main,7,0.9581015006380587,210,16,78,304
1416,dark,main,8,0.9724333197928774,264,27,89,380
1416,dark,main,9,0.9352054822981013,254,27,88,369
1417,dark,main,0,0.9580805513631242,255,24,92,371
1417,dark,main,1,0.9437276302973674,229,30,87,346
1417,dark,main,2,0.9358738017103978,267,26,83,376
1417,dark,main,3,0.9652658023307669,243,26,88,357
1417,dark,main,4,0.9404480181387717,247,25,92,364
1417,dark,main,5,0.9551103068848212,265,23,89,377
1417,dark,main,6,0.9779603949321379,208,27,69,304
1417,dark,main,7,0.9432192756572567,210,22,78,310
1417,dark,main,8,0.947798227937519,245,31,96,372
1417,dark,main,9,0.9615797882022072,251,35,80,366
1418,dark,main,0,0.9687253996434768,280,23,83,386
1418,dark,main,1,0.9570528005296682,269,20,73,362
1418,dark,main,2,0.9682377405806611,260,37,91,388
1418,dark,main,3,0.9363395792194124,229,28,86,343
1418,dark,main,4,0.9562322562406899,259,24,83,366
1418,dark,main,5,0.9555742300909665,268,30,74,372
1418,dark,main,6,0.9228367556611592,228,21,79,328
1418,dark,main,7,0.9499037141766656,245,24,56,325
1418,dark,main,8,0.9590213201327352,266,17,95,378
1418,dark,main,9,0.9597057893246881,268,19,91,378
1419,dark,main,0,0.9688927156143728,281,23,76,380
1419,dark,main,1,0.9640508746375913,229,33,71,333
1419,dark,main,2,0.9366271550817791,291,19,74,384
1419,dark,main,3,0.9619020874734628,245,27,78,350
1419,dark,main,4,0.936759101984807,236,38,71,345
1419,dark,main,5,0.9772496866286898,251,28,84,363
1419,dark,main,6,0.9376571360513822,225,19,77,321
1419,dark,main,7,0.9405256703998179,195,31,83,309
1419,dark,main,8,0.928942649443826,256,27,80,363
1419,dark,main,9,0.9456483885972183,270,19,79,368
1420,dark,main,0,0.95936393505208,276,25,81,382
1420,dark,main,1,0.9237126637023084,246,29,70,345
1420,dark,main,2,0.9539985316812822,265,20,86,371
1420,dark,main,3,0.9778152141630463,271,15,67,353
1420,dark,main,4,0.9751482960458457,254,27,79,360
1420,dark,main,5,0.9782928703730722,259,20,86,365
1420,dark,main,6,0.9503701268016622,232,22,76,330
1420,dark,main,7,0.9555483301746431,225,22,75,322
1420,dark,main,8,0.9732210020892308,274,22,88,384
1420,dark,main,9,0.9732210020892308,274,22,88,384
1421,dark,main,0,0.9537964288102093,250,27,83,360
1421,dark,main,1,0.9453583580101478,246,24,89,359
1421,dark,main,2,0.9638480244602757,240,29,100,369
1421,dark,main,3,0.9465263653265978,232,21,85,338
1421,dark,main,4,0.9554649354195737,254,20,88,362
1421,dark,main,5,0.9616319553923092,240,19,87,346
1421,dark,main,6,0.9698786469460592,223,27,78,328
1421,dark,main,7,0.9362388805518024,213,32,64,309
1421,dark,main,8,0.953526135680684,232,51,83,366
1421,dark,main,9,0.980405042167564,257,20,95,372
1422,dark,main,0,0.9716142726182695,259,38,65,362
1422,dark,main,1,0.9414862639232486,235,37,72,344
1422,dark,main,2,0.9803642625046299,251,35,80,366
1422,dark,main,3,0.9644146489288745,228,39,73,340
1422,dark,main,4,0.9636100328524865,227,38,80,345
1422,dark,main,5,0.941989718897666,209,45,100,354
1422,dark,main,6,0.9363876938968921,241,28,68,337
1422,dark,main,7,0.9369845518300784,218,28,79,325
1422,dark,main,8,0.977773421620859,234,51,75,360
1422,dark,main,9,0.9563621034813478,248,36,88,372
1423,dark,main,0,0.9592104339671309,252,40,74,366
1423,dark,main,1,0.928829292042724,230,37,74,341
1423,dark,main,2,0.9507196199329344,255,37,79,371
1423,dark,main,3,0.9690457257136443,247,37,79,363
1423,dark,main,4,0.9781694720187764,225,34,78,337
1423,dark,main,5,0.9641814857099454,262,24,82,368
1423,dark,main,6,0.9422730476302955,226,26,63,315
1423,dark,main,7,0.9599922478458875,220,33,67,320
1423,dark,main,8,0.9603232391968385,281,33,69,383
1423,dark,main,9,0.9161515745033845,226,42,89,357
1424,dark,main,0,0.9602970320112472,233,55,79,367
1424,dark,main,1,0.9551348364371284,226,51,70,347
1424,dark,main,2,0.9367690777805058,240,57,78,375
1424,dark,main,3,0.9576272492432939,242,40,63,345
1424,dark,main,4,0.9498995301419944,254,54,57,365
1424,dark,main,5,0.9570277100301049,241,51,77,369
1424,dark,main,6,0.9045606849299477,128,27,38,193
1424,dark,main,7,0.9460377587941589,206,44,73,323
1424,dark,main,8,0.9646434146399945,239,56,81,376
1424,dark,main,9,0.9427127854017695,247,49,72,368
1425,dark,main,0,0.9708056840214682,240,62,68,370
1425,dark,main,1,0.9491448319665587,223,51,65,339
1425,dark,main,2,0.9459738399107854,249,43,85,377
1425,dark,main,3,0.9577137636635474,218,54,76,348
1425,dark,main,4,0.9548605494196372,208,67,54,329
1425,dark,main,5,0.9647194616059392,212,59,73,344
1425,dark,main,6,0.958294108586416,206,61,59,326
1425,dark,main,7,0.9567538705736456,206,50,59,315
1425,dark,main,8,0.9389909268698385,211,73,71,355
1425,dark,main,9,0.9602687913265131,242,51,65,358
1427,dark,main,0,0.9451097296336882,228,62,72,362
1427,dark,main,1,0.9358722989046994,219,54,72,345
1427,dark,main,2,0.9738913282775853,228,47,90,365
1427,dark,main,3,0.9689837784038977,195,56,80,331
1427,dark,main,4,0.9522914369207947,219,34,57,310
1427,dark,main,5,0.9639988449824514,209,54,84,347
1427,dark,main,6,0.9646872688055822,187,56,63,306
1427,dark,main,7,0.9515449996591651,182,49,62,293
1427,dark,main,8,0.9606002772727719,234,57,60,351
1427,dark,main,9,0.9781355164476391,234,62,68,364
1428,dark,main,0,0.9483313481624207,258,52,60,370
1428,dark,main,1,0.9327895700088035,229,32,95,356
1428,dark,main,2,0.9535264030519269,243,42,85,370
1428,dark,main,3,0.9563512104511475,224,47,75,346
1428,dark,main,4,0.9611416179703397,250,38,76,364
1428,dark,main,5,0.9540015153635674,246,43,74,363
1428,dark,main,6,0.9477995295862575,199,38,75,312
1428,dark,main,7,0.9706443201190734,205,29,82,316
1428,dark,main,8,0.9370938698162538,254,52,58,364
1428,dark,main,9,0.960178482307225,233,43,88,364
1429,dark,main,0,0.9616275971404061,245,51,63,359
1429,dark,main,1,0.9641604555468518,190,51,82,323
1429,dark,main,2,0.9742757574128186,232,47,80,359
1429,dark,main,3,0.9424429984478739,238,43,71,352
1429,dark,main,4,0.9689886935558817,205,52,81,338
1429,dark,main,5,0.9408835541462301,213,63,73,349
1429,dark,main,6,0.9350499677588378,206,41,51,298
1429,dark,main,7,0.9533518966802451,196,38,63,297
1429,dark,main,8,0.9312156619911549,223,49,78,350
1429,dark,main,9,0.9749749705995016,245,76,51,372
1430,dark,main,0,0.9398190037231717,236,58,76,370
1430,dark,main,1,0.9294511304995738,195,70,54,319
1430,dark,main,2,0.9630920678090895,239,35,87,361
1430,dark,main,3,0.9442330856535005,221,43,82,346
1430,dark,main,4,0.951050600878537,239,36,83,358
1430,dark,main,5,0.9733347367275035,244,36,91,371
1430,dark,main,6,0.9590632354111416,212,30,76,318
1430,dark,main,7,0.9110995990427367,221,42,60,323
1430,dark,main,8,0.9462339599924007,253,47,69,369
1430,dark,main,9,0.9318644875090218,237,52,76,365
1431,dark,main,0,0.9578377479609217,254,30,97,381
1431,dark,main,1,0.9631693529189843,241,25,89,355
1431,dark,main,2,0.9561253525286075,253,27,93,373
1431,dark,main,3,0.9547306589945183,238,20,81,339
1431,dark,main,4,0.958022277289751,265,22,72,359
1431,dark,main,5,0.9623872605519701,256,25,78,359
1431,dark,main,6,0.9622975091666199,202,19,88,309
1431,dark,main,7,0.9511044125033988,223,29,69,321
1431,dark,main,8,0.9606116278553213,277,17,82,376
1431,dark,main,9,0.9606116278553213,277,17,82,376
1432,dark,main,0,0.9679712918807446,265,29,82,376
1432,dark,main,1,0.9349299037720146,253,25,67,345
1432,dark,main,2,0.9623278504631015,249,28,99,376
1432,dark,main,3,0.9537645078183846,249,26,77,352
1432,dark,main,4,0.9517023868125228,240,28,84,352
1432,dark,main,5,0.9547950630210081,258,27,85,370
1432,dark,main,6,0.9549185459658741,226,27,61,314
1432,dark,main,7,0.9304058691480452,231,20,65,316
1432,dark,main,8,0.9583978344607397,267,21,71,359
1432,dark,main,9,0.9387126218835176,251,23,100,374
1433,dark,main,0,0.9674665783984758,239,67,62,368
1433,dark,main,1,0.9735764293273458,215,56,75,346
1433,dark,main,2,0.9620212041173017,223,72,85,380
1433,dark,main,3,0.9585859595834236,227,46,74,347
1433,dark,main,4,0.970870694419764,217,51,76,344
1433,dark,main,5,0.9529102624725505,241,47,79,367
1433,dark,main,6,0.9569849036013967,185,49,74,308
1433,dark,main,7,0.9540857345468488,160,83,50,293
1433,dark,main,8,0.9769767895109228,187,87,42,316
1433,dark,main,9,0.9530705077924317,147,53,28,228
1514,dark,main,0,0.961519946564407,253,31,86,370
1514,dark,main,1,0.9331909028936749,238,31,86,355
1514,dark,main,2,0.9768366039568077,259,20,73,352
1514,dark,main,3,0.9567810368776783,238,24,91,353
1514,dark,main,4,0.9422723991489778,248,24,86,358
1514,dark,main,5,0.9678392009982805,246,23,90,359
1514,dark,main,6,0.9753105370719392,241,20,65,326
1514,dark,main,7,0.9509702999814967,216,29,70,315
1514,dark,main,8,0.9465670255884845,262,26,83,371
1514,dark,main,9,0.9564628551893131,243,29,86,358
1548,dark,main,0,0.9622692698426858,288,14,95,397
1548,dark,main,1,0.9421777247927579,235,16,91,342
1548,dark,main,2,0.9395673301254466,266,14,103,383
1548,dark,main,3,0.971625749336694,265,11,94,370
1548,dark,main,4,0.96050023987486,267,14,83,364
1548,dark,main,5,0.974419561231315,263,10,86,359
1548,dark,main,6,0.9677294525737317,224,17,83,324
1548,dark,main,7,0.9395986077069924,228,13,80,321
1548,dark,main,8,0.9592969220344711,283,16,86,385
1548,dark,main,9,0.9492990620345915,259,13,91,363
1573,dark,main,0,0.9664648838706539,264,22,98,384
1573,dark,main,1,0.9368350008190882,259,23,68,350
1573,dark,main,2,0.9500765346480904,288,18,75,381
1573,dark,main,3,0.9507302046086814,228,17,101,346
1573,dark,main,4,0.9332155855646981,156,9,75,240
1573,dark,main,5,0.9681015064965821,270,20,84,374
1573,dark,main,6,0.9440018201152633,234,17,74,325
1573,dark,main,7,0.9542273285004179,248,17,69,334
1573,dark,main,8,0.9660011649299355,246,22,93,361
1573,dark,main,9,0.9602097341610726,281,17,82,380
1578,dark,main,0,0.96375538359177,286,16,85,387
1578,dark,main,1,0.9533052146422617,225,19,100,344
1578,dark,main,2,0.972746588483278,292,12,82,386
1578,dark,main,3,0.9547836741671892,260,21,72,353
1578,dark,main,4,0.9786558013698254,261,14,76,351
1578,dark,main,5,0.9399972819949551,270,21,96,387
1578,dark,main,6,0.9594408279053275,225,17,80,322
1578,dark,main,7,0.9275299188210431,241,13,70,324
1578,dark,main,8,0.9590754653119238,262,17,100,379
1578,dark,main,9,0.9668466363097733,260,15,98,373
1586,dark,main,0,0.9538923861050927,192,16,70,278
1586,dark,main,1,0.9520963952467759,192,24,66,282
1586,dark,main,2,0.9602964739163238,294,17,89,400
1586,dark,main,3,0.940102856288462,263,18,65,346
1586,dark,main,4,0.8915867774364732,169,16,58,243
1586,dark,main,5,0.9375601179014605,276,17,92,385
1586,dark,main,6,0.9027428087574597,222,16,78,316
1586,dark,main,7,0.9436338084591841,219,19,74,312
1586,dark,main,8,0.9436125479072199,288,19,78,385
1586,dark,main,9,0.9534125834849022,239,21,86,346
1588,dark,main,0,0.9513540834664675,236,37,88,361
1588,dark,main,1,0.9078351089854463,248,18,96,362
1588,dark,main,2,0.9565794539257422,268,28,80,376
1588,dark,main,3,0.953987154311385,224,20,98,342
1588,dark,main,4,0.9730046919512426,249,16,80,345
1588,dark,main,5,0.965576927954327,246,15,98,359
1588,dark,main,6,0.9248072334700919,227,28,75,330
1588,dark,main,7,0.9620750063246601,222,18,87,327
1588,dark,main,8,0.9513668705229078,284,20,74,378
1588,dark,main,9,0.9691873696625022,256,20,98,374
1590,dark,main,0,0.9651284178339924,271,15,92,378
1590,dark,main,1,0.953878507268237,241,21,81,343
1590,dark,main,2,0.9726663860162973,293,13,78,384
1590,dark,main,3,0.9306334623752767,259,17,86,362
1590,dark,main,4,0.9537607650386849,253,16,80,349
1590,dark,main,5,0.9714904318368164,276,20,85,381
1590,dark,main,6,0.9486685513094221,225,18,88,331
1590,dark,main,7,0.9543159893462849,211,16,71,298
1590,dark,main,8,0.9626537533581945,251,15,112,378
1590,dark,main,9,0.9609430628362302,247,22,105,374
1646,dark,main,0,0.9506844428841984,274,18,95,387
1646,dark,main,1,0.9699346060809982,249,11,105,365
1646,dark,main,2,0.9606406096128537,282,11,105,398
1646,dark,main,3,0.9638039554528047,260,13,88,361
1646,dark,main,4,0.9541606373106345,274,17,71,362
1646,dark,main,5,0.9631110003441891,287,14,84,385
1646,dark,main,6,0.9293191284165286,246,11,80,337
1646,dark,main,7,0.9639991114538118,251,11,68,330
1646,dark,main,8,0.9611632266683212,288,12,87,387
1646,dark,main,9,0.9580186395862289,266,15,87,368
1726,dark,main,0,0.9790849369581986,270,13,93,376
1726,dark,main,1,0.923562439890959,263,17,83,363
1726,dark,main,2,0.9226988180128514,267,29,77,373
1726,dark,main,3,0.9735523943812681,268,14,73,355
1726,dark,main,4,0.9566074585411726,232,19,94,345
1726,dark,main,5,0.9425479071114553,251,21,90,362
1726,dark,main,6,0.9591491956278604,223,20,71,314
1726,dark,main,7,0.9387966077033133,238,17,67,322
1726,dark,main,8,0.9525114052053226,275,24,75,374
1726,dark,main,9,0.9592950921267217,257,20,90,367
1727,dark,main,0,0.9127984401389718,267,26,86,379
1727,dark,main,1,0.9776925765381959,245,16,92,353
1727,dark,main,2,0.9693936790155162,291,16,75,382
1727,dark,main,3,0.9578650780906438,257,23,87,367
1727,dark,main,4,0.9449042385356531,260,14,87,361
1727,dark,main,5,0.9431898652467499,258,16,104,378
1727,dark,main,6,0.9608963162208685,248,14,69,331
1727,dark,main,7,0.9430227103392982,213,17,83,313
1727,dark,main,8,0.9471069265114017,262,13,103,378
1727,dark,main,9,0.9420999498743895,272,16,85,373
1728,dark,main,0,0.9579054100010608,274,15,96,385
1728,dark,main,1,0.9788156638637633,227,26,94,347
1728,dark,main,2,0.9566751670898518,257,15,100,372
1728,dark,main,3,0.9506029555988538,268,16,76,360
1728,dark,main,4,0.9365082352873566,259,14,88,361
1728,dark,main,5,0.942449946186617,264,17,100,381
1728,dark,main,6,0.94779596838512,246,15,75,336
1728,dark,main,7,0.9303051956379375,246,18,66,330
1728,dark,main,8,0.953160078132219,271,19,93,383
1728,dark,main,9,0.943175866379038,256,19,84,359
1729,dark,main,0,0.9673934881016728,280,20,91,391
1729,dark,main,1,0.9639853837219583,254,15,93,362
1729,dark,main,2,0.9670724105236992,278,17,82,377
1729,dark,main,3,0.9747750725500557,240,21,84,345
1729,dark,main,4,0.9413900910683725,261,19,70,350
1729,dark,main,5,0.9489103429638348,249,24,98,371
1729,dark,main,6,0.9341864920861561,222,18,77,317
1729,dark,main,7,0.9293091630802239,216,19,68,303
1729,dark,main,8,0.9586642101612932,254,27,86,367
1729,dark,main,9,0.9586642101612932,254,27,86,367
1731,dark,main,0,0.9658472391266549,277,21,78,376
1731,dark,main,1,0.9345826503521097,259,20,76,355
1731,dark,main,2,0.9413560171905002,265,15,102,382
1731,dark,main,3,0.959612836456136,245,25,86,356
1731,dark,main,4,0.9652257070534573,241,18,100,359
1731,dark,main,5,0.9781088825534652,262,23,91,376
1731,dark,main,6,0.9616886633337031,231,20,74,325
1731,dark,main,7,0.9484603587989592,171,16,69,256
1731,dark,main,8,0.9350786663395967,264,19,90,373
1731,dark,main,9,0.9412188243867374,274,17,96,387
1734,dark,main,0,0.9532544357308658,264,20,101,385
1734,dark,main,1,0.9478669422318473,266,14,84,364
1734,dark,main,2,0.9335808782570983,265,21,92,378
1734,dark,main,3,0.9471119211484033,268,15,77,360
1734,dark,main,4,0.9756345632267114,271,15,73,359
1734,dark,main,5,0.9630091192834311,250,29,100,379
1734,dark,main,6,0.9616257195628964,219,15,91,325
1734,dark,main,7,0.9259783928478712,242,15,74,331
1734,dark,main,8,0.9645832214440679,276,18,83,377
1734,dark,main,9,0.9515025558084071,260,19,100,379
1735,dark,main,0,0.9664518342168357,294,18,89,401
1735,dark,main,1,0.9626347729116536,260,15,81,356
1735,dark,main,2,0.9653736142778039,271,18,94,383
1735,dark,main,3,0.9686909809386063,275,14,83,372
1735,dark,main,4,0.9548863632515366,233,17,67,317
1735,dark,main,5,0.9628318732254969,269,11,95,375
1735,dark,main,6,0.9586388279016484,227,16,77,320
1735,dark,main,7,0.9576961745525246,236,14,70,320
1735,dark,main,8,0.941999252194719,282,26,74,382
1735,dark,main,9,0.9635636528409461,290,17,85,392
1736,dark,main,0,0.9640376634793136,261,28,97,386
1736,dark,main,1,0.9376533694709054,253,17,76,346
1736,dark,main,2,0.9517759944824273,263,18,95,376
1736,dark,main,3,0.9462032738890478,226,16,94,336
1736,dark,main,4,0.9667699662382919,254,17,93,364
1736,dark,main,5,0.9524094066924298,241,15,100,356
1736,dark,main,6,0.9183708424588101,248,14,67,329
1736,dark,main,7,0.9194742968608636,227,14,73,314
1736,dark,main,8,0.9720410182826571,289,16,71,376
1736,dark,main,9,0.9566382719181785,258,24,82,364
1737,dark,main,0,0.959771714634911,268,20,98,386
1737,dark,main,1,0.9620185041768099,251,15,91,357
1737,dark,main,2,0.9658996324988117,271,18,84,373
1737,dark,main,3,0.9375234220844489,250,19,70,339
1737,dark,main,4,0.9553343170326156,227,22,84,333
1737,dark,main,5,0.9779615072854198,264,22,62,348
1737,dark,main,6,0.9533487028858771,233,19,70,322
1737,dark,main,7,0.9650820320292354,239,16,83,338
1737,dark,main,8,0.9638948495730019,270,16,89,375
1737,dark,main,9,0.942747962456643,274,17,90,381
1738,dark,main,0,0.9489978532159729,269,17,103,389
1738,dark,main,1,0.9602410819927524,251,17,96,364
1738,dark,main,2,0.9639019526237383,256,23,99,378
1738,dark,main,3,0.9505402385386268,247,14,83,344
1738,dark,main,4,0.955844725859693,247,17,97,361
1738,dark,main,5,0.9596529317334457,244,22,92,358
1738,dark,main,6,0.9368105689462721,237,16,66,319
1738,dark,main,7,0.9694824517826105,265,21,55,341
1738,dark,main,8,0.9301081518921517,275,18,87,380
1738,dark,main,9,0.9551121566159411,266,20,94,380
1739,dark,main,0,0.9567846291501501,291,16,89,396
1739,dark,main,1,0.929957693681717,246,26,80,352
1739,dark,main,2,0.947318084590001,264,15,94,373
1739,dark,main,3,0.9639918041585348,251,19,77,347
1739,dark,main,4,0.9608406621847025,271,20,77,368
1739,dark,main,5,0.9418460880586825,258,21,83,362
1739,dark,main,6,0.9594594846326361,220,18,80,318
1739,dark,main,7,0.9656935902976944,198,17,48,263
1739,dark,main,8,0.9619022938279452,298,16,78,392
1739,dark,main,9,0.9681266002331403,280,18,91,389
1740,dark,main,0,0.9435360312068549,302,18,85,405
1740,dark,main,1,0.966313447487166,266,15,89,370
1740,dark,main,2,0.9674653289212692,272,15,91,378
1740,dark,main,3,0.9535847225522923,243,19,94,356
1740,dark,main,4,0.9342544471398376,245,17,98,360
1740,dark,main,5,0.9601564973222457,260,18,97,375
1740,dark,main,6,0.9371422859744711,233,15,76,324
1740,dark,main,7,0.9084689670552143,179,13,65,257
1740,dark,main,8,0.9594957344319242,280,16,88,384
1740,dark,main,9,0.9544380232070376,280,18,91,389
1741,dark,main,0,0.9525456096953097,284,19,79,382
1741,dark,main,1,0.9521862306028654,261,17,78,356
1741,dark,main,2,0.9527794324908053,233,33,89,355
1741,dark,main,3,0.9460544081578347,249,23,86,358
1741,dark,main,4,0.9447260978532573,255,21,91,367
1741,dark,main,5,0.9600550199262236,247,21,97,365
1741,dark,main,6,0.9649131932685644,212,18,83,313
1741,dark,main,7,0.9444955446381522,186,16,54,256
1741,dark,main,8,0.9628892917653644,249,22,98,369
1741,dark,main,9,0.95775003817662,284,18,85,387
1742,dark,main,0,0.9714553744115362,289,18,88,395
1742,dark,main,1,0.9305845131396212,255,19,70,344
1742,dark,main,2,0.9583406128509152,280,14,65,359
1742,dark,main,3,0.9254722595194772,260,18,72,350
1742,dark,main,4,0.9661854681337233,255,18,82,355
1742,dark,main,5,0.9358923163282606,255,13,85,353
1742,dark,main,6,0.9357851699126107,230,16,69,315
1742,dark,main,7,0.9242174957050521,220,16,62,298
1742,dark,main,8,0.9443997377501484,279,20,77,376
1742,dark,main,9,0.9707238479154879,267,16,90,373
1744,dark,main,0,0.9317665228361524,262,19,96,377
1744,dark,main,1,0.9445994098057516,236,23,90,349
1744,dark,main,2,0.956625610302144,272,25,85,382
1744,dark,main,3,0.9380007988912588,258,22,77,357
1744,dark,main,4,0.9768123912062864,241,15,88,344
1744,dark,main,5,0.9800964542342891,253,15,88,356
1744,dark,main,6,0.9793719185382227,221,19,81,321
1744,dark,main,7,0.9540938648085482,232,15,69,316
1744,dark,main,8,0.9726126583047542,252,24,96,372
1744,dark,main,9,0.9343455266629602,264,13,98,375
1746,dark,main,0,0.9668845969611536,268,17,89,374
1746,dark,main,1,0.9644330194257501,227,18,96,341
1746,dark,main,2,0.9663751774819418,296,16,76,388
1746,dark,main,3,0.945148969857587,252,20,89,361
1746,dark,main,4,0.9453010040022093,251,18,76,345
1746,dark,main,5,0.9510864921649125,241,16,92,349
1746,dark,main,6,0.9500904430568392,237,21,62,320
1746,dark,main,7,0.9411588666606401,208,20,76,304
1746,dark,main,8,0.9409144958812882,263,22,87,372
1746,dark,main,9,0.9409144958812882,263,22,87,372
1747,dark,main,0,0.9477499993328271,258,22,92,372
1747,dark,main,1,0.9628898398110726,243,20,83,346
1747,dark,main,2,0.9490659677252521,252,18,100,370
1747,dark,main,3,0.9637458286091644,245,22,75,342
1747,dark,main,4,0.9304670280770592,260,19,85,364
1747,dark,main,5,0.9633666139537759,259,16,100,375
1747,dark,main,6,0.9465076284427185,209,16,92,317
1747,dark,main,7,0.934081799341339,199,19,84,302
1747,dark,main,8,0.9544772369044054,252,24,92,368
1747,dark,main,9,0.9584636978080142,239,20,94,353
1748,dark,main,0,0.9604266947463849,280,16,87,383
1748,dark,main,1,0.9619226483519449,252,16,84,352
1748,dark,main,2,0.9599847458550643,283,18,85,386
1748,dark,main,3,0.9526408547207504,262,16,74,352
1748,dark,main,4,0.9583338120550867,261,16,79,356
1748,dark,main,5,0.9560537378557118,260,19,90,369
1748,dark,main,6,0.9501021132254234,223,31,59,313
1748,dark,main,7,0.9557983958434058,232,13,66,311
1748,dark,main,8,0.9546354612360352,271,24,84,379
1748,dark,main,9,0.9546354612360352,271,24,84,379
1749,dark,main,0,0.9584431990629213,269,16,89,374
1749,dark,main,1,0.9694153806909743,247,14,80,341
1749,dark,main,2,0.9645025123775993,263,24,99,386
1749,dark,main,3,0.9546621586849597,243,24,83,350
1749,dark,main,4,0.9677004986691963,248,13,78,339
1749,dark,main,5,0.9599088804124714,241,19,82,342
1749,dark,main,6,0.958783990697653,227,17,74,318
1749,dark,main,7,0.9487253961820755,233,17,74,324
1749,dark,main,8,0.9539051186630039,274,17,94,385
1749,dark,main,9,0.9612592935275258,269,17,100,386
1750,dark,main,0,0.9658827365266363,293,23,82,398
1750,dark,main,1,0.9472432666527998,239,13,78,330
1750,dark,main,2,0.9511036505263649,258,29,68,355
1750,dark,main,3,0.9516244720947797,223,31,92,346
1750,dark,main,4,0.957821661003206,247,13,96,356
1750,dark,main,5,0.9649226818665446,259,30,82,371
1750,dark,main,6,0.9515778625962393,214,28,68,310
1750,dark,main,7,0.9668384629000395,245,21,64,330
1750,dark,main,8,0.9721015986234898,284,22,72,378
1750,dark,main,9,0.9546192556740857,275,23,81,379
1751,dark,main,0,0.9610416369948689,265,19,87,371
1751,dark,main,1,0.943786871493421,246,22,79,347
1751,dark,main,2,0.954748004696202,267,17,88,372
1751,dark,main,3,0.9654091590093887,258,19,83,360
1751,dark,main,4,0.9524528904773714,254,25,84,363
1751,dark,main,5,0.9585529096455929,269,23,87,379
1751,dark,main,6,0.9253503059979753,215,24,88,327
1751,dark,main,7,0.9810891039568801,216,17,86,319
1751,dark,main,8,0.9726874333561363,279,22,81,382
1751,dark,main,9,0.9370985230983717,276,22,75,373
1757,dark,main,0,0.9676433646839112,279,22,85,386
1757,dark,main,1,0.9611172833318061,244,26,91,361
1757,dark,main,2,0.9561994058514605,277,22,80,379
1757,dark,main,3,0.9538041334648841,248,24,96,368
1757,dark,main,4,0.9486278068253481,253,18,87,358
1757,dark,main,5,0.9350158280176635,255,15,94,364
1757,dark,main,6,0.9307058198479881,228,16,84,328
1757,dark,main,7,0.9252589332051167,172,20,61,253
1757,dark,main,8,0.9504637024322803,288,22,78,388
1757,dark,main,9,0.9614606878733797,279,25,78,382
1758,dark,main,0,0.9379373829950612,260,20,81,361
1758,dark,main,1,0.952054371047415,239,25,82,346
1758,dark,main,2,0.9744057825870447,282,21,83,386
1758,dark,main,3,0.9578428418104505,241,17,81,339
1758,dark,main,4,0.9328757872689671,262,16,74,352
1758,dark,main,5,0.951223516579771,274,15,85,374
1758,dark,main,6,0.9428444716084627,241,17,61,319
1758,dark,main,7,0.9634177603237615,221,23,66,310
1758,dark,main,8,0.9503491577159753,293,13,79,385
1758,dark,main,9,0.9503491577159753,293,13,79,385
1759,dark,main,0,0.9430767650021389,286,17,77,380
1759,dark,main,1,0.9626280821177488,254,18,80,352
1759,dark,main,2,0.967231123677698,269,18,90,377
1759,dark,main,3,0.9463979954153946,250,22,83,355
1759,dark,main,4,0.959448776722442,244,30,87,361
1759,dark,main,5,0.956011031290379,282,17,94,393
1759,dark,main,6,0.9651007156254495,238,14,78,330
1759,dark,main,7,0.9206184252093479,175,21,59,255
1759,dark,main,8,0.9442474597577941,270,27,82,379
1759,dark,main,9,0.9760543286563684,266,25,84,375
1760,dark,main,0,0.9646813542572339,273,21,84,378
1760,dark,main,1,0.9792373210292554,254,22,63,339
1760,dark,main,2,0.9526522351158789,267,22,87,376
1760,dark,main,3,0.9703223130750221,246,17,81,344
1760,dark,main,4,0.9717488456766674,253,20,84,357
1760,dark,main,5,0.9595956487505067,275,17,89,381
1760,dark,main,6,0.9479425986789577,248,16,57,321
1760,dark,main,7,0.9426999161132521,223,16,72,311
1760,dark,main,8,0.9440710971209488,297,19,68,384
1760,dark,main,9,0.9440710971209488,297,19,68,384
1761,dark,main,0,0.9394493880714282,268,23,83,374
1761,dark,main,1,0.9403476028842997,253,21,83,357
1761,dark,main,2,0.9438259619254059,255,19,93,367
1761,dark,main,3,0.9389448155096273,237,20,83,340
1761,dark,main,4,0.949359781836617,252,21,77,350
1761,dark,main,5,0.9630466717557641,263,20,95,378
1761,dark,main,6,0.9642317716442877,222,25,73,320
1761,dark,main,7,0.9622092143141187,234,22,56,312
1761,dark,main,8,0.9638431956767034,243,33,84,360
1761,dark,main,9,0.9638431956767034,243,33,84,360
1762,dark,main,0,0.9677336527529184,290,25,81,396
1762,dark,main,1,0.9646183863731989,256,23,81,360
1762,dark,main,2,0.9728220582074943,255,31,94,380
1762,dark,main,3,0.9611653665398506,232,38,78,348
1762,dark,main,4,0.920010670047595,265,24,79,368
1762,dark,main,5,0.9768461586840876,206,114,57,377
1762,dark,main,6,0.9616851182878059,230,28,64,322
1762,dark,main,7,0.951512479967253,228,24,73,325
1762,dark,main,8,0.9524860568525314,275,17,90,382
1762,dark,main,9,0.9592146907439408,275,19,80,374
1763,dark,main,0,0.9763990951073293,274,18,87,379
1763,dark,main,1,0.9324156287528638,263,21,69,353
1763,dark,main,2,0.9586252163019165,269,19,84,372
1763,dark,main,3,0.9572752255295156,254,17,89,360
1763,dark,main,4,0.9380786639036954,256,18,93,367
1763,dark,main,5,0.9673441762789141,258,17,84,359
1763,dark,main,6,0.9306394562670679,222,25,75,322
1763,dark,main,7,0.9597165378756075,232,20,69,321
1763,dark,main,8,0.9369023203362044,273,21,85,379
1763,dark,main,9,0.9369023203362044,273,21,85,379
1764,dark,main,0,0.9585130313546734,265,20,102,387
1764,dark,main,1,0.9418097790870845,227,21,95,343
1764,dark,main,2,0.9499422928230752,288,22,73,383
1764,dark,main,3,0.9439920524198172,239,21,78,338
1764,dark,main,4,0.9553519708768794,251,21,86,358
1764,dark,main,5,0.970657133731614,258,19,99,376
1764,dark,main,6,0.9326591269005315,229,16,81,326
1764,dark,main,7,0.9554267461225217,238,18,69,325
1764,dark,main,8,0.9529883003029138,261,25,96,382
1764,dark,main,9,0.9527145557011176,255,19,87,361
1765,dark,main,0,0.9557346614028857,275,18,91,384
1765,dark,main,1,0.9383088613430135,254,16,78,348
1765,dark,main,2,0.9660412688550143,277,20,84,381
1765,dark,main,3,0.9301382989795413,256,14,76,346
1765,dark,main,4,0.9701320056566494,243,18,88,349
1765,dark,main,5,0.9526579770307294,250,19,93,362
1765,dark,main,6,0.9412858692365508,238,15,60,313
1765,dark,main,7,0.9548813867957994,226,14,81,321
1765,dark,main,8,0.955991826078817,273,17,81,371
1765,dark,main,9,0.957830103408542,262,13,113,388
1766,dark,main,0,0.9511590270877929,292,14,86,392
1766,dark,main,1,0.9548648418901391,262,12,91,365
1766,dark,main,2,0.9658448987850666,275,24,73,372
1766,dark,main,3,0.9279684162833705,267,13,67,347
1766,dark,main,4,0.9556459591440499,264,17,82,363
1766,dark,main,5,0.9639630773998719,272,15,73,360
1766,dark,main,6,0.9434384539581946,239,13,74,326
1766,dark,main,7,0.9524502568776013,235,13,73,321
1766,dark,main,8,0.9460516831828701,274,15,100,389
1766,dark,main,9,0.9371678453655967,252,18,100,370
1773,dark,main,0,0.9659402260337531,292,15,92,399
1773,dark,main,1,0.9601929661577021,248,14,91,353
1773,dark,main,2,0.9841437372698951,280,22,85,387
1773,dark,main,3,0.9065026483535329,260,15,81,356
1773,dark,main,4,0.9524734290980824,258,13,88,359
1773,dark,main,5,0.9469835520513435,255,12,97,364
1773,dark,main,6,0.9416552623481308,222,21,76,319
1773,dark,main,7,0.9528861533798773,230,12,80,322
1773,dark,main,8,0.9573638410060543,277,12,84,373
1773,dark,main,9,0.952031546636382,277,11,89,377
1774,dark,main,0,0.9606520417423338,291,15,76,382
1774,dark,main,1,0.9375991794114035,254,14,84,352
1774,dark,main,2,0.9555297643305329,269,15,90,374
1774,dark,main,3,0.9362175926406066,248,12,75,335
1774,dark,main,4,0.9669542771531935,259,12,82,353
1774,dark,main,5,0.9537422216879891,277,14,80,371
1774,dark,main,6,0.967893222498404,241,12,69,322
1774,dark,main,7,0.9659688494270542,233,13,74,320
1774,dark,main,8,0.9632289339552165,258,14,96,368
1774,dark,main,9,0.9671848154701823,285,18,82,385
1775,dark,main,0,0.9601749814771322,292,12,86,390
1775,dark,main,1,0.9492513307072716,261,10,83,354
1775,dark,main,2,0.9303058523823272,269,14,96,379
1775,dark,main,3,0.9602408884439748,258,18,72,348
1775,dark,main,4,0.9617374147608004,260,12,78,350
1775,dark,main,5,0.9430373259848082,256,16,93,365
1775,dark,main,6,0.9643616677235752,239,20,67,326
1775,dark,main,7,0.9763395473729669,233,14,81,328
1775,dark,main,8,0.932776314878093,283,16,85,384
1775,dark,main,9,0.9612110668117491,269,19,96,384
1776,dark,main,0,0.9684315456300121,304,12,80,396
1776,dark,main,1,0.9475629116966355,265,15,63,343
1776,dark,main,2,0.9626733486322044,270,17,97,384
1776,dark,main,3,0.9656567093671707,261,13,82,356
1776,dark,main,4,0.9403502930896473,254,20,87,361
1776,dark,main,5,0.9663864875892065,286,13,81,380
1776,dark,main,6,0.9306470318371048,220,17,86,323
1776,dark,main,7,0.9644638802743578,236,15,58,309
1776,dark,main,8,0.9583446950381996,283,13,86,382
1776,dark,main,9,0.9784858973975951,288,21,78,387
1786,dark,main,0,0.9697041071953801,262,33,84,379
1786,dark,main,1,0.968555825798397,246,25,83,354
1786,dark,main,2,0.9581220516307838,254,24,101,379
1786,dark,main,3,0.9696151344452133,256,14,84,354
1786,dark,main,4,0.9531481077488169,258,22,69,349
1786,dark,main,5,0.969297671440825,240,18,111,369
1786,dark,main,6,0.9544454902935234,240,17,63,320
1786,dark,main,7,0.936766114701503,206,22,80,308
1786,dark,main,8,0.9630241584178038,276,18,80,374
1786,dark,main,9,0.9757946908852128,258,19,97,374
1789,dark,main,0,0.9651663594900739,269,20,99,388
1789,dark,main,1,0.9511926125326384,252,19,79,350
1789,dark,main,2,0.9662354465491511,250,28,102,380
1789,dark,main,3,0.949282777701937,229,29,89,347
1789,dark,main,4,0.9466269566179079,240,21,87,348
1789,dark,main,5,0.9703661127344315,250,14,92,356
1789,dark,main,6,0.9716636164811931,220,14,85,319
1789,dark,main,7,0.9259911447229796,213,21,88,322
1789,dark,main,8,0.9525024730412286,261,23,96,380
1789,dark,main,9,0.9525024730412286,261,23,96,380
1790,dark,main,0,0.9642129437700914,276,19,82,377
1790,dark,main,1,0.9723234268456945,262,22,71,355
1790,dark,main,2,0.9683957147339096,282,21,75,378
1790,dark,main,3,0.9771349213162813,249,19,79,347
1790,dark,main,4,0.9543231018065316,263,19,72,354
1790,dark,main,5,0.9711239057916563,257,22,89,368
1790,dark,main,6,0.9758188713052175,231,14,76,321
1790,dark,main,7,0.926415094857718,180,17,63,260
1790,dark,main,8,0.9245375436256339,236,34,85,355
1790,dark,main,9,0.955218433061005,261,21,86,368
1791,dark,main,0,0.9828261280189082,265,16,104,385
1791,dark,main,1,0.9446029285433309,250,16,95,361
1791,dark,main,2,0.9466106277582047,284,13,88,385
1791,dark,main,3,0.9342087146248059,236,13,99,348
1791,dark,main,4,0.9622945707905076,264,14,83,361
1791,dark,main,5,0.9402060060537483,262,17,88,367
1791,dark,main,6,0.9492334588787492,248,10,57,315
1791,dark,main,7,0.9248856818112038,222,14,83,319
1791,dark,main,8,0.982323031489176,284,14,93,391
1791,dark,main,9,0.9579789337889973,287,12,86,385
1816,dark,main,0,0.9692219011862114,270,20,92,382
1816,dark,main,1,0.9619880072525958,229,26,81,336
1816,dark,main,2,0.9261601584285405,250,29,82,361
1816,dark,main,3,0.9567234016112603,219,31,84,334
1816,dark,main,4,0.9357528923676313,221,28,90,339
1816,dark,main,5,0.9798012993569523,233,22,88,343
1816,dark,main,6,0.9261265217996871,221,23,69,313
1816,dark,main,7,0.9496354691208762,211,19,90,320
1816,dark,main,8,0.970559000918448,276,24,78,378
1816,dark,main,9,0.970559000918448,276,24,78,378
1818,dark,main,0,0.9366338049593464,264,21,83,368
1818,dark,main,1,0.9587264913013844,232,20,79,331
1818,dark,main,2,0.9655089483581477,266,18,90,374
1818,dark,main,3,0.9400319326807418,252,21,66,339
1818,dark,main,4,0.9703433873221173,241,18,93,352
1818,dark,main,5,0.9555750326325885,271,16,81,368
1818,dark,main,6,0.9429812597284882,218,26,73,317
1818,dark,main,7,0.964629745775131,212,15,73,300
1818,dark,main,8,0.9765154926628881,255,22,84,361
1818,dark,main,9,0.9660874465062343,249,12,92,353
1821,dark,main,0,0.9616008783803058,276,21,89,386
1821,dark,main,1,0.9682881452821511,266,18,69,353
1821,dark,main,2,0.9715117293415904,261,24,77,362
1821,dark,main,3,0.9676969653587196,229,28,78,335
1821,dark,main,4,0.9504328696959864,249,22,75,346
1821,dark,main,5,0.9563591466481263,267,19,72,358
1821,dark,main,6,0.9456717567010721,215,19,68,302
1821,dark,main,7,0.9221070464741457,195,14,57,266
1821,dark,main,8,0.963392422501394,242,40,83,365
1821,dark,main,9,0.9645901310513313,182,16,74,272
1822,dark,main,0,0.9213779679746852,271,31,78,380
1822,dark,main,1,0.9740670610054937,245,29,74,348
1822,dark,main,2,0.9614012548776387,254,25,82,361
1822,dark,main,3,0.9329121014744634,221,27,77,325
1822,dark,main,4,0.9592471847360099,251,26,65,342
1822,dark,main,5,0.9706385425787916,235,27,88,350
1822,dark,main,6,0.9484780542493232,201,20,90,311
1822,dark,main,7,0.9632976767497557,212,36,62,310
1822,dark,main,8,0.9363422121975402,260,37,80,377
1822,dark,main,9,0.9363422121975402,260,37,80,377
1823,dark,main,0,0.9487712799305633,274,23,72,369
1823,dark,main,1,0.969967332943987,263,21,65,349
1823,dark,main,2,0.9239470501023976,271,25,73,369
1823,dark,main,3,0.9499763490406788,246,26,68,340
1823,dark,main,4,0.9635689460298162,252,15,80,347
1823,dark,main,5,0.9597570097944057,240,20,93,353
1823,dark,main,6,0.9542484281279318,247,17,62,326
1823,dark,main,7,0.955465590834924,207,19,79,305
1823,dark,main,8,0.9485542540046927,261,16,85,362
1823,dark,main,9,0.9546347711188886,220,14,90,324
1824,dark,main,0,0.9766107481716555,266,20,79,365
1824,dark,main,1,0.9454672614199119,221,34,67,322
1824,dark,main,2,0.9572460624151875,256,26,98,380
1824,dark,main,3,0.9283626101578539,259,19,77,355
1824,dark,main,4,0.95950535539283,269,13,78,360
1824,dark,main,5,0.9588894079647675,238,16,66,320
1824,dark,main,6,0.9272408504948095,224,17,69,310
1824,dark,main,7,0.9339470991136836,238,13,41,292
1824,dark,main,8,0.9346950995762636,282,21,77,380
1824,dark,main,9,0.9616710960288303,268,23,74,365
1830,dark,main,0,0.9599618976505141,253,27,83,363
1830,dark,main,1,0.9637990303447048,252,25,72,349
1830,dark,main,2,0.9672686761500311,245,20,112,377
1830,dark,main,3,0.9244892290786649,250,25,76,351
1830,dark,main,4,0.9530489665522369,254,20,73,347
1830,dark,main,5,0.9556569699354892,245,29,81,355
1830,dark,main,6,0.9551555940600152,209,23,82,314
1830,dark,main,7,0.937652172784427,239,15,60,314
1830,dark,main,8,0.947247105499878,280,16,78,374
1830,dark,main,9,0.9587030143827042,249,25,90,364
1831,dark,main,0,0.9628134340596505,269,30,82,381
1831,dark,main,1,0.9487450863245879,214,47,84,345
1831,dark,main,2,0.9606726025575878,210,75,81,366
1831,dark,main,3,0.9359474359333502,222,38,78,338
1831,dark,main,4,0.9659358356199583,245,24,77,346
1831,dark,main,5,0.9696432068562787,216,47,83,346
1831,dark,main,6,0.9422789749293706,222,27,77,326
1831,dark,main,7,0.9324435671225783,236,25,70,331
1831,dark,main,8,0.9193831760809978,253,26,83,362
1831,dark,main,9,0.9581808322460141,247,26,73,346
1832,dark,main,0,0.9734969380826887,228,45,98,371
1832,dark,main,1,0.9405607942426676,210,36,77,323
1832,dark,main,2,0.9411519959197787,250,48,66,364
1832,dark,main,3,0.9527763962859102,227,35,72,334
1832,dark,main,4,0.9408482445271755,224,48,75,347
1832,dark,main,5,0.9349299037720143,252,30,63,345
1832,dark,main,6,0.9777878994486386,194,37,72,303
1832,dark,main,7,0.9544453399284144,205,33,79,317
1832,dark,main,8,0.9482275040208926,251,33,82,366
1832,dark,main,9,0.9673789756110748,249,45,67,361
1833,dark,main,0,0.9822709657384152,247,37,88,372
1833,dark,main,1,0.9250672440328572,217,37,65,319
1833,dark,main,2,0.9585015430019262,242,36,79,357
1833,dark,main,3,0.9637054816108886,235,26,62,323
1833,dark,main,4,0.9423212902132934,237,34,75,346
1833,dark,main,5,0.9661559225821856,246,32,70,348
1833,dark,main,6,0.9636619047694723,198,39,58,295
1833,dark,main,7,0.9530056847955999,187,40,70,297
1833,dark,main,8,0.9506822536451525,243,40,75,358
1833,dark,main,9,0.9378092895422064,228,36,83,347
1834,dark,main,0,0.9669118192892936,257,35,69,361
1834,dark,main,1,0.9538146200950596,211,57,50,318
1834,dark,main,2,0.9491734938869235,238,41,87,366
1834,dark,main,3,0.9413446802749035,219,33,78,330
1834,dark,main,4,0.9444033432842655,227,38,70,335
1834,dark,main,5,0.9545155798063887,262,32,58,352
1834,dark,main,6,0.9648007557214512,185,33,83,301
1834,dark,main,7,0.9539262834057719,205,34,68,307
1834,dark,main,8,0.9475067432710333,270,25,80,375
1834,dark,main,9,0.9500599295684198,240,31,72,343
1835,dark,main,0,0.9635817859644981,249,45,81,375
1835,dark,main,1,0.947053686620681,204,47,76,327
1835,dark,main,2,0.9732887544035161,232,49,84,365
1835,dark,main,3,0.9566808116121507,212,61,61,334
1835,dark,main,4,0.9765013189821854,218,71,53,342
1835,dark,main,5,0.9462870170923897,231,62,68,361
1835,dark,main,6,0.9667043825886412,183,43,83,309
1835,dark,main,7,0.9548985054238278,184,54,75,313
1835,dark,main,8,0.9553085909786658,225,56,74,355
1835,dark,main,9,0.9451108456504644,214,61,81,356
1836,dark,main,0,0.9676953971797839,219,66,71,356
1836,dark,main,1,0.9531981994043289,225,49,63,337
1836,dark,main,2,0.9636474453036951,248,59,64,371
1836,dark,main,3,0.9601836738925572,199,53,78,330
1836,dark,main,4,0.9561111169789959,244,33,71,348
1836,dark,main,5,0.9565958537273072,238,49,73,360
1836,dark,main,6,0.9319061383363264,208,30,72,310
1836,dark,main,7,0.916355101419698,193,39,74,306
1836,dark,main,8,0.9645205442348532,218,57,78,353
1836,dark,main,9,0.950458530007805,259,39,76,374
1841,dark,main,0,0.9552231069084776,285,26,75,386
1841,dark,main,1,0.9497406844575073,222,31,88,341
1841,dark,main,2,0.9377911979302289,259,32,76,367
1841,dark,main,3,0.9673355584621898,252,25,67,344
1841,dark,main,4,0.969266492959293,233,27,72,332
1841,dark,main,5,0.944443806596264,266,17,79,362
1841,dark,main,6,0.9452398573109044,215,28,70,313
1841,dark,main,7,0.9602967566938998,220,26,60,306
1841,dark,main,8,0.9459572472039297,249,30,99,378
1841,dark,main,9,0.9516294237355546,246,17,76,339
1842,dark,main,0,0.970597064405843,258,29,103,390
1842,dark,main,1,0.9626395171268303,238,29,70,337
1842,dark,main,2,0.9736688784775765,249,33,95,377
1842,dark,main,3,0.9581215910499608,220,26,98,344
1842,dark,main,4,0.9612277699497167,216,33,83,332
1842,dark,main,5,0.9697101578640541,248,34,75,357
1842,dark,main,6,0.957547141802878,211,24,72,307
1842,dark,main,7,0.9625390578751176,213,32,62,307
1842,dark,main,8,0.9499465173619315,248,35,76,359
1842,dark,main,9,0.952839405299883,254,26,82,362
1843,dark,main,0,0.9641545088765573,233,56,69,358
1843,dark,main,1,0.9523307693228124,196,57,81,334
1843,dark,main,2,0.9820019942456615,227,50,84,361
1843,dark,main,3,0.9458729719691736,234,30,72,336
1843,dark,main,4,0.9657006869460515,219,35,76,330
1843,dark,main,5,0.9488126358455562,225,46,80,351
1843,dark,main,6,0.9526489481909273,184,56,63,303
1843,dark,main,7,0.9674433454980005,213,24,64,301
1843,dark,main,8,0.9391953119530325,249,36,78,363
1843,dark,main,9,0.9411337463162777,252,30,71,353
1844,dark,main,0,0.9462477768684909,259,19,82,360
1844,dark,main,1,0.9486019664877648,221,17,84,322
1844,dark,main,2,0.9617203963802927,245,34,85,364
1844,dark,main,3,0.921774261791193,257,23,61,341
1844,dark,main,4,0.9629622217578325,244,24,57,325
1844,dark,main,5,0.9730210692818881,233,29,94,356
1844,dark,main,6,0.9328704344806333,209,22,62,293
1844,dark,main,7,0.9163767716607815,194,24,75,293
1844,dark,main,8,0.9664300072696311,273,23,85,381
1844,dark,main,9,0.9648762160021271,238,24,92,354
1845,dark,main,0,0.9592504300163143,282,26,72,380
1845,dark,main,1,0.9507612417222392,218,23,92,333
1845,dark,main,2,0.9599159330442231,271,18,74,363
1845,dark,main,3,0.9750182944918679,243,25,88,356
1845,dark,main,4,0.976471269266325,230,21,80,331
1845,dark,main,5,0.9559270558768285,245,35,57,337
1845,dark,main,6,0.92943249215623,204,19,80,303
1845,dark,main,7,0.9430117936804473,211,22,65,298
1845,dark,main,8,0.9514602675325115,256,26,90,372
1845,dark,main,9,0.9661196103891871,258,20,97,375
1846,dark,main,0,0.9662132463024022,259,43,65,367
1846,dark,main,1,0.9457205052700448,218,36,85,339
1846,dark,main,2,0.9427102022585195,225,54,78,357
1846,dark,main,3,0.9477224024283617,225,38,69,332
1846,dark,main,4,0.9581808322460141,245,33,66,344
1846,dark,main,5,0.9430320625605418,218,47,91,356
1846,dark,main,6,0.9534053174998001,227,38,60,325
1846,dark,main,7,0.9599885260228993,213,32,58,303
1846,dark,main,8,0.9538041334648839,268,40,63,371
1846,dark,main,9,0.9538041334648839,268,40,63,371
1847,dark,main,0,0.9232903015315933,247,50,64,361
1847,dark,main,1,0.9528974601296291,192,66,73,331
1847,dark,main,2,0.9522792782808032,199,60,82,341
1847,dark,main,3,0.9165142313665678,239,52,50,341
1847,dark,main,4,0.9363719186897246,193,75,66,334
1847,dark,main,5,0.9536884310934788,246,41,72,359
1847,dark,main,6,0.9488047030447679,208,41,56,305
1847,dark,main,7,0.9436567536634712,190,57,70,317
1847,dark,main,8,0.9520175024372306,237,46,71,354
1847,dark,main,9,0.9520175024372306,237,46,71,354
1848,dark,main,0,0.9452566819337005,269,33,69,371
1848,dark,main,1,0.9354637526582514,251,28,53,332
1848,dark,main,2,0.9557524734672552,267,40,62,369
1848,dark,main,3,0.9170868358324551,229,38,70,337
1848,dark,main,4,0.932354893738434,213,41,90,344
1848,dark,main,5,0.9523287735108228,237,30,80,347
1848,dark,main,6,0.9449569860426951,209,37,68,314
1848,dark,main,7,0.9442931054413558,229,26,66,321
1848,dark,main,8,0.9593369935763137,235,41,78,354
1848,dark,main,9,0.9593369935763137,235,41,78,354
1853,dark,main,0,0.963147762238157,277,17,91,385
1853,dark,main,1,0.9636226324691921,243,14,97,354
1853,dark,main,2,0.980454597643881,242,15,113,370
1853,dark,main,3,0.9608824600882323,252,25,87,364
1853,dark,main,4,0.980382511698121,238,20,92,350
1853,dark,main,5,0.9389166001957558,234,36,94,364
1853,dark,main,6,0.9510807498238177,223,20,76,319
1853,dark,main,7,0.9672509532738569,223,15,82,320
1853,dark,main,8,0.941805325873353,267,19,82,368
1853,dark,main,9,0.9606520417423338,290,19,72,381
1869,dark,main,0,0.9628134340596505,258,24,101,383
1869,dark,main,1,0.9388254018014573,214,34,87,335
1869,dark,main,2,0.9570791239241564,231,38,87,356
1869,dark,main,3,0.9329806878623511,236,26,90,352
1869,dark,main,4,0.9549560362149493,251,12,85,348
1869,dark,main,5,0.9280003852286988,252,20,85,357
1869,dark,main,6,0.9684777728282775,245,19,61,325
1869,dark,main,7,0.9609671129762881,226,26,72,324
1869,dark,main,8,0.9543862109480004,274,24,86,384
1869,dark,main,9,0.9336011705801464,287,20,76,383
1874,dark,main,0,0.9542871643540318,250,36,73,359
1874,dark,main,1,0.9417498326386973,240,35,66,341
1874,dark,main,2,0.9629759298131119,262,28,84,374
1874,dark,main,3,0.9423957801260489,197,31,102,330
1874,dark,main,4,0.9706779653772131,224,31,74,329
1874,dark,main,5,0.9722438703960338,238,35,85,358
1874,dark,main,6,0.9537594694809922,225,26,71,322
1874,dark,main,7,0.9638424954683735,201,29,75,305
1874,dark,main,8,0.9800392326244646,236,40,81,357
1874,dark,main,9,0.9467325136894555,243,35,79,357
1882,dark,main,0,0.9227656062805776,255,39,82,376
1882,dark,main,1,0.9438537177651739,232,33,68,333
1882,dark,main,2,0.9699330754438458,271,32,79,382
1882,dark,main,3,0.9642159370667998,224,34,78,336
1882,dark,main,4,0.9584258517361519,231,37,74,342
1882,dark,main,5,0.9704698212756185,258,41,59,358
1882,dark,main,6,0.952944189178385,207,35,72,314
1882,dark,main,7,0.9366460311274973,217,27,64,308
1882,dark,main,8,0.947085579601018,257,43,76,376
1882,dark,main,9,0.9569186142890294,269,45,63,377
1884,dark,main,0,0.9629485389425986,274,37,68,379
1884,dark,main,1,0.9558385573180954,219,55,66,340
1884,dark,main,2,0.968922462636578,274,31,89,394
1884,dark,main,3,0.9491303055647814,217,44,73,334
1884,dark,main,4,0.9520615555697898,246,32,65,343
1884,dark,main,5,0.9654732194131405,235,33,88,356
1884,dark,main,6,0.9202380144483442,215,35,70,320
1884,dark,main,7,0.952110806379922,198,46,77,321
1884,dark,main,8,0.9454913383794751,239,48,80,367
1884,dark,main,9,0.9518945669174936,241,58,70,369
1885,dark,main,0,0.9692965901684479,266,49,66,381
1885,dark,main,1,0.9661920837099834,233,32,79,344
1885,dark,main,2,0.9747929533605063,262,41,69,372
1885,dark,main,3,0.9231316528827187,234,29,68,331
1885,dark,main,4,0.9743451735974203,231,40,74,345
1885,dark,main,5,0.97144842628881,245,43,74,362
1885,dark,main,6,0.9354304000060281,238,27,57,322
1885,dark,main,7,0.9607474721414907,222,30,62,314
1885,dark,main,8,0.9431608071037617,232,46,77,355
1885,dark,main,9,0.9431608071037617,232,46,77,355
1886,dark,main,0,0.9662123047543126,254,38,80,372
1886,dark,main,1,0.9589639986221289,246,36,72,354
1886,dark,main,2,0.9511168944775632,272,32,76,380
1886,dark,main,3,0.9484477514118925,256,32,58,346
1886,dark,main,4,0.9635278592071458,243,24,78,345
1886,dark,main,5,0.9689917821616935,215,56,84,355
1886,dark,main,6,0.9583679578641388,228,35,55,318
1886,dark,main,7,0.9311263125177638,220,39,65,324
1886,dark,main,8,0.9710149412289703,256,39,77,372
1886,dark,main,9,0.9404474990848604,255,41,77,373
1887,dark,main,0,0.9413465568238722,238,39,86,363
1887,dark,main,1,0.9594993587552865,227,36,79,342
1887,dark,main,2,0.9705345302022793,264,27,78,369
1887,dark,main,3,0.938181975552357,247,35,70,352
1887,dark,main,4,0.9445408574608154,235,35,81,351
1887,dark,main,5,0.9503833057154591,221,32,86,339
1887,dark,main,6,0.950531742645643,203,38,69,310
1887,dark,main,7,0.953867523726161,208,43,51,302
1887,dark,main,8,0.9744477719351674,232,41,98,371
1887,dark,main,9,0.9550112689786319,225,55,92,372
1888,dark,main,0,0.9566761362842939,232,50,73,355
1888,dark,main,1,0.9626746785437181,211,57,76,344
1888,dark,main,2,0.9549606546986996,220,57,79,356
1888,dark,main,3,0.9536607845572237,227,33,80,340
1888,dark,main,4,0.9620548135210281,224,43,78,345
1888,dark,main,5,0.956019345787078,244,56,76,376
1888,dark,main,6,0.9612910630497637,197,45,77,319
1888,dark,main,7,0.9454276940839966,190,69,46,305
1888,dark,main,8,0.9702325681845166,245,49,70,364
1888,dark,main,9,0.9680254370599334,243,56,79,378
1889,dark,main,0,0.9597942866045864,254,34,88,376
1889,dark,main,1,0.9524420662938418,236,35,64,335
1889,dark,main,2,0.9618291709755215,238,35,87,360
1889,dark,main,3,0.930711603089114,218,53,72,343
1889,dark,main,4,0.9728310410886324,242,18,85,345
1889,dark,main,5,0.9673466835979682,254,23,66,343
1889,dark,main,6,0.9737085298671979,208,27,67,302
1889,dark,main,7,0.9351832760742211,143,17,43,203
1889,dark,main,8,0.9265071833181958,201,22,82,305
1889,dark,main,9,0.9265071833181958,201,22,82,305
1890,dark,main,0,0.9508100228372914,256,34,76,366
1890,dark,main,1,0.9541262342030208,253,27,77,357
1890,dark,main,2,0.9706576536526202,266,23,73,362
1890,dark,main,3,0.9446980112981475,250,25,80,355
1890,dark,main,4,0.939921927848424,231,42,78,351
1890,dark,main,5,0.9666316692573541,251,29,88,368
1890,dark,main,6,0.9418969673564369,227,22,65,314
1890,dark,main,7,0.9585366166169282,180,47,71,298
1890,dark,main,8,0.9535128363466195,236,53,77,366
1890,dark,main,9,0.9535128363466195,236,53,77,366
1891,dark,main,0,0.9602261503497702,272,31,77,380
1891,dark,main,1,0.9595049986847474,245,30,71,346
1891,dark,main,2,0.9634807301421968,260,30,88,378
1891,dark,main,3,0.9412132934414886,238,30,75,343
1891,dark,main,4,0.9543028253558894,241,29,91,361
1891,dark,main,5,0.9511093521445336,245,31,85,361
1891,dark,main,6,0.9613176458168726,209,26,76,311
1891,dark,main,7,0.9430708079317444,221,27,71,319
1891,dark,main,8,0.9601613778049982,238,42,88,368
1891,dark,main,9,0.9601613778049982,238,42,88,368
1892,dark,main,0,0.9630164519053175,260,37,69,366
1892,dark,main,1,0.9384883957609499,235,45,65,345
1892,dark,main,2,0.9417545697938479,247,44,76,367
1892,dark,main,3,0.9515815460739341,261,18,73,352
1892,dark,main,4,0.9387120644581521,221,23,84,328
1892,dark,main,5,0.9512582645721808,252,22,87,361
1892,dark,main,6,0.9466698686482017,216,25,75,316
1892,dark,main,7,0.9677537683675081,218,22,65,305
1892,dark,main,8,0.9520856918155708,258,27,92,377
1892,dark,main,9,0.951380369694902,239,27,84,350
1893,dark,main,0,0.9571289644885497,267,26,107,400
1893,dark,main,1,0.9533069661663415,239,46,76,361
1893,dark,main,2,0.9587606922378846,299,20,88,407
1893,dark,main,3,0.9805559126361444,255,23,84,362
1893,dark,main,4,0.9454595275071672,256,26,73,355
1893,dark,main,5,0.9820071256255765,275,38,85,398
1893,dark,main,6,0.9576753914502388,208,41,79,328
1893,dark,main,7,0.9603585115874829,231,23,76,330
1893,dark,main,8,0.9510633253109193,268,30,83,381
1893,dark,main,9,0.9510633253109193,268,30,83,381
1894,dark,main,0,0.9673441682396038,281,23,73,377
1894,dark,main,1,0.963891476139811,247,27,72,346
1894,dark,main,2,0.9726407266410039,254,21,90,365
1894,dark,main,3,0.947005629118497,237,30,93,360
1894,dark,main,4,0.9537459708742675,248,19,68,335
1894,dark,main,5,0.9387847343016392,254,25,84,363
1894,dark,main,6,0.953515591769551,216,31,70,317
1894,dark,main,7,0.9496318366832182,219,27,50,296
1894,dark,main,8,0.9643103519984846,256,33,71,360
1894,dark,main,9,0.9637695509552346,259,23,87,369
1895,dark,main,0,0.9558109810437068,268,23,83,374
1895,dark,main,1,0.9611401636942322,242,18,81,341
1895,dark,main,2,0.973060755417422,245,19,95,359
1895,dark,main,3,0.9398466081984369,241,32,72,345
1895,dark,main,4,0.9661969503078051,233,23,95,351
1895,dark,main,5,0.9457870559769045,266,21,82,369
1895,dark,main,6,0.9357774260737441,239,15,68,322
1895,dark,main,7,0.8978269868983833,172,18,60,250
1895,dark,main,8,0.963283796188959,248,32,93,373
1895,dark,main,9,0.9598872983180551,263,28,92,383
1896,dark,main,0,0.9429028970977361,266,34,75,375
1896,dark,main,1,0.9238631004781047,221,31,73,325
1896,dark,main,2,0.9738428786838008,294,25,71,390
1896,dark,main,3,0.9467007268444406,240,18,86,344
1896,dark,main,4,0.9564525625317749,253,23,74,350
1896,dark,main,5,0.9452534112242392,257,29,83,369
1896,dark,main,6,0.9408201382640947,221,19,70,310
1896,dark,main,7,0.95136549322527,209,22,75,306
1896,dark,main,8,0.967061808320495,286,20,68,374
1896,dark,main,9,0.9690872763348531,278,29,76,383
1897,dark,main,0,0.9472182491118177,291,22,71,384
1897,dark,main,1,0.9632514656969431,249,24,75,348
1897,dark,main,2,0.9637279405760939,269,20,87,376
1897,dark,main,3,0.9667010687328942,244,17,82,343
1897,dark,main,4,0.9361342268096926,230,17,84,331
1897,dark,main,5,0.9519690602890335,276,28,77,381
1897,dark,main,6,0.9429090293221105,221,25,71,317
1897,dark,main,7,0.955082425596412,231,21,60,312
1897,dark,main,8,0.9639870874935471,263,24,83,370
1897,dark,main,9,0.9551644520640102,278,17,82,377
1899,dark,main,0,0.9482808454986575,279,25,88,392
1899,dark,main,1,0.9719155826105913,256,25,81,362
1899,dark,main,2,0.9518466803107445,269,36,79,384
1899,dark,main,3,0.9464369281957694,248,28,89,365
1899,dark,main,4,0.9710761800517687,266,21,85,372
1899,dark,main,5,0.9665498548573684,269,27,82,378
1899,dark,main,6,0.9580159014542493,250,26,66,342
1899,dark,main,7,0.9653547792180166,230,29,76,335
1899,dark,main,8,0.9572236625503556,287,24,72,383
1899,dark,main,9,0.9572236625503556,287,24,72,383
1900,dark,main,0,0.9810627320795334,265,23,92,380
1900,dark,main,1,0.9557549767903544,237,23,80,340
1900,dark,main,2,0.9795809150477786,248,30,90,368
1900,dark,main,3,0.959316410348099,240,19,91,350
1900,dark,main,4,0.9397086949401129,248,20,79,347
1900,dark,main,5,0.9403110528657486,253,16,93,362
1900,dark,main,6,0.9365523173208352,234,23,66,323
1900,dark,main,7,0.9573174492274377,219,24,67,310
1900,dark,main,8,0.9516275062815902,261,26,79,366
1900,dark,main,9,0.9516275062815902,261,26,79,366
1901,dark,main,0,0.957882866929793,280,20,86,386
1901,dark,main,1,0.9595041675103626,246,21,83,350
1901,dark,main,2,0.9507468808448134,262,23,99,384
1901,dark,main,3,0.9339998542111562,257,22,75,354
1901,dark,main,4,0.9539660468202659,246,18,86,350
1901,dark,main,5,0.9610420987252245,275,22,81,378
1901,dark,main,6,0.9126123691174342,220,24,71,315
1901,dark,main,7,0.9185657340559069,186,17,45,248
1901,dark,main,8,0.967410431229982,277,21,82,380
1901,dark,main,9,0.9582018444155731,282,18,64,364
1902,dark,main,0,0.9533335039362087,268,30,81,379
1902,dark,main,1,0.9578242561372654,245,23,78,346
1902,dark,main,2,0.9567811907504773,252,31,74,357
1902,dark,main,3,0.9737377155801686,238,25,87,350
1902,dark,main,4,0.9686365242389745,257,22,76,355
1902,dark,main,5,0.9497488799098835,248,22,92,362
1902,dark,main,6,0.9591080095127698,200,37,80,317
1902,dark,main,7,0.9195817410565915,216,27,58,301
1902,dark,main,8,0.962480128455456,271,24,83,378
1902,dark,main,9,0.962480128455456,271,24,83,378
1903,dark,main,0,0.9636923996988587,266,25,77,368
1903,dark,main,1,0.9382683244465337,229,21,81,331
1903,dark,main,2,0.9498607259205831,260,28,77,365
1903,dark,main,3,0.9528333327206074,243,34,76,353
1903,dark,main,4,0.934227392429391,247,31,74,352
1903,dark,main,5,0.9386439408955902,242,23,78,343
1903,dark,main,6,0.9419285203752159,206,17,83,306
1903,dark,main,7,0.9333742100311478,228,24,66,318
1903,dark,main,8,0.967871260652895,267,22,83,372
1903,dark,main,9,0.9752830767298746,265,24,81,370
1905,dark,main,0,0.8893899416785621,92,12,28,132
1905,dark,main,1,0.954265222477054,234,35,83,352
1905,dark,main,2,0.9560356980441093,255,27,84,366
1905,dark,main,3,0.955687905698718,239,31,73,343
1905,dark,main,4,0.9522624914908527,225,39,80,344
1905,dark,main,5,0.9646183863731989,252,33,76,361
1905,dark,main,6,0.9396115796310491,204,29,72,305
1905,dark,main,7,0.9522709929119181,225,28,70,323
1905,dark,main,8,0.9656278182254171,254,33,80,367
1905,dark,main,9,0.9656278182254171,254,33,80,367
1909,dark,main,0,0.9437349135040571,244,42,70,356
1909,dark,main,1,0.9545656980848228,214,59,70,343
1909,dark,main,2,0.9482694363855259,235,50,83,368
1909,dark,main,3,0.9633169769957506,236,38,75,349
1909,dark,main,4,0.9365109340410392,224,54,71,349
1909,dark,main,5,0.9703264265988975,225,49,84,358
1909,dark,main,6,0.9524515213058034,193,41,82,316
1909,dark,main,7,0.9390525693832467,185,54,69,308
1909,dark,main,8,0.9684379342588334,229,48,79,356
1909,dark,main,9,0.9652017799251141,240,46,73,359
1910,dark,main,0,0.9721633521379892,241,36,90,367
1910,dark,main,1,0.9298737606531511,210,42,89,341
1910,dark,main,2,0.9440518399035278,235,41,79,355
1910,dark,main,3,0.9361889276000352,218,34,90,342
1910,dark,main,4,0.9614830761449247,224,34,86,344
1910,dark,main,5,0.9532673213977656,247,35,79,361
1910,dark,main,6,0.9371259090731798,198,33,73,304
1910,dark,main,7,0.9247355041008068,201,36,65,302
1910,dark,main,8,0.9536850283486972,256,36,80,372
1910,dark,main,9,0.9572170503281315,237,34,96,367
1911,dark,main,0,0.9613185984927622,277,27,82,386
1911,dark,main,1,0.9489764185946419,234,21,79,334
1911,dark,main,2,0.9785326134876591,257,33,83,373
1911,dark,main,3,0.9540533468097961,225,21,92,338
1911,dark,main,4,0.9357199947509065,217,21,72,310
1911,dark,main,5,0.9624512829576229,270,20,66,356
1911,dark,main,6,0.9527978465376904,217,32,76,325
1911,dark,main,7,0.9641031558092321,217,21,71,309
1911,dark,main,8,0.9582140812370037,278,21,93,392
1911,dark,main,9,0.9525295765329556,257,27,96,380
1912,dark,main,0,0.9721327159341788,252,32,92,376
1912,dark,main,1,0.9570303166698911,236,28,83,347
1912,dark,main,2,0.9624440740253399,256,42,86,384
1912,dark,main,3,0.9360756140925758,243,24,81,348
1912,dark,main,4,0.9485369658811499,238,19,90,347
1912,dark,main,5,0.9661285881428118,253,36,76,365
1912,dark,main,6,0.9321927315949068,218,23,68,309
1912,dark,main,7,0.940219933152497,226,25,67,318
1912,dark,main,8,0.9701272175616575,269,26,93,388
1912,dark,main,9,0.9559146748224405,245,40,84,369
1913,dark,main,0,0.9666510968989931,255,34,98,387
1913,dark,main,1,0.9653159705972683,250,23,73,346
1913,dark,main,2,0.974977658083953,250,33,93,376
1913,dark,main,3,0.9305252719435676,235,34,78,347
1913,dark,main,4,0.9649272680308283,216,20,61,297
1913,dark,main,5,0.9581189291645197,246,34,89,369
1913,dark,main,6,0.9644386294896813,223,31,60,314
1913,dark,main,7,0.9512912693376591,209,32,69,310
1913,dark,main,8,0.9500829013505679,275,34,71,380
1913,dark,main,9,0.9483763025575845,242,33,94,369
1914,dark,main,0,0.9495660708677423,260,35,69,364
1914,dark,main,1,0.9474573040622108,244,29,80,353
1914,dark,main,2,0.9505421790982677,234,62,72,368
1914,dark,main,3,0.9735295752701681,241,34,79,354
1914,dark,main,4,0.9394003940383572,238,38,71,347
1914,dark,main,5,0.9688866037665771,243,39,81,363
1914,dark,main,6,0.962941079245238,221,25,72,318
1914,dark,main,7,0.9625841024252003,222,31,56,309
1914,dark,main,8,0.9681426885462007,242,36,77,355
1914,dark,main,9,0.9666752119983859,255,37,72,364
1915,dark,main,0,0.9474576655663182,240,48,80,368
1915,dark,main,1,0.9749131414140212,230,38,67,335
1915,dark,main,2,0.9431357200675615,257,41,80,378
1915,dark,main,3,0.9550340314965241,241,33,78,352
1915,dark,main,4,0.9624464326353633,243,35,87,365
1915,dark,main,5,0.9528372592628583,246,49,86,381
1915,dark,main,6,0.885112598561932,136,26,37,199
1915,dark,main,7,0.9444893105557182,160,62,84,306
1915,dark,main,8,0.9394240263501925,247,53,70,370
1915,dark,main,9,0.9778309046770883,238,63,65,366
1916,dark,main,0,0.9267898937528913,242,44,87,373
1916,dark,main,1,0.9506390291183549,215,43,72,330
1916,dark,main,2,0.9729331827607561,248,33,88,369
1916,dark,main,3,0.9346033052647528,242,41,74,357
1916,dark,main,4,0.9379315292381983,240,28,83,351
1916,dark,main,5,0.9774319958888267,235,44,90,369
1916,dark,main,6,0.96472927309598,208,34,71,313
1916,dark,main,7,0.9401809039302287,204,33,86,323
1916,dark,main,8,0.9609793295643886,245,61,62,368
1916,dark,main,9,0.9524286073237439,257,34,80,371
1917,dark,main,0,0.9417116128888305,255,37,78,370
1917,dark,main,1,0.9497777230103505,225,41,83,349
1917,dark,main,2,0.9565000348330202,243,38,80,361
1917,dark,main,3,0.9710564837525254,217,65,69,351
1917,dark,main,4,0.9627562156667878,243,27,85,355
1917,dark,main,5,0.9716872334358113,262,32,80,374
1917,dark,main,6,0.951380122473679,230,29,63,322
1917,dark,main,7,0.9370595299205471,226,29,68,323
1917,dark,main,8,0.9563073697676027,262,34,78,374
1917,dark,main,9,0.965371396879586,246,27,99,372
1918,dark,main,0,0.9630401560574444,272,24,94,390
1918,dark,main,1,0.9380123166636,255,30,67,352
1918,dark,main,2,0.9524175397703887,265,31,88,384
1918,dark,main,3,0.9436693947711378,238,29,70,337
1918,dark,main,4,0.9511119759147297,249,24,73,346
1918,dark,main,5,0.929606703402275,238,27,93,358
1918,dark,main,6,0.9554384653282245,214,19,80,313
1918,dark,main,7,0.937652172784427,214,31,69,314
1918,dark,main,8,0.9541608641091317,249,30,85,364
1918,dark,main,9,0.9601291809437857,251,30,87,368
1919,dark,main,0,0.9619384579128856,251,49,69,369
1919,dark,main,1,0.9629985159231591,228,22,79,329
1919,dark,main,2,0.9785126958637325,263,19,75,357
1919,dark,main,3,0.9453213635816671,236,26,93,355
1919,dark,main,4,0.9655798528816695,231,34,87,352
1919,dark,main,5,0.9769087102751739,252,23,91,366
1919,dark,main,6,0.946435398036341,214,25,80,319
1919,dark,main,7,0.9305149730518817,195,46,62,303
1919,dark,main,8,0.9708272785687483,264,31,89,384
1919,dark,main,9,0.9708272785687483,264,31,89,384
1920,dark,main,0,0.9660806561443834,269,43,80,392
1920,dark,main,1,0.9531078917034485,230,38,100,368
1920,dark,main,2,0.9679712874969326,275,44,80,399
1920,dark,main,3,0.976104915011495,227,54,81,362
1920,dark,main,4,0.9489056700454575,263,39,70,372
1920,dark,main,5,0.9724580089111772,268,39,79,386
1920,dark,main,6,0.9566464449281403,221,24,92,337
1920,dark,main,7,0.9525062939203194,213,33,79,325
1920,dark,main,8,0.9397137265582921,276,36,85,397
1920,dark,main,9,0.9554741493971537,276,29,72,377
1921,dark,main,0,0.9486765859976531,277,20,84,381
1921,dark,main,1,0.961268338459644,237,20,87,344
1921,dark,main,2,0.9557428779132829,248,31,80,359
1921,dark,main,3,0.9476510147843393,241,26,82,349
1921,dark,main,4,0.9367254697985491,253,19,80,352
1921,dark,main,5,0.9508080421522116,261,21,80,362
1921,dark,main,6,0.9586199607888659,237,21,75,333
1921,dark,main,7,0.9350909495083489,232,26,63,321
1921,dark,main,8,0.958779067855506,283,19,83,385
1921,dark,main,9,0.958779067855506,283,19,83,385
1922,dark,main,0,0.951223516579771,270,20,83,373
1922,dark,main,1,0.9550537504320681,224,34,78,336
1922,dark,main,2,0.9695074544241424,271,18,90,379
1922,dark,main,3,0.9445322597321344,249,19,78,346
1922,dark,main,4,0.9544754375083772,252,22,79,353
1922,dark,main,5,0.946924580906414,268,21,69,358
1922,dark,main,6,0.9742091898458115,174,111,49,334
1922,dark,main,7,0.9568946626206732,225,20,79,324
1922,dark,main,8,0.9547173884872516,261,25,91,377
1922,dark,main,9,0.9547173884872516,261,25,91,377
1923,dark,main,0,0.963055197244297,274,19,87,380
1923,dark,main,1,0.9661824714078437,233,23,87,343
1923,dark,main,2,0.9254733933902812,267,25,81,373
1923,dark,main,3,0.9499148252888028,245,23,84,352
1923,dark,main,4,0.9647819224375617,259,22,91,372
1923,dark,main,5,0.9523503472006927,249,24,90,363
1923,dark,main,6,0.8806340298798286,218,22,74,314
1923,dark,main,7,0.9526644781206658,222,22,82,326
1923,dark,main,8,0.9576005919587949,247,23,102,372
1923,dark,main,9,0.9530245595068892,262,22,85,369
1924,dark,main,0,0.9670812456581438,274,24,83,381
1924,dark,main,1,0.9269024158246107,254,15,68,337
1924,dark,main,2,0.9506193303546441,269,22,78,369
1924,dark,main,3,0.9625262228784074,260,15,72,347
1924,dark,main,4,0.9497846819642215,255,19,77,351
1924,dark,main,5,0.962959137887661,243,17,95,355
1924,dark,main,6,0.9619609269293545,241,18,67,326
1924,dark,main,7,0.933729953994073,228,18,74,320
1924,dark,main,8,0.9520047485281156,266,33,75,374
1924,dark,main,9,0.9520047485281156,266,33,75,374
1925,dark,main,0,0.974781005312715,263,23,91,377
1925,dark,main,1,0.9378517736201946,264,28,71,363
1925,dark,main,2,0.9712602736372643,260,28,73,361
1925,dark,main,3,0.9713083596491966,245,17,81,343
1925,dark,main,4,0.9579183500079386,270,15,83,368
1925,dark,main,5,0.9482337691916195,270,18,84,372
1925,dark,main,6,0.9310306896756319,240,23,57,320
1925,dark,main,7,0.9536938518873879,216,25,73,314
1925,dark,main,8,0.9565543886736546,258,20,97,375
1925,dark,main,9,0.9565543886736546,258,20,97,375
1926,dark,main,0,0.9351202535022511,252,25,97,374
1926,dark,main,1,0.9319178778443923,243,18,71,332
1926,dark,main,2,0.9522864929272761,266,18,90,374
1926,dark,main,3,0.9424458146287542,229,19,86,334
1926,dark,main,4,0.9432765657627167,257,21,76,354
1926,dark,main,5,0.9562865138735055,275,23,73,371
1926,dark,main,6,0.947889766429355,244,18,63,325
1926,dark,main,7,0.9229143994183453,223,20,62,305
1926,dark,main,8,0.947282232372256,267,25,85,377
1926,dark,main,9,0.9672345077252777,238,20,90,348
1927,dark,main,0,0.957994772677112,275,30,76,381
1927,dark,main,1,0.9464661992228649,235,28,80,343
1927,dark,main,2,0.9646214841405848,246,21,105,372
1927,dark,main,3,0.9627785767301498,261,21,75,357
1927,dark,main,4,0.952944189178385,210,32,71,313
1927,dark,main,5,0.9426208141772678,262,17,85,364
1927,dark,main,6,0.9663158754947699,237,21,62,320
1927,dark,main,7,0.9384433256929882,221,30,61,312
1927,dark,main,8,0.956640034266575,278,25,75,378
1927,dark,main,9,0.9553678768822393,255,26,87,368
1928,dark,main,0,0.9586070548247815,282,18,76,376
1928,dark,main,1,0.9602408884439748,236,16,99,351
1928,dark,main,2,0.9688346461732184,260,37,76,373
1928,dark,main,3,0.9728088985234601,264,22,74,360
1928,dark,main,4,0.9256509268392963,211,22,60,293
1928,dark,main,5,0.9700913965877307,242,20,87,349
1928,dark,main,6,0.958069275819067,209,21,82,312
1928,dark,main,7,0.9195142246772334,205,21,69,295
1928,dark,main,8,0.9620224208930971,264,27,83,374
1928,dark,main,9,0.9720011919854581,252,22,87,361
1929,dark,main,0,0.955387670281597,242,44,79,365
1929,dark,main,1,0.9669374719486968,217,40,87,344
1929,dark,main,2,0.9579529240950756,271,27,75,373
1929,dark,main,3,0.9520184996560259,240,43,73,356
1929,dark,main,4,0.9570831630976612,242,33,75,350
1929,dark,main,5,0.9679429095394673,247,35,77,359
1929,dark,main,6,0.9721363008787518,213,27,67,307
1929,dark,main,7,0.9324333724860269,220,23,66,309
1929,dark,main,8,0.9573223978247934,247,41,80,368
1929,dark,main,9,0.9533714966622318,237,30,79,346
1930,dark,main,0,0.9505132637215498,238,46,91,375
1930,dark,main,1,0.957383857893664,242,42,73,357
1930,dark,main,2,0.9614329464510728,257,37,79,373
1930,dark,main,3,0.9502126809770378,244,32,63,339
1930,dark,main,4,0.9502878202429877,217,44,94,355
1930,dark,main,5,0.9586642101612932,237,45,82,364
1930,dark,main,6,0.9507205049636199,216,50,58,324
1930,dark,main,7,0.948397572614921,215,42,64,321
1930,dark,main,8,0.9488129320978778,255,57,54,366
1930,dark,main,9,0.9475963329460043,253,45,73,371
1931,dark,main,0,0.9616696974038133,282,23,70,375
1931,dark,main,1,0.9577418795903622,256,30,70,356
1931,dark,main,2,0.9702325681845166,239,36,91,366
1931,dark,main,3,0.9618998292408447,234,38,83,355
1931,dark,main,4,0.9526791147067408,240,21,76,337
1931,dark,main,5,0.951218740967152,249,32,78,359
1931,dark,main,6,0.948636453290749,214,25,66,305
1931,dark,main,7,0.9342322489824475,234,22,58,314
1931,dark,main,8,0.9563008646585497,268,21,84,373
1931,dark,main,9,0.9563008646585497,268,21,84,373
2070,dark,main,0,0.9297238460249048,258,38,70,366
2070,dark,main,1,0.9566652219239276,246,34,71,351
2070,dark,main,2,0.9454620665513346,250,33,74,357
2070,dark,main,3,0.9743490413614381,229,26,85,340
2070,dark,main,4,0.9481165239808624,237,37,75,349
2070,dark,main,5,0.9558024266714396,239,22,93,354
2070,dark,main,6,0.961958884292017,214,27,75,316
2070,dark,main,7,0.9395129270526624,204,29,65,298
2070,dark,main,8,0.958682546914354,265,29,82,376
2070,dark,main,9,0.9619090464273338,247,35,69,351
2071,dark,main,0,0.9816607843277455,255,45,81,381
2071,dark,main,1,0.9267499491254821,237,34,67,338
2071,dark,main,2,0.9614978408513266,261,35,84,380
2071,dark,main,3,0.9583264209534156,251,36,62,349
2071,dark,main,4,0.9659257385707158,246,18,86,350
2071,dark,main,5,0.9473090962887649,230,28,98,356
2071,dark,main,6,0.9344419517870537,201,42,70,313
2071,dark,main,7,0.9476784741096315,211,31,61,303
2071,dark,main,8,0.9615369039461384,248,42,80,370
2071,dark,main,9,0.9522755340441026,252,36,76,364
2072,dark,main,0,0.9381731603253417,257,29,93,379
2072,dark,main,1,0.9644053224726626,228,24,73,325
2072,dark,main,2,0.9441659158177705,247,26,85,358
2072,dark,main,3,0.9300239836478109,241,30,71,342
2072,dark,main,4,0.9528235846967229,262,22,84,368
2072,dark,main,5,0.9542250801790424,255,19,81,355
2072,dark,main,6,0.9291011580603071,155,18,36,209
2072,dark,main,7,0.9194622708349416,206,36,63,305
2072,dark,main,8,0.969692648813804,267,34,68,369
2072,dark,main,9,0.9628303898387889,265,37,64,366
2075,dark,main,0,0.9555583920767006,282,23,81,386
2075,dark,main,1,0.948426249272723,239,26,78,343
2075,dark,main,2,0.966330561362537,275,24,78,377
2075,dark,main,3,0.948034472300619,235,23,79,337
2075,dark,main,4,0.9419987601032985,253,21,71,345
2075,dark,main,5,0.9595930542302401,267,23,76,366
2075,dark,main,6,0.9488334691171968,228,19,76,323
2075,dark,main,7,0.9620175218034448,219,17,77,313
2075,dark,main,8,0.957932221166096,268,36,72,376
2075,dark,main,9,0.9710274114055903,257,29,90,376
2156,dark,main,0,0.9518099184167761,281,12,93,386
2156,dark,main,1,0.9578604931001918,246,13,92,351
2156,dark,main,2,0.9651659844434461,292,15,84,391
2156,dark,main,3,0.9539277015858013,253,16,85,354
2156,dark,main,4,0.9379939980954304,259,12,88,359
2156,dark,main,5,0.966441770070369,254,10,79,343
2156,dark,main,6,0.9391203207424256,207,9,87,303
2156,dark,main,7,0.94978963478136,239,19,66,324
2156,dark,main,8,0.960420328043907,263,21,99,383
2156,dark,main,9,0.9634306358770136,280,16,94,390
2160,dark,main,0,0.9653300945973795,289,13,80,382
2160,dark,main,1,0.9375409050803732,232,14,84,330
2160,dark,main,2,0.9388541276265949,254,13,69,336
2160,dark,main,3,0.940468418118684,222,12,96,330
2160,dark,main,4,0.9587319290290949,256,12,88,356
2160,dark,main,5,0.9438155776526189,265,20,85,370
2160,dark,main,6,0.9362584053367864,238,14,76,328
2160,dark,main,7,0.9376431584166868,235,12,77,324
2160,dark,main,8,0.9627449067233292,306,12,78,396
2160,dark,main,9,0.9635564260938593,257,17,92,366
2161,dark,main,0,0.9629714929119721,280,13,93,386
2161,dark,main,1,0.9545380950412157,255,12,84,351
2161,dark,main,2,0.9638867979152567,260,14,95,369
2161,dark,main,3,0.9648458319518517,261,15,91,367
2161,dark,main,4,0.9564231690537791,251,14,93,358
2161,dark,main,5,0.9428162967175935,248,14,100,362
2161,dark,main,6,0.9561731122632583,240,13,71,324
2161,dark,main,7,0.9479994692823858,234,15,80,329
2161,dark,main,8,0.943490698847892,271,17,90,378
2161,dark,main,9,0.943724904091463,271,13,94,378
2162,dark,main,0,0.9742172843186038,310,11,70,391
2162,dark,main,1,0.9286307045186548,244,16,93,353
2162,dark,main,2,0.9637553835917698,277,12,97,386
2162,dark,main,3,0.9529458940144293,252,18,88,358
2162,dark,main,4,0.9565306795483438,257,10,86,353
2162,dark,main,5,0.9638543881973777,277,13,74,364
2162,dark,main,6,0.9391484159508457,230,13,86,329
2162,dark,main,7,0.9246064370977152,224,14,78,316
2162,dark,main,8,0.9720041649815269,277,12,82,371
2162,dark,main,9,0.9707502867625137,286,13,94,393
2163,dark,main,0,0.9615836604333415,301,13,81,395
2163,dark,main,1,0.9641052654451268,251,13,96,360
2163,dark,main,2,0.9641428374477053,275,16,103,394
2163,dark,main,3,0.9310509892784921,263,15,72,350
2163,dark,main,4,0.9356598327849532,270,13,85,368
2163,dark,main,5,0.9686915132400803,278,13,100,391
2163,dark,main,6,0.9545206917235834,224,12,88,324
2163,dark,main,7,0.9811870338997181,227,22,79,328
2163,dark,main,8,0.9558836605015789,278,13,87,378
2163,dark,main,9,0.9482938523590945,284,12,89,385
2172,dark,main,0,0.963784546253231,292,14,92,398
2172,dark,main,1,0.9704525217954769,260,14,92,366
2172,dark,main,2,0.9694815517980852,274,21,97,392
2172,dark,main,3,0.9704309647285901,266,15,72,353
2172,dark,main,4,0.9646214841405847,274,15,85,374
2172,dark,main,5,0.9610398140136653,264,12,91,367
2172,dark,main,6,0.961853174582306,230,14,71,315
2172,dark,main,7,0.9619608282580856,224,14,83,321
2172,dark,main,8,0.9644657927166708,276,15,79,370
2172,dark,main,9,0.9580206107806788,283,11,97,391
2173,dark,main,0,0.9465055386101553,303,12,81,396
2173,dark,main,1,0.9680377879528161,269,16,70,355
2173,dark,main,2,0.9405541207882752,282,16,82,380
2173,dark,main,3,0.9455418479641781,260,14,85,359
2173,dark,main,4,0.959131674793893,270,14,86,370
2173,dark,main,5,0.9639377480938999,264,13,78,355
2173,dark,main,6,0.9590938018376116,223,12,88,323
2173,dark,main,7,0.9439337357903802,241,13,76,330
2173,dark,main,8,0.9637572980944398,280,13,79,372
2173,dark,main,9,0.9677321575002455,299,13,88,400
2175,dark,main,0,0.959160743229125,287,15,90,392
2175,dark,main,1,0.975490759408215,252,13,92,357
2175,dark,main,2,0.9706694843420782,268,12,119,399
2175,dark,main,3,0.9639390463569681,272,12,80,364
2175,dark,main,4,0.9611565235557049,266,14,83,363
2175,dark,main,5,0.9646249040158796,294,17,69,380
2175,dark,main,6,0.9662424178562313,254,15,74,343
2175,dark,main,7,0.9338328165007937,260,11,64,335
2175,dark,main,8,0.9632908457321113,247,16,105,368
2175,dark,main,9,0.9668653290989335,274,11,104,389
2181,dark,main,0,0.9694365519865887,292,19,92,403
2181,dark,main,1,0.9756076364212343,261,14,80,355
2181,dark,main,2,0.9655159718231557,287,14,95,396
2181,dark,main,3,0.9628898398110726,257,11,78,346
2181,dark,main,4,0.961083729745313,279,12,60,351
2181,dark,main,5,0.9572796500136586,263,20,83,366
2181,dark,main,6,0.9305381305773737,238,13,75,326
2181,dark,main,7,0.953570532519604,231,14,82,327
2181,dark,main,8,0.9574630404802332,278,12,84,374
2181,dark,main,9,0.9784549929554988,281,15,77,373
2184,dark,main,0,0.9558545001753875,287,13,81,381
2184,dark,main,1,0.9467007268444405,234,14,99,347
2184,dark,main,2,0.9627631158068519,294,16,75,385
2184,dark,main,3,0.951381489396453,235,16,91,342
2184,dark,main,4,0.9681524098007755,259,14,87,360
2184,dark,main,5,0.9608505094879323,271,18,81,370
2184,dark,main,6,0.9282329123752755,185,7,53,245
2184,dark,main,7,0.9492582746009973,202,14,76,292
2184,dark,main,8,0.9526285578129364,228,11,89,328
2184,dark,main,9,0.9689819665479352,264,13,89,366
2187,dark,main,0,0.9704472283456279,279,12,105,396
2187,dark,main,1,0.9478892814507971,240,15,86,341
2187,dark,main,2,0.9682377405806614,276,13,99,388
2187,dark,main,3,0.9709748469579875,249,14,87,350
2187,dark,main,4,0.938349368943924,272,12,84,368
2187,dark,main,5,0.9641926459208382,269,12,99,380
2187,dark,main,6,0.9549863516223761,229,18,60,307
2187,dark,main,7,0.9386559543578686,235,13,72,320
2187,dark,main,8,0.9628606365238169,286,15,80,381
2187,dark,main,9,0.9679849495366912,267,11,107,385
2195,dark,main,0,0.9533335039362085,268,13,98,379
2195,dark,main,1,0.9402161758620741,249,13,95,357
2195,dark,main,2,0.96088982073287,292,15,72,379
2195,dark,main,3,0.967335330365056,250,16,73,339
2195,dark,main,4,0.983286121636646,255,12,90,357
2195,dark,main,5,0.9708675957983632,284,19,68,371
2195,dark,main,6,0.9535705325196042,245,11,71,327
2195,dark,main,7,0.9443912435062767,228,13,74,315
2195,dark,main,8,0.960592105873212,278,14,91,383
2195,dark,main,9,0.958971580568402,287,16,84,387
2196,dark,main,0,0.961151755037298,311,13,74,398
2196,dark,main,1,0.954939430955943,264,16,74,354
2196,dark,main,2,0.9569172598696923,280,13,90,383
2196,dark,main,3,0.9685629874521683,271,13,76,360
2196,dark,main,4,0.9581685414423846,275,14,74,363
2196,dark,main,5,0.9595930542302399,259,16,89,364
2196,dark,main,6,0.9469362048024347,239,13,69,321
2196,dark,main,7,0.9517841935912675,224,11,93,328
2196,dark,main,8,0.9629814688522627,306,16,69,391
2196,dark,main,9,0.9614289691060562,278,18,82,378
2197,dark,main,0,0.9605474835758696,287,16,94,397
2197,dark,main,1,0.9402106487131761,242,17,86,345
2197,dark,main,2,0.9613368843096282,260,18,100,378
2197,dark,main,3,0.9715811147298279,255,14,88,357
2197,dark,main,4,0.9629538522197901,247,18,99,364
2197,dark,main,5,0.944186879416961,256,17,103,376
2197,dark,main,6,0.9286378121694153,236,13,77,326
2197,dark,main,7,0.946001519841005,245,15,76,336
2197,dark,main,8,0.9573345505414165,276,15,93,384
2197,dark,main,9,0.9425182319596878,275,13,88,376
2202,dark,main,0,0.9566838676092783,291,12,83,386
2202,dark,main,1,0.9683971411227092,257,10,93,360
2202,dark,main,2,0.9808348740252594,279,17,94,390
2202,dark,main,3,0.9580659981657054,228,17,115,360
2202,dark,main,4,0.9440399533272628,266,13,84,363
2202,dark,main,5,0.9615704979296347,257,16,102,375
2202,dark,main,6,0.9420739449660384,231,13,76,320
2202,dark,main,7,0.9483856757712937,226,14,70,310
2202,dark,main,8,0.9365258217187122,301,9,64,374
2202,dark,main,9,0.9441331579939656,284,16,80,380
2203,dark,main,0,0.9354873184744723,281,14,82,377
2203,dark,main,1,0.9611314340659295,255,16,83,354
2203,dark,main,2,0.9719787181022967,269,18,86,373
2203,dark,main,3,0.9648680362230597,253,17,71,341
2203,dark,main,4,0.9511949615194002,260,20,82,362
2203,dark,main,5,0.959620661701848,271,17,91,379
2203,dark,main,6,0.9640645794639362,223,38,52,313
2203,dark,main,7,0.9251996026730408,218,19,87,324
2203,dark,main,8,0.9683808029851698,277,14,85,376
2203,dark,main,9,0.9627684788782157,271,17,91,379
2204,dark,main,0,0.9582350645723221,294,12,94,400
2204,dark,main,1,0.9598593543738352,273,9,79,361
2204,dark,main,2,0.9717029005930702,275,16,79,370
2204,dark,main,3,0.9404411284187376,267,15,77,359
2204,dark,main,4,0.9673945985864244,261,14,90,365
2204,dark,main,5,0.9456992107490484,290,11,88,389
2204,dark,main,6,0.9547913276892717,258,16,62,336
2204,dark,main,7,0.9317318665284028,231,18,70,319
2204,dark,main,8,0.9656960501208216,282,12,88,382
2204,dark,main,9,0.9839443475865428,297,14,83,394
2220,dark,main,0,0.9292393513186671,277,14,96,387
2220,dark,main,1,0.9434233787387214,261,17,81,359
2220,dark,main,2,0.9550125862154739,295,18,80,393
2220,dark,main,3,0.960070256031441,217,12,70,299
2220,dark,main,4,0.9606601075046929,263,12,82,357
2220,dark,main,5,0.9622483567207949,301,14,73,388
2220,dark,main,6,0.9453070748879157,229,14,79,322
2220,dark,main,7,0.9575767017462518,229,13,73,315
2220,dark,main,8,0.9647794870703998,275,17,85,377
2220,dark,main,9,0.9743258454338208,280,19,83,382
2677,dark,main,0,0.9407459093321543,244,13,58,315
2677,dark,main,1,0.9471089447046296,200,14,43,257
2677,dark,main,2,0.9362862996125269,249,15,68,332
2677,dark,main,3,0.9587382572901556,253,15,84,352
2677,dark,main,4,0.9433883453219966,272,20,61,353
2677,dark,main,5,0.9689260165294404,281,15,68,364
2677,dark,main,6,0.9516092109815185,242,14,57,313
2677,dark,main,7,0.9490048146559151,244,13,53,310
2677,dark,main,8,0.9619141101903889,247,11,60,318
2677,dark,main,9,0.9759804337556925,217,10,80,307
2782,dark,main,0,0.9483926038544138,249,18,37,304
2782,dark,main,1,0.9590289856709157,241,14,42,297
2782,dark,main,2,0.9670203138438068,253,19,70,342
2782,dark,main,3,0.9597446901766575,258,12,55,325
2782,dark,main,4,0.9718651019482556,301,16,52,369
2782,dark,main,5,0.9707402296248496,293,13,67,373
2782,dark,main,6,0.9192577742945635,248,17,62,327
2782,dark,main,7,0.9426002349994377,240,21,62,323
2782,dark,main,8,0.952302874636638,301,22,52,375
2782,dark,main,9,0.939119408009632,286,20,61,367
2968,dark,main,0,0.9340127571710388,254,52,63,369
2968,dark,main,1,0.9530101311373383,242,37,51,330
2968,dark,main,2,0.9534009363096297,279,31,57,367
2968,dark,main,3,0.9665812821990083,246,60,46,352
2968,dark,main,4,0.9356745034416528,268,34,54,356
2968,dark,main,5,0.9667588098151262,272,41,68,381
2968,dark,main,6,0.9729152131139323,240,36,45,321
2968,dark,main,7,0.957572558229001,257,34,36,327
2968,dark,main,8,0.9633461809152385,256,52,60,368
2968,dark,main,9,0.9556635056422151,254,33,69,356
2969,dark,main,0,0.9571920574398292,308,18,62,388
2969,dark,main,1,0.968226101985443,250,25,65,340
2969,dark,main,2,0.9589137103429255,303,27,59,389
2969,dark,main,3,0.9669357337682198,269,15,73,357
2969,dark,main,4,0.9494547102430944,261,29,75,365
2969,dark,main,5,0.9374581303521863,313,20,54,387
2969,dark,main,6,0.929472875858549,261,23,39,323
2969,dark,main,7,0.9465728238970544,247,25,61,333
2969,dark,main,8,0.9765154926628881,285,16,59,360
2969,dark,main,9,0.9570167471021952,294,19,63,376
2977,dark,main,0,0.9736742240189648,308,26,49,383
2977,dark,main,1,0.9646734607242667,300,18,41,359
2977,dark,main,2,0.9691755657892851,257,41,70,368
2977,dark,main,3,0.9630867929842807,243,42,66,351
2977,dark,main,4,0.9591936882197833,258,32,76,366
2977,dark,main,5,0.9549116122193264,290,31,61,382
2977,dark,main,6,0.9513185673752196,234,28,52,314
2977,dark,main,7,0.930986482334784,227,42,52,321
2977,dark,main,8,0.9769916684670986,302,23,43,368
2977,dark,main,9,0.9333756360335836,277,43,53,373
2986,dark,main,0,0.9702428684236604,284,33,60,377
2986,dark,main,1,0.9204504938342156,232,34,70,336
2986,dark,main,2,0.9482251147139228,277,39,70,386
2986,dark,main,3,0.9507483926036457,256,29,68,353
2986,dark,main,4,0.9557281632788901,264,40,70,374
2986,dark,main,5,0.9451444309762862,291,20,61,372
2986,dark,main,6,0.9387077372687531,248,35,39,322
2986,dark,main,7,0.9681149047666027,232,41,57,330
2986,dark,main,8,0.9269509310647303,268,42,50,360
2986,dark,main,9,0.9583264209534158,251,42,56,349
2988,dark,main,0,0.9662916119896692,333,17,47,397
2988,dark,main,1,0.9640894041279239,260,14,51,325
2988,dark,main,2,0.9653736142778039,279,30,71,380
2988,dark,main,3,0.9707538770915844,294,20,46,360
2988,dark,main,4,0.956472800218866,259,19,76,354
2988,dark,main,5,0.9600942241973711,267,21,79,367
2988,dark,main,6,0.9322881193681383,245,19,58,322
2988,dark,main,7,0.9434744174165485,266,23,50,339
2988,dark,main,8,0.9662550692729646,294,22,61,377
2988,dark,main,9,0.9704835088288757,285,25,66,376
2996,dark,main,0,0.9711159583650202,219,77,70,366
2996,dark,main,1,0.9313299013783347,252,37,57,346
2996,dark,main,2,0.801155884903606,83,10,11,104
2996,dark,main,3,0.9724442854783577,264,41,55,360
2996,dark,main,4,0.9738673149021244,250,38,71,359
2996,dark,main,5,0.9707813560409542,271,34,54,359
2996,dark,main,6,0.9423856177586953,212,48,49,309
2996,dark,main,7,0.8911490641354698,224,47,43,314
2996,dark,main,8,0.9670804006780617,239,45,66,350
2996,dark,main,9,0.9672659992418947,209,73,87,369
2997,dark,main,0,0.9613402520859478,238,51,84,373
2997,dark,main,1,0.9424371591297166,214,52,61,327
2997,dark,main,2,0.9552737682441319,279,27,63,369
2997,dark,main,3,0.9744674775599099,246,50,52,348
2997,dark,main,4,0.9541380971435002,242,52,54,348
2997,dark,main,5,0.966223589929783,241,59,63,363
2997,dark,main,6,0.9663436581235154,194,58,59,311
2997,dark,main,7,0.9391627112047165,198,57,65,320
2997,dark,main,8,0.9692791555503407,199,80,79,358
2997,dark,main,9,0.9497386911377821,206,62,88,356
3393,dark,main,0,0.9563179275722411,293,34,54,381
3393,dark,main,1,0.9506390291183549,232,47,50,329
3393,dark,main,2,0.9781704720857652,224,54,74,352
3393,dark,main,3,0.9511284970772588,216,51,72,339
3393,dark,main,4,0.9618468475340493,194,61,72,327
3393,dark,main,5,0.9516294237355544,214,56,68,338
3393,dark,main,6,0.9434694612380454,196,43,73,312
3393,dark,main,7,0.9533929102267251,230,31,61,322
3393,dark,main,8,0.9767602239848219,269,34,60,363
3393,dark,main,9,0.9540797472716585,280,34,44,358
3440,dark,main,0,0.9819684670576482,272,44,67,383
3440,dark,main,1,0.9786643077785392,272,31,50,353
3440,dark,main,2,0.9516237164900728,277,41,60,378
3440,dark,main,3,0.9565268775949659,254,49,55,358
3440,dark,main,4,0.9731205807924097,253,29,51,333
3440,dark,main,5,0.9532464699728039,258,26,70,354
3440,dark,main,6,0.9531841895286471,210,40,74,324
3440,dark,main,7,0.9531817048631269,219,31,64,314
3440,dark,main,8,0.981003179236755,239,52,90,381
3440,dark,main,9,0.9656538903313224,238,61,61,360
20000,bright,main,0,0.9723517124655785,334,108,4,446
20000,bright,main,1,0.9742824582610217,296,104,4,404
20000,bright,main,2,0.9645016078470723,326,103,4,433
20000,bright,main,3,0.9530968457844707,308,83,4,395
20000,bright,main,4,0.976005203212126,300,106,3,409
20000,bright,main,5,0.9551130288382892,306,113,3,422
20000,bright,main,6,0.9818966633071131,264,103,7,374
20000,bright,main,7,0.9426767641957626,262,101,1,364
20000,bright,main,8,0.9747665951931928,325,98,4,427
20000,bright,main,9,0.9480586303382843,281,138,4,423
20001,bright,main,0,0.9718319645351937,374,57,2,433
20001,bright,main,1,0.9445861425974456,326,72,2,400
20001,bright,main,2,0.9681100544801657,339,91,4,434
20001,bright,main,3,0.9590476884910085,322,75,3,400
20001,bright,main,4,0.9778357631294389,305,88,5,398
20001,bright,main,5,0.9758532647834581,322,93,3,418
20001,bright,main,6,0.946492508190425,304,59,0,363
20001,bright,main,7,0.9627502287320929,275,88,5,368
20001,bright,main,8,0.9756321477289056,336,84,1,421
20001,bright,main,9,0.9756321477289056,336,84,1,421
20004,bright,main,0,0.9681128179348154,341,81,2,424
20004,bright,main,1,0.9347194377412598,301,69,3,373
20004,bright,main,2,0.9677157494414054,328,84,2,414
20004,bright,main,3,0.9719534762073264,304,66,11,381
20004,bright,main,4,0.9613925012751858,309,73,2,384
20004,bright,main,5,0.9323752065393316,330,67,6,403
20004,bright,main,6,0.9473766056216333,282,66,4,352
20004,bright,main,7,0.958503362356009,274,68,3,345
20004,bright,main,8,0.9545010787741964,350,58,1,409
20004,bright,main,9,0.9082949771476875,319,89,4,412
20005,bright,main,0,0.9743037601744423,335,87,3,425
20005,bright,main,1,0.9516518406047139,332,55,4,391
20005,bright,main,2,0.9644804821905002,346,69,2,417
20005,bright,main,3,0.9695071840512821,319,59,2,380
20005,bright,main,4,0.9766713314693876,313,71,2,386
20005,bright,main,5,0.9608468469280222,339,67,3,409
20005,bright,main,6,0.9644525400437396,289,71,3,363
20005,bright,main,7,0.9572010530957701,296,57,1,354
20005,bright,main,8,0.9688246749528663,314,84,1,399
20005,bright,main,9,0.9528564006674072,351,70,2,423
20007,bright,main,0,0.9638067130971475,294,104,8,406
20007,bright,main,1,0.9666971299744057,320,66,2,388
20007,bright,main,2,0.962580461590933,336,71,0,407
20007,bright,main,3,0.9549551318997508,314,65,3,382
20007,bright,main,4,0.9640646598200054,317,76,2,395
20007,bright,main,5,0.9788692958222698,324,68,5,397
20007,bright,main,6,0.937849536740738,298,51,3,352
20007,bright,main,7,0.9459891778493262,287,48,5,340
20007,bright,main,8,0.974123017236384,341,66,6,413
20007,bright,main,9,0.9448414301487498,308,93,1,402
20010,bright,main,0,0.9638399680911983,361,77,5,443
20010,bright,main,1,0.9649783862928898,313,75,5,393
20010,bright,main,2,0.9523536509121601,318,106,4,428
20010,bright,main,3,0.9552242484924821,332,63,5,400
20010,bright,main,4,0.9647981592184169,343,60,4,407
20010,bright,main,5,0.9733665569708105,346,72,4,422
20010,bright,main,6,0.9463664464319037,309,57,3,369
20010,bright,main,7,0.9539064403243768,257,96,6,359
20010,bright,main,8,0.9708124290539111,324,87,7,418
20010,bright,main,9,0.9742315389374244,352,65,7,424
20030,bright,main,0,0.9747297657710392,366,70,2,438
20030,bright,main,1,0.9533813301549314,322,64,2,388
20030,bright,main,2,0.9611352915138693,361,71,3,435
20030,bright,main,3,0.9594576695382215,287,101,5,393
20030,bright,main,4,0.9656555347981738,321,80,4,405
20030,bright,main,5,0.9672887794475411,304,106,6,416
20030,bright,main,6,0.952573496147621,288,77,1,366
20030,bright,main,7,0.9642817752882358,259,108,2,369
20030,bright,main,8,0.9629401630818064,335,89,3,427
20030,bright,main,9,0.9804757951505866,366,56,4,426
20031,bright,main,0,0.9739355586638669,329,109,3,441
20031,bright,main,1,0.9595157517206695,280,112,3,395
20031,bright,main,2,0.9538536877169449,301,130,7,438
20031,bright,main,3,0.9759893585452802,256,137,4,397
20031,bright,main,4,0.9525995019074869,309,96,3,408
20031,bright,main,5,0.9711806640403847,287,125,6,418
20031,bright,main,6,0.9665283542030048,260,102,3,365
20031,bright,main,7,0.9549883042711406,281,81,2,364
20031,bright,main,8,0.9558439469167784,339,83,4,426
20031,bright,main,9,0.961002248272061,308,114,4,426
20032,bright,main,0,0.9508287605591387,343,91,4,438
20032,bright,main,1,0.9733104919567139,332,67,2,401
20032,bright,main,2,0.9675712821903877,326,110,3,439
20032,bright,main,3,0.973202719498512,287,110,5,402
20032,bright,main,4,0.9570149155128503,317,96,5,418
20032,bright,main,5,0.9450601016035715,314,110,4,428
20032,bright,main,6,0.9559265622272475,293,78,1,372
20032,bright,main,7,0.9657901650713216,270,101,4,375
20032,bright,main,8,0.9551742116586932,331,91,6,428
20032,bright,main,9,0.9822945477384264,310,116,6,432
20033,bright,main,0,0.9526559833494164,357,87,6,450
20033,bright,main,1,0.9584998940600367,304,97,2,403
20033,bright,main,2,0.9591579079121653,343,97,2,442
20033,bright,main,3,0.9576948268723081,278,123,3,404
20033,bright,main,4,0.967929289516426,295,113,4,412
20033,bright,main,5,0.937987252670352,336,91,6,433
20033,bright,main,6,0.9843823884987407,273,83,6,362
20033,bright,main,7,0.9603619569615792,275,90,6,371
20033,bright,main,8,0.9670195960668331,326,90,6,422
20033,bright,main,9,0.9681902671924028,361,75,2,438
20040,bright,main,0,0.9693468884409807,337,96,7,440
20040,bright,main,1,0.9441648345579968,327,68,4,399
20040,bright,main,2,0.9566137185923027,367,63,6,436
20040,bright,main,3,0.9678361012566052,312,79,4,395
20040,bright,main,4,0.9491027189042941,321,84,4,409
20040,bright,main,5,0.9420818926246713,366,54,3,423
20040,bright,main,6,0.9598350663152633,302,60,4,366
20040,bright,main,7,0.9368347797695126,281,82,5,368
20040,bright,main,8,0.9559108113389713,346,73,6,425
20040,bright,main,9,0.9634143975297549,315,104,7,426
20067,bright,main,0,0.980476512189054,355,79,4,438
20067,bright,main,1,0.9606753001729321,304,97,6,407
20067,bright,main,2,0.9542866221675952,351,84,1,436
20067,bright,main,3,0.9596981253051253,298,92,5,395
20067,bright,main,4,0.9670776621351543,332,81,6,419
20067,bright,main,5,0.9776283719207528,356,65,4,425
20067,bright,main,6,0.9359994749748056,291,73,4,368
20067,bright,main,7,0.9679107115399119,294,78,4,376
20067,bright,main,8,0.9630492078066633,314,101,6,421
20067,bright,main,9,0.978550744989951,331,88,7,426
20068,bright,main,0,0.9666149389082582,358,77,6,441
20068,bright,main,1,0.9546119460835196,321,78,4,403
20068,bright,main,2,0.9714441423355827,365,73,3,441
20068,bright,main,3,0.9452044740878983,306,87,3,396
20068,bright,main,4,0.9679236560726558,312,92,4,408
20068,bright,main,5,0.9713562117612066,350,70,5,425
20068,bright,main,6,0.9610010097922544,276,88,3,367
20068,bright,main,7,0.9740486822030184,256,107,4,367
20068,bright,main,8,0.9686826238004098,318,104,5,427
20068,bright,main,9,0.9722664700461713,370,59,4,433
20069,bright,main,0,0.9757326754835401,321,122,2,445
20069,bright,main,1,0.9778200169892596,293,101,3,397
20069,bright,main,2,0.9574288389426439,327,106,4,437
20069,bright,main,3,0.9826164041078103,302,94,2,398
20069,bright,main,4,0.9530523959470837,321,89,2,412
20069,bright,main,5,0.9607411524687317,338,85,2,425
20069,bright,main,6,0.9551848624677207,290,71,6,367
20069,bright,main,7,0.9608018887297218,301,64,5,370
20069,bright,main,8,0.9656214204537391,365,62,4,431
20069,bright,main,9,0.9668742633806306,327,104,3,434
20076,bright,main,0,0.95791131748389,340,97,6,443
20076,bright,main,1,0.9417221333050986,327,78,2,407
20076,bright,main,2,0.940649784651964,353,68,2,423
20076,bright,main,3,0.970610292141192,313,88,4,405
20076,bright,main,4,0.9539273222268598,284,121,8,413
20076,bright,main,5,0.9749024791603578,301,109,4,414
20076,bright,main,6,0.9724994319327964,261,103,5,369
20076,bright,main,7,0.961581858341302,285,79,5,369
20076,bright,main,8,0.9667637037450961,302,123,6,431
20076,bright,main,9,0.9716027949141146,295,136,2,433
20077,bright,main,0,0.9579251394938558,362,68,2,432
20077,bright,main,1,0.9535319443098339,305,91,4,400
20077,bright,main,2,0.975234787026768,340,84,0,424
20077,bright,main,3,0.9648544989353914,304,99,3,406
20077,bright,main,4,0.9666675124257692,314,99,0,413
20077,bright,main,5,0.9608904594936658,342,73,5,420
20077,bright,main,6,0.9536854197017001,298,71,5,374
20077,bright,main,7,0.9766107481716555,283,81,3,367
20077,bright,main,8,0.9695314534801089,315,108,6,429
20077,bright,main,9,0.9615593958096482,332,95,2,429
20079,bright,main,0,0.9386179319156533,269,82,4,355
20079,bright,main,1,0.9753576447172996,278,117,10,405
20079,bright,main,2,0.9743574170477514,328,93,5,426
20079,bright,main,3,0.9564592542753927,299,100,5,404
20079,bright,main,4,0.9393215186111771,268,137,3,408
20079,bright,main,5,0.9611167269531897,301,122,1,424
20079,bright,main,6,0.9302764212179419,297,74,2,373
20079,bright,main,7,0.9303758556531645,209,77,3,289
20079,bright,main,8,0.9793558937319498,339,83,3,425
20079,bright,main,9,0.9784456187617807,328,98,4,430
20080,bright,main,0,0.9794398855477631,292,142,5,439
20080,bright,main,1,0.9575689864613195,313,85,4,402
20080,bright,main,2,0.9627051631051761,307,110,9,426
20080,bright,main,3,0.961794584061376,271,114,3,388
20080,bright,main,4,0.9548611884829762,282,117,2,401
20080,bright,main,5,0.954975559242496,304,109,1,414
20080,bright,main,6,0.945906822107593,258,101,4,363
20080,bright,main,7,0.9557173663753209,262,104,2,368
20080,bright,main,8,0.9709503030343475,324,94,4,422
20080,bright,main,9,0.9486871610344032,332,99,2,433
20081,bright,main,0,0.9659946324136696,356,81,2,439
20081,bright,main,1,0.9684518034123153,345,46,7,398
20081,bright,main,2,0.9539125440651882,355,70,6,431
20081,bright,main,3,0.9584963166410791,320,65,3,388
20081,bright,main,4,0.9806440845527028,336,61,3,400
20081,bright,main,5,0.958526354441696,327,84,3,414
20081,bright,main,6,0.9530076021251578,275,87,7,369
20081,bright,main,7,0.9256637642424066,272,83,4,359
20081,bright,main,8,0.947337925739372,316,99,4,419
20081,bright,main,9,0.947337925739372,316,99,4,419
20082,bright,main,0,0.9664174820673589,330,105,1,436
20082,bright,main,1,0.921163669647999,320,68,1,389
20082,bright,main,2,0.9624920244605569,341,80,5,426
20082,bright,main,3,0.9554870970939313,316,78,2,396
20082,bright,main,4,0.9674788792169768,342,62,2,406
20082,bright,main,5,0.9487559632335664,363,51,3,417
20082,bright,main,6,0.9261993986524393,274,86,2,362
20082,bright,main,7,0.9716599322641636,278,74,1,353
20082,bright,main,8,0.9583955247334569,324,96,4,424
20082,bright,main,9,0.9583955247334569,324,96,4,424
20083,bright,main,0,0.9662484755557954,314,113,9,436
20083,bright,main,1,0.9633231970740422,300,92,2,394
20083,bright,main,2,0.9558439469167784,336,83,5,424
20083,bright,main,3,0.9748501002710844,307,84,3,394
20083,bright,main,4,0.9614891180340484,305,84,9,398
20083,bright,main,5,0.9752928373213884,348,59,9,416
20083,bright,main,6,0.9677093163078756,306,55,1,362
20083,bright,main,7,0.9493477841013785,301,54,2,357
20083,bright,main,8,0.9768027193851133,363,52,1,416
20083,bright,main,9,0.9605510545726803,335,90,3,428
20084,bright,main,0,0.9475583349192361,329,103,1,433
20084,bright,main,1,0.9636493094566942,304,91,2,397
20084,bright,main,2,0.9433664910198787,342,82,3,427
20084,bright,main,3,0.9550599949909845,300,86,2,388
20084,bright,main,4,0.9650345239370366,340,66,2,408
20084,bright,main,5,0.9510708496310815,323,86,6,415
20084,bright,main,6,0.9499396503213544,306,60,2,368
20084,bright,main,7,0.947452490965486,299,55,4,358
20084,bright,main,8,0.9717957902567987,358,56,5,419
20084,bright,main,9,0.9617794355208715,347,78,5,430
20085,bright,main,0,0.9700391421729657,333,103,2,438
20085,bright,main,1,0.9350249838145731,309,85,5,399
20085,bright,main,2,0.9616401871876464,335,92,4,431
20085,bright,main,3,0.9256076947450066,292,101,2,395
20085,bright,main,4,0.9601269989859409,313,91,0,404
20085,bright,main,5,0.946655349304067,304,100,2,406
20085,bright,main,6,0.9489147360545525,278,81,5,364
20085,bright,main,7,0.9659155555550686,265,94,1,360
20085,bright,main,8,0.948572406634097,341,83,1,425
20085,bright,main,9,0.9612195055598142,355,83,0,438
20086,bright,main,0,0.9699702789978445,371,61,1,433
20086,bright,main,1,0.9761045384042468,354,39,2,395
20086,bright,main,2,0.9634476582909642,336,86,4,426
20086,bright,main,3,0.9648277182491704,333,63,2,398
20086,bright,main,4,0.9598282153211195,318,70,5,393
20086,bright,main,5,0.959351041105376,354,59,3,416
20086,bright,main,6,0.9536596941420009,296,68,1,365
20086,bright,main,7,0.9639935787255464,308,48,3,359
20086,bright,main,8,0.9518735322734881,370,50,2,422
20086,bright,main,9,0.9518735322734881,370,50,2,422
20087,bright,main,0,0.960495763416379,354,72,6,432
20087,bright,main,1,0.9407019587086849,301,85,6,392
20087,bright,main,2,0.9698341248449672,320,96,4,420
20087,bright,main,3,0.974291011109577,324,63,5,392
20087,bright,main,4,0.9736226883130428,325,74,2,401
20087,bright,main,5,0.9742497681604846,330,73,6,409
20087,bright,main,6,0.9488692821661091,327,36,2,365
20087,bright,main,7,0.946358590455629,298,56,5,359
20087,bright,main,8,0.9432374950088568,336,79,4,419
20087,bright,main,9,0.9728115182343374,355,62,5,422
20088,bright,main,0,0.9658601890580348,307,116,5,428
20088,bright,main,1,0.967447584207929,257,120,4,381
20088,bright,main,2,0.9730395066957706,327,90,2,419
20088,bright,main,3,0.9535780715899108,314,72,4,390
20088,bright,main,4,0.9625785450390494,295,99,4,398
20088,bright,main,5,0.9588043908245806,329,80,3,412
20088,bright,main,6,0.9784722827725685,273,90,4,367
20088,bright,main,7,0.9454016420381715,275,74,2,351
20088,bright,main,8,0.950864542726092,311,105,4,420
20088,bright,main,9,0.9598374991957309,263,146,4,413
20089,bright,main,0,0.9735303735818914,238,81,2,321
20089,bright,main,1,0.9329149614428561,287,79,2,368
20089,bright,main,2,0.9530792060151055,352,72,4,428
20089,bright,main,3,0.9357646200586046,323,68,5,396
20089,bright,main,4,0.9685765611992879,325,73,2,400
20089,bright,main,5,0.9564894944338052,348,74,3,425
20089,bright,main,6,0.9649998331229208,301,66,1,368
20089,bright,main,7,0.9794808723241264,303,59,5,367
20089,bright,main,8,0.9562163403354033,325,88,1,414
20089,bright,main,9,0.9616787801117963,337,88,4,429
20090,bright,main,0,0.9631995088115713,354,80,5,439
20090,bright,main,1,0.9580065609893373,320,73,2,395
20090,bright,main,2,0.9687339004809592,361,66,2,429
20090,bright,main,3,0.9706717379546461,317,71,4,392
20090,bright,main,4,0.9638611295789831,215,52,3,270
20090,bright,main,5,0.9599111453642993,339,78,4,421
20090,bright,main,6,0.9212183238877131,287,79,1,367
20090,bright,main,7,0.9774018115512985,275,82,1,358
20090,bright,main,8,0.9718173663959564,337,78,5,420
20090,bright,main,9,0.9449048930469113,363,66,4,433
20091,bright,main,0,0.9592105911560952,379,60,1,440
20091,bright,main,1,0.9655781991047216,348,50,3,401
20091,bright,main,2,0.9604646172509755,356,74,1,431
20091,bright,main,3,0.9383850696143301,304,91,2,397
20091,bright,main,4,0.9538304525845257,330,72,2,404
20091,bright,main,5,0.9566585491299305,335,72,6,413
20091,bright,main,6,0.962215685798033,271,85,6,362
20091,bright,main,7,0.975859515783375,275,80,4,359
20091,bright,main,8,0.9644405442382321,354,68,6,428
20091,bright,main,9,0.9684464778749364,362,64,0,426
20092,bright,main,0,0.9632728591136468,354,84,2,440
20092,bright,main,1,0.9800890805890689,294,102,2,398
20092,bright,main,2,0.9622895800450362,323,101,7,431
20092,bright,main,3,0.948876309757106,288,104,2,394
20092,bright,main,4,0.9504045411985385,306,93,2,401
20092,bright,main,5,0.9692746732893527,313,98,3,414
20092,bright,main,6,0.9364807188609506,295,63,10,368
20092,bright,main,7,0.9377084623656149,293,74,1,368
20092,bright,main,8,0.9673613260661257,339,83,2,424
20092,bright,main,9,0.9651668494233748,241,82,0,323
20093,bright,main,0,0.9463220481861042,306,78,2,386
20093,bright,main,1,0.9772519811754159,300,79,3,382
20093,bright,main,2,0.9681447556407492,349,81,1,431
20093,bright,main,3,0.9733628021524845,296,100,2,398
20093,bright,main,4,0.9720457557615622,260,139,3,402
20093,bright,main,5,0.9720268986104673,322,84,2,408
20093,bright,main,6,0.9214774817698204,275,89,3,367
20093,bright,main,7,0.9630131828166151,298,59,3,360
20093,bright,main,8,0.9527686472864029,336,82,5,423
20093,bright,main,9,0.9547413761547872,310,100,4,414
20094,bright,main,0,0.9443274735956515,365,70,2,437
20094,bright,main,1,0.9628380327603135,309,87,2,398
20094,bright,main,2,0.9531183459650373,327,97,9,433
20094,bright,main,3,0.9591858898923357,295,95,4,394
20094,bright,main,4,0.9445294006639351,301,103,1,405
20094,bright,main,5,0.9687488578125555,337,75,2,414
20094,bright,main,6,0.9072613420331191,317,55,3,375
20094,bright,main,7,0.9659257803289355,306,55,4,365
20094,bright,main,8,0.9778157576384474,328,93,3,424
20094,bright,main,9,0.9629946314938406,343,75,0,418
20095,bright,main,0,0.9823335483263755,335,104,3,442
20095,bright,main,1,0.9807355907961164,314,77,7,398
20095,bright,main,2,0.944561487184347,335,98,3,436
20095,bright,main,3,0.961335153973243,308,88,7,403
20095,bright,main,4,0.9599166481960141,301,106,8,415
20095,bright,main,5,0.9775414542862344,332,88,6,426
20095,bright,main,6,0.9695845404220044,290,70,7,367
20095,bright,main,7,0.9654397648910636,287,77,6,370
20095,bright,main,8,0.9549238138339442,330,83,5,418
20095,bright,main,9,0.9689236663914133,346,75,5,426
20096,bright,main,0,0.9692734027136016,325,110,2,437
20096,bright,main,1,0.9688760576229126,334,64,1,399
20096,bright,main,2,0.9792170859779012,371,62,0,433
20096,bright,main,3,0.9586091807570589,352,44,2,398
20096,bright,main,4,0.9608665029940192,319,88,1,408
20096,bright,main,5,0.9766064650455418,334,80,1,415
20096,bright,main,6,0.9531248490851796,277,90,1,368
20096,bright,main,7,0.9561135200105084,273,85,3,361
20096,bright,main,8,0.9471974420984774,321,98,4,423
20096,bright,main,9,0.9730948015215897,305,126,3,434
20097,bright,main,0,0.9620728375253051,359,71,6,436
20097,bright,main,1,0.9664573717214348,323,70,2,395
20097,bright,main,2,0.9652437431810883,352,73,3,428
20097,bright,main,3,0.9520537756468783,325,69,4,398
20097,bright,main,4,0.9634412989874073,344,58,5,407
20097,bright,main,5,0.9801911553017696,375,42,3,420
20097,bright,main,6,0.9557310862735587,309,57,1,367
20097,bright,main,7,0.9505365223172413,287,52,4,343
20097,bright,main,8,0.9697881717213201,363,55,8,426
20097,bright,main,9,0.9697881717213201,363,55,8,426
20098,bright,main,0,0.9798421319980913,344,95,1,440
20098,bright,main,1,0.9705518303251935,282,116,2,400
20098,bright,main,2,0.9571765078463956,335,98,1,434
20098,bright,main,3,0.957409286379948,296,99,4,399
20098,bright,main,4,0.9561854534947981,305,99,4,408
20098,bright,main,5,0.9778919839674535,336,84,1,421
20098,bright,main,6,0.9700685645920514,296,69,2,367
20098,bright,main,7,0.9606737852942292,291,64,8,363
20098,bright,main,8,0.9740294568222296,324,95,7,426
20098,bright,main,9,0.9626158492243028,345,73,3,421
20099,bright,main,0,0.9441400850223686,373,60,3,436
20099,bright,main,1,0.956125924678128,336,63,3,402
20099,bright,main,2,0.9720925659021176,378,56,2,436
20099,bright,main,3,0.9488025620242846,322,70,4,396
20099,bright,main,4,0.9501841665305749,335,65,1,401
20099,bright,main,5,0.9544511476567187,346,71,4,421
20099,bright,main,6,0.9628121405089882,318,50,2,370
20099,bright,main,7,0.9701320056566494,307,41,3,351
20099,bright,main,8,0.9678574218460855,343,77,5,425
20099,bright,main,9,0.9678574218460855,343,77,5,425
20100,bright,main,0,0.9624594105884028,301,115,1,417
20100,bright,main,1,0.9718320899885877,278,111,4,393
20100,bright,main,2,0.9761387681801428,332,87,4,423
20100,bright,main,3,0.967488929311055,317,68,5,390
20100,bright,main,4,0.9764955508125643,305,86,3,394
20100,bright,main,5,0.9587296157281237,338,68,5,411
20100,bright,main,6,0.9456941461933513,311,53,3,367
20100,bright,main,7,0.9498514231865627,290,66,4,360
20100,bright,main,8,0.9569938367424791,306,99,6,411
20100,bright,main,9,0.9569938367424791,306,99,6,411
20102,bright,main,0,0.9621372487624452,375,50,5,430
20102,bright,main,1,0.9755092100225128,317,77,4,398
20102,bright,main,2,0.9646394889279016,391,42,5,438
20102,bright,main,3,0.9734194583476197,334,59,1,394
20102,bright,main,4,0.9523274143133746,338,58,1,397
20102,bright,main,5,0.9615127604302254,325,84,3,412
20102,bright,main,6,0.9498995301419941,285,79,1,365
20102,bright,main,7,0.9727523198530721,285,73,3,361
20102,bright,main,8,0.9665462099949299,360,57,3,420
20102,bright,main,9,0.9577399471821871,363,59,4,426
20103,bright,main,0,0.9782090034797748,366,65,4,435
20103,bright,main,1,0.9601960976199533,330,64,2,396
20103,bright,main,2,0.9376773442748104,360,64,2,426
20103,bright,main,3,0.9660847885354382,314,65,4,383
20103,bright,main,4,0.9504826049241629,339,56,3,398
20103,bright,main,5,0.9561883224260272,362,49,6,417
20103,bright,main,6,0.9785767182693852,289,68,1,358
20103,bright,main,7,0.9531293839684598,314,40,5,359
20103,bright,main,8,0.9640798149216533,335,75,5,415
20103,bright,main,9,0.9640798149216533,335,75,5,415
20104,bright,main,0,0.9747113837093201,363,71,3,437
20104,bright,main,1,0.9631047006596319,308,72,5,385
20104,bright,main,2,0.9664248760377045,357,61,2,420
20104,bright,main,3,0.9572384836822118,309,76,2,387
20104,bright,main,4,0.9560542648166124,323,69,6,398
20104,bright,main,5,0.9607767988163657,342,69,2,413
20104,bright,main,6,0.9650618844107758,308,51,3,362
20104,bright,main,7,0.9679932878537083,310,50,3,363
20104,bright,main,8,0.966597154375134,370,55,3,428
20104,bright,main,9,0.9560651113531735,365,48,5,418
20105,bright,main,0,0.9748272591587067,344,91,5,440
20105,bright,main,1,0.9773226076689924,325,73,6,404
20105,bright,main,2,0.972567241680344,363,62,2,427
20105,bright,main,3,0.9623229703769848,323,74,3,400
20105,bright,main,4,0.9704721959389331,323,83,3,409
20105,bright,main,5,0.9589895630010207,315,103,5,423
20105,bright,main,6,0.9572262895274928,290,80,5,375
20105,bright,main,7,0.9511983251560582,287,81,0,368
20105,bright,main,8,0.973940684771377,343,80,0,423
20105,bright,main,9,0.9460212777727258,326,103,1,430
20106,bright,main,0,0.9677581537090575,373,65,3,441
20106,bright,main,1,0.9621039313382919,342,61,3,406
20106,bright,main,2,0.9534869003656734,322,107,6,435
20106,bright,main,3,0.9613741390198147,306,90,3,399
20106,bright,main,4,0.9614533064626404,332,72,4,408
20106,bright,main,5,0.9712341502757945,329,79,3,411
20106,bright,main,6,0.956008387806963,296,70,4,370
20106,bright,main,7,0.9479622480841459,275,84,3,362
20106,bright,main,8,0.9681780918250155,317,104,1,422
20106,bright,main,9,0.9515844152215414,349,84,4,437
20107,bright,main,0,0.9686691715185232,374,66,2,442
20107,bright,main,1,0.9609364537172392,324,73,6,403
20107,bright,main,2,0.9637715300563009,337,93,3,433
20107,bright,main,3,0.9768191936116335,332,59,0,391
20107,bright,main,4,0.9718409650566874,308,93,3,404
20107,bright,main,5,0.9681047323867661,298,108,4,410
20107,bright,main,6,0.9578011030479168,281,85,3,369
20107,bright,main,7,0.952510896462094,275,86,5,366
20107,bright,main,8,0.949042014199405,358,68,3,429
20107,bright,main,9,0.9654281930071374,361,73,1,435
20108,bright,main,0,0.9644701490415578,364,74,0,438
20108,bright,main,1,0.9671028886860501,337,59,3,399
20108,bright,main,2,0.9623571496673282,325,99,1,425
20108,bright,main,3,0.9501636831407975,295,94,2,391
20108,bright,main,4,0.9634595172741168,317,82,3,402
20108,bright,main,5,0.9607910650300275,317,91,2,410
20108,bright,main,6,0.977505520092485,277,78,1,356
20108,bright,main,7,0.9556168276374779,250,99,3,352
20108,bright,main,8,0.9747257492715288,342,74,4,420
20108,bright,main,9,0.9608760272619602,343,83,1,427
20109,bright,main,0,0.9529454334712836,377,59,2,438
20109,bright,main,1,0.9571337452812749,311,72,6,389
20109,bright,main,2,0.9623215673091285,298,118,2,418
20109,bright,main,3,0.9382426664075281,300,89,3,392
20109,bright,main,4,0.9528233089763216,311,84,1,396
20109,bright,main,5,0.9413093213927067,357,55,6,418
20109,bright,main,6,0.9734642074967871,307,50,5,362
20109,bright,main,7,0.9506664946379615,300,55,3,358
20109,bright,main,8,0.9681921972548247,353,58,2,413
20109,bright,main,9,0.9685930050295262,352,65,2,419
20110,bright,main,0,0.9689150076031621,355,69,4,428
20110,bright,main,1,0.9688442850088781,307,84,4,395
20110,bright,main,2,0.9741352817202308,339,79,6,424
20110,bright,main,3,0.9470257363989215,306,75,4,385
20110,bright,main,4,0.9595382104353773,338,62,3,403
20110,bright,main,5,0.9634524377177336,343,67,4,414
20110,bright,main,6,0.951172655197314,284,72,4,360
20110,bright,main,7,0.9225575041020563,273,79,3,355
20110,bright,main,8,0.9708453318438278,328,82,4,414
20110,bright,main,9,0.9442755549660887,327,88,2,417
20111,bright,main,0,0.9610481161474788,322,107,0,429
20111,bright,main,1,0.9858175291908492,251,127,6,384
20111,bright,main,2,0.9467290812427998,312,102,2,416
20111,bright,main,3,0.9544031963059276,330,60,4,394
20111,bright,main,4,0.9667932460970716,335,62,2,399
20111,bright,main,5,0.9562565138258378,326,79,6,411
20111,bright,main,6,0.9543010722374808,320,41,4,365
20111,bright,main,7,0.9576778571847093,280,77,1,358
20111,bright,main,8,0.9800585892978132,330,73,5,408
20111,bright,main,9,0.9686816103851031,304,112,2,418
20112,bright,main,0,0.9595211258666929,358,62,6,426
20112,bright,main,1,0.9684874399421823,342,52,3,397
20112,bright,main,2,0.9625309849363655,373,50,2,425
20112,bright,main,3,0.957836337471385,327,60,2,389
20112,bright,main,4,0.9550459229044422,342,54,4,400
20112,bright,main,5,0.9612525404588641,318,83,3,404
20112,bright,main,6,0.9628409150815652,268,72,2,342
20112,bright,main,7,0.9746937845103684,275,77,0,352
20112,bright,main,8,0.9653086978483243,342,77,2,421
20112,bright,main,9,0.9852857401682475,372,48,5,425
20113,bright,main,0,0.9577903928278368,329,82,4,415
20113,bright,main,1,0.9470913410487145,318,66,3,387
20113,bright,main,2,0.9762749398463829,355,63,3,421
20113,bright,main,3,0.9661482911522322,333,51,5,389
20113,bright,main,4,0.9433888264291473,336,64,0,400
20113,bright,main,5,0.9773789473859668,332,68,5,405
20113,bright,main,6,0.9505452506224844,299,55,3,357
20113,bright,main,7,0.9630829015578816,306,47,4,357
20113,bright,main,8,0.9647135877336918,336,70,4,410
20113,bright,main,9,0.9647135877336918,336,70,4,410
20114,bright,main,0,0.9736997794769816,344,82,3,429
20114,bright,main,1,0.9606699339604574,319,72,2,393
20114,bright,main,2,0.9544833458069122,364,54,6,424
20114,bright,main,3,0.9563030282654096,329,57,6,392
20114,bright,main,4,0.9661387383268313,322,66,5,393
20114,bright,main,5,0.9606527327768787,345,67,3,415
20114,bright,main,6,0.9746022547315897,327,35,0,362
20114,bright,main,7,0.9494659022043429,290,60,1,351
20114,bright,main,8,0.9662887043714646,344,75,1,420
20114,bright,main,9,0.9662887043714646,344,75,1,420
20115,bright,main,0,0.9711676800946693,349,77,1,427
20115,bright,main,1,0.9527872394476742,324,59,0,383
20115,bright,main,2,0.9576092495761532,353,60,3,416
20115,bright,main,3,0.9516759958307861,319,70,1,390
20115,bright,main,4,0.956448989334413,354,37,5,396
20115,bright,main,5,0.957315129425787,350,57,2,409
20115,bright,main,6,0.9566737405611424,267,77,3,347
20115,bright,main,7,0.9542442175112261,284,63,2,349
20115,bright,main,8,0.9720618331095092,347,59,5,411
20115,bright,main,9,0.9720618331095092,347,59,5,411
20116,bright,main,0,0.9659138073217409,346,78,3,427
20116,bright,main,1,0.9614376619458262,315,69,8,392
20116,bright,main,2,0.9525267034372915,342,66,4,412
20116,bright,main,3,0.9488961779437478,315,71,4,390
20116,bright,main,4,0.9579705570725643,332,60,1,393
20116,bright,main,5,0.9498366936093271,324,77,2,403
20116,bright,main,6,0.9645550833204185,293,67,2,362
20116,bright,main,7,0.9328768610206429,275,74,2,351
20116,bright,main,8,0.9518160725361634,335,74,3,412
20116,bright,main,9,0.9607810178581246,320,97,2,419
20117,bright,main,0,0.9640667955665185,356,75,7,438
20117,bright,main,1,0.97429665134322,311,78,0,389
20117,bright,main,2,0.9600036837672912,352,79,3,434
20117,bright,main,3,0.9395816127813079,333,58,0,391
20117,bright,main,4,0.9651381771319515,338,62,3,403
20117,bright,main,5,0.9755578750448443,336,75,2,413
20117,bright,main,6,0.969325382539897,287,73,5,365
20117,bright,main,7,0.9484840030068518,282,75,1,358
20117,bright,main,8,0.9633003529976795,327,80,5,412
20117,bright,main,9,0.9440093893413357,323,96,0,419
20118,bright,main,0,0.9678352851155371,367,64,3,434
20118,bright,main,1,0.9646014464831342,299,83,8,390
20118,bright,main,2,0.9627105944487135,335,81,3,419
20118,bright,main,3,0.9468651160414241,297,78,7,382
20118,bright,main,4,0.964682066889297,311,78,2,391
20118,bright,main,5,0.9588894881633182,337,70,2,409
20118,bright,main,6,0.9667509410877656,268,79,5,352
20118,bright,main,7,0.9570219023143322,280,72,4,356
20118,bright,main,8,0.9637289574624681,314,85,6,405
20118,bright,main,9,0.9784310610095397,377,44,7,428
20119,bright,main,0,0.9641186317479542,354,74,7,435
20119,bright,main,1,0.9417868081919257,335,48,6,389
20119,bright,main,2,0.976502647159127,347,70,1,418
20119,bright,main,3,0.9706921305685974,317,69,2,388
20119,bright,main,4,0.9426846403274275,338,64,3,405
20119,bright,main,5,0.9522542181859475,329,75,2,406
20119,bright,main,6,0.93923292721917,286,71,2,359
20119,bright,main,7,0.9648356598595608,299,52,3,354
20119,bright,main,8,0.9551835849493144,337,73,4,414
20119,bright,main,9,0.9643687188147262,356,59,6,421
20120,bright,main,0,0.9543009103318317,377,60,2,439
20120,bright,main,1,0.9599257868998138,326,58,6,390
20120,bright,main,2,0.9708064591079382,353,67,4,424
20120,bright,main,3,0.967148722822776,306,91,3,400
20120,bright,main,4,0.9536431955543543,347,58,3,408
20120,bright,main,5,0.9622460547973132,325,84,2,411
20120,bright,main,6,0.9536142402535578,306,56,4,366
20120,bright,main,7,0.9576778571847097,297,60,2,359
20120,bright,main,8,0.9521860181301213,353,62,9,424
20120,bright,main,9,0.9613724659416939,378,44,4,426
20121,bright,main,0,0.9573049721559413,373,54,3,430
20121,bright,main,1,0.9525294125275222,343,50,3,396
20121,bright,main,2,0.9443664350788122,328,77,7,412
20121,bright,main,3,0.9633188166165747,289,86,1,376
20121,bright,main,4,0.9461188506867649,310,79,3,392
20121,bright,main,5,0.9674019874892038,336,70,4,410
20121,bright,main,6,0.9522541237617285,320,40,3,363
20121,bright,main,7,0.9697024480523319,283,60,4,347
20121,bright,main,8,0.9187782025184089,356,55,3,414
20121,bright,main,9,0.9635228013788608,330,80,5,415
20122,bright,main,0,0.9388121500177524,352,78,2,432
20122,bright,main,1,0.9516250097941573,346,47,3,396
20122,bright,main,2,0.9520319737216176,328,73,2,403
20122,bright,main,3,0.9708970832154994,332,50,1,383
20122,bright,main,4,0.9541991156359646,340,51,3,394
20122,bright,main,5,0.9623931531044003,333,70,4,407
20122,bright,main,6,0.9730039429493735,312,44,3,359
20122,bright,main,7,0.9505144439439627,283,59,6,348
20122,bright,main,8,0.950607440939204,314,88,7,409
20122,bright,main,9,0.950607440939204,314,88,7,409
20123,bright,main,0,0.9807489142375677,367,58,4,429
20123,bright,main,1,0.958689924373226,335,52,3,390
20123,bright,main,2,0.9356191032874904,356,61,2,419
20123,bright,main,3,0.9610407801569506,321,55,6,382
20123,bright,main,4,0.9608843511939384,349,40,7,396
20123,bright,main,5,0.9397531837575187,358,48,5,411
20123,bright,main,6,0.9605163036861964,291,63,4,358
20123,bright,main,7,0.967964269705019,277,70,3,350
20123,bright,main,8,0.943092800314623,359,53,3,415
20123,bright,main,9,0.943092800314623,359,53,3,415
20124,bright,main,0,0.9531897968354596,341,83,6,430
20124,bright,main,1,0.9457737317977276,325,59,3,387
20124,bright,main,2,0.9680642289218168,341,69,0,410
20124,bright,main,3,0.975605160902046,287,97,2,386
20124,bright,main,4,0.9655215669828761,333,57,4,394
20124,bright,main,5,0.974534935011795,337,70,4,411
20124,bright,main,6,0.9764521896101077,275,79,6,360
20124,bright,main,7,0.9730042446141373,271,78,4,353
20124,bright,main,8,0.9579212324804425,299,105,6,410
20124,bright,main,9,0.9652585364696703,343,70,4,417
20130,bright,main,0,0.9783833225257003,354,86,2,442
20130,bright,main,1,0.9796784620126486,303,94,9,406
20130,bright,main,2,0.9790365320727237,340,94,3,437
20130,bright,main,3,0.9759966576949515,313,85,4,402
20130,bright,main,4,0.9589739226345213,343,62,6,411
20130,bright,main,5,0.9638829322631042,336,85,3,424
20130,bright,main,6,0.9706242570883062,298,72,3,373
20130,bright,main,7,0.9458907043899314,287,71,6,364
20130,bright,main,8,0.9643937244405645,351,72,4,427
20130,bright,main,9,0.9542487439272259,353,80,4,437
20133,bright,main,0,0.9504775734887053,357,75,5,437
20133,bright,main,1,0.958253731173231,327,56,7,390
20133,bright,main,2,0.9407581732171799,372,54,3,429
20133,bright,main,3,0.961467670632646,326,55,3,384
20133,bright,main,4,0.968060648551988,343,47,4,394
20133,bright,main,5,0.9595572985618385,342,66,3,411
20133,bright,main,6,0.9617549393801177,293,52,4,349
20133,bright,main,7,0.9640403553871956,290,54,2,346
20133,bright,main,8,0.9789594702329144,323,85,2,410
20133,bright,main,9,0.9526023204478388,337,74,6,417
20134,bright,main,0,0.9633886272930179,358,79,3,440
20134,bright,main,1,0.9591992903365366,320,80,4,404
20134,bright,main,2,0.9525920798515854,375,53,2,430
20134,bright,main,3,0.9455918488010113,348,55,5,408
20134,bright,main,4,0.9640798149216532,364,50,0,414
20134,bright,main,5,0.9587721217084286,365,61,3,429
20134,bright,main,6,0.9696859443289425,291,73,2,366
20134,bright,main,7,0.9515263942294753,309,59,3,371
20134,bright,main,8,0.9559768555556184,326,85,5,416
20134,bright,main,9,0.9663860264724454,358,67,3,428
20193,bright,main,0,0.949781787389721,342,82,5,429
20193,bright,main,1,0.9494086378083486,331,55,4,390
20193,bright,main,2,0.9550736937425212,367,51,3,421
20193,bright,main,3,0.9666182012876333,318,59,4,381
20193,bright,main,4,0.9531271989019829,336,60,7,403
20193,bright,main,5,0.9569290066604038,326,66,8,400
20193,bright,main,6,0.9477243395952877,282,66,11,359
20193,bright,main,7,0.9485806800456897,277,56,2,335
20193,bright,main,8,0.956423121547457,358,58,3,419
20193,bright,main,9,0.9502230418481082,327,74,8,409
20199,bright,main,0,0.9715704923398087,369,60,4,433
20199,bright,main,1,0.9507860299713722,317,66,6,389
20199,bright,main,2,0.9628736415593876,347,74,4,425
20199,bright,main,3,0.948951345998008,308,77,2,387
20199,bright,main,4,0.9685484355923396,270,65,4,339
20199,bright,main,5,0.965142517455215,334,70,3,407
20199,bright,main,6,0.9453980441456816,297,53,8,358
20199,bright,main,7,0.9635419340286147,276,73,3,352
20199,bright,main,8,0.9344753174841356,325,83,5,413
20199,bright,main,9,0.9710864747005876,318,97,7,422
20206,bright,main,0,0.958398273431697,350,98,1,449
20206,bright,main,1,0.9517119464551469,311,77,7,395
20206,bright,main,2,0.9518709285896232,357,78,4,439
20206,bright,main,3,0.9322060592061238,326,71,5,402
20206,bright,main,4,0.9659529231677885,322,85,3,410
20206,bright,main,5,0.9724803240458259,327,92,6,425
20206,bright,main,6,0.9465775363738549,276,82,6,364
20206,bright,main,7,0.9596888535220575,309,58,2,369
20206,bright,main,8,0.968694967891939,348,75,5,428
20206,bright,main,9,0.970202347471218,351,80,4,435
20207,bright,main,0,0.9711412705321814,372,70,0,442
20207,bright,main,1,0.9355029733322053,328,73,2,403
20207,bright,main,2,0.9554925886952299,361,72,4,437
20207,bright,main,3,0.9456505572828731,303,95,2,400
20207,bright,main,4,0.9672680262786759,324,88,1,413
20207,bright,main,5,0.9617258361943665,324,99,4,427
20207,bright,main,6,0.965022971444835,300,68,3,371
20207,bright,main,7,0.9751181344500506,288,78,1,367
20207,bright,main,8,0.9640512858669307,340,80,3,423
20207,bright,main,9,0.9646525154728168,372,60,1,433
20208,bright,main,0,0.980738992727396,373,66,2,441
20208,bright,main,1,0.9584456331447901,361,44,2,407
20208,bright,main,2,0.9769048654223872,345,95,2,442
20208,bright,main,3,0.968491741255951,317,85,3,405
20208,bright,main,4,0.9639118445397196,312,92,2,406
20208,bright,main,5,0.9536044869792786,350,71,5,426
20208,bright,main,6,0.9651001227012114,286,78,5,369
20208,bright,main,7,0.9555971169093815,295,76,2,373
20208,bright,main,8,0.9537343631429426,373,54,2,429
20208,bright,main,9,0.9577153523107255,378,56,5,439
20209,bright,main,0,0.973424629242256,363,82,5,450
20209,bright,main,1,0.9677165704119873,298,100,3,401
20209,bright,main,2,0.9498866139396278,340,87,1,428
20209,bright,main,3,0.9567011424162747,305,89,3,397
20209,bright,main,4,0.9311814234389972,346,69,3,418
20209,bright,main,5,0.9666678901490423,341,75,7,423
20209,bright,main,6,0.9372297571424916,297,69,3,369
20209,bright,main,7,0.9665102945298514,285,85,2,372
20209,bright,main,8,0.9810737804986979,319,108,4,431
20209,bright,main,9,0.9680388466823793,367,65,3,435
20210,bright,main,0,0.990160141094038,362,62,7,431
20210,bright,main,1,0.9498719701742462,351,49,1,401
20210,bright,main,2,0.9396835983544553,346,81,3,430
20210,bright,main,3,0.9546277436013102,329,58,8,395
20210,bright,main,4,0.9712073850537809,322,80,3,405
20210,bright,main,5,0.9836412423692689,355,61,4,420
20210,bright,main,6,0.9474455044482352,342,30,1,373
20210,bright,main,7,0.95111197591473,284,56,4,344
20210,bright,main,8,0.9673492885905542,329,83,5,417
20210,bright,main,9,0.9527141282847327,343,74,4,421
20211,bright,main,0,0.9755346655957935,356,88,3,447
20211,bright,main,1,0.9557482193825493,338,70,0,408
20211,bright,main,2,0.9596330677500993,366,76,1,443
20211,bright,main,3,0.9483840938162537,347,55,2,404
20211,bright,main,4,0.9452278992236754,355,58,6,419
20211,bright,main,5,0.9640299199851381,356,72,2,430
20211,bright,main,6,0.9442255112163964,301,69,4,374
20211,bright,main,7,0.9569186142890294,310,64,4,378
20211,bright,main,8,0.9815462505618967,301,118,8,427
20211,bright,main,9,0.9720657704401353,343,93,2,438
20212,bright,main,0,0.9600382112853022,346,90,5,441
20212,bright,main,1,0.9569290066604038,309,89,2,400
20212,bright,main,2,0.9675140916764319,326,101,2,429
20212,bright,main,3,0.9661467358900239,261,136,2,399
20212,bright,main,4,0.9576206355748853,297,57,2,356
20212,bright,main,5,0.9359369501531281,317,83,3,403
20212,bright,main,6,0.9433822224782444,286,82,1,369
20212,bright,main,7,0.9622660165364931,282,72,3,357
20212,bright,main,8,0.9613235738998206,298,118,3,419
20212,bright,main,9,0.9708260680540575,307,115,8,430
20213,bright,main,0,0.9598445325206159,335,99,4,438
20213,bright,main,1,0.968101262661599,294,100,9,403
20213,bright,main,2,0.9624560391288076,361,69,4,434
20213,bright,main,3,0.9577243026916745,309,80,3,392
20213,bright,main,4,0.97018272516384,331,65,7,403
20213,bright,main,5,0.9809980371910468,317,93,6,416
20213,bright,main,6,0.9711239057916563,288,76,4,368
20213,bright,main,7,0.9683853224375152,266,77,4,347
20213,bright,main,8,0.9772700488251099,325,100,4,429
20213,bright,main,9,0.9595879902888858,326,91,9,426
20219,bright,main,0,0.9671652777888581,359,86,0,445
20219,bright,main,1,0.9622864583707805,332,71,2,405
20219,bright,main,2,0.973219237188384,348,91,0,439
20219,bright,main,3,0.9688978372014019,327,78,4,409
20219,bright,main,4,0.9567079167933086,345,66,2,413
20219,bright,main,5,0.9706179274414009,339,82,5,426
20219,bright,main,6,0.9297916744559256,304,63,3,370
20219,bright,main,7,0.9574614608580647,313,55,1,369
20219,bright,main,8,0.9750933094766341,344,83,7,434
20219,bright,main,9,0.9720629084793292,327,102,3,432
20220,bright,main,0,0.9647691993196151,365,73,4,442
20220,bright,main,1,0.975168772939719,300,102,2,404
20220,bright,main,2,0.9448400618923481,325,102,3,430
20220,bright,main,3,0.9571311360713275,315,80,4,399
20220,bright,main,4,0.9773984399678611,301,103,2,406
20220,bright,main,5,0.9658678522974155,310,102,5,417
20220,bright,main,6,0.9623684241428052,272,93,0,365
20220,bright,main,7,0.9822794545693629,267,79,2,348
20220,bright,main,8,0.984865162593608,352,68,5,425
20220,bright,main,9,0.9690441876869149,333,87,4,424
20222,bright,main,0,0.9594256381315027,347,82,4,433
20222,bright,main,1,0.9576472885165773,308,87,3,398
20222,bright,main,2,0.9530176015217908,334,93,1,428
20222,bright,main,3,0.9445155738562114,301,88,4,393
20222,bright,main,4,0.9698291089050667,316,87,2,405
20222,bright,main,5,0.9460800484251527,333,80,5,418
20222,bright,main,6,0.9614850339623014,254,112,0,366
20222,bright,main,7,0.9462081320999148,273,85,2,360
20222,bright,main,8,0.9528138575039733,350,71,1,422
20222,bright,main,9,0.9641822512677292,352,72,6,430
20223,bright,main,0,0.9538593933887973,352,72,6,430
20223,bright,main,1,0.9734379538915767,332,65,3,400
20223,bright,main,2,0.9667163015573376,368,60,5,433
20223,bright,main,3,0.9649783862928898,309,81,2,392
20223,bright,main,4,0.9662985613181267,333,69,3,405
20223,bright,main,5,0.9401542103093118,340,71,5,416
20223,bright,main,6,0.9346724120257021,276,88,3,367
20223,bright,main,7,0.9487922609442346,277,82,2,361
20223,bright,main,8,0.9547674236369326,319,97,4,420
20223,bright,main,9,0.9656359782059801,324,102,3,429
20224,bright,main,0,0.9683747620182773,323,104,5,432
20224,bright,main,1,0.9772791872694545,325,68,1,394
20224,bright,main,2,0.9535047276853109,369,59,2,430
20224,bright,main,3,0.9772211050870064,320,68,6,394
20224,bright,main,4,0.9621951447605436,326,69,6,401
20224,bright,main,5,0.9732246307850233,360,56,4,420
20224,bright,main,6,0.9257269174053862,330,40,2,372
20224,bright,main,7,0.9677263009796838,272,62,4,338
20224,bright,main,8,0.9764698818693717,334,82,6,422
20224,bright,main,9,0.9449620921063756,360,61,3,424
20234,bright,main,0,0.9566494385585512,349,74,4,427
20234,bright,main,1,0.9430365884276665,316,77,2,395
20234,bright,main,2,0.9683651938956744,341,64,2,407
20234,bright,main,3,0.9676995341648404,300,70,6,376
20234,bright,main,4,0.9655469991877195,337,50,1,388
20234,bright,main,5,0.9735223308978384,362,41,4,407
20234,bright,main,6,0.9586972443101507,285,72,3,360
20234,bright,main,7,0.9470863189478144,249,86,5,340
20234,bright,main,8,0.9606873247808323,309,104,2,415
20234,bright,main,9,0.9810962068803156,328,86,1,415
20235,bright,main,0,0.9662439002941767,343,86,4,433
20235,bright,main,1,0.9690048201897637,281,112,3,396
20235,bright,main,2,0.9599661673217903,298,116,4,418
20235,bright,main,3,0.9638761164413961,298,89,7,394
20235,bright,main,4,0.9618998292408449,272,78,4,354
20235,bright,main,5,0.9471466766601994,361,52,1,414
20235,bright,main,6,0.9550509039566677,304,58,2,364
20235,bright,main,7,0.9576948887885443,290,61,2,353
20235,bright,main,8,0.9684268604559002,310,107,4,421
20235,bright,main,9,0.968133214046915,347,76,1,424
20236,bright,main,0,0.9794541737119996,348,88,3,439
20236,bright,main,1,0.9163240879802116,298,89,6,393
20236,bright,main,2,0.9802395735870055,346,66,8,420
20236,bright,main,3,0.9438783070670044,315,76,4,395
20236,bright,main,4,0.978554997816748,340,60,1,401
20236,bright,main,5,0.9751984215771423,374,42,2,418
20236,bright,main,6,0.9640424226766742,311,53,5,369
20236,bright,main,7,0.9668950724015141,272,64,2,338
20236,bright,main,8,0.9800462208930457,343,80,1,424
20236,bright,main,9,0.953734702807813,366,57,8,431
20240,bright,main,0,0.9733687475212974,358,76,2,436
20240,bright,main,1,0.9435338256965143,299,76,7,382
20240,bright,main,2,0.9642809654337221,340,79,4,423
20240,bright,main,3,0.9673144961236845,299,89,0,388
20240,bright,main,4,0.971562921883235,300,88,3,391
20240,bright,main,5,0.9677117612661109,329,72,4,405
20240,bright,main,6,0.9598421258373452,308,61,4,373
20240,bright,main,7,0.9599969426967112,294,56,8,358
20240,bright,main,8,0.9738660997825935,352,62,4,418
20240,bright,main,9,0.9607555059664584,371,48,6,425
20241,bright,main,0,0.977883017795623,322,90,2,414
20241,bright,main,1,0.9606491803276547,286,90,2,378
20241,bright,main,2,0.9580885781744258,298,104,6,408
20241,bright,main,3,0.974876122365027,291,73,1,365
20241,bright,main,4,0.9582581240611889,296,80,3,379
20241,bright,main,5,0.9621268411233276,306,84,3,393
20241,bright,main,6,0.9551509454485584,290,66,3,359
20241,bright,main,7,0.9486732825852008,250,66,4,320
20241,bright,main,8,0.9485759419394434,295,108,4,407
20241,bright,main,9,0.9445315992614775,313,81,4,398
20243,bright,main,0,0.945359076943816,337,93,4,434
20243,bright,main,1,0.9703011921717483,301,85,7,393
20243,bright,main,2,0.9762677708108864,321,103,0,424
20243,bright,main,3,0.9729758630901424,309,75,3,387
20243,bright,main,4,0.9423325124402665,294,52,4,350
20243,bright,main,5,0.9645355305028667,352,64,3,419
20243,bright,main,6,0.9541834558128452,294,59,4,357
20243,bright,main,7,0.9649271584673033,285,54,5,344
20243,bright,main,8,0.9684951811082323,318,89,1,408
20243,bright,main,9,0.9605932725775452,307,111,5,423
20245,bright,main,0,0.9652924430709031,323,89,6,418
20245,bright,main,1,0.9474303287274406,304,79,7,390
20245,bright,main,2,0.9462480877605334,318,96,5,419
20245,bright,main,3,0.9591577935967415,296,88,3,387
20245,bright,main,4,0.9654224783935567,331,61,6,398
20245,bright,main,5,0.9516025324611426,329,82,2,413
20245,bright,main,6,0.9423449768203848,292,60,3,355
20245,bright,main,7,0.9731084904764101,256,80,3,339
20245,bright,main,8,0.9555668118041805,323,87,4,414
20245,bright,main,9,0.9642204765124385,340,73,4,417
20247,bright,main,0,0.9691525524995198,356,83,3,442
20247,bright,main,1,0.9583599942841121,299,103,2,404
20247,bright,main,2,0.9643837034153339,330,110,1,441
20247,bright,main,3,0.9758586926596001,321,81,2,404
20247,bright,main,4,0.9726196275249589,313,94,4,411
20247,bright,main,5,0.9498843834008901,334,91,7,432
20247,bright,main,6,0.9702886009969492,259,105,4,368
20247,bright,main,7,0.9505115896549339,292,80,4,376
20247,bright,main,8,0.9518044010312902,319,106,2,427
20247,bright,main,9,0.967110464012211,345,86,1,432
20248,bright,main,0,0.9680675722808669,373,71,2,446
20248,bright,main,1,0.9364981494655655,335,63,0,398
20248,bright,main,2,0.9790170358940736,356,78,3,437
20248,bright,main,3,0.9469088846445987,327,74,2,403
20248,bright,main,4,0.9499199744746867,312,95,4,411
20248,bright,main,5,0.9517372050352133,338,89,1,428
20248,bright,main,6,0.9636858231050903,294,74,2,370
20248,bright,main,7,0.9804597758813088,305,68,1,374
20248,bright,main,8,0.9734078601962947,338,84,9,431
20248,bright,main,9,0.9647378084786528,363,67,3,433
20249,bright,main,0,0.943483650934797,380,64,3,447
20249,bright,main,1,0.9261554555908194,316,87,5,408
20249,bright,main,2,0.9830958333269842,341,89,2,432
20249,bright,main,3,0.9600199178064925,313,85,4,402
20249,bright,main,4,0.9791790339051719,341,69,2,412
20249,bright,main,5,0.970620586095075,355,74,2,431
20249,bright,main,6,0.9681846362331609,328,38,3,369
20249,bright,main,7,0.9765889255720168,335,39,3,377
20249,bright,main,8,0.9382879887065609,380,48,3,431
20249,bright,main,9,0.9450077744370128,390,44,6,440
20251,bright,main,0,0.9606700992099577,315,111,5,431
20251,bright,main,1,0.9482858593679336,318,78,6,402
20251,bright,main,2,0.9487072814273255,343,81,3,427
20251,bright,main,3,0.951719777365289,327,70,6,403
20251,bright,main,4,0.9538797809126601,318,82,3,403
20251,bright,main,5,0.9721538884078452,359,59,5,423
20251,bright,main,6,0.9564487152286909,294,72,3,369
20251,bright,main,7,0.9711219950513327,270,79,2,351
20251,bright,main,8,0.9465505282583618,325,98,1,424
20251,bright,main,9,0.9747556254466341,323,104,1,428
20252,bright,main,0,0.9642858183386183,324,116,2,442
20252,bright,main,1,0.961287464258134,305,96,4,405
20252,bright,main,2,0.9714409106741462,340,95,1,436
20252,bright,main,3,0.9591842019874257,302,99,2,403
20252,bright,main,4,0.9660502480516171,296,107,3,406
20252,bright,main,5,0.9518738784703752,316,101,4,421
20252,bright,main,6,0.9724053642230127,269,97,0,366
20252,bright,main,7,0.9668091100920209,267,101,2,370
20252,bright,main,8,0.9536667976357154,353,71,2,426
20252,bright,main,9,0.9645223154461636,342,89,7,438
20253,bright,main,0,0.9589870606941618,363,74,3,440
20253,bright,main,1,0.9656389949455513,298,96,3,397
20253,bright,main,2,0.9507802000068907,322,103,6,431
20253,bright,main,3,0.9559059136917426,337,63,0,400
20253,bright,main,4,0.9544288273316477,297,75,3,375
20253,bright,main,5,0.9733056723205237,308,106,5,419
20253,bright,main,6,0.9544053686325683,265,96,2,363
20253,bright,main,7,0.9492690677387379,265,83,5,353
20253,bright,main,8,0.9661276891215841,356,63,1,420
20253,bright,main,9,0.9617595714897943,360,68,2,430
20254,bright,main,0,0.968478608880802,356,74,3,433
20254,bright,main,1,0.9518890091575449,330,64,2,396
20254,bright,main,2,0.9636100442586392,349,73,6,428
20254,bright,main,3,0.9777166392695529,349,47,5,401
20254,bright,main,4,0.958159991248023,325,52,2,379
20254,bright,main,5,0.9638514991872081,320,87,6,413
20254,bright,main,6,0.9448684189856381,314,50,4,368
20254,bright,main,7,0.9509630966673454,267,71,6,344
20254,bright,main,8,0.9596853694906169,330,84,5,419
20254,bright,main,9,0.9560908092951205,324,104,1,429
20256,bright,main,0,0.9450196970128665,376,58,7,441
20256,bright,main,1,0.9575689864613195,319,81,2,402
20256,bright,main,2,0.9655023758164615,348,78,4,430
20256,bright,main,3,0.968380162959966,321,73,4,398
20256,bright,main,4,0.9310468666003124,334,66,4,404
20256,bright,main,5,0.977271361800004,379,43,3,425
20256,bright,main,6,0.9585526799924794,317,48,4,369
20256,bright,main,7,0.9333565300671729,297,47,1,345
20256,bright,main,8,0.9462235362917714,335,86,2,423
20256,bright,main,9,0.9462235362917714,335,86,2,423
20257,bright,main,0,0.9630595550403747,335,82,2,419
20257,bright,main,1,0.9475260731490945,293,84,2,379
20257,bright,main,2,0.9734001375470316,386,34,0,420
20257,bright,main,3,0.9793892696930532,341,48,3,392
20257,bright,main,4,0.9595495874129059,338,54,4,396
20257,bright,main,5,0.9611320137793324,338,66,4,408
20257,bright,main,6,0.9760701242444614,289,61,1,351
20257,bright,main,7,0.9540921132857194,251,91,3,345
20257,bright,main,8,0.9534289135346616,312,100,4,416
20257,bright,main,9,0.9535466192399873,367,53,4,424
20258,bright,main,0,0.9544444502474088,358,87,2,447
20258,bright,main,1,0.9544568067567036,301,97,2,400
20258,bright,main,2,0.9717469202208778,368,62,7,437
20258,bright,main,3,0.9570211920303476,358,40,3,401
20258,bright,main,4,0.9681023702342295,344,70,1,415
20258,bright,main,5,0.9641546105661222,351,75,4,430
20258,bright,main,6,0.9277430448752642,299,66,3,368
20258,bright,main,7,0.9605629317717456,282,84,3,369
20258,bright,main,8,0.9676533400096572,360,65,3,428
20258,bright,main,9,0.9731092232200714,364,65,5,434
20274,bright,main,0,0.945187014057932,381,59,4,444
20274,bright,main,1,0.9308162614876693,325,59,5,389
20274,bright,main,2,0.9537625924994734,365,55,5,425
20274,bright,main,3,0.9552726075553496,320,56,1,377
20274,bright,main,4,0.9644605861530752,343,53,3,399
20274,bright,main,5,0.9660878872266738,374,44,2,420
20274,bright,main,6,0.9681373805888427,318,47,1,366
20274,bright,main,7,0.9641652863121346,300,49,3,352
20274,bright,main,8,0.9337915499340206,342,69,1,412
20274,bright,main,9,0.9607411524687319,345,79,2,426
20298,bright,main,0,0.9728912399547475,360,70,3,433
20298,bright,main,1,0.9684157994898331,313,81,5,399
20298,bright,main,2,0.9740774567496324,313,114,4,431
20298,bright,main,3,0.9627449067233294,282,109,5,396
20298,bright,main,4,0.9679934902033969,283,115,5,403
20298,bright,main,5,0.9592004997006061,273,144,3,420
20298,bright,main,6,0.9428197894049768,268,98,3,369
20298,bright,main,7,0.958990480356171,279,82,4,365
20298,bright,main,8,0.9649428466152926,310,109,3,422
20298,bright,main,9,0.9608280701032501,331,83,10,424
20299,bright,main,0,0.9552018523603004,274,150,7,431
20299,bright,main,1,0.9530906759903174,278,111,6,395
20299,bright,main,2,0.9783108510376866,289,124,9,422
20299,bright,main,3,0.9467641154949035,294,80,14,388
20299,bright,main,4,0.972577963104276,296,90,14,400
20299,bright,main,5,0.9548996812131659,314,95,5,414
20299,bright,main,6,0.954183455812845,273,76,10,359
20299,bright,main,7,0.9456856517826744,269,82,8,359
20299,bright,main,8,0.9442583405174624,287,120,13,420
20299,bright,main,9,0.959619366770839,302,113,7,422
20301,bright,main,0,0.981323717678523,332,109,3,444
20301,bright,main,1,0.9610134156805034,312,89,2,403
20301,bright,main,2,0.9513430779627621,315,113,5,433
20301,bright,main,3,0.9725094688588638,302,98,4,404
20301,bright,main,4,0.9463116083326286,298,115,3,416
20301,bright,main,5,0.9649295120707465,283,132,5,420
20301,bright,main,6,0.9672539904083389,295,70,1,366
20301,bright,main,7,0.9551007281854856,289,83,3,375
20301,bright,main,8,0.9717686019138332,317,101,5,423
20301,bright,main,9,0.95173198373019,330,97,7,434
20302,bright,main,0,0.9623082986057112,372,61,5,438
20302,bright,main,1,0.9607134778675347,311,81,7,399
20302,bright,main,2,0.9618456691466287,335,88,8,431
20302,bright,main,3,0.970919016898307,296,92,3,391
20302,bright,main,4,0.9633909439707619,304,99,4,407
20302,bright,main,5,0.9615877706128133,321,96,5,422
20302,bright,main,6,0.9437388220498283,282,81,5,368
20302,bright,main,7,0.9424351521604756,303,57,4,364
20302,bright,main,8,0.9819981976969762,332,83,5,420
20302,bright,main,9,0.9591700026770271,323,98,7,428
20303,bright,main,0,0.9751613621997716,349,84,6,439
20303,bright,main,1,0.9626860303864909,303,91,6,400
20303,bright,main,2,0.9377921831336816,302,126,6,434
20303,bright,main,3,0.9649208442861545,258,137,1,396
20303,bright,main,4,0.97718062909134,265,138,4,407
20303,bright,main,5,0.9549727021996194,283,131,3,417
20303,bright,main,6,0.9660659884572849,279,85,2,366
20303,bright,main,7,0.9560105721891524,284,74,3,361
20303,bright,main,8,0.976727733689724,294,120,8,422
20303,bright,main,9,0.9638626912854352,324,100,4,428
20305,bright,main,0,0.9579723192525448,362,81,1,444
20305,bright,main,1,0.9615195247131303,321,78,3,402
20305,bright,main,2,0.9558523803556951,341,82,5,428
20305,bright,main,3,0.9599135257441885,301,105,2,408
20305,bright,main,4,0.9754645872018953,319,98,1,418
20305,bright,main,5,0.9507327297526678,334,96,2,432
20305,bright,main,6,0.9392244757933813,304,66,4,374
20305,bright,main,7,0.9492262250619627,234,140,3,377
20305,bright,main,8,0.9553594899217279,323,103,2,428
20305,bright,main,9,0.9492978457349296,331,94,10,435
20310,bright,main,0,0.9852520607149882,312,128,4,444
20310,bright,main,1,0.9701790917974311,269,132,4,405
20310,bright,main,2,0.9653298408379225,288,138,4,430
20310,bright,main,3,0.9543385853868666,265,128,6,399
20310,bright,main,4,0.9700619909542008,310,95,0,405
20310,bright,main,5,0.9647809039745083,307,106,6,419
20310,bright,main,6,0.9436385324715377,256,113,1,370
20310,bright,main,7,0.9590141031955829,227,130,2,359
20310,bright,main,8,0.9787442096200473,298,123,1,422
20310,bright,main,9,0.9663430386795078,303,120,3,426
20377,bright,main,0,0.9512002940381955,355,50,6,411
20377,bright,main,1,0.9358436529115629,331,41,1,373
20377,bright,main,2,0.9558837335427698,325,61,1,387
20377,bright,main,3,0.9492515023794816,299,63,2,364
20377,bright,main,4,0.9635855335267999,309,55,5,369
20377,bright,main,5,0.9635048007496638,348,46,5,399
20377,bright,main,6,0.9642069654258895,288,52,4,344
20377,bright,main,7,0.9663820497800383,316,27,4,347
20377,bright,main,8,0.9672670530407848,347,57,1,405
20377,bright,main,9,0.9629902460169895,345,60,2,407
20384,bright,main,0,0.9697026560178907,366,73,7,446
20384,bright,main,1,0.9826915636352936,286,119,3,408
20384,bright,main,2,0.9613065186018204,340,101,6,447
20384,bright,main,3,0.9668803189057517,301,102,7,410
20384,bright,main,4,0.9610663124525611,346,75,1,422
20384,bright,main,5,0.9728705949277843,353,69,3,425
20384,bright,main,6,0.9633527575090064,297,67,6,370
20384,bright,main,7,0.9425534017361632,259,120,1,380
20384,bright,main,8,0.9521956736858621,288,141,2,431
20384,bright,main,9,0.9589393675252995,337,99,1,437
20385,bright,main,0,0.9613947490258916,324,115,4,443
20385,bright,main,1,0.9686274248524652,313,81,7,401
20385,bright,main,2,0.9838781134954219,352,79,5,436
20385,bright,main,3,0.9490688881919704,292,103,6,401
20385,bright,main,4,0.9687420576006605,280,100,3,383
20385,bright,main,5,0.9811459720443826,305,110,5,420
20385,bright,main,6,0.9774881940739685,238,138,0,376
20385,bright,main,7,0.9711011516901973,231,127,2,360
20385,bright,main,8,0.9623628493819275,294,127,5,426
20385,bright,main,9,0.9465320350548531,328,103,2,433
20386,bright,main,0,0.960933325566513,338,96,3,437
20386,bright,main,1,0.9617385172285519,273,130,2,405
20386,bright,main,2,0.9695631558641601,301,124,9,434
20386,bright,main,3,0.963427053460244,297,97,3,397
20386,bright,main,4,0.9448277542477458,319,94,2,415
20386,bright,main,5,0.975234787026768,276,147,3,426
20386,bright,main,6,0.9656666224468281,276,83,5,364
20386,bright,main,7,0.9458973540569637,289,76,2,367
20386,bright,main,8,0.9312789631051634,321,104,2,427
20386,bright,main,9,0.9312789631051634,321,104,2,427
20387,bright,main,0,0.9714092272856903,316,110,5,431
20387,bright,main,1,0.9721500394494529,299,101,6,406
20387,bright,main,2,0.9819586324025283,305,126,3,434
20387,bright,main,3,0.971869378719189,264,133,2,399
20387,bright,main,4,0.9557195668093407,308,94,7,409
20387,bright,main,5,0.9515157441813505,322,103,1,426
20387,bright,main,6,0.9810121720256311,279,89,3,371
20387,bright,main,7,0.969574992147202,242,107,5,354
20387,bright,main,8,0.9549854842012447,299,120,6,425
20387,bright,main,9,0.9660785709699506,357,72,3,432
20388,bright,main,0,0.9468817894382976,319,121,4,444
20388,bright,main,1,0.9498480088256459,261,139,4,404
20388,bright,main,2,0.9633889576093139,305,130,8,443
20388,bright,main,3,0.9580449351910177,306,93,6,405
20388,bright,main,4,0.9640090096420294,297,114,5,416
20388,bright,main,5,0.9742647996986339,334,92,1,427
20388,bright,main,6,0.9579365423857137,284,87,2,373
20388,bright,main,7,0.9708094117239687,287,87,5,379
20388,bright,main,8,0.9727626384797363,352,73,6,431
20388,bright,main,9,0.9577074927189643,356,74,4,434
20389,bright,main,0,0.9473608202415872,299,134,2,435
20389,bright,main,1,0.9777522795160505,292,108,2,402
20389,bright,main,2,0.9693213620547021,294,133,7,434
20389,bright,main,3,0.9633456996640675,268,132,3,403
20389,bright,main,4,0.9468427736208392,297,96,4,397
20389,bright,main,5,0.9430851276525202,316,97,7,420
20389,bright,main,6,0.9771307315003699,276,88,4,368
20389,bright,main,7,0.9508332237038414,249,94,8,351
20389,bright,main,8,0.977271361800004,233,188,3,424
20389,bright,main,9,0.9611285678606065,282,140,6,428
20390,bright,main,0,0.9798898640382145,340,95,3,438
20390,bright,main,1,0.975356677894036,296,101,4,401
20390,bright,main,2,0.9717213999655535,349,81,2,432
20390,bright,main,3,0.9542804510056202,302,95,5,402
20390,bright,main,4,0.945979834594539,333,69,2,404
20390,bright,main,5,0.9741832388789408,337,85,4,426
20390,bright,main,6,0.9608370061997892,278,86,3,367
20390,bright,main,7,0.9639624417713482,267,90,8,365
20390,bright,main,8,0.9492059202816779,295,129,2,426
20390,bright,main,9,0.9744827747238902,332,89,8,429
20391,bright,main,0,0.9520285631894186,310,126,4,440
20391,bright,main,1,0.9518119627352325,293,105,2,400
20391,bright,main,2,0.9567273595101683,304,119,4,427
20391,bright,main,3,0.9637424354936782,281,114,3,398
20391,bright,main,4,0.967190408221121,277,117,7,401
20391,bright,main,5,0.9475352119839964,280,142,3,425
20391,bright,main,6,0.9696859443289425,270,94,3,367
20391,bright,main,7,0.9429683291039046,248,102,3,353
20391,bright,main,8,0.9587667949213581,337,82,1,420
20391,bright,main,9,0.9539636162695748,326,94,2,422
20392,bright,main,0,0.9580904688180825,327,97,8,432
20392,bright,main,1,0.9372938717182233,297,101,4,402
20392,bright,main,2,0.9379964090907443,315,108,6,429
20392,bright,main,3,0.968842778310668,264,111,4,379
20392,bright,main,4,0.9541205696027975,288,81,6,375
20392,bright,main,5,0.9262800483661902,334,85,3,422
20392,bright,main,6,0.9468821481444054,282,81,4,367
20392,bright,main,7,0.9707673062200728,291,74,4,369
20392,bright,main,8,0.9636242623460098,321,104,4,429
20392,bright,main,9,0.9636242623460098,321,104,4,429
20393,bright,main,0,0.9635876468753858,305,127,3,435
20393,bright,main,1,0.9619210442610404,282,117,5,404
20393,bright,main,2,0.9716469568250404,301,127,4,432
20393,bright,main,3,0.9575541624795932,283,108,7,398
20393,bright,main,4,0.9691683320195671,261,113,8,382
20393,bright,main,5,0.969030317477609,309,110,2,421
20393,bright,main,6,0.9632524679307158,291,77,3,371
20393,bright,main,7,0.9237687346061635,248,103,3,354
20393,bright,main,8,0.9611949019963199,301,112,3,416
20393,bright,main,9,0.9611153462433654,280,135,3,418
20394,bright,main,0,0.9742976809147325,299,138,3,440
20394,bright,main,1,0.9511910011303277,259,140,7,406
20394,bright,main,2,0.9261954494367822,325,102,4,431
20394,bright,main,3,0.9173043646465125,319,80,1,400
20394,bright,main,4,0.9682235753627846,324,73,7,404
20394,bright,main,5,0.9620291894418063,357,65,3,425
20394,bright,main,6,0.972887369908875,299,76,0,375
20394,bright,main,7,0.9763232821981888,265,99,3,367
20394,bright,main,8,0.9637436466481576,297,126,5,428
20394,bright,main,9,0.9770061099109005,315,112,3,430
20395,bright,main,0,0.9518769651680821,372,48,5,425
20395,bright,main,1,0.9761810284348392,359,44,0,403
20395,bright,main,2,0.9655664764445032,362,68,4,434
20395,bright,main,3,0.9290999246533552,285,107,8,400
20395,bright,main,4,0.9597971036507843,330,73,6,409
20395,bright,main,5,0.950733596501635,317,96,2,415
20395,bright,main,6,0.9560982977296365,276,82,6,364
20395,bright,main,7,0.9597360515774727,280,67,0,347
20395,bright,main,8,0.9643687188147261,356,65,2,423
20395,bright,main,9,0.9676533400096574,351,77,1,429
20396,bright,main,0,0.9666773761242256,363,77,4,444
20396,bright,main,1,0.9413472726783119,341,66,0,407
20396,bright,main,2,0.9678098415227954,371,63,6,440
20396,bright,main,3,0.966302982727408,316,88,2,406
20396,bright,main,4,0.9369487572512412,329,87,7,423
20396,bright,main,5,0.9726578119298293,349,80,2,431
20396,bright,main,6,0.9696926488138041,281,84,4,369
20396,bright,main,7,0.967055817816844,288,89,1,378
20396,bright,main,8,0.9843524702310095,308,117,4,429
20396,bright,main,9,0.9575365702168603,344,81,7,432
20397,bright,main,0,0.9684444437093087,335,102,2,439
20397,bright,main,1,0.9818289463025366,315,93,0,408
20397,bright,main,2,0.971352509074485,347,83,2,432
20397,bright,main,3,0.9661049925230862,302,90,5,397
20397,bright,main,4,0.9659740557079858,335,67,3,405
20397,bright,main,5,0.957145534338511,341,82,2,425
20397,bright,main,6,0.9526682503875269,304,55,5,364
20397,bright,main,7,0.950884324229436,300,64,3,367
20397,bright,main,8,0.9678831526077065,314,93,4,411
20397,bright,main,9,0.9723135308093914,324,106,3,433
20398,bright,main,0,0.9634318633363935,257,165,6,428
20398,bright,main,1,0.9290513945187134,277,120,5,402
20398,bright,main,2,0.943036975529447,299,128,3,430
20398,bright,main,3,0.9539828372717886,247,156,1,404
20398,bright,main,4,0.9730195452041062,291,120,1,412
20398,bright,main,5,0.9677783138188756,281,135,6,422
20398,bright,main,6,0.9444568798845133,271,98,2,371
20398,bright,main,7,0.9502299409135104,219,130,3,352
20398,bright,main,8,0.9774602363663151,323,100,3,426
20398,bright,main,9,0.9628180378309963,304,106,4,414
20399,bright,main,0,0.9539600487978726,347,83,1,431
20399,bright,main,1,0.9671843630692736,294,105,3,402
20399,bright,main,2,0.9744499857113691,334,96,5,435
20399,bright,main,3,0.9504251154170463,328,68,3,399
20399,bright,main,4,0.9657718468536782,330,73,5,408
20399,bright,main,5,0.9584243977876671,321,91,9,421
20399,bright,main,6,0.9520501916789111,286,76,6,368
20399,bright,main,7,0.9356166451932229,255,94,2,351
20399,bright,main,8,0.9537104768088752,320,111,2,433
20399,bright,main,9,0.9663385217397611,316,108,6,430
20400,bright,main,0,0.9785670574036222,344,90,4,438
20400,bright,main,1,0.9533828501348655,299,97,4,400
20400,bright,main,2,0.942549147081414,326,109,2,437
20400,bright,main,3,0.9689894414421995,307,90,2,399
20400,bright,main,4,0.9837305231692459,320,85,4,409
20400,bright,main,5,0.9650847728010798,359,56,6,421
20400,bright,main,6,0.9245962676743472,293,71,3,367
20400,bright,main,7,0.9462967200674203,279,84,3,366
20400,bright,main,8,0.9614119176539178,327,87,8,422
20400,bright,main,9,0.97040590903806,356,73,3,432
20401,bright,main,0,0.9350915624333069,310,125,5,440
20401,bright,main,1,0.9575276647445531,304,95,4,403
20401,bright,main,2,0.9756001473146361,325,104,6,435
20401,bright,main,3,0.9610073743163342,319,77,3,399
20401,bright,main,4,0.9583120376818717,337,68,4,409
20401,bright,main,5,0.9577009187923029,342,71,2,415
20401,bright,main,6,0.9719239843885515,280,91,1,372
20401,bright,main,7,0.9470227563224911,284,77,3,364
20401,bright,main,8,0.9473445498595451,300,127,2,429
20401,bright,main,9,0.9770532486986305,313,116,3,432
20402,bright,main,0,0.968478608880802,326,106,2,434
20402,bright,main,1,0.9555937173354143,299,100,3,402
20402,bright,main,2,0.9573049721559413,352,72,5,429
20402,bright,main,3,0.9727118338725649,314,83,4,401
20402,bright,main,4,0.9632964150927568,301,98,4,403
20402,bright,main,5,0.9790078159599469,320,94,7,421
20402,bright,main,6,0.9654331882972953,288,77,3,368
20402,bright,main,7,0.9697140644829156,270,76,4,350
20402,bright,main,8,0.9528760023914432,290,128,7,425
20402,bright,main,9,0.9473190161658123,337,89,6,432
20403,bright,main,0,0.9637482787220413,303,135,0,438
20403,bright,main,1,0.9549537375344984,310,92,1,403
20403,bright,main,2,0.9670195778284976,317,114,1,432
20403,bright,main,3,0.9675891084771245,300,99,1,400
20403,bright,main,4,0.9624769875635477,323,82,4,409
20403,bright,main,5,0.9737147041455914,353,67,5,425
20403,bright,main,6,0.9588539443809361,317,50,3,370
20403,bright,main,7,0.9306719336457965,299,66,4,369
20403,bright,main,8,0.9697881717213201,330,91,5,426
20403,bright,main,9,0.9632178092337471,338,90,2,430
20404,bright,main,0,0.9778333440256656,315,113,2,430
20404,bright,main,1,0.9534673915673685,300,86,9,395
20404,bright,main,2,0.9591026339132656,311,119,0,430
20404,bright,main,3,0.9617251575831159,280,113,5,398
20404,bright,main,4,0.9496801693857407,289,112,7,408
20404,bright,main,5,0.965206452955192,294,124,4,422
20404,bright,main,6,0.9332640564139513,266,95,5,366
20404,bright,main,7,0.9496965048725136,249,96,3,348
20404,bright,main,8,0.961257644360791,330,92,4,426
20404,bright,main,9,0.9626155030274155,328,90,4,422
20405,bright,main,0,0.9554313276434645,339,94,8,441
20405,bright,main,1,0.9561457584733459,304,92,8,404
20405,bright,main,2,0.9545970554032686,341,88,5,434
20405,bright,main,3,0.93661825167081,307,92,3,402
20405,bright,main,4,0.951281208281047,264,79,7,350
20405,bright,main,5,0.9662081638862794,334,89,3,426
20405,bright,main,6,0.9721391563992734,280,91,2,373
20405,bright,main,7,0.9433057593614611,276,86,0,362
20405,bright,main,8,0.9702180759940341,341,82,5,428
20405,bright,main,9,0.9457295754716124,338,94,5,437
20406,bright,main,0,0.9655279077114551,314,114,6,434
20406,bright,main,1,0.9626811716242238,293,108,4,405
20406,bright,main,2,0.9554285050005304,311,116,5,432
20406,bright,main,3,0.9647692201194761,291,109,6,406
20406,bright,main,4,0.9632083850343188,300,106,4,410
20406,bright,main,5,0.9487741458495181,339,82,5,426
20406,bright,main,6,0.9540147727565381,275,97,4,376
20406,bright,main,7,0.968780588416306,270,97,2,369
20406,bright,main,8,0.9514620873080417,310,113,3,426
20406,bright,main,9,0.9674937766017616,331,99,4,434
20407,bright,main,0,0.9670232584221012,365,74,2,441
20407,bright,main,1,0.9507553793772853,326,74,5,405
20407,bright,main,2,0.9844784945025931,351,97,1,449
20407,bright,main,3,0.9696676377455199,332,72,3,407
20407,bright,main,4,0.9474875115691349,335,82,2,419
20407,bright,main,5,0.9489080721450159,319,106,3,428
20407,bright,main,6,0.9611414617845876,303,72,0,375
20407,bright,main,7,0.9654377280222298,314,64,1,379
20407,bright,main,8,0.9752980318601593,342,92,2,436
20407,bright,main,9,0.953250699734093,360,70,5,435
20408,bright,main,0,0.9667094523460734,321,122,3,446
20408,bright,main,1,0.9576855057816066,297,104,3,404
20408,bright,main,2,0.9670691372953303,351,86,2,439
20408,bright,main,3,0.9636029299788161,288,109,5,402
20408,bright,main,4,0.9681148358307645,329,87,5,421
20408,bright,main,5,0.9686821704476439,331,98,3,432
20408,bright,main,6,0.9638948495730019,304,68,2,374
20408,bright,main,7,0.9703495454841856,295,77,3,375
20408,bright,main,8,0.9805904875339376,329,101,3,433
20408,bright,main,9,0.9794865105631753,287,147,3,437
20409,bright,main,0,0.9718137638595797,357,93,1,451
20409,bright,main,1,0.9469088846445989,307,90,6,403
20409,bright,main,2,0.9591173162699899,350,88,2,440
20409,bright,main,3,0.9532137028016576,345,57,1,403
20409,bright,main,4,0.9754835296537967,344,68,3,415
20409,bright,main,5,0.9704244628947488,367,62,3,432
20409,bright,main,6,0.943773588252934,312,58,2,372
20409,bright,main,7,0.9512300216888245,299,70,5,374
20409,bright,main,8,0.9665252748056705,349,78,3,430
20409,bright,main,9,0.9705331245261172,332,106,2,440
20410,bright,main,0,0.9762078311853042,397,40,4,441
20410,bright,main,1,0.9702857865310508,330,71,4,405
20410,bright,main,2,0.9629126020351961,345,81,1,427
20410,bright,main,3,0.9680856755733407,331,66,6,403
20410,bright,main,4,0.9639504029000641,329,71,1,401
20410,bright,main,5,0.9737774944270166,334,79,6,419
20410,bright,main,6,0.957701385120603,304,59,0,363
20410,bright,main,7,0.9525288969020345,287,78,3,368
20410,bright,main,8,0.9628199846860785,341,83,2,426
20410,bright,main,9,0.9859532221730154,333,93,5,431
20411,bright,main,0,0.9673229804374556,321,114,2,437
20411,bright,main,1,0.9539569999448028,316,85,3,404
20411,bright,main,2,0.9677854675963006,323,100,5,428
20411,bright,main,3,0.9790872051594619,275,126,2,403
20411,bright,main,4,0.9635147557645447,304,102,3,409
20411,bright,main,5,0.8672808060392377,101,37,3,141
20411,bright,main,6,0.9339892231955395,262,101,6,369
20411,bright,main,7,0.9761332849875428,257,86,2,345
20411,bright,main,8,0.9726046612534384,290,136,4,430
20411,bright,main,9,0.958658795508679,274,142,6,422
20412,bright,main,0,0.9676179072058001,341,89,6,436
20412,bright,main,1,0.9769631782595817,311,89,5,405
20412,bright,main,2,0.9686636809677623,317,119,4,440
20412,bright,main,3,0.9598151302267873,322,76,4,402
20412,bright,main,4,0.964226903632814,335,69,3,407
20412,bright,main,5,0.9738888823144023,302,119,4,425
20412,bright,main,6,0.9589450264677276,259,99,7,365
20412,bright,main,7,0.9584050522791856,251,113,2,366
20412,bright,main,8,0.9448300502663391,313,104,1,418
20412,bright,main,9,0.9448300502663391,313,104,1,418
20413,bright,main,0,0.9535269301183926,307,121,4,432
20413,bright,main,1,0.978811806315153,284,112,2,398
20413,bright,main,2,0.9687282545372525,322,105,3,430
20413,bright,main,3,0.9651848436495424,308,86,4,398
20413,bright,main,4,0.9354235031432325,327,81,0,408
20413,bright,main,5,0.9653967974262155,344,68,8,420
20413,bright,main,6,0.9324258754317696,292,78,0,370
20413,bright,main,7,0.955652148079643,237,106,8,351
20413,bright,main,8,0.9769852393131894,320,96,5,421
20413,bright,main,9,0.9660896039470506,271,113,4,388
20414,bright,main,0,0.9431714291204109,319,112,3,434
20414,bright,main,1,0.9731219929888284,286,113,6,405
20414,bright,main,2,0.9534799152175167,327,108,3,438
20414,bright,main,3,0.9299030066356313,305,92,3,400
20414,bright,main,4,0.9540020206029692,324,86,2,412
20414,bright,main,5,0.9594524763991565,319,98,3,420
20414,bright,main,6,0.9561633131799877,309,61,2,372
20414,bright,main,7,0.9634571661352251,257,86,5,348
20414,bright,main,8,0.97956285469642,300,116,4,420
20414,bright,main,9,0.97956285469642,300,116,4,420
20415,bright,main,0,0.969414512728105,327,118,1,446
20415,bright,main,1,0.9673523318567,301,98,5,404
20415,bright,main,2,0.9707603782306471,323,111,0,434
20415,bright,main,3,0.9571513938536306,319,69,8,396
20415,bright,main,4,0.9506077761440664,322,80,5,407
20415,bright,main,5,0.9635897550310089,330,91,2,423
20415,bright,main,6,0.9663687826702928,313,53,2,368
20415,bright,main,7,0.9674249402173658,281,78,4,363
20415,bright,main,8,0.9478299114483091,309,117,1,427
20415,bright,main,9,0.9720215020218055,317,104,10,431
20416,bright,main,0,0.971286894454576,352,82,1,435
20416,bright,main,1,0.9528163872992664,338,64,4,406
20416,bright,main,2,0.9641383283518341,376,48,3,427
20416,bright,main,3,0.9785956571557732,300,95,3,398
20416,bright,main,4,0.9573669848717946,314,85,7,406
20416,bright,main,5,0.9433307092908889,327,90,6,423
20416,bright,main,6,0.9673977587474143,326,45,1,372
20416,bright,main,7,0.9786064284490618,301,51,1,353
20416,bright,main,8,0.9723849612070855,355,70,4,429
20416,bright,main,9,0.9620266579420911,355,71,4,430
20417,bright,main,0,0.9642218472886258,378,57,1,436
20417,bright,main,1,0.9665009409772721,334,63,8,405
20417,bright,main,2,0.9591395087678618,339,83,5,427
20417,bright,main,3,0.97796452569629,313,81,3,397
20417,bright,main,4,0.9704183185916567,318,87,1,406
20417,bright,main,5,0.9666137173442592,341,76,5,422
20417,bright,main,6,0.9658828594364469,272,101,0,373
20417,bright,main,7,0.9435213501548552,253,113,1,367
20417,bright,main,8,0.9718043503824565,333,90,3,426
20417,bright,main,9,0.9736492523748035,338,79,3,420
20418,bright,main,0,0.9441371589519079,344,95,5,444
20418,bright,main,1,0.9705948609238164,332,69,3,404
20418,bright,main,2,0.9722531590134182,336,97,4,437
20418,bright,main,3,0.9492827105470522,312,80,5,397
20418,bright,main,4,0.9566942219366733,283,81,1,365
20418,bright,main,5,0.9648417586897424,328,88,4,420
20418,bright,main,6,0.9695923592355136,284,82,2,368
20418,bright,main,7,0.9436307958210945,253,101,3,357
20418,bright,main,8,0.9615926824549618,329,97,3,429
20418,bright,main,9,0.9632517315394875,340,95,0,435
20419,bright,main,0,0.9582569001669041,343,104,2,449
20419,bright,main,1,0.9622520535655682,334,62,5,401
20419,bright,main,2,0.9765333027772957,356,84,4,444
20419,bright,main,3,0.9643335983664342,320,84,3,407
20419,bright,main,4,0.9596417330330415,357,50,3,410
20419,bright,main,5,0.9601686766010847,348,80,4,432
20419,bright,main,6,0.9812692282137085,316,55,3,374
20419,bright,main,7,0.9608833855712257,308,65,4,377
20419,bright,main,8,0.9449877109967132,358,71,3,432
20419,bright,main,9,0.9399932653770133,354,79,5,438
20420,bright,main,0,0.9493325086848182,348,94,3,445
20420,bright,main,1,0.967696690093498,322,76,6,404
20420,bright,main,2,0.9459606784530822,373,70,2,445
20420,bright,main,3,0.9719019606743146,334,73,2,409
20420,bright,main,4,0.9658335961381604,357,60,1,418
20420,bright,main,5,0.9518090846046768,350,79,1,430
20420,bright,main,6,0.923774467959249,304,61,4,369
20420,bright,main,7,0.9707238479154877,301,72,2,375
20420,bright,main,8,0.9461347544781366,348,81,3,432
20420,bright,main,9,0.9636914937379103,318,111,3,432
20421,bright,main,0,0.9455141741654259,357,81,4,442
20421,bright,main,1,0.970487474371978,319,84,5,408
20421,bright,main,2,0.9586197782088319,356,81,3,440
20421,bright,main,3,0.9626507538215716,331,68,2,401
20421,bright,main,4,0.9519277315155377,336,78,3,417
20421,bright,main,5,0.9359062333408825,346,84,2,432
20421,bright,main,6,0.9565877782619624,287,81,2,370
20421,bright,main,7,0.944219006107343,299,70,4,373
20421,bright,main,8,0.9661128514125692,301,119,2,422
20421,bright,main,9,0.9563393478503736,309,123,3,435
20422,bright,main,0,0.9637339905578047,320,114,2,436
20422,bright,main,1,0.9530401828761167,308,95,1,404
20422,bright,main,2,0.948788842247019,341,83,3,427
20422,bright,main,3,0.9444881321195737,319,83,2,404
20422,bright,main,4,0.9485936221602489,334,77,3,414
20422,bright,main,5,0.9685485406100124,327,90,5,422
20422,bright,main,6,0.9570723563395691,278,92,3,373
20422,bright,main,7,0.9519882799020161,282,82,4,368
20422,bright,main,8,0.9695571839605215,329,92,2,423
20422,bright,main,9,0.9613095566560689,313,113,3,429
20423,bright,main,0,0.9701104322322429,325,96,3,424
20423,bright,main,1,0.9611120012333726,291,117,0,408
20423,bright,main,2,0.9522396750034302,354,73,0,427
20423,bright,main,3,0.9646825680709233,337,61,3,401
20423,bright,main,4,0.9665771333209038,316,90,1,407
20423,bright,main,5,0.96097821287467,322,99,1,422
20423,bright,main,6,0.946640136059382,285,78,3,366
20423,bright,main,7,0.954678773573805,286,62,7,355
20423,bright,main,8,0.9661688605106971,344,82,1,427
20423,bright,main,9,0.9555524881370844,341,79,2,422
20424,bright,main,0,0.9757168016157883,339,89,2,430
20424,bright,main,1,0.9585778051606334,310,93,4,407
20424,bright,main,2,0.9724179081875289,322,99,8,429
20424,bright,main,3,0.9463614538952054,301,99,2,402
20424,bright,main,4,0.9474420484740435,288,90,2,380
20424,bright,main,5,0.9701313117610877,296,119,6,421
20424,bright,main,6,0.9582749495795224,283,81,4,368
20424,bright,main,7,0.9624604171199669,273,85,3,361
20424,bright,main,8,0.9751160192353785,355,59,0,414
20424,bright,main,9,0.9641691683183633,350,79,2,431
20425,bright,main,0,0.981432728878276,340,86,2,428
20425,bright,main,1,0.9689383711080989,291,98,5,394
20425,bright,main,2,0.9532331794475929,242,80,1,323
20425,bright,main,3,0.9597922114043463,281,112,2,395
20425,bright,main,4,0.9427529936648134,262,98,3,363
20425,bright,main,5,0.9463366931161101,320,97,2,419
20425,bright,main,6,0.9520118138775159,290,77,4,371
20425,bright,main,7,0.960160664366157,293,67,2,362
20425,bright,main,8,0.9425475214783581,327,79,6,412
20425,bright,main,9,0.9549916948810641,320,98,3,421
20427,bright,main,0,0.965737062456175,324,101,8,433
20427,bright,main,1,0.9495794828877164,301,97,6,404
20427,bright,main,2,0.9359730531905796,296,122,6,424
20427,bright,main,3,0.9582424160535784,270,128,1,399
20427,bright,main,4,0.9705551103759412,282,74,4,360
20427,bright,main,5,0.9537826131746846,320,85,7,412
20427,bright,main,6,0.9437633622398786,263,96,5,364
20427,bright,main,7,0.9639064987294839,270,88,2,360
20427,bright,main,8,0.9644673677423786,320,93,4,417
20427,bright,main,9,0.9684315481175818,301,130,3,434
20428,bright,main,0,0.9733127847869136,323,109,2,434
20428,bright,main,1,0.9510475274091611,281,117,3,401
20428,bright,main,2,0.9668026363341166,320,104,6,430
20428,bright,main,3,0.9619751337741584,320,76,6,402
20428,bright,main,4,0.9670788456853435,320,55,4,379
20428,bright,main,5,0.9508137330977764,297,99,2,398
20428,bright,main,6,0.9279832588961843,260,92,4,356
20428,bright,main,7,0.9366508278772887,259,99,2,360
20428,bright,main,8,0.9660765860613536,283,139,4,426
20428,bright,main,9,0.9547777023714509,303,122,1,426
20429,bright,main,0,0.9717222062735977,317,120,3,440
20429,bright,main,1,0.9671543736068359,286,114,5,405
20429,bright,main,2,0.954487951853299,318,113,3,434
20429,bright,main,3,0.9778797414509133,288,108,6,402
20429,bright,main,4,0.9465198408978516,311,87,6,404
20429,bright,main,5,0.935591839517274,300,103,3,406
20429,bright,main,6,0.9490094902944582,245,116,5,366
20429,bright,main,7,0.9684509252050126,254,98,3,355
20429,bright,main,8,0.9787162607948433,302,110,4,416
20429,bright,main,9,0.9698559800763685,295,132,4,431
20430,bright,main,0,0.9487253932770191,340,91,4,435
20430,bright,main,1,0.9662735435771109,256,114,3,373
20430,bright,main,2,0.9568265073024483,311,120,1,432
20430,bright,main,3,0.9585507577132139,295,106,2,403
20430,bright,main,4,0.9668717701949664,279,81,5,365
20430,bright,main,5,0.9431575896978804,335,78,5,418
20430,bright,main,6,0.9607356022928508,287,76,1,364
20430,bright,main,7,0.9520821129199029,267,90,2,359
20430,bright,main,8,0.9556701116477418,352,73,2,427
20430,bright,main,9,0.9556411341262657,358,72,1,431
20431,bright,main,0,0.9670028120142624,329,96,5,430
20431,bright,main,1,0.9658487100627053,318,79,6,403
20431,bright,main,2,0.978606401277375,343,87,4,434
20431,bright,main,3,0.960842607827001,320,77,2,399
20431,bright,main,4,0.9532750776766636,313,86,4,403
20431,bright,main,5,0.9709691971699757,337,78,3,418
20431,bright,main,6,0.9796214805022119,295,68,2,365
20431,bright,main,7,0.9460549083969583,289,60,1,350
20431,bright,main,8,0.9374351316708033,337,83,1,421
20431,bright,main,9,0.9684608313726629,312,113,1,426
20432,bright,main,0,0.9672757933364377,370,62,2,434
20432,bright,main,1,0.956262859316576,301,101,3,405
20432,bright,main,2,0.9476162654442842,303,121,6,430
20432,bright,main,3,0.9538937900195323,312,77,2,391
20432,bright,main,4,0.9551829762728063,349,56,5,410
20432,bright,main,5,0.955492214615867,382,35,3,420
20432,bright,main,6,0.9683406566481635,312,55,2,369
20432,bright,main,7,0.9273281746650999,289,55,4,348
20432,bright,main,8,0.9661688605106971,357,65,4,426
20432,bright,main,9,0.9545432080295055,350,77,4,431
20433,bright,main,0,0.9463394619263363,287,130,5,422
20433,bright,main,1,0.9626860303864909,260,139,4,403
20433,bright,main,2,0.9640659778068565,341,91,1,433
20433,bright,main,3,0.9681213158198383,271,126,6,403
20433,bright,main,4,0.9754124742976342,269,139,2,410
20433,bright,main,5,0.9795576329473706,294,128,4,426
20433,bright,main,6,0.9638564975686186,224,146,3,373
20433,bright,main,7,0.9835610569017149,196,165,6,367
20433,bright,main,8,0.9623278504631015,244,133,1,378
20433,bright,main,9,0.9250274954098896,173,93,2,268
20502,bright,main,0,0.979355382291981,372,64,1,437
20502,bright,main,1,0.9341046033570656,312,86,3,401
20502,bright,main,2,0.9722801346571787,333,92,4,429
20502,bright,main,3,0.9697580114817622,297,91,5,393
20502,bright,main,4,0.9599151728097488,307,96,3,406
20502,bright,main,5,0.9754124742976342,326,78,7,411
20502,bright,main,6,0.9430827798732515,272,91,3,366
20502,bright,main,7,0.9713013466263231,269,97,2,368
20502,bright,main,8,0.9779591451198955,308,112,1,421
20502,bright,main,9,0.9647904624197503,354,77,2,433
20503,bright,main,0,0.9690071444133392,336,102,3,441
20503,bright,main,1,0.9665422095216338,312,90,3,405
20503,bright,main,2,0.9483578598938264,327,99,5,431
20503,bright,main,3,0.9640520780826569,297,95,5,397
20503,bright,main,4,0.9473652470769504,307,94,3,404
20503,bright,main,5,0.9669856692937249,344,72,4,420
20503,bright,main,6,0.9715509695654891,303,59,1,363
20503,bright,main,7,0.9558399052419067,284,60,7,351
20503,bright,main,8,0.9689060957946279,361,63,5,429
20503,bright,main,9,0.9755295566388865,344,75,4,423
20504,bright,main,0,0.9757619809378842,331,106,4,441
20504,bright,main,1,0.9604709971779763,303,100,2,405
20504,bright,main,2,0.951139852886352,344,89,1,434
20504,bright,main,3,0.9515703195087418,330,68,4,402
20504,bright,main,4,0.9562719283371062,347,61,4,412
20504,bright,main,5,0.9724410206702433,354,69,3,426
20504,bright,main,6,0.9498121829626641,306,51,3,360
20504,bright,main,7,0.9576620400146455,288,77,3,368
20504,bright,main,8,0.9517253832859897,346,76,3,425
20504,bright,main,9,0.9333187153930396,342,79,4,425
20505,bright,main,0,0.9684930305792838,359,72,4,435
20505,bright,main,1,0.954158072757354,321,73,4,398
20505,bright,main,2,0.9550724018357634,348,70,8,426
20505,bright,main,3,0.9747041017835694,298,85,11,394
20505,bright,main,4,0.9762579903981031,295,104,4,403
20505,bright,main,5,0.9745014780273973,307,108,8,423
20505,bright,main,6,0.9699279564139659,257,102,6,365
20505,bright,main,7,0.9603750405038053,278,81,5,364
20505,bright,main,8,0.9734004837439189,329,90,3,422
20505,bright,main,9,0.9662836820915998,350,71,5,426
20506,bright,main,0,0.9629978320740518,334,97,5,436
20506,bright,main,1,0.9543742219167338,304,92,2,398
20506,bright,main,2,0.9640510678175419,315,110,2,427
20506,bright,main,3,0.9781867816927402,296,89,11,396
20506,bright,main,4,0.9526549161397196,303,98,5,406
20506,bright,main,5,0.9500231028931224,353,71,0,424
20506,bright,main,6,0.9713632584032181,274,93,4,371
20506,bright,main,7,0.9472503604404308,260,96,5,361
20506,bright,main,8,0.9632925681148881,332,89,2,423
20506,bright,main,9,0.9638772325485051,304,115,7,426
20507,bright,main,0,0.9562485154971931,378,72,1,451
20507,bright,main,1,0.9395074120232243,310,92,4,406
20507,bright,main,2,0.9765234258568962,339,98,5,442
20507,bright,main,3,0.9720738471058215,308,97,1,406
20507,bright,main,4,0.9595402297801605,320,98,4,422
20507,bright,main,5,0.950734509741952,358,67,5,430
20507,bright,main,6,0.9439210163318043,293,75,5,373
20507,bright,main,7,0.9502611788494136,296,75,5,376
20507,bright,main,8,0.9628242109412406,330,97,3,430
20507,bright,main,9,0.9671660955193965,322,106,2,430
20508,bright,main,0,0.9557787686885311,337,94,6,437
20508,bright,main,1,0.9338493525051049,313,90,1,404
20508,bright,main,2,0.9548476777333309,326,108,1,435
20508,bright,main,3,0.979184677855704,318,78,1,397
20508,bright,main,4,0.9526433087292407,302,104,2,408
20508,bright,main,5,0.9614760493855149,306,108,5,419
20508,bright,main,6,0.9624724983191357,285,83,2,370
20508,bright,main,7,0.95895167613476,292,70,3,365
20508,bright,main,8,0.9424687249287625,356,69,2,427
20508,bright,main,9,0.9757444423173952,307,114,7,428
20510,bright,main,0,0.9485758754499016,357,81,2,440
20510,bright,main,1,0.9602317341498208,320,72,6,398
20510,bright,main,2,0.9671243929502809,356,78,2,436
20510,bright,main,3,0.9469554626508937,308,91,6,405
20510,bright,main,4,0.9610970792802905,319,86,3,408
20510,bright,main,5,0.9790615371674113,334,89,4,427
20510,bright,main,6,0.9619624084653163,270,94,2,366
20510,bright,main,7,0.9705315627231812,282,92,1,375
20510,bright,main,8,0.9653451474049894,327,99,0,426
20510,bright,main,9,0.9558803159841143,344,91,3,438
20511,bright,main,0,0.9779154021756511,325,107,5,437
20511,bright,main,1,0.9530048990320843,330,74,1,405
20511,bright,main,2,0.969921968691228,368,66,3,437
20511,bright,main,3,0.9564733975993759,316,84,3,403
20511,bright,main,4,0.938952169282828,324,91,0,415
20511,bright,main,5,0.9562487865214185,331,95,2,428
20511,bright,main,6,0.9823876981667711,255,110,4,369
20511,bright,main,7,0.9419938539381545,277,93,4,374
20511,bright,main,8,0.9709065842913401,313,108,5,426
20511,bright,main,9,0.9579907541137648,321,106,5,432
20512,bright,main,0,0.9605951354665841,371,74,4,449
20512,bright,main,1,0.972670512155798,336,62,4,402
20512,bright,main,2,0.9809786570841115,355,79,4,438
20512,bright,main,3,0.9550984794132014,316,72,8,396
20512,bright,main,4,0.9518154443509176,328,86,3,417
20512,bright,main,5,0.9431142724457892,335,87,4,426
20512,bright,main,6,0.9611803043745549,297,70,1,368
20512,bright,main,7,0.9562093626171293,281,85,5,371
20512,bright,main,8,0.9765476412602518,328,95,5,428
20512,bright,main,9,0.9655335008893328,356,73,3,432
20514,bright,main,0,0.9482859803243627,371,54,4,429
20514,bright,main,1,0.9769095074188245,329,63,5,397
20514,bright,main,2,0.9633697373393474,325,95,5,425
20514,bright,main,3,0.9611287458754667,279,108,4,391
20514,bright,main,4,0.9670413140461526,324,73,3,400
20514,bright,main,5,0.9621840735878765,318,97,3,418
20514,bright,main,6,0.9696299943104477,281,77,7,365
20514,bright,main,7,0.9600438387698494,261,87,8,356
20514,bright,main,8,0.9671173791250562,315,100,4,419
20514,bright,main,9,0.9533301836270659,315,109,2,426
20515,bright,main,0,0.9739902086365871,336,93,5,434
20515,bright,main,1,0.979734801729623,303,95,6,404
20515,bright,main,2,0.9782479067154078,335,101,4,440
20515,bright,main,3,0.9574173398884404,329,73,3,405
20515,bright,main,4,0.9494430947602885,316,96,1,413
20515,bright,main,5,0.971376280305247,315,114,2,431
20515,bright,main,6,0.9566880678402526,261,104,5,370
20515,bright,main,7,0.9443931677214665,270,103,3,376
20515,bright,main,8,0.968079557173606,338,85,1,424
20515,bright,main,9,0.9777636481034747,339,89,6,434
20548,bright,main,0,0.9565127433050157,381,59,4,444
20548,bright,main,1,0.9634145616922474,316,70,3,389
20548,bright,main,2,0.9507773843936858,323,90,5,418
20548,bright,main,3,0.9760641482791848,327,56,8,391
20548,bright,main,4,0.9631239505631156,355,49,4,408
20548,bright,main,5,0.9461287958175084,344,67,0,411
20548,bright,main,6,0.9666882214085368,289,65,2,356
20548,bright,main,7,0.9386033060324857,276,81,4,361
20548,bright,main,8,0.9604571009113051,333,83,5,421
20548,bright,main,9,0.9589765746533616,333,80,8,421
20572,bright,main,0,0.9725819380778448,358,63,6,427
20572,bright,main,1,0.9496020289301459,324,61,2,387
20572,bright,main,2,0.9399303546609679,368,57,1,426
20572,bright,main,3,0.9711948231993804,322,72,0,394
20572,bright,main,4,0.9245267525152383,224,45,1,270
20572,bright,main,5,0.9694288587720288,345,57,6,408
20572,bright,main,6,0.9338436418531887,291,65,3,359
20572,bright,main,7,0.9569578799086794,305,44,7,356
20572,bright,main,8,0.9456223448162054,345,64,6,415
20572,bright,main,9,0.9629421038704834,340,67,5,412
20573,bright,main,0,0.9720629084793292,363,65,5,433
20573,bright,main,1,0.97888209291984,342,47,6,395
20573,bright,main,2,0.9743379218890864,341,72,5,418
20573,bright,main,3,0.9546903839376566,327,57,9,393
20573,bright,main,4,0.982653635832624,326,69,3,398
20573,bright,main,5,0.9310547498201078,344,61,3,408
20573,bright,main,6,0.9149778165132745,341,29,0,370
20573,bright,main,7,0.966057748429239,289,60,5,354
20573,bright,main,8,0.9627285637954628,345,60,8,413
20573,bright,main,9,0.958287774591512,351,66,0,417
20574,bright,main,0,0.956501773213085,371,55,5,431
20574,bright,main,1,0.9279473194220726,333,63,2,398
20574,bright,main,2,0.9671512857262891,347,68,4,419
20574,bright,main,3,0.9601645642785628,297,78,4,379
20574,bright,main,4,0.9199396652277344,211,49,1,261
20574,bright,main,5,0.9191790988477628,340,65,3,408
20574,bright,main,6,0.9737089388187211,275,83,5,363
20574,bright,main,7,0.9374386317856246,274,70,2,346
20574,bright,main,8,0.9824794734841859,335,78,3,416
20574,bright,main,9,0.9786564562390432,353,67,2,422
20575,bright,main,0,0.9656527115184119,361,61,4,426
20575,bright,main,1,0.9482413581006338,315,66,6,387
20575,bright,main,2,0.9683259565794344,359,65,3,427
20575,bright,main,3,0.9601162942719506,329,58,2,389
20575,bright,main,4,0.9068198351626428,217,49,3,269
20575,bright,main,5,0.9585757221050741,348,60,5,413
20575,bright,main,6,0.9450923911871988,287,67,6,360
20575,bright,main,7,0.9698495516293434,296,55,2,353
20575,bright,main,8,0.9807271049741494,356,60,5,421
20575,bright,main,9,0.9695571839605215,347,67,6,420
20576,bright,main,0,0.967496200859354,329,97,0,426
20576,bright,main,1,0.9654883119825378,325,62,3,390
20576,bright,main,2,0.9659564576529924,337,76,3,416
20576,bright,main,3,0.9704491700541217,323,63,3,389
20576,bright,main,4,0.9663557387333479,194,75,2,271
20576,bright,main,5,0.949758347427696,307,78,11,396
20576,bright,main,6,0.9629463076769893,305,50,4,359
20576,bright,main,7,0.9615247553686477,293,50,8,351
20576,bright,main,8,0.9647433827924904,333,70,3,406
20576,bright,main,9,0.9662490230788092,371,50,2,423
20581,bright,main,0,0.9420254867543919,383,44,2,429
20581,bright,main,1,0.9643252110321614,341,49,4,394
20581,bright,main,2,0.9543948617341186,333,81,1,415
20581,bright,main,3,0.9688056021104573,313,70,4,387
20581,bright,main,4,0.9807679992282237,327,66,2,395
20581,bright,main,5,0.945631130155361,362,46,5,413
20581,bright,main,6,0.9638931924187887,309,52,5,366
20581,bright,main,7,0.9469387774239155,286,62,2,350
20581,bright,main,8,0.9527018093396478,354,47,3,404
20581,bright,main,9,0.9693816771985132,374,44,3,421
20582,bright,main,0,0.9774369378599423,365,57,8,430
20582,bright,main,1,0.9324420981347554,300,86,2,388
20582,bright,main,2,0.9559108113389715,364,57,5,426
20582,bright,main,3,0.9458002172921613,333,56,3,392
20582,bright,main,4,0.9712512937415732,310,80,3,393
20582,bright,main,5,0.981200809560335,352,59,2,413
20582,bright,main,6,0.9093877243163198,299,57,3,359
20582,bright,main,7,0.956277710129133,328,36,3,367
20582,bright,main,8,0.9580443922600745,359,51,5,415
20582,bright,main,9,0.9696649715879909,327,88,3,418
20584,bright,main,0,0.9637395319469984,384,51,1,436
20584,bright,main,1,0.9364513426038376,141,17,0,158
20584,bright,main,2,0.9548009523191123,350,64,4,418
20584,bright,main,3,0.9721389671296652,327,55,3,385
20584,bright,main,4,0.9593431168135813,323,65,6,394
20584,bright,main,5,0.9500014620690487,340,65,6,411
20584,bright,main,6,0.9770330551761381,292,62,4,358
20584,bright,main,7,0.9653458559566084,314,48,1,363
20584,bright,main,8,0.9606891732885939,343,73,3,419
20584,bright,main,9,0.9502993775127386,372,46,2,420
20585,bright,main,0,0.9639477092458503,359,74,1,434
20585,bright,main,1,0.9703698484488229,340,55,1,396
20585,bright,main,2,0.948359267989478,356,61,8,425
20585,bright,main,3,0.9364778537981063,330,58,5,393
20585,bright,main,4,0.9467245139047112,338,58,5,401
20585,bright,main,5,0.9712810705266891,370,48,5,423
20585,bright,main,6,0.9582933910411497,290,67,5,362
20585,bright,main,7,0.9528175035224737,271,85,4,360
20585,bright,main,8,0.9601004069341296,310,95,8,413
20585,bright,main,9,0.949905474628401,331,87,4,422
20586,bright,main,0,0.9640112252820762,240,63,1,304
20586,bright,main,1,0.9377497569365808,261,65,0,326
20586,bright,main,2,0.9684611742724369,340,84,3,427
20586,bright,main,3,0.961527101919222,266,110,3,379
20586,bright,main,4,0.935767716050034,289,89,7,385
20586,bright,main,5,0.9528905942046678,313,93,4,410
20586,bright,main,6,0.947512430208854,276,85,1,362
20586,bright,main,7,0.9316135564012779,261,87,4,352
20586,bright,main,8,0.9556822441602795,337,76,4,417
20586,bright,main,9,0.957316160342964,314,82,1,397
20587,bright,main,0,0.9723318105306946,344,80,5,429
20587,bright,main,1,0.9719527541013262,303,76,5,384
20587,bright,main,2,0.9673232612953175,338,71,5,414
20587,bright,main,3,0.9635410245059823,287,95,1,383
20587,bright,main,4,0.9362793280058885,211,59,2,272
20587,bright,main,5,0.9726223833436217,347,62,8,417
20587,bright,main,6,0.9724930857344518,288,63,3,354
20587,bright,main,7,0.9348636217520445,266,80,1,347
20587,bright,main,8,0.960594757544348,315,98,4,417
20587,bright,main,9,0.9585371153545664,341,77,3,421
20588,bright,main,0,0.9728059469489114,321,109,5,435
20588,bright,main,1,0.968096652468761,298,94,2,394
20588,bright,main,2,0.97342716199468,293,115,4,412
20588,bright,main,3,0.9518036187322192,283,102,0,385
20588,bright,main,4,0.9783410319822103,343,59,1,403
20588,bright,main,5,0.947941267228659,355,56,2,413
20588,bright,main,6,0.9356938043669624,288,68,4,360
20588,bright,main,7,0.9728013223932639,263,87,2,352
20588,bright,main,8,0.9635296777176268,335,75,1,411
20588,bright,main,9,0.9676836169757951,315,95,9,419
20589,bright,main,0,0.9729725334842179,348,73,1,422
20589,bright,main,1,0.9728973259792153,305,80,6,391
20589,bright,main,2,0.9624966436295448,331,72,7,410
20589,bright,main,3,0.9360725390088456,304,77,3,384
20589,bright,main,4,0.9661809120377581,335,54,5,394
20589,bright,main,5,0.9796618586505136,350,55,3,408
20589,bright,main,6,0.9338831097123433,301,60,2,363
20589,bright,main,7,0.9463332371200217,281,67,5,353
20589,bright,main,8,0.9716185795456448,341,75,2,418
20589,bright,main,9,0.9651873638910989,357,62,2,421
20592,bright,main,0,0.9702482151012607,370,58,3,431
20592,bright,main,1,0.976996557791624,338,44,10,392
20592,bright,main,2,0.9755105792275977,368,48,8,424
20592,bright,main,3,0.9594894347473671,338,43,4,385
20592,bright,main,4,0.9578339260822488,318,71,4,393
20592,bright,main,5,0.9687702157406802,370,47,2,419
20592,bright,main,6,0.9542548416745752,339,29,0,368
20592,bright,main,7,0.9540015153635674,313,43,4,360
20592,bright,main,8,0.9635710941367694,340,71,5,416
20592,bright,main,9,0.9569127371310493,347,81,2,430
20641,bright,main,0,0.9629690935233715,354,69,3,426
20641,bright,main,1,0.9725134588305756,301,69,3,373
20641,bright,main,2,0.9664356646359276,331,58,4,393
20641,bright,main,3,0.9525199063141504,336,48,3,387
20641,bright,main,4,0.9691452858994996,322,64,4,390
20641,bright,main,5,0.9453736374914633,329,68,3,400
20641,bright,main,6,0.9675869376002039,295,53,2,350
20641,bright,main,7,0.9476620935141546,290,46,2,338
20641,bright,main,8,0.9792508300712844,369,49,3,421
20641,bright,main,9,0.9532464649070549,352,53,5,410
20646,bright,main,0,0.9659179886687462,342,63,5,410
20646,bright,main,1,0.9460264085884661,293,71,6,370
20646,bright,main,2,0.944207871399404,348,53,5,406
20646,bright,main,3,0.9448107560128476,293,67,4,364
20646,bright,main,4,0.9705416479386522,346,43,3,392
20646,bright,main,5,0.9542318166967625,323,65,1,389
20646,bright,main,6,0.963692491320278,308,42,1,351
20646,bright,main,7,0.9571791959172757,274,66,6,346
20646,bright,main,8,0.9629914715338613,349,61,4,414
20646,bright,main,9,0.9647433827924902,351,46,8,405
20654,bright,main,0,0.9740921988594227,347,67,2,416
20654,bright,main,1,0.9740921988594227,347,67,2,416
20654,bright,main,2,0.9341377113696275,372,41,2,415
20654,bright,main,3,0.9590159004425807,310,64,1,375
20654,bright,main,4,0.976263022676924,329,46,2,377
20654,bright,main,5,0.972613380735618,317,66,2,385
20654,bright,main,6,0.9658884627196631,306,46,6,358
20654,bright,main,7,0.9536657729491433,265,60,2,327
20654,bright,main,8,0.949848118412438,333,54,6,393
20654,bright,main,9,0.9650601054489041,355,50,4,409
20655,bright,main,0,0.9652718628494559,306,86,4,396
20655,bright,main,1,0.9340920026478553,295,72,6,373
20655,bright,main,2,0.9739088259098239,322,62,2,386
20655,bright,main,3,0.9598318390769198,327,50,1,378
20655,bright,main,4,0.9598318390769198,327,50,1,378
20655,bright,main,5,0.9538801110611932,322,70,1,393
20655,bright,main,6,0.9671455923921347,288,51,5,344
20655,bright,main,7,0.954903665221205,267,60,3,330
20655,bright,main,8,0.9624557836846324,349,57,2,408
20655,bright,main,9,0.9625429085091823,329,66,3,398
20728,bright,main,0,0.9663836086896209,304,102,9,415
20728,bright,main,1,0.957501750296193,278,97,4,379
20728,bright,main,2,0.9660209018804382,307,95,11,413
20728,bright,main,3,0.9477276149908986,302,73,3,378
20728,bright,main,4,0.9430788293360309,303,78,4,385
20728,bright,main,5,0.9430788293360309,303,78,4,385
20728,bright,main,6,0.9303282650495963,263,78,4,345
20728,bright,main,7,0.9706853538961376,244,82,2,328
20728,bright,main,8,0.9584083230448154,321,85,2,408
20728,bright,main,9,0.9561661539087644,306,93,10,409
20732,bright,main,0,0.9451864781264631,314,92,4,410
20732,bright,main,1,0.9459452716235345,303,83,5,391
20732,bright,main,2,0.9694823460111097,299,109,5,413
20732,bright,main,3,0.9719464544167691,323,59,4,386
20732,bright,main,4,0.9719373275180382,336,50,3,389
20732,bright,main,5,0.9719373275180382,336,50,3,389
20732,bright,main,6,0.9609440770694143,288,48,3,339
20732,bright,main,7,0.9259710043289462,253,74,4,331
20732,bright,main,8,0.973761557692064,313,85,8,406
20732,bright,main,9,0.9606873247808321,335,72,7,414
20733,bright,main,0,0.9576364714167369,333,83,4,420
20733,bright,main,1,0.9738396351457921,308,67,7,382
20733,bright,main,2,0.9453042020611652,345,62,6,413
20733,bright,main,3,0.9643496706370287,303,76,3,382
20733,bright,main,4,0.96327467030126,310,71,3,384
20733,bright,main,5,0.9387532827584448,323,68,4,395
20733,bright,main,6,0.9512016721538534,308,43,3,354
20733,bright,main,7,0.9610711539157941,255,67,7,329
20733,bright,main,8,0.9342635583404426,318,82,4,404
20733,bright,main,9,0.9647283116198773,297,107,2,406
20734,bright,main,0,0.9516496072262438,319,102,2,423
20734,bright,main,1,0.9603421951000684,304,79,4,387
20734,bright,main,2,0.9341528022423039,292,113,1,406
20734,bright,main,3,0.9793588388824236,271,97,5,373
20734,bright,main,4,0.951633649090591,277,103,5,385
20734,bright,main,5,0.9688222315664213,322,74,9,405
20734,bright,main,6,0.9278497902854427,294,54,5,353
20734,bright,main,7,0.9479171008584596,262,78,4,344
20734,bright,main,8,0.9622404858314062,317,92,2,411
20734,bright,main,9,0.9668834277121146,347,80,1,428
20736,bright,main,0,0.9463160049266294,330,95,3,428
20736,bright,main,1,0.9541770373702897,329,58,5,392
20736,bright,main,2,0.9537789416756696,350,76,2,428
20736,bright,main,3,0.953774163542785,273,100,9,382
20736,bright,main,4,0.9609507066290155,274,112,4,390
20736,bright,main,5,0.9673523318567,298,97,10,405
20736,bright,main,6,0.9207454129111725,279,80,2,361
20736,bright,main,7,0.9542478903755153,256,72,8,336
20736,bright,main,8,0.9751302588166545,333,85,1,419
20736,bright,main,9,0.9536930520064784,310,99,1,410
20738,bright,main,0,0.9766336791672775,371,60,5,436
20738,bright,main,1,0.9598151302267871,339,57,5,401
20738,bright,main,2,0.9671015949282903,344,74,4,422
20738,bright,main,3,0.9406002984476667,309,73,6,388
20738,bright,main,4,0.9686591340432762,291,76,5,372
20738,bright,main,5,0.9358455519223414,347,60,10,417
20738,bright,main,6,0.9357571074197427,291,69,3,363
20738,bright,main,7,0.9611150369467496,294,62,1,357
20738,bright,main,8,0.949239406117397,353,60,5,418
20738,bright,main,9,0.9626371527341404,377,42,5,424
20744,bright,main,0,0.9737197338373886,334,107,4,445
20744,bright,main,1,0.9715494605107572,313,76,6,395
20744,bright,main,2,0.9703794952968737,377,58,7,442
20744,bright,main,3,0.9746044398965331,320,73,5,398
20744,bright,main,4,0.9549755592424958,315,94,4,413
20744,bright,main,5,0.9482300929108487,328,95,2,425
20744,bright,main,6,0.9303494908294441,275,83,3,361
20744,bright,main,7,0.9395626937298784,301,67,1,369
20744,bright,main,8,0.9662887043714645,303,111,8,422
20744,bright,main,9,0.9764809094555057,332,91,3,426
20746,bright,main,0,0.9690171366892274,377,65,1,443
20746,bright,main,1,0.943073812358049,286,104,7,397
20746,bright,main,2,0.9689013685098568,368,72,1,441
20746,bright,main,3,0.9571870303834978,306,87,4,397
20746,bright,main,4,0.9442073922056011,340,72,4,416
20746,bright,main,5,0.9424816706308112,328,93,1,422
20746,bright,main,6,0.9498607259205832,290,73,3,366
20746,bright,main,7,0.9516970184852519,297,72,5,374
20746,bright,main,8,0.9686539168049567,350,70,7,427
20746,bright,main,9,0.959037068854507,353,75,4,432
20747,bright,main,0,0.9570515355807497,320,120,5,445
20747,bright,main,1,0.9672974787205175,310,80,3,393
20747,bright,main,2,0.9675646479091154,359,71,3,433
20747,bright,main,3,0.93970611454472,324,67,2,393
20747,bright,main,4,0.969592816044393,335,75,3,413
20747,bright,main,5,0.9794075939660867,342,76,2,420
20747,bright,main,6,0.9579276777761708,267,97,1,365
20747,bright,main,7,0.9738675284915632,318,52,2,372
20747,bright,main,8,0.9650303947283513,353,70,4,427
20747,bright,main,9,0.9625542156633313,334,86,6,426
20750,bright,main,0,0.9780792006728012,359,76,3,438
20750,bright,main,1,0.9580366683323096,321,74,3,398
20750,bright,main,2,0.9752494834242685,348,75,4,427
20750,bright,main,3,0.9680429279492823,311,83,2,396
20750,bright,main,4,0.9479999579051532,286,65,1,352
20750,bright,main,5,0.9715241638013988,337,73,6,416
20750,bright,main,6,0.9657514100674834,305,64,0,369
20750,bright,main,7,0.9636419486829009,284,68,4,356
20750,bright,main,8,0.9486347172905337,344,76,6,426
20750,bright,main,9,0.9646110478874746,331,96,6,433
20751,bright,main,0,0.9811158792286283,345,85,2,432
20751,bright,main,1,0.9446032397138269,323,67,6,396
20751,bright,main,2,0.9518769651680821,353,71,1,425
20751,bright,main,3,0.9652970196874933,327,61,6,394
20751,bright,main,4,0.9657413012860819,315,83,5,403
20751,bright,main,5,0.9661065877685917,304,97,6,407
20751,bright,main,6,0.9407684221912646,304,54,1,359
20751,bright,main,7,0.9446218977834655,281,59,4,344
20751,bright,main,8,0.967452954649194,325,92,3,420
20751,bright,main,9,0.9673232612953175,307,98,9,414
20757,bright,main,0,0.9712506394350318,351,91,3,445
20757,bright,main,1,0.9528905942046678,336,68,4,408
20757,bright,main,2,0.9770565288209667,343,86,8,437
20757,bright,main,3,0.974241399555431,332,69,1,402
20757,bright,main,4,0.9631151845882872,332,77,5,414
20757,bright,main,5,0.9539614971000281,331,87,6,424
20757,bright,main,6,0.982560854007242,303,61,3,367
20757,bright,main,7,0.9399511103609643,294,77,3,374
20757,bright,main,8,0.9564069071189308,335,88,3,426
20757,bright,main,9,0.9576862903088781,346,72,6,424
20758,bright,main,0,0.9703301830766577,370,75,2,447
20758,bright,main,1,0.9764955508125643,306,83,6,395
20758,bright,main,2,0.970255107074722,355,82,2,439
20758,bright,main,3,0.9529320430788252,336,68,1,405
20758,bright,main,4,0.9772402853323511,343,73,1,417
20758,bright,main,5,0.9782401368027985,346,79,3,428
20758,bright,main,6,0.968746604129944,273,88,4,365
20758,bright,main,7,0.9358669885353024,285,78,5,368
20758,bright,main,8,0.9725819380778448,358,61,6,425
20758,bright,main,9,0.9743502710070516,362,67,6,435
20760,bright,main,0,0.9583417142708167,370,68,3,441
20760,bright,main,1,0.9724182053426197,343,56,5,404
20760,bright,main,2,0.9723140721930672,351,81,5,437
20760,bright,main,3,0.9739031762249537,337,66,3,406
20760,bright,main,4,0.9448922505556095,362,47,4,413
20760,bright,main,5,0.9653857993875303,339,80,9,428
20760,bright,main,6,0.9366957167362413,288,76,4,368
20760,bright,main,7,0.9796335504865444,307,66,1,374
20760,bright,main,8,0.9392049260078583,347,82,2,431
20760,bright,main,9,0.9653299393224906,371,61,2,434
20761,bright,main,0,0.9620730249634776,390,55,3,448
20761,bright,main,1,0.9759966576949515,308,91,4,403
20761,bright,main,2,0.9765430734878178,362,79,1,442
20761,bright,main,3,0.9386181594465279,305,94,2,401
20761,bright,main,4,0.9629581526820505,320,89,1,410
20761,bright,main,5,0.9548445667936433,320,102,2,424
20761,bright,main,6,0.9669118192892936,287,70,3,360
20761,bright,main,7,0.9475301759069177,285,79,3,367
20761,bright,main,8,0.9480652236257614,344,72,6,422
20761,bright,main,9,0.951702783251895,321,100,7,428
20762,bright,main,0,0.9573411303010124,338,95,6,439
20762,bright,main,1,0.9579596563751025,310,92,2,404
20762,bright,main,2,0.9678845771533792,355,86,3,444
20762,bright,main,3,0.9650499742456206,307,87,5,399
20762,bright,main,4,0.9584755596528778,333,78,5,416
20762,bright,main,5,0.9614431590455875,250,178,1,429
20762,bright,main,6,0.9762606825126616,276,87,3,366
20762,bright,main,7,0.9698148047559063,291,82,1,374
20762,bright,main,8,0.9506225624454632,331,98,2,431
20762,bright,main,9,0.9512053185721955,338,98,2,438
20763,bright,main,0,0.97501340661623,393,51,5,449
20763,bright,main,1,0.9760379794117182,346,54,3,403
20763,bright,main,2,0.9658480034384858,329,103,8,440
20763,bright,main,3,0.9682870369229819,324,68,4,396
20763,bright,main,4,0.9644321966955856,329,80,6,415
20763,bright,main,5,0.9651576455242539,351,75,4,430
20763,bright,main,6,0.9675353102259759,304,65,3,372
20763,bright,main,7,0.9468791564294747,302,71,4,377
20763,bright,main,8,0.9486516189278974,363,68,0,431
20763,bright,main,9,0.9681426935449039,361,68,3,432
20764,bright,main,0,0.9585312720054682,310,95,2,407
20764,bright,main,1,0.9565117734973281,331,54,3,388
20764,bright,main,2,0.9544802313752442,344,62,4,410
20764,bright,main,3,0.9362855702289988,298,82,6,386
20764,bright,main,4,0.9632244293667385,304,81,6,391
20764,bright,main,5,0.9462600156794945,320,80,8,408
20764,bright,main,6,0.9585685984013984,280,75,0,355
20764,bright,main,7,0.9445601465155562,233,96,2,331
20764,bright,main,8,0.9714975481224631,312,81,2,395
20764,bright,main,9,0.9762136239143924,311,99,3,413
20765,bright,main,0,0.9686405790576346,379,55,3,437
20765,bright,main,1,0.9703913340334578,350,45,3,398
20765,bright,main,2,0.9810917992395993,354,64,3,421
20765,bright,main,3,0.9636782020261575,323,64,3,390
20765,bright,main,4,0.9794775571782881,325,64,5,394
20765,bright,main,5,0.9515791204818986,368,42,6,416
20765,bright,main,6,0.9695845404220044,317,44,4,365
20765,bright,main,7,0.9450933101761742,294,59,3,356
20765,bright,main,8,0.9512843897061021,330,79,3,412
20765,bright,main,9,0.9659369984536739,354,67,2,423
20766,bright,main,0,0.9455384914760916,341,85,6,432
20766,bright,main,1,0.9754836210434285,278,95,5,378
20766,bright,main,2,0.9739579296894856,298,97,3,398
20766,bright,main,3,0.9542745027907212,282,88,2,372
20766,bright,main,4,0.953990949050155,268,78,3,349
20766,bright,main,5,0.9616956278903194,328,68,2,398
20766,bright,main,6,0.9456300082693536,258,86,4,348
20766,bright,main,7,0.9417602425393405,242,90,2,334
20766,bright,main,8,0.9582785753477834,340,66,9,415
20766,bright,main,9,0.96335972926733,329,89,3,421
20767,bright,main,0,0.9528619917934906,338,82,6,426
20767,bright,main,1,0.9579793127834844,329,50,6,385
20767,bright,main,2,0.9621308925918309,341,71,4,416
20767,bright,main,3,0.9461888404384444,325,55,5,385
20767,bright,main,4,0.9622429052233122,337,57,5,399
20767,bright,main,5,0.9605758478612365,340,45,7,392
20767,bright,main,6,0.9700216926293903,314,33,10,357
20767,bright,main,7,0.9594205272437535,267,60,4,331
20767,bright,main,8,0.9832513678166646,354,59,4,417
20767,bright,main,9,0.9633803214958924,336,78,6,420
20768,bright,main,0,0.9646344241317939,342,81,4,427
20768,bright,main,1,0.9550075418486454,328,59,4,391
20768,bright,main,2,0.978839122309675,349,65,3,417
20768,bright,main,3,0.9561554182174835,283,88,5,376
20768,bright,main,4,0.9735066715733622,272,65,1,338
20768,bright,main,5,0.9572303383321472,344,67,2,413
20768,bright,main,6,0.9615635747347534,269,84,4,357
20768,bright,main,7,0.9563750965153038,254,84,4,342
20768,bright,main,8,0.9567991911029092,342,58,4,404
20768,bright,main,9,0.9637422088071455,356,58,0,414
20769,bright,main,0,0.9773369452309804,348,69,4,421
20769,bright,main,1,0.9368432860864493,301,77,1,379
20769,bright,main,2,0.9429461228274717,367,46,3,416
20769,bright,main,3,0.9621477903987189,326,47,6,379
20769,bright,main,4,0.9509286811784243,337,53,5,395
20769,bright,main,5,0.9710937385526753,338,54,5,397
20769,bright,main,6,0.9706585029468249,285,66,4,355
20769,bright,main,7,0.9389147963213486,272,63,3,338
20769,bright,main,8,0.9705776518554251,324,68,3,395
20769,bright,main,9,0.9724389076908119,314,87,7,408
20770,bright,main,0,0.9648180789460616,277,115,4,396
20770,bright,main,1,0.9650551683060479,268,96,6,370
20770,bright,main,2,0.9788691103158408,305,100,3,408
20770,bright,main,3,0.949059603233381,289,79,5,373
20770,bright,main,4,0.9592146907439406,289,81,5,375
20770,bright,main,5,0.9481368065429805,254,121,6,381
20770,bright,main,6,0.9577137636635474,275,71,3,349
20770,bright,main,7,0.9361773426112602,237,82,9,328
20770,bright,main,8,0.9538574110619592,279,110,2,391
20770,bright,main,9,0.9663180539000211,290,113,4,407
20771,bright,main,0,0.9693645003099478,325,84,4,413
20771,bright,main,1,0.9670618083204953,285,83,6,374
20771,bright,main,2,0.9859426139475427,377,34,5,416
20771,bright,main,3,0.970559000918448,323,55,1,379
20771,bright,main,4,0.9574052981169032,338,53,4,395
20771,bright,main,5,0.9700907437246789,356,53,2,411
20771,bright,main,6,0.94439370936747,273,73,2,348
20771,bright,main,7,0.9199885416149879,250,63,5,318
20771,bright,main,8,0.9684722486740569,341,61,5,407
20771,bright,main,9,0.9633003529976796,317,90,7,414
20772,bright,main,0,0.9437522733192056,325,87,4,416
20772,bright,main,1,0.9527596034797541,267,106,2,375
20772,bright,main,2,0.9441318990060418,301,106,5,412
20772,bright,main,3,0.9405637872481514,299,80,2,381
20772,bright,main,4,0.9699953973947028,292,93,3,388
20772,bright,main,5,0.953495247380192,294,81,8,383
20772,bright,main,6,0.9702381260243753,260,81,7,348
20772,bright,main,7,0.9617590879799214,240,80,4,324
20772,bright,main,8,0.9508245100130691,315,81,7,403
20772,bright,main,9,0.9616881622119063,322,80,3,405
20773,bright,main,0,0.9661488072983713,337,86,2,425
20773,bright,main,1,0.9511766529133142,292,82,4,378
20773,bright,main,2,0.9368795843739619,313,80,8,401
20773,bright,main,3,0.941288242848834,317,52,1,370
20773,bright,main,4,0.9574604952024762,301,44,6,351
20773,bright,main,5,0.9388313742142944,350,55,7,412
20773,bright,main,6,0.9537921396346657,308,47,2,357
20773,bright,main,7,0.9583351465651622,290,48,4,342
20773,bright,main,8,0.9545550372784951,293,105,2,400
20773,bright,main,9,0.9593999294710512,339,74,6,419
20774,bright,main,0,0.9645351809448446,353,60,4,417
20774,bright,main,1,0.9511604356061751,326,56,7,389
20774,bright,main,2,0.9357168800188405,334,78,4,416
20774,bright,main,3,0.941415953059622,325,53,5,383
20774,bright,main,4,0.9525220675072236,294,44,4,342
20774,bright,main,5,0.9708983106610155,358,37,9,404
20774,bright,main,6,0.9708983106610155,358,37,9,404
20774,bright,main,7,0.9370405452721315,280,61,6,347
20774,bright,main,8,0.9507676012080444,340,57,6,403
20774,bright,main,9,0.9373196063467315,321,77,3,401
20775,bright,main,0,0.9534427835271262,382,44,5,431
20775,bright,main,1,0.962058224395286,333,53,4,390
20775,bright,main,2,0.9746245301089288,353,61,4,418
20775,bright,main,3,0.9764366475796623,304,69,4,377
20775,bright,main,4,0.9590231398192421,247,77,1,325
20775,bright,main,5,0.9297656362058445,320,71,5,396
20775,bright,main,6,0.9707446629465176,272,76,3,351
20775,bright,main,7,0.9580569647746408,256,72,2,330
20775,bright,main,8,0.9537332455113068,358,53,4,415
20775,bright,main,9,0.9621886712131167,374,42,8,424
20776,bright,main,0,0.9765532872039584,371,56,4,431
20776,bright,main,1,0.9652614256528285,336,50,4,390
20776,bright,main,2,0.9757512789188273,355,64,5,424
20776,bright,main,3,0.9532718182355854,323,63,4,390
20776,bright,main,4,0.960785118319884,338,54,6,398
20776,bright,main,5,0.9484858171960793,332,65,5,402
20776,bright,main,6,0.9627735388536993,287,64,3,354
20776,bright,main,7,0.9601650827853268,303,48,6,357
20776,bright,main,8,0.9629763428893755,336,73,5,414
20776,bright,main,9,0.954335246717451,381,47,4,432
20777,bright,main,0,0.9671346989479664,353,51,10,414
20777,bright,main,1,0.9646813542572339,319,56,1,376
20777,bright,main,2,0.9812627957950912,323,76,2,401
20777,bright,main,3,0.9588751347147106,306,73,7,386
20777,bright,main,4,0.9598677814941153,309,72,3,384
20777,bright,main,5,0.9568364576088816,352,47,4,403
20777,bright,main,6,0.9549154271460308,282,66,1,349
20777,bright,main,7,0.95830701860129,295,39,2,336
20777,bright,main,8,0.9756761656271115,334,65,7,406
20777,bright,main,9,0.9605273368949505,324,77,6,407
20778,bright,main,0,0.9462283730373141,334,81,0,415
20778,bright,main,1,0.9707618085668679,291,82,2,375
20778,bright,main,2,0.9718457979334165,311,88,1,400
20778,bright,main,3,0.9554746392637851,291,81,1,373
20778,bright,main,4,0.9709570190846212,306,74,1,381
20778,bright,main,5,0.9548821250193124,305,83,7,395
20778,bright,main,6,0.952689138849464,273,70,8,351
20778,bright,main,7,0.964478359809596,270,64,4,338
20778,bright,main,8,0.9746457812817036,334,62,7,403
20778,bright,main,9,0.9660121759256441,332,62,6,400
20779,bright,main,0,0.9613634993686818,361,61,1,423
20779,bright,main,1,0.9511764473203417,316,66,0,382
20779,bright,main,2,0.9559411465884,328,79,3,410
20779,bright,main,3,0.9439906137906293,311,60,8,379
20779,bright,main,4,0.9523921778796971,290,40,2,332
20779,bright,main,5,0.9601627571872442,319,69,5,393
20779,bright,main,6,0.9463979954153946,280,72,1,353
20779,bright,main,7,0.9485764722673827,284,59,0,343
20779,bright,main,8,0.9686687465692319,334,63,4,401
20779,bright,main,9,0.9648039476507656,337,66,6,409
20780,bright,main,0,0.9467969626959918,291,115,2,408
20780,bright,main,1,0.9535858288745184,288,82,3,373
20780,bright,main,2,0.9539305931978133,317,93,2,412
20780,bright,main,3,0.9729041429712398,294,75,3,372
20780,bright,main,4,0.9730147003895787,300,84,4,388
20780,bright,main,5,0.9721735813780036,305,91,5,401
20780,bright,main,6,0.9347738038918847,290,55,3,348
20780,bright,main,7,0.9574574379537457,260,65,4,329
20780,bright,main,8,0.9608594917539753,321,77,5,403
20780,bright,main,9,0.9280083569905285,305,103,4,412
20784,bright,main,0,0.9474011211140467,351,66,4,421
20784,bright,main,1,0.9511326652793368,317,61,0,378
20784,bright,main,2,0.9585211626185639,326,74,3,403
20784,bright,main,3,0.9693717691386431,305,68,6,379
20784,bright,main,4,0.9608238195716388,301,78,2,381
20784,bright,main,5,0.9652937158267055,318,78,0,396
20784,bright,main,6,0.953990949050155,257,87,4,348
20784,bright,main,7,0.9461551130971539,224,95,5,324
20784,bright,main,8,0.9737964814913339,309,89,6,404
20784,bright,main,9,0.9433556051108305,333,71,5,409
20786,bright,main,0,0.9745254744543865,330,111,5,446
20786,bright,main,1,0.9710487611029882,316,83,2,401
20786,bright,main,2,0.9646777870366214,324,105,3,432
20786,bright,main,3,0.9691400569863005,308,84,6,398
20786,bright,main,4,0.9530583862673523,329,82,2,413
20786,bright,main,5,0.958758234568805,319,104,4,427
20786,bright,main,6,0.9656081478323264,282,86,4,372
20786,bright,main,7,0.9597873921236001,293,76,6,375
20786,bright,main,8,0.973044773096595,332,89,4,425
20786,bright,main,9,0.9582561346327412,342,89,3,434
20788,bright,main,0,0.9634623203573491,363,57,0,420
20788,bright,main,1,0.952341226641021,290,81,4,375
20788,bright,main,2,0.9569291378571804,294,100,3,397
20788,bright,main,3,0.9675463285312853,276,71,3,350
20788,bright,main,4,0.9634045746051564,301,69,4,374
20788,bright,main,5,0.968096652468761,311,78,3,392
20788,bright,main,6,0.9448858930938008,308,49,1,358
20788,bright,main,7,0.9415115316244708,270,59,3,332
20788,bright,main,8,0.9679934902033969,325,73,5,403
20788,bright,main,9,0.9684430541125777,328,68,7,403
20789,bright,main,0,0.9703346524229652,338,84,8,430
20789,bright,main,1,0.9771688448385811,324,68,9,401
20789,bright,main,2,0.971599305150832,302,105,11,418
20789,bright,main,3,0.928768505811972,294,94,4,392
20789,bright,main,4,0.981354981165035,314,82,5,401
20789,bright,main,5,0.9472458603837132,362,56,3,421
20789,bright,main,6,0.9450527680978712,263,94,7,364
20789,bright,main,7,0.9334568580858966,246,93,5,344
20789,bright,main,8,0.9737854240410436,294,124,4,422
20789,bright,main,9,0.9715693504058257,303,114,7,424
20790,bright,main,0,0.9661846884497713,333,107,5,445
20790,bright,main,1,0.9716117789406398,318,79,4,401
20790,bright,main,2,0.9787774849593822,361,75,4,440
20790,bright,main,3,0.9618401365973496,316,80,2,398
20790,bright,main,4,0.9644826549674572,313,92,6,411
20790,bright,main,5,0.9680328369693074,340,78,5,423
20790,bright,main,6,0.965729222132355,293,71,3,367
20790,bright,main,7,0.9691873696625022,291,79,3,373
20790,bright,main,8,0.972473485709891,313,93,3,409
20790,bright,main,9,0.9628543500484671,319,107,3,429
20791,bright,main,0,0.9627180941174346,328,89,4,421
20791,bright,main,1,0.96405802106948,314,63,4,381
20791,bright,main,2,0.9811459720443825,366,52,5,423
20791,bright,main,3,0.9657769858774394,328,58,2,388
20791,bright,main,4,0.9710848286286384,328,59,8,395
20791,bright,main,5,0.9567007750236598,299,91,6,396
20791,bright,main,6,0.9631453453292174,285,62,1,348
20791,bright,main,7,0.9222648132134901,291,53,1,345
20791,bright,main,8,0.9599763408946426,358,50,4,412
20791,bright,main,9,0.9575487180357326,368,50,4,422
20816,bright,main,0,0.9673257363130202,366,65,5,436
20816,bright,main,1,0.9565905853007102,309,89,4,402
20816,bright,main,2,0.9769679556927946,330,101,2,433
20816,bright,main,3,0.949661374430994,303,98,1,402
20816,bright,main,4,0.972150039449453,297,107,2,406
20816,bright,main,5,0.972150039449453,297,107,2,406
20816,bright,main,6,0.9499139126792174,274,98,3,375
20816,bright,main,7,0.9415118233500962,256,95,3,354
20816,bright,main,8,0.9674149829394347,344,75,7,426
20816,bright,main,9,0.9747386912468082,358,67,2,427
20817,bright,main,0,0.9644856448308397,312,125,5,442
20817,bright,main,1,0.9536381376861695,307,89,6,402
20817,bright,main,2,0.9754818787536298,321,111,3,435
20817,bright,main,3,0.9699452268456108,291,104,4,399
20817,bright,main,4,0.958818135568213,278,118,4,400
20817,bright,main,5,0.958818135568213,278,118,4,400
20817,bright,main,6,0.9517915098740557,259,103,3,365
20817,bright,main,7,0.9675772155921583,258,92,2,352
20817,bright,main,8,0.9558238937044529,325,96,4,425
20817,bright,main,9,0.9617120667571099,313,114,4,431
20818,bright,main,0,0.9748897479097919,340,92,1,433
20818,bright,main,1,0.9648965339054608,325,74,4,403
20818,bright,main,2,0.9674467158385414,334,98,2,434
20818,bright,main,3,0.9510359890942264,303,90,3,396
20818,bright,main,4,0.951094655688077,332,74,3,409
20818,bright,main,5,0.9566141473247947,326,94,3,423
20818,bright,main,6,0.967871260652895,309,61,2,372
20818,bright,main,7,0.9672319319342756,278,85,4,367
20818,bright,main,8,0.9733448293757325,322,99,5,426
20818,bright,main,9,0.9733448293757325,322,99,5,426
20821,bright,main,0,0.9570253693320999,326,112,1,439
20821,bright,main,1,0.9490119793869455,315,84,4,403
20821,bright,main,2,0.9635714513344892,316,108,5,429
20821,bright,main,3,0.9602551521995571,292,107,2,401
20821,bright,main,4,0.9638769207404496,321,82,3,406
20821,bright,main,5,0.9774246986119846,368,49,3,420
20821,bright,main,6,0.9378320541280109,296,74,5,375
20821,bright,main,7,0.9613598345912472,281,81,3,365
20821,bright,main,8,0.9557426757845336,314,107,4,425
20821,bright,main,9,0.9557426757845336,314,107,4,425
20822,bright,main,0,0.9624504459509302,327,99,8,434
20822,bright,main,1,0.9830381070928511,299,100,1,400
20822,bright,main,2,0.9588245202445391,317,94,5,416
20822,bright,main,3,0.9728548828956859,299,99,4,402
20822,bright,main,4,0.9599826817823468,326,83,0,409
20822,bright,main,5,0.9599826817823468,326,83,0,409
20822,bright,main,6,0.9666711241798313,274,96,2,372
20822,bright,main,7,0.9544685585424819,276,74,3,353
20822,bright,main,8,0.9585360992412844,334,86,5,425
20822,bright,main,9,0.9674323624206319,317,101,4,422
20823,bright,main,0,0.9519554318454049,367,62,7,436
20823,bright,main,1,0.9555880107693082,314,84,6,404
20823,bright,main,2,0.9762249172232123,303,129,1,433
20823,bright,main,3,0.9566168103040752,329,69,2,400
20823,bright,main,4,0.9741209871014749,340,63,4,407
20823,bright,main,5,0.9579484960418725,362,57,3,422
20823,bright,main,6,0.9667703366370399,286,79,3,368
20823,bright,main,7,0.9451933762759565,304,53,8,365
20823,bright,main,8,0.9701313117610877,318,100,3,421
20823,bright,main,9,0.955837822603454,369,55,4,428
20824,bright,main,0,0.967933538800184,336,93,5,434
20824,bright,main,1,0.9554885446519457,285,90,8,383
20824,bright,main,2,0.9726578119298296,342,83,6,431
20824,bright,main,3,0.9677261066858633,285,104,5,394
20824,bright,main,4,0.9624769875635477,301,104,4,409
20824,bright,main,5,0.9714053863395171,299,110,5,414
20824,bright,main,6,0.961219826608485,274,84,5,363
20824,bright,main,7,0.957021902314332,267,87,4,358
20824,bright,main,8,0.9717560732668968,323,91,5,419
20824,bright,main,9,0.9635636528409464,295,89,9,393
20825,bright,main,0,0.961300763174275,326,100,4,430
20825,bright,main,1,0.9311767943923371,336,62,4,402
20825,bright,main,2,0.9592195887646993,312,102,6,420
20825,bright,main,3,0.9631414625536003,276,107,2,385
20825,bright,main,4,0.963547744369425,315,76,2,393
20825,bright,main,5,0.9566180897727132,326,78,9,413
20825,bright,main,6,0.9596878084701459,272,90,5,367
20825,bright,main,7,0.942856573981726,283,62,3,348
20825,bright,main,8,0.9616783858645962,331,83,6,420
20825,bright,main,9,0.9539462630197252,297,112,8,417
20830,bright,main,0,0.934359911623445,318,118,3,439
20830,bright,main,1,0.9523071565310718,299,96,3,398
20830,bright,main,2,0.9696272011013931,315,107,5,427
20830,bright,main,3,0.9657224816794268,314,77,7,398
20830,bright,main,4,0.9832630886708699,327,73,10,410
20830,bright,main,5,0.9447563445783741,331,85,4,420
20830,bright,main,6,0.9372445740746546,265,99,2,366
20830,bright,main,7,0.9519524179158518,235,112,3,350
20830,bright,main,8,0.9608427665007508,343,82,1,426
20830,bright,main,9,0.9608427665007508,343,82,1,426
20831,bright,main,0,0.9673087688916081,329,100,3,432
20831,bright,main,1,0.9741559109007448,320,83,3,406
20831,bright,main,2,0.9664471253705869,339,89,5,433
20831,bright,main,3,0.9574400673619399,316,94,1,411
20831,bright,main,4,0.9572048846524107,313,100,1,414
20831,bright,main,5,0.966550477609528,300,120,4,424
20831,bright,main,6,0.9686362472248612,264,104,4,372
20831,bright,main,7,0.96438656867283,293,79,4,376
20831,bright,main,8,0.9594281656178015,323,100,2,425
20831,bright,main,9,0.966907487730277,323,102,0,425
20835,bright,main,0,0.9579525218711489,322,110,3,435
20835,bright,main,1,0.9685510362863697,281,107,9,397
20835,bright,main,2,0.9512936088538301,321,95,9,425
20835,bright,main,3,0.975234897429442,287,112,3,402
20835,bright,main,4,0.945258237516658,273,86,2,361
20835,bright,main,5,0.9782506887108133,318,106,2,426
20835,bright,main,6,0.9560087834605483,267,98,3,368
20835,bright,main,7,0.9452337861751942,252,101,2,355
20835,bright,main,8,0.9462029440632089,295,120,7,422
20835,bright,main,9,0.9517888809087292,312,111,5,428
20836,bright,main,0,0.9575926619036994,346,94,0,440
20836,bright,main,1,0.9779467411548524,288,113,3,404
20836,bright,main,2,0.9825504267559338,348,79,5,432
20836,bright,main,3,0.9383166010053057,293,110,0,403
20836,bright,main,4,0.9617295545497534,310,69,4,383
20836,bright,main,5,0.9537877633106793,332,88,2,422
20836,bright,main,6,0.9506035079230012,300,61,3,364
20836,bright,main,7,0.9636617674075498,259,99,4,362
20836,bright,main,8,0.9653156227505519,305,119,6,430
20836,bright,main,9,0.9529020138417205,333,95,8,436
20841,bright,main,0,0.9773565249697901,306,121,8,435
20841,bright,main,1,0.9575086034046847,296,104,5,405
20841,bright,main,2,0.9688759566874013,310,114,4,428
20841,bright,main,3,0.9534181266997844,284,111,5,400
20841,bright,main,4,0.9699095903157435,305,87,6,398
20841,bright,main,5,0.9699095903157435,305,87,6,398
20841,bright,main,6,0.9587750752223096,293,74,3,370
20841,bright,main,7,0.9370405854232567,264,86,3,353
20841,bright,main,8,0.9724614167823429,300,119,5,424
20841,bright,main,9,0.9495513906451326,300,122,2,424
20843,bright,main,0,0.9652914905316804,307,114,3,424
20843,bright,main,1,0.9858081756292518,292,97,3,392
20843,bright,main,2,0.9527318586425164,286,128,8,422
20843,bright,main,3,0.9601468487157231,232,152,9,393
20843,bright,main,4,0.964170413886449,272,126,5,403
20843,bright,main,5,0.964170413886449,272,126,5,403
20843,bright,main,6,0.9334844100746478,255,106,4,365
20843,bright,main,7,0.9655187817191294,224,124,2,350
20843,bright,main,8,0.973439818839687,318,100,4,422
20843,bright,main,9,0.9789593976747107,309,102,9,420
20844,bright,main,0,0.9705793217890947,308,132,1,441
20844,bright,main,1,0.9697074266261508,280,119,2,401
20844,bright,main,2,0.9762946545685852,281,146,1,428
20844,bright,main,3,0.9688887575556168,281,119,2,402
20844,bright,main,4,0.9553231926420043,276,132,1,409
20844,bright,main,5,0.9630516876944066,310,109,5,424
20844,bright,main,6,0.9597725813722022,274,94,3,371
20844,bright,main,7,0.9531481077488169,253,96,1,350
20844,bright,main,8,0.9684419812002725,317,112,1,430
20844,bright,main,9,0.9684419812002725,317,112,1,430
20845,bright,main,0,0.9179238170907356,328,105,2,435
20845,bright,main,1,0.9568716483500637,295,96,5,396
20845,bright,main,2,0.9753245665908965,360,66,3,429
20845,bright,main,3,0.9650139703231384,301,90,8,399
20845,bright,main,4,0.9625073411168724,317,80,3,400
20845,bright,main,5,0.9625073411168724,317,80,3,400
20845,bright,main,6,0.9750886785134766,309,59,3,371
20845,bright,main,7,0.9473588685901672,270,81,1,352
20845,bright,main,8,0.9316301540576511,338,82,5,425
20845,bright,main,9,0.9596839046063055,313,107,5,425
20846,bright,main,0,0.9523632292151464,343,99,4,446
20846,bright,main,1,0.9647534848823398,315,85,3,403
20846,bright,main,2,0.9594112164330209,331,99,4,434
20846,bright,main,3,0.9389659960493544,291,112,0,403
20846,bright,main,4,0.941042422975775,312,99,4,415
20846,bright,main,5,0.9398401021628041,289,131,1,421
20846,bright,main,6,0.966058371566389,261,106,5,372
20846,bright,main,7,0.957853724620897,256,114,4,374
20846,bright,main,8,0.9591976433786343,302,125,4,431
20846,bright,main,9,0.9634552931063296,347,83,3,433
20847,bright,main,0,0.96801883180602,332,94,7,433
20847,bright,main,1,0.9528447945609563,289,104,4,397
20847,bright,main,2,0.9654452725883916,298,120,8,426
20847,bright,main,3,0.9682092896335621,273,123,3,399
20847,bright,main,4,0.9302137675858996,277,94,8,379
20847,bright,main,5,0.982444016653013,333,88,5,426
20847,bright,main,6,0.9519501511473542,277,92,4,373
20847,bright,main,7,0.9657171933841029,248,111,2,361
20847,bright,main,8,0.9578603964639811,323,94,6,423
20847,bright,main,9,0.954805606317835,309,113,4,426
20850,bright,main,0,0.9744753990103161,313,93,8,414
20850,bright,main,1,0.9544015827437837,286,117,3,406
20850,bright,main,2,0.9691590824862945,291,135,3,429
20850,bright,main,3,0.9784488044404125,280,123,0,403
20850,bright,main,4,0.9785730056840632,314,95,4,413
20850,bright,main,5,0.9606494562986921,299,110,8,417
20850,bright,main,6,0.9551848624677208,216,145,5,366
20850,bright,main,7,0.9396034321796791,280,83,3,366
20850,bright,main,8,0.973396449982141,334,88,6,428
20850,bright,main,9,0.9705453633046088,308,118,0,426
20853,bright,main,0,0.9807019585698394,337,104,3,444
20853,bright,main,1,0.9649870309959973,270,129,5,404
20853,bright,main,2,0.9406761090708462,303,129,8,440
20853,bright,main,3,0.9762943144126424,313,91,2,406
20853,bright,main,4,0.9581486419550324,297,115,3,415
20853,bright,main,5,0.9774007026289401,291,119,5,415
20853,bright,main,6,0.9635952303152703,265,96,3,364
20853,bright,main,7,0.9492499851536869,260,104,5,369
20853,bright,main,8,0.9599144049997856,290,132,7,429
20853,bright,main,9,0.940519067790045,274,151,2,427
20861,bright,main,0,0.9592071654568812,359,71,9,439
20861,bright,main,1,0.9600920500181969,335,63,4,402
20861,bright,main,2,0.9527965158371885,353,78,3,434
20861,bright,main,3,0.9550125862154739,295,95,5,395
20861,bright,main,4,0.9750989253411794,312,90,3,405
20861,bright,main,5,0.9518450583217802,367,46,6,419
20861,bright,main,6,0.9663317960064246,310,51,4,365
20861,bright,main,7,0.9607474253661171,255,86,7,348
20861,bright,main,8,0.9560678455809021,335,80,5,420
20861,bright,main,9,0.9833085219829196,349,74,3,426
20869,bright,main,0,0.9535925447383014,341,87,7,435
20869,bright,main,1,0.9429354104880893,316,79,2,397
20869,bright,main,2,0.9652378336583716,318,103,3,424
20869,bright,main,3,0.9341202136885935,302,95,2,399
20869,bright,main,4,0.958268730767868,310,92,4,406
20869,bright,main,5,0.9675204619985233,320,94,7,421
20869,bright,main,6,0.9724613142415076,273,89,4,366
20869,bright,main,7,0.9728601391308772,259,93,7,359
20869,bright,main,8,0.9646580424596762,343,70,6,419
20869,bright,main,9,0.9646580424596762,343,70,6,419
20878,bright,main,0,0.9500945721806383,337,103,4,444
20878,bright,main,1,0.9731405461560343,303,88,8,399
20878,bright,main,2,0.9265653693629127,367,67,4,438
20878,bright,main,3,0.9763813499445632,339,58,4,401
20878,bright,main,4,0.9630694147062304,350,52,4,406
20878,bright,main,5,0.9735272444984427,358,66,6,430
20878,bright,main,6,0.9554890741885351,275,83,6,364
20878,bright,main,7,0.9627677901532617,267,95,5,367
20878,bright,main,8,0.9691934990395197,311,104,3,418
20878,bright,main,9,0.9474755399505048,307,108,6,421
20882,bright,main,0,0.9678251253325131,321,113,2,436
20882,bright,main,1,0.9683088541786998,276,126,2,404
20882,bright,main,2,0.9662877257146706,326,107,2,435
20882,bright,main,3,0.9611259930985874,273,130,2,405
20882,bright,main,4,0.9405247008815877,277,105,2,384
20882,bright,main,5,0.9613778227565187,304,116,7,427
20882,bright,main,6,0.9726384949660677,261,105,2,368
20882,bright,main,7,0.9455021618286442,258,100,1,359
20882,bright,main,8,0.9575514155156498,293,127,4,424
20882,bright,main,9,0.9753220475610603,339,84,3,426
20884,bright,main,0,0.9688143521940868,355,75,0,430
20884,bright,main,1,0.9485813726573082,305,96,2,403
20884,bright,main,2,0.9648616702175368,336,94,4,434
20884,bright,main,3,0.9657982100911066,327,74,1,402
20884,bright,main,4,0.9592406843072435,302,102,2,406
20884,bright,main,5,0.9510403956849875,314,99,7,420
20884,bright,main,6,0.9664926062240828,304,63,4,371
20884,bright,main,7,0.9609409517629931,285,83,2,370
20884,bright,main,8,0.9698559800763688,337,88,3,428
20884,bright,main,9,0.9579891264615201,333,88,10,431
20885,bright,main,0,0.9761139887541754,350,71,6,427
20885,bright,main,1,0.9396948459361021,295,103,7,405
20885,bright,main,2,0.9561905355638333,333,96,7,436
20885,bright,main,3,0.9407474791922394,289,106,6,401
20885,bright,main,4,0.967935556842961,329,72,6,407
20885,bright,main,5,0.9640040245492764,339,81,3,423
20885,bright,main,6,0.9240242013587738,283,83,3,369
20885,bright,main,7,0.9647479920137689,284,62,4,350
20885,bright,main,8,0.9684755277701635,327,95,2,424
20885,bright,main,9,0.9596948143182535,322,106,4,432
20886,bright,main,0,0.9655502918695489,335,102,3,440
20886,bright,main,1,0.9524720290624682,301,102,3,406
20886,bright,main,2,0.9727835468621688,290,144,5,439
20886,bright,main,3,0.95692303102011,273,119,6,398
20886,bright,main,4,0.9746810768268633,307,97,5,409
20886,bright,main,5,0.9680621408950688,336,75,1,412
20886,bright,main,6,0.9518945669174936,268,100,1,369
20886,bright,main,7,0.9629961579374228,264,105,0,369
20886,bright,main,8,0.9491507837605334,330,95,3,428
20886,bright,main,9,0.9569464346322983,251,81,0,332
20887,bright,main,0,0.9606471455732115,309,124,4,437
20887,bright,main,1,0.9610225939353356,320,79,2,401
20887,bright,main,2,0.9622644895033989,311,109,3,423
20887,bright,main,3,0.945291493287812,297,99,3,399
20887,bright,main,4,0.9596410222162531,313,91,2,406
20887,bright,main,5,0.9720321854245761,298,123,5,426
20887,bright,main,6,0.9651117591084305,266,107,1,374
20887,bright,main,7,0.9470173381445905,260,103,6,369
20887,bright,main,8,0.9686407092560727,308,109,10,427
20887,bright,main,9,0.95788690725124,296,135,3,434
20888,bright,main,0,0.9690527811335123,313,113,2,428
20888,bright,main,1,0.9668303546213217,284,116,1,401
20888,bright,main,2,0.94866930354072,345,84,0,429
20888,bright,main,3,0.9586869280464788,295,98,5,398
20888,bright,main,4,0.9756844613386229,310,87,6,403
20888,bright,main,5,0.9515679404571891,304,106,3,413
20888,bright,main,6,0.9749668677766923,250,106,4,360
20888,bright,main,7,0.9663370005076671,261,94,2,357
20888,bright,main,8,0.9628819947711988,328,89,2,419
20888,bright,main,9,0.9475064364059251,324,92,3,419
20889,bright,main,0,0.9730881089171898,331,103,3,437
20889,bright,main,1,0.9582363092165078,307,87,3,397
20889,bright,main,2,0.9500833024168165,328,98,5,431
20889,bright,main,3,0.9411146782025099,322,68,4,394
20889,bright,main,4,0.946188955348455,304,103,2,409
20889,bright,main,5,0.9214277986453018,314,99,6,419
20889,bright,main,6,0.9708113465944694,279,85,2,366
20889,bright,main,7,0.927874116884493,284,72,0,356
20889,bright,main,8,0.9411704344753328,336,87,1,424
20889,bright,main,9,0.9511482815331331,314,112,3,429
20890,bright,main,0,0.9526265832520259,314,119,5,438
20890,bright,main,1,0.9493814482298775,293,105,4,402
20890,bright,main,2,0.9575655086030315,340,90,6,436
20890,bright,main,3,0.9483367230211108,302,97,1,400
20890,bright,main,4,0.9543954404240778,304,99,6,409
20890,bright,main,5,0.9530146798384446,299,113,4,416
20890,bright,main,6,0.9677830822664133,252,114,3,369
20890,bright,main,7,0.9540958013545331,213,127,2,342
20890,bright,main,8,0.9681174546040127,338,87,3,428
20890,bright,main,9,0.9634552931063298,334,96,2,432
20891,bright,main,0,0.9678056712922485,336,88,4,428
20891,bright,main,1,0.9762166686813366,291,106,4,401
20891,bright,main,2,0.977908374987565,344,79,3,426
20891,bright,main,3,0.9836780868937667,297,96,7,400
20891,bright,main,4,0.9675481293042718,308,97,3,408
20891,bright,main,5,0.9380930721592904,306,106,6,418
20891,bright,main,6,0.9670511825944627,246,119,2,367
20891,bright,main,7,0.9591403715397889,233,119,5,357
20891,bright,main,8,0.9562735211743195,297,121,6,424
20891,bright,main,9,0.9753245665908965,327,99,4,430
20892,bright,main,0,0.9697481635743135,320,108,7,435
20892,bright,main,1,0.9588689992213904,311,87,2,400
20892,bright,main,2,0.9709653163872826,325,100,6,431
20892,bright,main,3,0.9553167975440043,276,123,3,402
20892,bright,main,4,0.957903316658128,298,103,4,405
20892,bright,main,5,0.9620211291951742,297,122,2,421
20892,bright,main,6,0.9689886162149673,268,93,3,364
20892,bright,main,7,0.9605080817824099,243,105,4,352
20892,bright,main,8,0.97996263270256,294,128,1,423
20892,bright,main,9,0.9814128648471988,326,96,8,430
20893,bright,main,0,0.952331765309116,327,110,6,443
20893,bright,main,1,0.9547549951066409,314,84,5,403
20893,bright,main,2,0.9767508526490153,333,103,2,438
20893,bright,main,3,0.9626564352918406,303,91,6,400
20893,bright,main,4,0.9411518609185119,270,124,6,400
20893,bright,main,5,0.9678574218460855,336,83,7,426
20893,bright,main,6,0.9665671584244157,287,75,3,365
20893,bright,main,7,0.9653942538477078,275,72,5,352
20893,bright,main,8,0.9481194309544009,346,83,2,431
20893,bright,main,9,0.9712213369679783,299,124,2,425
20894,bright,main,0,0.9704915385343285,348,84,3,435
20894,bright,main,1,0.9512288917393417,302,96,3,401
20894,bright,main,2,0.9854999407958412,335,96,5,436
20894,bright,main,3,0.9634891123687667,280,118,4,402
20894,bright,main,4,0.9621039313382919,309,92,3,404
20894,bright,main,5,0.9627371831815279,312,107,2,421
20894,bright,main,6,0.965025244351348,263,101,1,365
20894,bright,main,7,0.9440518399035276,255,97,3,355
20894,bright,main,8,0.958157583380102,322,98,2,422
20894,bright,main,9,0.9659406240230171,339,93,2,434
20895,bright,main,0,0.9675259567177239,328,110,4,442
20895,bright,main,1,0.9735321013098402,297,108,3,408
20895,bright,main,2,0.9760455354266598,341,98,4,443
20895,bright,main,3,0.9664203745565204,294,102,2,398
20895,bright,main,4,0.9507373178457618,322,89,5,416
20895,bright,main,5,0.95088964889776,358,68,2,428
20895,bright,main,6,0.9698976225207234,303,67,2,372
20895,bright,main,7,0.9629485389425981,282,93,1,376
20895,bright,main,8,0.9559736923020314,326,101,6,433
20895,bright,main,9,0.9610355768095517,327,103,4,434
20896,bright,main,0,0.9695327756325901,369,52,3,424
20896,bright,main,1,0.9611035011332073,277,94,3,374
20896,bright,main,2,0.9797788262598792,334,91,5,430
20896,bright,main,3,0.9699767121382853,306,96,2,404
20896,bright,main,4,0.9562977831158459,325,76,6,407
20896,bright,main,5,0.9266284998588127,368,52,4,424
20896,bright,main,6,0.9525288969020345,298,70,3,371
20896,bright,main,7,0.9386119884252052,287,72,5,364
20896,bright,main,8,0.9620943910640504,355,66,2,423
20896,bright,main,9,0.9468935182145558,351,76,3,430
20897,bright,main,0,0.96494541119877,359,82,4,445
20897,bright,main,1,0.9678890780535767,292,116,0,408
20897,bright,main,2,0.9598087448862712,311,129,0,440
20897,bright,main,3,0.9686323160418276,305,88,4,397
20897,bright,main,4,0.9409808983411929,300,114,7,421
20897,bright,main,5,0.9707541884845937,318,103,7,428
20897,bright,main,6,0.9725382053877771,256,109,6,371
20897,bright,main,7,0.9562535510306492,273,99,5,377
20897,bright,main,8,0.9775892691425336,334,91,5,430
20897,bright,main,9,0.9487457558543755,344,91,2,437
20899,bright,main,0,0.9653569319751548,343,90,6,439
20899,bright,main,1,0.972762697525742,335,60,8,403
20899,bright,main,2,0.9611285678606065,349,78,3,430
20899,bright,main,3,0.9637428028862933,311,84,4,399
20899,bright,main,4,0.9745000005127529,319,87,3,409
20899,bright,main,5,0.9638382720726966,326,96,2,424
20899,bright,main,6,0.9611968661027009,290,77,2,369
20899,bright,main,7,0.9509402742479308,286,74,4,364
20899,bright,main,8,0.9655413084054818,346,80,2,428
20899,bright,main,9,0.9623571496673282,337,81,8,426
20900,bright,main,0,0.9461543603543067,353,83,4,440
20900,bright,main,1,0.9589605667129752,329,67,3,399
20900,bright,main,2,0.9681426935449039,310,115,7,432
20900,bright,main,3,0.9411522246000904,285,111,4,400
20900,bright,main,4,0.9385496176754569,309,94,5,408
20900,bright,main,5,0.9532663051504273,345,78,0,423
20900,bright,main,6,0.9752664552659872,292,78,2,372
20900,bright,main,7,0.9603024478667349,267,89,5,361
20900,bright,main,8,0.9643687188147264,350,68,5,423
20900,bright,main,9,0.9604332669183135,351,77,5,433
20901,bright,main,0,0.967990020384095,374,66,2,442
20901,bright,main,1,0.9547171273079861,341,63,2,406
20901,bright,main,2,0.9697520319761834,356,79,7,442
20901,bright,main,3,0.9846530719823239,303,99,3,405
20901,bright,main,4,0.9488989154628453,309,98,4,411
20901,bright,main,5,0.9339343844466537,323,101,4,428
20901,bright,main,6,0.9873267348751751,263,108,1,372
20901,bright,main,7,0.9473528100831099,285,82,6,373
20901,bright,main,8,0.9433275305440701,337,90,0,427
20901,bright,main,9,0.9602760128138434,362,72,4,438
20902,bright,main,0,0.9801381657911467,333,99,5,437
20902,bright,main,1,0.9580140532200576,307,87,5,399
20902,bright,main,2,0.9552492076891379,350,77,7,434
20902,bright,main,3,0.9366538919173076,319,80,2,401
20902,bright,main,4,0.9785128831334908,345,62,1,408
20902,bright,main,5,0.9687982254759334,349,61,3,413
20902,bright,main,6,0.9722988527762155,291,74,4,369
20902,bright,main,7,0.9662691963208973,274,89,4,367
20902,bright,main,8,0.9210912370235079,339,78,4,421
20902,bright,main,9,0.9828722568837825,363,65,5,433
20903,bright,main,0,0.9664317702315954,348,83,5,436
20903,bright,main,1,0.9738779758643468,327,71,2,400
20903,bright,main,2,0.9419244476091206,330,84,4,418
20903,bright,main,3,0.9659214048225228,307,77,4,388
20903,bright,main,4,0.9393598087900056,301,100,5,406
20903,bright,main,5,0.9634088651900578,310,102,7,419
20903,bright,main,6,0.9778935043626156,284,80,1,365
20903,bright,main,7,0.959316410348099,275,72,4,351
20903,bright,main,8,0.9570962703892786,328,85,7,420
20903,bright,main,9,0.9526005530903873,324,99,4,427
20905,bright,main,0,0.9659937914475537,288,138,3,429
20905,bright,main,1,0.9693030448998783,287,113,1,401
20905,bright,main,2,0.9720811258455854,295,137,3,435
20905,bright,main,3,0.9579626705500115,280,114,5,399
20905,bright,main,4,0.9637858355157655,293,113,2,408
20905,bright,main,5,0.976453758793452,286,128,3,417
20905,bright,main,6,0.9289567653148042,262,104,2,368
20905,bright,main,7,0.9614396707247418,262,93,0,355
20905,bright,main,8,0.9421639954302066,289,136,2,427
20905,bright,main,9,0.9602478913036389,268,153,6,427
20909,bright,main,0,0.9638630309503056,341,86,3,430
20909,bright,main,1,0.9577264142812058,363,41,2,406
20909,bright,main,2,0.966821609439533,351,76,5,432
20909,bright,main,3,0.9750505266895547,310,88,4,402
20909,bright,main,4,0.9553380769667486,290,82,6,378
20909,bright,main,5,0.9759644175634467,325,99,2,426
20909,bright,main,6,0.9751901426102235,288,85,2,375
20909,bright,main,7,0.9704698212756183,266,86,7,359
20909,bright,main,8,0.9522557738610254,296,98,2,396
20909,bright,main,9,0.9678679241802753,314,112,8,434
20910,bright,main,0,0.9736398716022074,320,106,8,434
20910,bright,main,1,0.9692518686191346,265,137,3,405
20910,bright,main,2,0.9677170165545308,302,130,3,435
20910,bright,main,3,0.9608522025498544,283,121,0,404
20910,bright,main,4,0.9532719263423731,306,99,7,412
20910,bright,main,5,0.9572511849227249,285,135,1,421
20910,bright,main,6,0.9778746773098942,281,92,4,377
20910,bright,main,7,0.9327527973768988,270,78,1,349
20910,bright,main,8,0.9566432764905164,317,102,5,424
20910,bright,main,9,0.9760939355418496,342,84,0,426
20911,bright,main,0,0.9586056211286709,341,99,2,442
20911,bright,main,1,0.9547397716999609,349,50,4,403
20911,bright,main,2,0.9505175281187543,352,79,4,435
20911,bright,main,3,0.965380735026619,314,78,5,397
20911,bright,main,4,0.9550870588125643,302,49,0,351
20911,bright,main,5,0.9689569271526227,346,74,4,424
20911,bright,main,6,0.9693537600883584,295,64,2,361
20911,bright,main,7,0.939060133137053,262,81,2,345
20911,bright,main,8,0.9596475390244001,345,74,4,423
20911,bright,main,9,0.9344640990430941,354,75,3,432
20912,bright,main,0,0.9638024373576215,371,67,3,441
20912,bright,main,1,0.9766386726494404,328,68,8,404
20912,bright,main,2,0.9717002952054654,355,77,5,437
20912,bright,main,3,0.9554658917189728,325,73,5,403
20912,bright,main,4,0.9709783061894756,333,76,3,412
20912,bright,main,5,0.9708286228802353,338,82,3,423
20912,bright,main,6,0.9714593743569819,289,72,6,367
20912,bright,main,7,0.9204048626949517,292,65,3,360
20912,bright,main,8,0.954279269115296,348,76,4,428
20912,bright,main,9,0.9582664879899659,330,95,3,428
20913,bright,main,0,0.9476542069329141,363,74,2,439
20913,bright,main,1,0.9496875994343588,343,52,7,402
20913,bright,main,2,0.959271839159233,353,81,2,436
20913,bright,main,3,0.951825412813358,325,71,1,397
20913,bright,main,4,0.9829975778855564,336,67,7,410
20913,bright,main,5,0.9537729256016645,353,65,2,420
20913,bright,main,6,0.9785974821436229,314,51,2,367
20913,bright,main,7,0.9657253096176199,297,54,4,355
20913,bright,main,8,0.9511337237808919,358,69,2,429
20913,bright,main,9,0.9508333506832817,340,83,5,428
20914,bright,main,0,0.966868670202753,337,94,4,435
20914,bright,main,1,0.9746457812817038,313,84,6,403
20914,bright,main,2,0.9516849229669702,337,90,5,432
20914,bright,main,3,0.9348982700962087,334,62,5,401
20914,bright,main,4,0.9528002342875942,320,85,3,408
20914,bright,main,5,0.9717208843602043,281,122,8,411
20914,bright,main,6,0.976104915011495,243,114,4,361
20914,bright,main,7,0.9116332534231738,272,91,4,367
20914,bright,main,8,0.9594764656762852,316,108,3,427
20914,bright,main,9,0.9591223618603428,329,99,6,434
20915,bright,main,0,0.9400654604533547,339,92,4,435
20915,bright,main,1,0.9781867816927402,315,80,4,399
20915,bright,main,2,0.9629404477053013,360,65,3,428
20915,bright,main,3,0.9593090211941604,313,86,2,401
20915,bright,main,4,0.9544917045028972,312,69,2,383
20915,bright,main,5,0.9602783174499816,339,83,2,424
20915,bright,main,6,0.9723146685292158,293,78,2,373
20915,bright,main,7,0.9671367591965409,259,96,2,357
20915,bright,main,8,0.9449323569277651,340,71,3,414
20915,bright,main,9,0.9631459296642836,310,113,6,429
20916,bright,main,0,0.9694341119604071,356,78,3,437
20916,bright,main,1,0.9580090084340895,289,110,2,401
20916,bright,main,2,0.9688001025182185,334,93,7,434
20916,bright,main,3,0.9563481381324913,315,88,2,405
20916,bright,main,4,0.9566123845282246,328,78,3,409
20916,bright,main,5,0.9591040093270211,324,99,0,423
20916,bright,main,6,0.9643299994740993,278,92,3,373
20916,bright,main,7,0.9736512405954413,285,78,7,370
20916,bright,main,8,0.9612360646950224,367,52,3,422
20916,bright,main,9,0.9695874120297168,347,78,3,428
20917,bright,main,0,0.9550597313303447,325,105,3,433
20917,bright,main,1,0.9486936898471214,298,100,1,399
20917,bright,main,2,0.9598339532866583,370,57,1,428
20917,bright,main,3,0.9665443832683579,338,54,9,401
20917,bright,main,4,0.9655230027375679,349,53,5,407
20917,bright,main,5,0.9765667184398436,338,81,4,423
20917,bright,main,6,0.9579210281091388,282,80,4,366
20917,bright,main,7,0.970035150663305,274,75,4,353
20917,bright,main,8,0.9580037375463849,339,75,4,418
20917,bright,main,9,0.9736478397233985,337,85,3,425
20918,bright,main,0,0.9601484889139125,333,106,3,442
20918,bright,main,1,0.9672261445411859,303,99,4,406
20918,bright,main,2,0.9580461896862733,355,74,5,434
20918,bright,main,3,0.9551916054501851,300,93,5,398
20918,bright,main,4,0.9421999339289892,289,61,3,353
20918,bright,main,5,0.9618307847241507,342,74,5,421
20918,bright,main,6,0.9564037608335273,288,78,5,371
20918,bright,main,7,0.9453438468915248,297,61,3,361
20918,bright,main,8,0.9474352766488219,366,58,4,428
20918,bright,main,9,0.9630061293388099,332,103,3,438
20919,bright,main,0,0.9700401362688349,353,78,4,435
20919,bright,main,1,0.9636382065437352,329,70,4,403
20919,bright,main,2,0.9610441628163979,339,83,5,427
20919,bright,main,3,0.9521300483815313,328,68,2,398
20919,bright,main,4,0.9649870309959975,311,93,2,406
20919,bright,main,5,0.967067668155182,327,92,3,422
20919,bright,main,6,0.9632518143233083,303,59,3,365
20919,bright,main,7,0.9721936212405536,293,54,4,351
20919,bright,main,8,0.9815850601608671,349,77,2,428
20919,bright,main,9,0.9566410215463101,376,50,3,429
20920,bright,main,0,0.9591507515459908,343,88,3,434
20920,bright,main,1,0.9502483467346554,310,88,6,404
20920,bright,main,2,0.9590040932993366,326,97,9,432
20920,bright,main,3,0.9750227351781728,303,87,5,395
20920,bright,main,4,0.953197232626382,318,85,3,406
20920,bright,main,5,0.9672945898362102,315,97,5,417
20920,bright,main,6,0.9540988212595725,267,97,6,370
20920,bright,main,7,0.9537645078183846,265,86,4,355
20920,bright,main,8,0.9699172273462873,320,105,2,427
20920,bright,main,9,0.9716940175882605,330,101,1,432
20921,bright,main,0,0.9525343223936399,378,64,1,443
20921,bright,main,1,0.9606189604559578,289,111,5,405
20921,bright,main,2,0.9720605624257218,352,81,5,438
20921,bright,main,3,0.9501845302121535,323,79,1,403
20921,bright,main,4,0.9661132257690571,352,61,3,416
20921,bright,main,5,0.9293494485881099,361,65,2,428
20921,bright,main,6,0.9505421790982679,312,56,1,369
20921,bright,main,7,0.9554979174352032,299,72,1,372
20921,bright,main,8,0.9491939988724053,353,77,2,432
20921,bright,main,9,0.9648327792631238,323,104,1,428
20922,bright,main,0,0.9661584309108198,377,58,1,436
20922,bright,main,1,0.9468523395211526,317,81,4,402
20922,bright,main,2,0.9623615109878857,374,67,2,443
20922,bright,main,3,0.9644249496232077,336,63,0,399
20922,bright,main,4,0.9672735406468783,326,87,2,415
20922,bright,main,5,0.9506215286147545,346,71,3,420
20922,bright,main,6,0.9516275062815903,234,130,3,367
20922,bright,main,7,0.9584923293047602,274,98,5,377
20922,bright,main,8,0.9678388574823765,322,96,6,424
20922,bright,main,9,0.9534962738683875,341,86,3,430
20923,bright,main,0,0.9679204494677018,367,72,2,441
20923,bright,main,1,0.9595242024289857,319,79,4,402
20923,bright,main,2,0.9592504543901547,352,77,2,431
20923,bright,main,3,0.9497737396524549,304,91,6,401
20923,bright,main,4,0.9530766989303843,285,113,4,402
20923,bright,main,5,0.9754645872018953,344,71,3,418
20923,bright,main,6,0.9375759759261119,300,64,4,368
20923,bright,main,7,0.9620704620392866,317,45,2,364
20923,bright,main,8,0.9633274798952363,372,53,1,426
20923,bright,main,9,0.9583343373127408,372,61,4,437
20924,bright,main,0,0.9620723639049918,367,78,1,446
20924,bright,main,1,0.9491949431517096,302,83,7,392
20924,bright,main,2,0.9725781211266196,312,115,6,433
20924,bright,main,3,0.9600826286696246,325,78,3,406
20924,bright,main,4,0.9529557290898368,317,91,1,409
20924,bright,main,5,0.9710461077652808,345,82,3,430
20924,bright,main,6,0.9334813406168153,293,78,3,374
20924,bright,main,7,0.9734768443508992,318,54,1,373
20924,bright,main,8,0.9539486385837186,348,80,1,429
20924,bright,main,9,0.9719162601072215,362,70,6,438
20925,bright,main,0,0.9549116749004415,336,106,6,448
20925,bright,main,1,0.9546957107872384,295,101,2,398
20925,bright,main,2,0.9668677939325907,338,96,2,436
20925,bright,main,3,0.9381891390704432,293,106,3,402
20925,bright,main,4,0.967452954649194,310,106,4,420
20925,bright,main,5,0.9580752241183543,323,100,8,431
20925,bright,main,6,0.9382486837120482,296,69,6,371
20925,bright,main,7,0.9661196103891874,287,80,5,372
20925,bright,main,8,0.9495513906451326,318,105,3,426
20925,bright,main,9,0.9770259739419778,311,115,4,430
20926,bright,main,0,0.9762216579491693,349,90,4,443
20926,bright,main,1,0.9441894638364188,329,72,3,404
20926,bright,main,2,0.9599812021810037,363,70,3,436
20926,bright,main,3,0.9513597237654897,319,83,1,403
20926,bright,main,4,0.9699304221589008,306,103,6,415
20926,bright,main,5,0.9763346352330793,335,88,2,425
20926,bright,main,6,0.9461824290034686,301,64,4,369
20926,bright,main,7,0.9520942077349693,300,72,2,374
20926,bright,main,8,0.9731881601499419,344,83,1,428
20926,bright,main,9,0.9616048103479143,370,63,3,436
20927,bright,main,0,0.9535265402329292,333,102,3,438
20927,bright,main,1,0.9438985658679635,291,90,9,390
20927,bright,main,2,0.9585247809604687,323,105,3,431
20927,bright,main,3,0.9766996314825274,323,65,5,393
20927,bright,main,4,0.9806440845527028,322,73,6,401
20927,bright,main,5,0.9752548609342898,318,94,3,415
20927,bright,main,6,0.9615409839807962,280,80,4,364
20927,bright,main,7,0.9699703923679323,287,59,6,352
20927,bright,main,8,0.9681632541160006,307,111,3,421
20927,bright,main,9,0.9562920855380284,341,78,5,424
20928,bright,main,0,0.971647267956608,341,76,6,423
20928,bright,main,1,0.954723418201324,320,59,4,383
20928,bright,main,2,0.9657639844623083,336,70,6,412
20928,bright,main,3,0.9776942887566773,307,65,10,382
20928,bright,main,4,0.9701796707039968,307,76,6,389
20928,bright,main,5,0.9701796707039968,307,76,6,389
20928,bright,main,6,0.9452300103716379,264,81,4,349
20928,bright,main,7,0.9495883737669166,241,80,7,328
20928,bright,main,8,0.9676614062494654,289,109,7,405
20928,bright,main,9,0.9670841659635335,308,96,3,407
20929,bright,main,0,0.9723849612070855,333,93,5,431
20929,bright,main,1,0.9520537756468783,303,95,0,398
20929,bright,main,2,0.971286894454576,336,97,1,434
20929,bright,main,3,0.9526150447175085,280,116,5,401
20929,bright,main,4,0.9571082654956748,323,80,3,406
20929,bright,main,5,0.9610235016738345,306,110,3,419
20929,bright,main,6,0.9664265502463302,263,99,3,365
20929,bright,main,7,0.9312336824811972,256,96,2,354
20929,bright,main,8,0.9621350143398076,318,103,5,426
20929,bright,main,9,0.9848708623082071,307,113,5,425
20930,bright,main,0,0.9457419358220508,319,110,5,434
20930,bright,main,1,0.9715318906639219,300,106,1,407
20930,bright,main,2,0.965173970674135,312,121,3,436
20930,bright,main,3,0.9715668144631918,344,58,2,404
20930,bright,main,4,0.944847659865265,287,75,1,363
20930,bright,main,5,0.9453916663639165,351,70,3,424
20930,bright,main,6,0.9470007764164442,278,89,1,368
20930,bright,main,7,0.9599000349513532,276,81,1,358
20930,bright,main,8,0.960245796952687,327,87,4,418
20930,bright,main,9,0.9586306232551179,337,83,3,423
20931,bright,main,0,0.9723875306441605,358,78,4,440
20931,bright,main,1,0.9662697590124198,313,84,1,398
20931,bright,main,2,0.9562154861114894,351,76,5,432
20931,bright,main,3,0.9492319903733304,326,71,3,400
20931,bright,main,4,0.9458136594642338,319,79,5,403
20931,bright,main,5,0.9674865352254151,364,55,4,423
20931,bright,main,6,0.954802242204612,319,45,2,366
20931,bright,main,7,0.9450073142094281,306,58,3,367
20931,bright,main,8,0.9687724656572568,330,90,1,421
20931,bright,main,9,0.9503362891084828,335,89,4,428
21070,bright,main,0,0.9759557410364611,337,96,1,434
21070,bright,main,1,0.9643904248728339,308,89,3,400
21070,bright,main,2,0.9453236263326112,329,101,3,433
21070,bright,main,3,0.9520672502865365,295,99,7,401
21070,bright,main,4,0.9660502480516171,313,88,3,404
21070,bright,main,5,0.9590906858692921,304,111,2,417
21070,bright,main,6,0.9426762777653231,278,93,2,373
21070,bright,main,7,0.9554475969730842,263,95,3,361
21070,bright,main,8,0.9467243635273986,317,106,3,426
21070,bright,main,9,0.9830262763084656,322,94,4,420
21071,bright,main,0,0.9713433333248038,341,85,4,430
21071,bright,main,1,0.9595889473952767,311,88,2,401
21071,bright,main,2,0.9525736906233834,327,101,1,429
21071,bright,main,3,0.9734166853330495,290,109,3,402
21071,bright,main,4,0.9685667824265488,334,61,2,397
21071,bright,main,5,0.9493355981829128,308,108,4,420
21071,bright,main,6,0.9483774344262317,277,93,3,373
21071,bright,main,7,0.9485707007739823,270,96,3,369
21071,bright,main,8,0.9626035490731568,302,121,4,427
21071,bright,main,9,0.9811313727018566,335,86,4,425
21072,bright,main,0,0.9626069467545522,297,132,6,435
21072,bright,main,1,0.9724583994191197,263,128,7,398
21072,bright,main,2,0.9515504519693039,304,124,3,431
21072,bright,main,3,0.9585564391834832,284,116,3,403
21072,bright,main,4,0.968021195703639,311,89,6,406
21072,bright,main,5,0.964252793180161,318,101,3,422
21072,bright,main,6,0.9386186380922374,293,73,1,367
21072,bright,main,7,0.9431137858398552,241,112,0,353
21072,bright,main,8,0.9750171816681023,308,111,4,423
21072,bright,main,9,0.9687874783298395,287,146,1,434
21075,bright,main,0,0.9498955697566452,323,105,5,433
21075,bright,main,1,0.9802695932185812,290,104,4,398
21075,bright,main,2,0.9432795733853602,335,88,3,426
21075,bright,main,3,0.9697804603562774,307,82,8,397
21075,bright,main,4,0.9607564870109484,336,71,2,409
21075,bright,main,5,0.9762364815343743,340,75,3,418
21075,bright,main,6,0.956744766154954,300,60,2,362
21075,bright,main,7,0.9490369922661682,301,58,4,363
21075,bright,main,8,0.9612372482486917,328,91,5,424
21075,bright,main,9,0.9545588231606529,307,123,2,432
21087,bright,main,0,0.9606722889659686,359,58,4,421
21087,bright,main,1,0.9705682806700043,327,50,4,381
21087,bright,main,2,0.9754157165929139,341,54,4,399
21087,bright,main,3,0.9445738024996441,309,68,4,381
21087,bright,main,4,0.9757848088071365,314,69,5,388
21087,bright,main,5,0.9662697590124198,310,80,8,398
21087,bright,main,6,0.9653695108719537,293,59,5,357
21087,bright,main,7,0.9632508336176644,280,49,7,336
21087,bright,main,8,0.947492415013608,345,60,8,413
21087,bright,main,9,0.9503407553704858,363,48,3,414
21088,bright,main,0,0.948967430103975,345,68,6,419
21088,bright,main,1,0.9530241638533042,313,53,5,371
21088,bright,main,2,0.9642324226151892,350,54,5,409
21088,bright,main,3,0.9457081271479345,338,46,2,386
21088,bright,main,4,0.9337748823475679,331,52,3,386
21088,bright,main,5,0.9595557434003379,335,67,3,405
21088,bright,main,6,0.9598408905462593,288,60,3,351
21088,bright,main,7,0.955652148079643,294,51,3,348
21088,bright,main,8,0.9320415903234169,349,60,5,414
21088,bright,main,9,0.9613445619953096,366,53,7,426
21089,bright,main,0,0.968287538643622,323,86,5,414
21089,bright,main,1,0.9435065373458612,319,63,2,384
21089,bright,main,2,0.977388855824966,322,73,5,400
21089,bright,main,3,0.9813381701318062,327,53,5,385
21089,bright,main,4,0.9519821351945291,331,62,5,398
21089,bright,main,5,0.9703621799558625,336,69,4,409
21089,bright,main,6,0.9428971830506444,261,84,3,348
21089,bright,main,7,0.9485551202545328,278,68,1,347
21089,bright,main,8,0.971826522710323,330,75,4,409
21089,bright,main,9,0.9501267564851642,348,60,1,409
21090,bright,main,0,0.9608420412084299,357,62,4,423
21090,bright,main,1,0.9780580191258891,341,53,4,398
21090,bright,main,2,0.9717087534351331,329,82,1,412
21090,bright,main,3,0.9771920453062943,320,56,5,381
21090,bright,main,4,0.95384410714442,339,50,4,393
21090,bright,main,5,0.9495389344328804,343,57,6,406
21090,bright,main,6,0.9657310224545812,281,67,1,349
21090,bright,main,7,0.9351337910777763,282,59,1,342
21090,bright,main,8,0.9665069256776014,327,74,3,404
21090,bright,main,9,0.9573260763721958,323,79,5,407
21101,bright,main,0,0.9414960530376559,335,81,1,417
21101,bright,main,1,0.9601526732295234,335,49,4,388
21101,bright,main,2,0.9746751513809929,342,61,6,409
21101,bright,main,3,0.9737132532564597,311,64,2,377
21101,bright,main,4,0.9755054693350876,326,60,5,391
21101,bright,main,5,0.972150039449453,333,71,2,406
21101,bright,main,6,0.9453213635816671,283,68,4,355
21101,bright,main,7,0.9646910614146078,285,48,5,338
21101,bright,main,8,0.9299912375540929,364,50,2,416
21101,bright,main,9,0.9299912375540929,364,50,2,416
21102,bright,main,0,0.9632408013862762,311,85,3,399
21102,bright,main,1,0.9367173012509137,314,65,6,385
21102,bright,main,2,0.9636605410996497,335,64,11,410
21102,bright,main,3,0.9642733185792094,320,55,7,382
21102,bright,main,4,0.9508883024905542,326,52,1,379
21102,bright,main,5,0.960781994906552,357,43,6,406
21102,bright,main,6,0.9602577244530752,301,50,2,353
21102,bright,main,7,0.9563840221853438,280,56,3,339
21102,bright,main,8,0.960127326583116,334,64,2,400
21102,bright,main,9,0.960127326583116,334,64,2,400
21103,bright,main,0,0.9733072047872194,377,51,3,431
21103,bright,main,1,0.9696650411422023,342,41,4,387
21103,bright,main,2,0.950609530462148,359,56,0,415
21103,bright,main,3,0.9657704532238729,329,47,1,377
21103,bright,main,4,0.9158867181001663,323,66,2,391
21103,bright,main,5,0.9730517853455262,365,35,5,405
21103,bright,main,6,0.9521290089930409,301,57,1,359
21103,bright,main,7,0.9567879158435738,304,46,5,355
21103,bright,main,8,0.9771035558716493,363,50,1,414
21103,bright,main,9,0.9636717538924656,361,58,4,423
21114,bright,main,0,0.9575978487505654,338,70,4,412
21114,bright,main,1,0.9676957485229529,306,60,6,372
21114,bright,main,2,0.9587901974462272,317,71,6,394
21114,bright,main,3,0.9711421369256117,329,44,3,376
21114,bright,main,4,0.9698099238700563,307,85,1,393
21114,bright,main,5,0.9737000371631683,327,66,3,396
21114,bright,main,6,0.9546621586849597,294,51,4,349
21114,bright,main,7,0.9684052953283537,286,62,3,351
21114,bright,main,8,0.9707214082840933,343,59,5,407
21114,bright,main,9,0.9469799155450881,358,56,3,417
21117,bright,main,0,0.9593221798547185,331,88,4,423
21117,bright,main,1,0.9666139560105379,318,61,7,386
21117,bright,main,2,0.9579640205564832,338,79,1,418
21117,bright,main,3,0.9692962071421046,317,62,3,382
21117,bright,main,4,0.9744057825870449,303,77,4,384
21117,bright,main,5,0.9690749662422125,339,61,4,404
21117,bright,main,6,0.9608278384515326,283,74,2,359
21117,bright,main,7,0.9550422908336439,278,60,3,341
21117,bright,main,8,0.9666838280545236,307,90,8,405
21117,bright,main,9,0.9704469763444759,346,63,3,412
21127,bright,main,0,0.9550838783649114,386,44,3,433
21127,bright,main,1,0.9689526514834946,281,101,0,382
21127,bright,main,2,0.9717402487597229,273,121,4,398
21127,bright,main,3,0.9584923293047601,292,80,5,377
21127,bright,main,4,0.9664115564395145,317,68,4,389
21127,bright,main,5,0.9388556319257196,325,81,5,411
21127,bright,main,6,0.960211569716689,310,47,2,359
21127,bright,main,7,0.9597963264101664,312,41,6,359
21127,bright,main,8,0.9751160192353785,358,54,2,414
21127,bright,main,9,0.9542066182558094,347,65,6,418
21128,bright,main,0,0.971550416785157,327,85,7,419
21128,bright,main,1,0.9478681260048331,360,34,0,394
21128,bright,main,2,0.9656858776247184,367,44,5,416
21128,bright,main,3,0.9441097530595348,338,46,5,389
21128,bright,main,4,0.9731257575352479,365,37,0,402
21128,bright,main,5,0.9593090211941604,333,61,7,401
21128,bright,main,6,0.9637059710885534,296,63,0,359
21128,bright,main,7,0.9620737191399963,273,74,3,350
21128,bright,main,8,0.9525696373238045,331,71,3,405
21128,bright,main,9,0.9711371774104787,314,89,2,405
21156,bright,main,0,0.9553731019887859,370,49,2,421
21156,bright,main,1,0.9471652924702687,305,52,1,358
21156,bright,main,2,0.9575942422653625,341,57,6,404
21156,bright,main,3,0.9453199431062282,318,52,3,373
21156,bright,main,4,0.975038643649694,350,41,3,394
21156,bright,main,5,0.9756893552594105,341,48,7,396
21156,bright,main,6,0.9602107031891681,290,57,5,352
21156,bright,main,7,0.9428864458914803,285,40,2,327
21156,bright,main,8,0.9706510092425632,301,78,6,385
21156,bright,main,9,0.9583639592147897,299,80,8,387
21157,bright,main,0,0.9763376899538796,325,80,7,412
21157,bright,main,1,0.9556328625511524,313,62,2,377
21157,bright,main,2,0.9589184559534225,341,51,7,399
21157,bright,main,3,0.972800696321253,310,52,6,368
21157,bright,main,4,0.9632229487191638,299,63,10,372
21157,bright,main,5,0.9610344134544732,316,62,5,383
21157,bright,main,6,0.9628898398110728,288,51,6,345
21157,bright,main,7,0.9359593891147668,272,51,6,329
21157,bright,main,8,0.9628900109547981,323,66,4,393
21157,bright,main,9,0.953358343741166,331,66,7,404
21161,bright,main,0,0.9520996232872502,328,84,3,415
21161,bright,main,1,0.9511145973059136,298,69,4,371
21161,bright,main,2,0.9550187560096277,330,58,5,393
21161,bright,main,3,0.9551031843082947,275,73,2,350
21161,bright,main,4,0.9204193234829209,312,57,6,375
21161,bright,main,5,0.9606225200737087,319,66,4,389
21161,bright,main,6,0.9402283795044855,296,47,3,346
21161,bright,main,7,0.9510046070720896,299,39,7,345
21161,bright,main,8,0.9671543736068359,354,44,6,404
21161,bright,main,9,0.9741135739389899,347,51,3,401
21162,bright,main,0,0.9546102776018145,336,80,3,419
21162,bright,main,1,0.9538838186500572,316,54,3,373
21162,bright,main,2,0.9690670005675958,339,67,6,412
21162,bright,main,3,0.9479747485908372,311,52,7,370
21162,bright,main,4,0.9580816793272456,318,63,3,384
21162,bright,main,5,0.9425261543862361,304,79,7,390
21162,bright,main,6,0.9353198448864133,249,83,5,337
21162,bright,main,7,0.9719560539438802,250,86,2,338
21162,bright,main,8,0.9539054976574907,282,102,0,384
21162,bright,main,9,0.9555105835270244,330,70,2,402
21163,bright,main,0,0.9649242080844295,347,62,7,416
21163,bright,main,1,0.9479618202344697,301,70,6,377
21163,bright,main,2,0.960838223195448,331,68,3,402
21163,bright,main,3,0.9668944808428044,282,75,6,363
21163,bright,main,4,0.9524580856979548,336,52,1,389
21163,bright,main,5,0.9505217602985858,313,75,4,392
21163,bright,main,6,0.9564586770430448,278,62,3,343
21163,bright,main,7,0.9737151743041298,298,48,6,352
21163,bright,main,8,0.9667341830711691,350,49,5,404
21163,bright,main,9,0.9720084209165633,335,61,9,405
21164,bright,main,0,0.9543512839176334,318,69,8,395
21164,bright,main,1,0.9275723005139132,315,60,2,377
21164,bright,main,2,0.9630134501494992,345,55,2,402
21164,bright,main,3,0.9813511423652194,278,74,4,356
21164,bright,main,4,0.9499288407926765,304,71,3,378
21164,bright,main,5,0.9665226967870351,328,57,4,389
21164,bright,main,6,0.9467488544910274,282,60,2,344
21164,bright,main,7,0.9243871447156213,249,68,3,320
21164,bright,main,8,0.968998773898581,345,55,4,404
21164,bright,main,9,0.9682287245964617,336,61,5,402
21166,bright,main,0,0.9544236629313471,287,105,2,394
21166,bright,main,1,0.9644230851922276,303,63,6,372
21166,bright,main,2,0.9583294352534918,322,72,4,398
21166,bright,main,3,0.9425599514817935,296,65,3,364
21166,bright,main,4,0.9613566337953096,298,72,4,374
21166,bright,main,5,0.9514085440451117,320,55,7,382
21166,bright,main,6,0.9771857767414779,259,76,3,338
21166,bright,main,7,0.9635842700083364,241,66,1,308
21166,bright,main,8,0.9569922074429109,317,74,4,395
21166,bright,main,9,0.9663992895389871,308,81,4,393
21167,bright,main,0,0.9449995861714845,322,83,1,406
21167,bright,main,1,0.9578795765529579,317,49,3,369
21167,bright,main,2,0.9599738416235032,310,84,3,397
21167,bright,main,3,0.9682549530774542,282,75,3,360
21167,bright,main,4,0.9536346739032376,259,74,1,334
21167,bright,main,5,0.9624970793060191,299,79,6,384
21167,bright,main,6,0.9542474782184978,306,50,2,358
21167,bright,main,7,0.9646910614146078,272,63,2,337
21167,bright,main,8,0.9610433782388161,315,78,3,396
21167,bright,main,9,0.9759507161759937,335,73,4,412
21169,bright,main,0,0.9799786622751546,371,54,5,430
21169,bright,main,1,0.945937401754799,332,46,7,385
21169,bright,main,2,0.9781585673310444,355,47,2,404
21169,bright,main,3,0.9659645845503465,320,40,4,364
21169,bright,main,4,0.9557574113283193,331,47,5,383
21169,bright,main,5,0.9588781137512947,325,64,3,392
21169,bright,main,6,0.8923769624836299,192,42,0,234
21169,bright,main,7,0.9203539936394924,279,40,3,322
21169,bright,main,8,0.9542841626389326,335,64,2,401
21169,bright,main,9,0.9481167120347258,337,63,2,402
21173,bright,main,0,0.9654339840337355,342,69,3,414
21173,bright,main,1,0.9498847107918129,304,58,6,368
21173,bright,main,2,0.9553893017925255,345,49,1,395
21173,bright,main,3,0.9816914564053352,313,57,1,371
21173,bright,main,4,0.9337775310283363,319,53,5,377
21173,bright,main,5,0.963547744369425,325,64,4,393
21173,bright,main,6,0.9564298967388745,285,57,6,348
21173,bright,main,7,0.9588121679387007,279,58,4,341
21173,bright,main,8,0.9436269940465382,333,59,2,394
21173,bright,main,9,0.971770757413385,359,44,2,405
21175,bright,main,0,0.9762030508963981,337,68,1,406
21175,bright,main,1,0.9484829355323564,283,68,3,354
21175,bright,main,2,0.9677321575002455,344,52,4,400
21175,bright,main,3,0.9665472062441914,307,52,2,361
21175,bright,main,4,0.9606515781697449,322,45,6,373
21175,bright,main,5,0.9704984205776153,305,67,4,376
21175,bright,main,6,0.935931540100753,284,57,3,344
21175,bright,main,7,0.9697417504451359,287,49,4,340
21175,bright,main,8,0.9665917919337569,331,50,4,385
21175,bright,main,9,0.968405939705189,316,72,3,391
21179,bright,main,0,0.9486019046927747,335,69,3,407
21179,bright,main,1,0.9403245136312559,288,78,5,371
21179,bright,main,2,0.9491442211794368,341,59,6,406
21179,bright,main,3,0.9481209205333743,331,45,1,377
21179,bright,main,4,0.9542745027907212,309,58,6,373
21179,bright,main,5,0.9697891908844274,305,74,11,390
21179,bright,main,6,0.9498475126728975,266,64,6,336
21179,bright,main,7,0.9604533289092979,247,61,8,316
21179,bright,main,8,0.9683470528967284,301,81,4,386
21179,bright,main,9,0.9726923559361152,339,63,2,404
21180,bright,main,0,0.9752188641722316,338,73,5,416
21180,bright,main,1,0.9670724105236994,314,60,4,378
21180,bright,main,2,0.9510712284596357,315,69,6,390
21180,bright,main,3,0.9543402765086282,294,69,1,364
21180,bright,main,4,0.966305640880621,273,48,5,326
21180,bright,main,5,0.9392691408441287,346,46,9,401
21180,bright,main,6,0.9482811413731985,278,63,5,346
21180,bright,main,7,0.9432610631679937,283,47,2,332
21180,bright,main,8,0.9409492574652701,341,52,5,398
21180,bright,main,9,0.9570436931946034,353,54,2,409
21181,bright,main,0,0.9612566569235848,373,45,3,421
21181,bright,main,1,0.955083955123121,333,37,3,373
21181,bright,main,2,0.9718785852237068,369,44,3,416
21181,bright,main,3,0.9576620981775185,302,53,3,358
21181,bright,main,4,0.9430049265536073,335,47,2,384
21181,bright,main,5,0.9782147565568672,371,40,3,414
21181,bright,main,6,0.9628140949962654,298,52,5,355
21181,bright,main,7,0.9592409927408035,294,42,1,337
21181,bright,main,8,0.9561165412646192,366,44,2,412
21181,bright,main,9,0.973761557692064,361,42,3,406
21184,bright,main,0,0.9686597480903573,364,55,4,423
21184,bright,main,1,0.9514620338794392,327,55,2,384
21184,bright,main,2,0.9710174641867895,376,42,3,421
21184,bright,main,3,0.9774668471635846,334,43,1,378
21184,bright,main,4,0.9512918807265024,336,49,4,389
21184,bright,main,5,0.953013985504368,368,35,2,405
21184,bright,main,6,0.9519237830649276,328,32,2,362
21184,bright,main,7,0.9540958013545331,282,58,2,342
21184,bright,main,8,0.9522043911909791,327,68,2,397
21184,bright,main,9,0.9680406882855334,332,70,3,405
21190,bright,main,0,0.9583769603697482,367,54,4,425
21190,bright,main,1,0.9642648179065044,324,45,1,370
21190,bright,main,2,0.9657411736588517,351,50,4,405
21190,bright,main,3,0.9630306635268571,324,49,1,374
21190,bright,main,4,0.9264712485661035,272,45,4,321
21190,bright,main,5,0.9373704699999091,356,40,7,403
21190,bright,main,6,0.9612308778386581,298,49,1,348
21190,bright,main,7,0.9399420040238974,288,42,4,334
21190,bright,main,8,0.9687112911335792,340,55,1,396
21190,bright,main,9,0.951790915757251,318,58,7,383
21193,bright,main,0,0.9621718621310144,310,52,18,380
21193,bright,main,1,0.9701826227804012,298,46,12,356
21193,bright,main,2,0.9562683799740747,308,65,11,384
21193,bright,main,3,0.9610288638798532,299,53,6,358
21193,bright,main,4,0.9645804244524483,307,51,9,367
21193,bright,main,5,0.9645804244524483,307,51,9,367
21193,bright,main,6,0.9586367968282855,277,40,9,326
21193,bright,main,7,0.9471831223777013,269,41,7,317
21193,bright,main,8,0.9399003460248753,310,78,8,396
21193,bright,main,9,0.9451764885484069,352,44,9,405
21194,bright,main,0,0.9739153445146269,335,69,8,412
21194,bright,main,1,0.9534837103377304,309,72,3,384
21194,bright,main,2,0.9630332341660792,353,52,3,408
21194,bright,main,3,0.9642749816547918,308,70,3,381
21194,bright,main,4,0.9575197503729004,279,52,5,336
21194,bright,main,5,0.9547534160247743,334,64,3,401
21194,bright,main,6,0.9414883994672948,313,38,5,356
21194,bright,main,7,0.9474426137633515,255,70,4,329
21194,bright,main,8,0.9706452159404617,328,74,3,405
21194,bright,main,9,0.9729960374490039,321,75,3,399
21195,bright,main,0,0.9701032594985622,322,81,4,407
21195,bright,main,1,0.9469644189193523,303,71,2,376
21195,bright,main,2,0.9682097074364567,338,61,8,407
21195,bright,main,3,0.9437291224925002,317,55,3,375
21195,bright,main,4,0.9272145418649975,329,47,8,384
21195,bright,main,5,0.9618082077287239,321,71,2,394
21195,bright,main,6,0.9478097320158193,279,59,9,347
21195,bright,main,7,0.9477915776424363,271,72,1,344
21195,bright,main,8,0.9571452870165602,328,62,6,396
21195,bright,main,9,0.949554874969625,332,74,3,409
21196,bright,main,0,0.9768410613939941,278,116,6,400
21196,bright,main,1,0.9639177363914169,296,74,5,375
21196,bright,main,2,0.9442078713994038,349,53,4,406
21196,bright,main,3,0.9627051484419007,275,85,1,361
21196,bright,main,4,0.9672758063786238,328,52,3,383
21196,bright,main,5,0.9688246749528661,325,70,2,397
21196,bright,main,6,0.9397851735483603,304,50,4,358
21196,bright,main,7,0.9330715771367774,294,51,3,348
21196,bright,main,8,0.9662750242796811,357,51,4,412
21196,bright,main,9,0.9707502867625137,297,94,3,394
21197,bright,main,0,0.9813554055794987,352,68,3,423
21197,bright,main,1,0.9655738004526352,299,73,7,379
21197,bright,main,2,0.9767648599649547,331,69,4,404
21197,bright,main,3,0.9590159004425807,293,76,4,373
21197,bright,main,4,0.9745757522286729,317,69,1,387
21197,bright,main,5,0.9529083024058613,323,67,2,392
21197,bright,main,6,0.9649420026876073,296,62,2,360
21197,bright,main,7,0.9498026252402396,278,67,3,348
21197,bright,main,8,0.9607640200596784,300,92,3,395
21197,bright,main,9,0.9613072007496647,309,83,3,395
21202,bright,main,0,0.9811455745436933,335,80,0,415
21202,bright,main,1,0.9309762432180057,329,61,3,393
21202,bright,main,2,0.9650070030513375,353,61,3,417
21202,bright,main,3,0.9743790315741216,312,67,1,380
21202,bright,main,4,0.935158526973117,311,66,5,382
21202,bright,main,5,0.970608739130218,340,61,1,402
21202,bright,main,6,0.9392883054630801,294,57,3,354
21202,bright,main,7,0.9557313454284576,280,63,2,345
21202,bright,main,8,0.9828837994477696,363,47,4,414
21202,bright,main,9,0.9460789393653842,338,65,7,410
21204,bright,main,0,0.9482825553855281,360,56,4,420
21204,bright,main,1,0.9700208448176826,312,66,7,385
21204,bright,main,2,0.944023124759794,342,57,4,403
21204,bright,main,3,0.9541753033165427,299,72,2,373
21204,bright,main,4,0.9569068589515656,313,72,5,390
21204,bright,main,5,0.9673350942775458,319,73,1,393
21204,bright,main,6,0.9643886031849718,286,64,1,351
21204,bright,main,7,0.9553743960453837,271,68,9,348
21204,bright,main,8,0.9615093758163511,317,76,4,397
21204,bright,main,9,0.9646391176228858,370,46,2,418
21205,bright,main,0,0.9468436625496449,342,65,6,413
21205,bright,main,1,0.9655374754543972,345,43,5,393
21205,bright,main,2,0.956877072233576,348,65,4,417
21205,bright,main,3,0.9519566562564074,282,89,1,372
21205,bright,main,4,0.9621787535116221,338,52,2,392
21205,bright,main,5,0.9722005068928022,335,56,8,399
21205,bright,main,6,0.9642414550916266,299,48,4,351
21205,bright,main,7,0.9424882947542153,257,63,7,327
21205,bright,main,8,0.9625236826417993,330,67,6,403
21205,bright,main,9,0.9630830906182031,338,68,5,411
21206,bright,main,0,0.9558539940407865,363,52,3,418
21206,bright,main,1,0.9799483588545603,351,38,4,393
21206,bright,main,2,0.9664505859606268,329,74,2,405
21206,bright,main,3,0.9682786302038068,315,61,5,381
21206,bright,main,4,0.9587287298259214,322,54,5,381
21206,bright,main,5,0.9813246114960471,336,59,3,398
21206,bright,main,6,0.961544571318126,296,53,5,354
21206,bright,main,7,0.9721119844460159,295,54,1,350
21206,bright,main,8,0.9523132093275808,318,73,3,394
21206,bright,main,9,0.9776782008376113,358,56,5,419
21219,bright,main,0,0.9358625578458737,293,48,2,343
21219,bright,main,1,0.9665697574804591,290,74,5,369
21219,bright,main,2,0.9509140131669906,341,49,5,395
21219,bright,main,3,0.9679730296574434,298,55,1,354
21219,bright,main,4,0.9769797535253116,328,40,6,374
21219,bright,main,5,0.9579320464708256,343,56,3,402
21219,bright,main,6,0.9719539745142706,302,39,0,341
21219,bright,main,7,0.9493272216130091,280,50,3,333
21219,bright,main,8,0.9698531567602896,287,86,2,375
21219,bright,main,9,0.9556328625511523,277,96,3,376
21220,bright,main,0,0.9594084316164526,357,66,5,428
21220,bright,main,1,0.9537036576940233,346,39,3,388
21220,bright,main,2,0.9739783319293008,341,61,7,409
21220,bright,main,3,0.9601432173681791,309,65,2,376
21220,bright,main,4,0.9635827608167752,322,68,1,391
21220,bright,main,5,0.9811263595365256,352,63,3,418
21220,bright,main,6,0.9668559523553764,315,40,1,356
21220,bright,main,7,0.961230877838658,275,68,6,349
21220,bright,main,8,0.971490308073933,358,50,2,410
21220,bright,main,9,0.980310877603078,347,64,3,414
21272,bright,main,0,0.9628611624136643,344,89,6,439
21272,bright,main,1,0.9728905231421832,327,65,8,400
21272,bright,main,2,0.9541442095983041,333,88,5,426
21272,bright,main,3,0.9722960340147028,284,103,3,390
21272,bright,main,4,0.9811634328949828,304,97,3,404
21272,bright,main,5,0.9373642558038178,327,86,4,417
21272,bright,main,6,0.9622553305666088,277,80,3,360
21272,bright,main,7,0.957826273869233,266,97,4,367
21272,bright,main,8,0.9680930867104691,319,96,2,417
21272,bright,main,9,0.950954472645222,359,66,1,426
21671,bright,main,0,0.9717103395460571,254,81,3,338
21671,bright,main,1,0.9457252588154513,337,57,4,398
21671,bright,main,2,0.9754460559499959,358,77,5,440
21671,bright,main,3,0.9840056240530892,261,141,5,407
21671,bright,main,4,0.9617272332458259,297,119,1,417
21671,bright,main,5,0.9740610799439414,279,149,4,432
21671,bright,main,6,0.9491278795021469,277,93,1,371
21671,bright,main,7,0.9608522682605366,279,98,2,379
21671,bright,main,8,0.977389433127258,313,113,5,431
21671,bright,main,9,0.9488219618453989,307,126,5,438
21672,bright,main,0,0.9498727194799443,326,113,1,440
21672,bright,main,1,0.9689987738985808,276,123,5,404
21672,bright,main,2,0.9748142690268211,334,100,2,436
21672,bright,main,3,0.9491118372206484,294,101,4,399
21672,bright,main,4,0.9659179886687462,300,106,4,410
21672,bright,main,5,0.954483345806912,327,94,3,424
21672,bright,main,6,0.9732562632224624,278,89,3,370
21672,bright,main,7,0.9552737682441319,224,142,3,369
21672,bright,main,8,0.9440847221273592,271,152,4,427
21672,bright,main,9,0.9629013945051078,282,148,3,433
21676,bright,main,0,0.9767970331906907,254,174,6,434
21676,bright,main,1,0.9735209261913367,237,150,2,389
21676,bright,main,2,0.9593412479832831,304,116,6,426
21676,bright,main,3,0.984906953292254,292,102,3,397
21676,bright,main,4,0.9662758658494902,256,138,3,397
21676,bright,main,5,0.9651099619010282,279,128,4,411
21676,bright,main,6,0.9605079389647699,241,118,3,362
21676,bright,main,7,0.9691090287664244,253,109,1,363
21676,bright,main,8,0.9659740557079856,255,149,1,405
21676,bright,main,9,0.9685813526681649,294,131,1,426
21700,bright,main,0,0.9720621480021131,272,169,3,444
21700,bright,main,1,0.9655079315649552,256,143,7,406
21700,bright,main,2,0.9667036773689591,287,142,5,434
21700,bright,main,3,0.957967686717323,269,127,6,402
21700,bright,main,4,0.9569346995091248,302,100,5,407
21700,bright,main,5,0.9531110444200938,288,126,8,422
21700,bright,main,6,0.9501018516765398,228,140,2,370
21700,bright,main,7,0.9702886009969492,221,144,3,368
21700,bright,main,8,0.9677394376664914,221,206,2,429
21700,bright,main,9,0.989047195281192,280,150,5,435
21996,bright,main,0,0.9381263420735166,369,47,5,421
21996,bright,main,1,0.9432604318246319,309,86,1,396
21996,bright,main,2,0.9672683658172343,330,93,2,425
21996,bright,main,3,0.9647182083174209,272,128,0,400
21996,bright,main,4,0.9451303397485056,258,147,3,408
21996,bright,main,5,0.9609903388913865,273,137,5,415
21996,bright,main,6,0.9718199361460275,217,146,3,366
21996,bright,main,7,0.9666685623313538,194,170,2,366
21996,bright,main,8,0.9586341448776078,316,85,4,405
21996,bright,main,9,0.9738660997825935,349,65,5,419
22393,bright,main,0,0.9666611361712357,281,157,3,441
22393,bright,main,1,0.961586007114944,248,153,5,406
22393,bright,main,2,0.9570115150126017,341,91,2,434
22393,bright,main,3,0.9509168505368321,325,78,3,406
22393,bright,main,4,0.9705035974075722,311,90,6,407
22393,bright,main,5,0.9542008078671407,268,145,4,417
22393,bright,main,6,0.9731853596844139,248,123,4,375
22393,bright,main,7,0.9600890721889905,254,123,0,377
22393,bright,main,8,0.9715053417708208,240,174,7,421
22393,bright,main,9,0.9674239796223363,259,161,5,425
22440,bright,main,0,0.9621305453191046,291,145,1,437
22440,bright,main,1,0.9748205890559126,267,127,5,399
22440,bright,main,2,0.9553018616302354,242,188,4,434
22440,bright,main,3,0.9396674774185537,235,164,2,401
22440,bright,main,4,0.9726392835909561,223,184,1,408
22440,bright,main,5,0.9704769169624443,293,125,4,422
22440,bright,main,6,0.9631298630010356,286,81,5,372
22440,bright,main,7,0.9566431134450889,255,110,4,369
22440,bright,main,8,0.9680133031726436,332,80,4,416
22440,bright,main,9,0.9562066573737137,300,110,1,411
22465,bright,main,0,0.9822945477384264,317,110,5,432
22465,bright,main,1,0.952493775997655,238,157,3,398
22465,bright,main,2,0.9691002858661967,273,152,6,431
22465,bright,main,3,0.9492470740171849,274,122,1,397
22465,bright,main,4,0.9755935506117442,251,156,4,411
22465,bright,main,5,0.9775895954820343,272,139,5,416
22465,bright,main,6,0.9571782461067203,249,112,6,367
22465,bright,main,7,0.9675131482904465,229,132,5,366
22465,bright,main,8,0.9605390997727621,313,106,1,420
22465,bright,main,9,0.9738529313903729,328,87,7,422
80605,lrgqso,sv1,0,0.9546893401784011,308,17,36,361
80605,lrgqso,sv1,1,0.936203782015834,270,19,40,329
80605,lrgqso,sv1,2,0.9531647781210867,300,22,40,362
80605,lrgqso,sv1,3,0.9426634213988283,223,25,43,291
80605,lrgqso,sv1,4,0.9384011516691696,263,27,50,340
80605,lrgqso,sv1,5,0.9521170906285142,262,35,51,348
80605,lrgqso,sv1,6,0.9671103744804777,309,26,34,369
80605,lrgqso,sv1,7,0.9455655648015459,242,15,41,298
80605,lrgqso,sv1,8,0.9616093296134987,284,19,52,355
80605,lrgqso,sv1,9,0.95764825236474,290,18,40,348
80606,elg,sv1,0,0.9403971009848823,318,11,9,338
80606,elg,sv1,1,0.9446848244846614,273,9,12,294
80606,elg,sv1,2,0.9529128063836012,303,11,8,322
80606,elg,sv1,3,0.9423147672815727,255,13,8,276
80606,elg,sv1,4,0.9704127670982982,297,17,8,322
80606,elg,sv1,5,0.9587738845264837,299,13,8,320
80606,elg,sv1,6,0.9446076715729058,310,20,13,343
80606,elg,sv1,7,0.9608620222135574,253,11,10,274
80606,elg,sv1,8,0.9167814132199358,298,10,13,321
80606,elg,sv1,9,0.9646508276498069,311,8,14,333
80607,lrgqso,sv1,0,0.9380163033478398,274,49,46,369
80607,lrgqso,sv1,1,0.9541659199435334,241,61,30,332
80607,lrgqso,sv1,2,0.955398879618572,265,51,35,351
80607,lrgqso,sv1,3,0.8911690367425721,231,31,34,296
80607,lrgqso,sv1,4,0.9754224575069843,271,38,30,339
80607,lrgqso,sv1,5,0.9799645705243872,265,38,48,351
80607,lrgqso,sv1,6,0.9581630401941622,284,47,36,367
80607,lrgqso,sv1,7,0.97462995103706,243,28,34,305
80607,lrgqso,sv1,8,0.9377916574112604,279,33,41,353
80607,lrgqso,sv1,9,0.9579825911542169,283,32,44,359
80608,elg,sv1,0,0.9390065943257239,304,20,14,338
80608,elg,sv1,1,0.94574789145374,270,18,12,300
80608,elg,sv1,2,0.9419066386168696,297,17,6,320
80608,elg,sv1,3,0.9278478377489026,248,13,11,272
80608,elg,sv1,4,0.9533487028858771,297,16,8,321
80608,elg,sv1,5,0.9575005537553134,313,6,9,328
80608,elg,sv1,6,0.9755324135506521,306,18,12,336
80608,elg,sv1,7,0.9168469314117188,261,10,9,280
80608,elg,sv1,8,0.9580439390490221,293,10,15,318
80608,elg,sv1,9,0.9088426246586706,313,17,11,341
80609,lrgqso,sv1,0,0.9417178942513665,298,23,39,360
80609,lrgqso,sv1,1,0.9218282696080923,268,28,38,334
80609,lrgqso,sv1,2,0.9725075885311381,295,29,36,360
80609,lrgqso,sv1,3,0.9580120115264182,232,22,37,291
80609,lrgqso,sv1,4,0.9606278169375011,267,25,43,335
80609,lrgqso,sv1,5,0.9510974969516751,287,21,49,357
80609,lrgqso,sv1,6,0.9654091590093887,300,18,43,361
80609,lrgqso,sv1,7,0.9480350493301919,246,25,33,304
80609,lrgqso,sv1,8,0.9655150945862966,294,21,39,354
80609,lrgqso,sv1,9,0.964994301520969,287,26,36,349
80610,elg,sv1,0,0.9701726147255679,331,9,11,351
80610,elg,sv1,1,0.9228191848988956,281,14,10,305
80610,elg,sv1,2,0.9385097987123177,316,12,13,341
80610,elg,sv1,3,0.9306032789539975,246,11,8,265
80610,elg,sv1,4,0.9555859337913708,281,18,11,310
80610,elg,sv1,5,0.9657438027476195,306,14,10,330
80610,elg,sv1,6,0.9592199138010814,311,16,7,334
80610,elg,sv1,7,0.9401436510470124,254,10,11,275
80610,elg,sv1,8,0.9531172002564451,295,16,11,322
80610,elg,sv1,9,0.9615902666674553,320,14,14,348
80611,bgsmws,sv1,0,0.9510198056304949,301,77,3,381
80611,bgsmws,sv1,1,0.9745832735085563,252,82,6,340
80611,bgsmws,sv1,2,0.9583762047754847,288,74,4,366
80611,bgsmws,sv1,3,0.9115445105172229,228,75,3,306
80611,bgsmws,sv1,4,0.9616722910226101,245,106,4,355
80611,bgsmws,sv1,5,0.9387450895330633,228,126,7,361
80611,bgsmws,sv1,6,0.9606491803276547,270,106,2,378
80611,bgsmws,sv1,7,0.9357082863323534,218,88,1,307
80611,bgsmws,sv1,8,0.9557658408672184,282,78,2,362
80611,bgsmws,sv1,9,0.9788481658028816,272,90,1,363
80612,bgsmws,sv1,0,0.9329916942331967,295,79,5,379
80612,bgsmws,sv1,1,0.9709404139435232,228,112,1,341
80612,bgsmws,sv1,2,0.9568356053868287,272,96,5,373
80612,bgsmws,sv1,3,0.9450150313366293,240,61,2,303
80612,bgsmws,sv1,4,0.9499497733335848,258,87,3,348
80612,bgsmws,sv1,5,0.9428240220408802,270,91,5,366
80612,bgsmws,sv1,6,0.9629041562042413,298,81,4,383
80612,bgsmws,sv1,7,0.9411588666606399,251,52,4,307
80612,bgsmws,sv1,8,0.9387863487851167,288,77,2,367
80612,bgsmws,sv1,9,0.9684996843993882,256,100,6,362
80613,bgsmws,sv1,0,0.9616324657026849,270,109,1,380
80613,bgsmws,sv1,1,0.9531956757716061,255,95,1,351
80613,bgsmws,sv1,2,0.9785974821436227,249,115,1,365
80613,bgsmws,sv1,3,0.9486063846222056,264,64,3,331
80613,bgsmws,sv1,4,0.9373594810172485,233,113,2,348
80613,bgsmws,sv1,5,0.9604830940777758,260,99,6,365
80613,bgsmws,sv1,6,0.96711378227999,264,97,4,365
80613,bgsmws,sv1,7,0.9557905212377098,234,74,3,311
80613,bgsmws,sv1,8,0.9605163036861964,246,106,4,356
80613,bgsmws,sv1,9,0.9542000549353488,271,104,6,381
80614,bgsmws,sv1,0,0.9675610892436947,267,111,4,382
80614,bgsmws,sv1,1,0.9810480068309568,247,84,2,333
80614,bgsmws,sv1,2,0.946310675376594,285,76,1,362
80614,bgsmws,sv1,3,0.9769449552462265,255,88,4,347
80614,bgsmws,sv1,4,0.9485962070772033,302,42,3,347
80614,bgsmws,sv1,5,0.9467807770879177,294,58,5,357
80614,bgsmws,sv1,6,0.9478386111313131,221,84,3,308
80614,bgsmws,sv1,7,0.9602806807006974,219,88,5,312
80614,bgsmws,sv1,8,0.9655117022860679,258,100,3,361
80614,bgsmws,sv1,9,0.9656949611343004,275,101,3,379
80615,m33,cmx,0,0.9279091750873171,238,66,41,345
80615,m33,cmx,1,0.9442743509558159,172,98,15,285
80615,m33,cmx,2,0.9639603756073575,225,67,26,318
80615,m33,cmx,3,0.9507365752404693,183,71,32,286
80615,m33,cmx,4,0.9500904430568392,241,46,36,323
80615,m33,cmx,5,0.9587999647318155,236,59,39,334
80615,m33,cmx,6,0.9585626035520624,239,59,49,347
80615,m33,cmx,7,0.9445270686371332,210,46,30,286
80615,m33,cmx,8,0.9140657792272,245,42,37,324
80615,m33,cmx,9,0.9528900132128969,248,53,42,343
80616,bgsmws,sv1,0,0.9438169888878906,312,63,2,377
80616,bgsmws,sv1,1,0.9551538740106871,274,52,6,332
80616,bgsmws,sv1,2,0.931735028715744,281,60,3,344
80616,bgsmws,sv1,3,0.9185404067143815,236,57,3,296
80616,bgsmws,sv1,4,0.9444067365161111,255,88,2,345
80616,bgsmws,sv1,5,0.9705909745560021,251,91,6,348
80616,bgsmws,sv1,6,0.9437291224925004,287,85,1,373
80616,bgsmws,sv1,7,0.9535607492811112,208,95,2,305
80616,bgsmws,sv1,8,0.931100618697058,223,138,2,363
80616,bgsmws,sv1,9,0.9752115990986261,250,111,2,363
80617,bgsmws,sv1,0,0.9608537495944766,251,127,6,384
80617,bgsmws,sv1,1,0.955687905698718,257,84,2,343
80617,bgsmws,sv1,2,0.9666685623313538,240,124,3,367
80617,bgsmws,sv1,3,0.9586072100194826,222,84,1,307
80617,bgsmws,sv1,4,0.9765535767170026,243,104,4,351
80617,bgsmws,sv1,5,0.9449502031419439,302,56,2,360
80617,bgsmws,sv1,6,0.9713892436602727,266,106,1,373
80617,bgsmws,sv1,7,0.9155694885042444,197,109,1,307
80617,bgsmws,sv1,8,0.9656278182254171,267,95,5,367
80617,bgsmws,sv1,9,0.9582864222446603,270,109,1,380
80618,bgsmws,sv1,0,0.9436843397185221,284,106,10,400
80618,bgsmws,sv1,1,0.9593934594399325,260,77,0,337
80618,bgsmws,sv1,2,0.9672397347337367,243,134,13,390
80618,bgsmws,sv1,3,0.960405395688091,264,92,5,361
80618,bgsmws,sv1,4,0.9502041419125447,280,71,14,365
80618,bgsmws,sv1,5,0.9747187684395938,274,85,8,367
80618,bgsmws,sv1,6,0.9486055365824664,263,108,5,376
80618,bgsmws,sv1,7,0.9678565642824083,215,118,34,367
80618,bgsmws,sv1,8,0.9433414595605335,246,135,22,403
80618,bgsmws,sv1,9,0.9704678183059812,278,120,11,409
80619,bgsmws,sv1,0,0.9630131828166149,228,134,1,363
80619,bgsmws,sv1,1,0.9587999647318155,232,98,3,333
80619,bgsmws,sv1,2,0.9474050282604836,227,116,2,345
80619,bgsmws,sv1,3,0.9444511068770273,225,97,2,324
80619,bgsmws,sv1,4,0.9604472217818507,242,78,2,322
80619,bgsmws,sv1,5,0.9629561218310426,270,72,5,347
80619,bgsmws,sv1,6,0.9626492404492394,292,73,1,366
80619,bgsmws,sv1,7,0.935897111042873,226,75,3,304
80619,bgsmws,sv1,8,0.9596146230519013,270,89,3,362
80619,bgsmws,sv1,9,0.9721816058161935,266,94,8,368
80620,lrgqso,sv1,0,0.9626663862463234,313,13,41,367
80620,lrgqso,sv1,1,0.9748976120213911,282,16,39,337
80620,lrgqso,sv1,2,0.9642528637186073,305,15,32,352
80620,lrgqso,sv1,3,0.9854074193151215,253,13,33,299
80620,lrgqso,sv1,4,0.9688297122742878,294,10,36,340
80620,lrgqso,sv1,5,0.9735487484399523,273,22,42,337
80620,lrgqso,sv1,6,0.9546500999545023,305,13,42,360
80620,lrgqso,sv1,7,0.9533818083080383,244,19,39,302
80620,lrgqso,sv1,8,0.9681290743474903,284,20,42,346
80620,lrgqso,sv1,9,0.975194499169038,298,17,40,355
80621,elg,sv1,0,0.9221209662704923,307,9,9,325
80621,elg,sv1,1,0.9536021058851719,268,2,17,287
80621,elg,sv1,2,0.9322826832626504,303,7,9,319
80621,elg,sv1,3,0.9217535665742012,241,5,6,252
80621,elg,sv1,4,0.9268980235964143,254,5,4,263
80621,elg,sv1,5,0.930989407418013,272,8,8,288
80621,elg,sv1,6,0.9659984782602317,292,4,6,302
80621,elg,sv1,7,0.9565910265409127,254,3,5,262
80621,elg,sv1,8,0.923349374381638,290,8,15,313
80621,elg,sv1,9,0.9602428279090067,305,9,7,321
80622,lrgqso,sv1,0,0.9776092286336718,300,19,39,358
80622,lrgqso,sv1,1,0.9499263867900438,261,22,46,329
80622,lrgqso,sv1,2,0.9794401717234283,308,17,35,360
80622,lrgqso,sv1,3,0.9574317058831145,244,9,32,285
80622,lrgqso,sv1,4,0.9423930543246761,266,21,40,327
80622,lrgqso,sv1,5,0.9235748980043903,293,11,43,347
80622,lrgqso,sv1,6,0.9788089255789828,294,15,51,360
80622,lrgqso,sv1,7,0.9401662532267752,241,17,33,291
80622,lrgqso,sv1,8,0.9693206767462837,262,29,54,345
80622,lrgqso,sv1,9,0.9545038578649717,303,20,24,347
80623,elg,sv1,0,0.9563501354293704,296,18,12,326
80623,elg,sv1,1,0.946234767310652,267,10,10,287
80623,elg,sv1,2,0.9301000828254861,287,15,10,312
80623,elg,sv1,3,0.9272060622434223,229,10,4,243
80623,elg,sv1,4,0.9522286612123475,268,11,4,283
80623,elg,sv1,5,0.9571816076782174,280,12,14,306
80623,elg,sv1,6,0.9676235324416135,296,15,8,319
80623,elg,sv1,7,0.9456814926828583,237,5,6,248
80623,elg,sv1,8,0.9470780655621192,269,13,14,296
80623,elg,sv1,9,0.940868452158612,286,9,10,305
80624,bgsmws,sv1,0,0.966269196320897,340,21,6,367
80624,bgsmws,sv1,1,0.9659792563012931,288,46,4,338
80624,bgsmws,sv1,2,0.9540988212595727,291,76,1,368
80624,bgsmws,sv1,3,0.9540988212595727,291,76,1,368
80624,bgsmws,sv1,4,0.9687240750882324,277,71,3,351
80624,bgsmws,sv1,5,0.9442048459342525,225,109,8,342
80624,bgsmws,sv1,6,0.9821635850346905,264,102,2,368
80624,bgsmws,sv1,7,0.9192184213986065,215,88,4,307
80624,bgsmws,sv1,8,0.9689901805880239,255,104,0,359
80624,bgsmws,sv1,9,0.9661911878283389,286,75,5,366
80626,bgsmws,sv1,0,0.9673327072321504,221,106,2,329
80626,bgsmws,sv1,1,0.9587508762235911,207,113,7,327
80626,bgsmws,sv1,2,0.9641144135992477,262,92,3,357
80626,bgsmws,sv1,3,0.9641144135992477,262,92,3,357
80626,bgsmws,sv1,4,0.9753105370719392,215,106,5,326
80626,bgsmws,sv1,5,0.9672435323606811,225,109,3,337
80626,bgsmws,sv1,6,0.9473390020766044,231,104,4,339
80626,bgsmws,sv1,7,0.9608775856979563,204,97,4,305
80626,bgsmws,sv1,8,0.9631601601924779,200,139,4,343
80626,bgsmws,sv1,9,0.9716451371354806,253,102,2,357
80627,bgsmws,sv1,0,0.9621000803811742,252,122,5,379
80627,bgsmws,sv1,1,0.9423528971365207,233,98,2,333
80627,bgsmws,sv1,2,0.966230115290607,246,119,3,368
80627,bgsmws,sv1,3,0.966230115290607,246,119,3,368
80627,bgsmws,sv1,4,0.97115029854115,253,89,3,345
80627,bgsmws,sv1,5,0.9478989450313657,259,101,1,361
80627,bgsmws,sv1,6,0.9632908457321115,257,105,6,368
80627,bgsmws,sv1,7,0.9500150105066371,222,81,2,305
80627,bgsmws,sv1,8,0.9617828331514683,282,83,3,368
80627,bgsmws,sv1,9,0.9391097025781655,253,106,4,363
80628,bgsmws,sv1,0,0.9199821255088708,240,108,3,351
80628,bgsmws,sv1,1,0.943977296091655,237,89,4,330
80628,bgsmws,sv1,2,0.9704289412617213,251,87,3,341
80628,bgsmws,sv1,3,0.9704289412617213,251,87,3,341
80628,bgsmws,sv1,4,0.9253841067145642,218,103,4,325
80628,bgsmws,sv1,5,0.9668681599426098,260,84,5,349
80628,bgsmws,sv1,6,0.9318693470066421,272,74,2,348
80628,bgsmws,sv1,7,0.9430844486807375,243,57,3,303
80628,bgsmws,sv1,8,0.9778935043626158,289,74,3,366
80628,bgsmws,sv1,9,0.950217776387897,282,84,2,368
80629,bgsmws,sv1,0,0.9524954876550625,294,68,4,366
80629,bgsmws,sv1,1,0.9102312555783398,272,68,2,342
80629,bgsmws,sv1,2,0.9365480822429696,255,88,5,348
80629,bgsmws,sv1,3,0.9365480822429696,255,88,5,348
80629,bgsmws,sv1,4,0.9605219771451649,251,84,3,338
80629,bgsmws,sv1,5,0.9571828324653433,277,76,6,359
80629,bgsmws,sv1,6,0.9408765352299078,335,37,3,375
80629,bgsmws,sv1,7,0.9551051257522392,254,53,3,310
80629,bgsmws,sv1,8,0.9589985543024729,280,78,5,363
80629,bgsmws,sv1,9,0.9176221634801717,274,87,3,364
80632,bgsmws,sv1,0,0.9528001650759845,277,82,4,363
80632,bgsmws,sv1,1,0.9263752279456581,274,61,0,335
80632,bgsmws,sv1,2,0.943805431524749,278,77,8,363
80632,bgsmws,sv1,3,0.9391615005645026,154,60,9,223
80632,bgsmws,sv1,4,0.9590569453587291,264,81,1,346
80632,bgsmws,sv1,5,0.9713239494037607,241,98,5,344
80632,bgsmws,sv1,6,0.9506952809605455,286,83,5,374
80632,bgsmws,sv1,7,0.95275515455279,224,72,0,296
80632,bgsmws,sv1,8,0.9588356375702816,266,88,2,356
80632,bgsmws,sv1,9,0.9460433659701973,301,66,3,370
80633,bgsmws,sv1,0,0.9429344219339668,270,87,5,362
80633,bgsmws,sv1,1,0.9703776411802826,261,61,4,326
80633,bgsmws,sv1,2,0.9599894175832316,298,65,9,372
80633,bgsmws,sv1,3,0.9599894175832316,298,65,9,372
80633,bgsmws,sv1,4,0.9610468226307581,268,62,6,336
80633,bgsmws,sv1,5,0.9417682031355729,261,78,3,342
80633,bgsmws,sv1,6,0.9390651962723303,265,90,2,357
80633,bgsmws,sv1,7,0.9471606185862357,239,69,4,312
80633,bgsmws,sv1,8,0.9555661887550811,265,85,7,357
80633,bgsmws,sv1,9,0.9441438711842434,241,102,1,344
80635,bgsmws,sv1,0,0.9629694247040586,295,75,2,372
80635,bgsmws,sv1,1,0.9766373712331959,229,72,1,302
80635,bgsmws,sv1,2,0.9708170757894955,241,87,3,331
80635,bgsmws,sv1,3,0.9708170757894955,241,87,3,331
80635,bgsmws,sv1,4,0.8979009238044117,223,66,32,321
80635,bgsmws,sv1,5,0.9558225339948226,260,69,5,334
80635,bgsmws,sv1,6,0.9565257481346812,261,79,1,341
80635,bgsmws,sv1,7,0.9179915054078442,226,65,6,297
80635,bgsmws,sv1,8,0.9401373491147746,245,80,4,329
80635,bgsmws,sv1,9,0.9594355363065227,250,88,0,338
80636,bgsmws,sv1,0,0.9787182323974526,277,99,4,380
80636,bgsmws,sv1,1,0.9535490548260397,243,86,3,332
80636,bgsmws,sv1,2,0.9774319958888265,247,117,5,369
80636,bgsmws,sv1,3,0.9774319958888265,247,117,5,369
80636,bgsmws,sv1,4,0.9445223777493094,220,107,5,332
80636,bgsmws,sv1,5,0.9748793835443302,241,109,2,352
80636,bgsmws,sv1,6,0.9692356967082378,253,111,12,376
80636,bgsmws,sv1,7,0.9351993868341462,227,85,3,315
80636,bgsmws,sv1,8,0.9555593879592525,266,91,1,358
80636,bgsmws,sv1,9,0.9753930273677799,265,96,1,362
80637,bgsmws,sv1,0,0.9342338417440983,259,103,3,365
80637,bgsmws,sv1,1,0.9625302664959148,256,69,4,329
80637,bgsmws,sv1,2,0.9595676670105452,221,103,3,327
80637,bgsmws,sv1,3,0.9531372967948312,194,75,2,271
80637,bgsmws,sv1,4,0.9412028795262347,263,71,1,335
80637,bgsmws,sv1,5,0.9238897151219914,262,78,17,357
80637,bgsmws,sv1,6,0.9284273684532269,235,117,2,354
80637,bgsmws,sv1,7,0.96434518458894,200,90,4,294
80637,bgsmws,sv1,8,0.9616851182878057,207,111,5,323
80637,bgsmws,sv1,9,0.9642414550916266,249,93,8,350
80638,bgsmws,sv1,0,0.9756571394066511,273,96,3,372
80638,bgsmws,sv1,1,0.9400926013754957,260,73,3,336
80638,bgsmws,sv1,2,0.9626537533581945,311,65,0,376
80638,bgsmws,sv1,3,0.9626537533581945,311,65,0,376
80638,bgsmws,sv1,4,0.9707778151008627,235,100,4,339
80638,bgsmws,sv1,5,0.9616046899408941,226,102,4,332
80638,bgsmws,sv1,6,0.950502104016063,266,96,3,365
80638,bgsmws,sv1,7,0.9501250658130569,247,58,4,309
80638,bgsmws,sv1,8,0.9590530800416979,268,91,5,364
80638,bgsmws,sv1,9,0.9622614763022599,283,63,5,351
80639,bgsmws,sv1,0,0.9443585049899148,284,94,5,383
80639,bgsmws,sv1,1,0.9625310643704668,250,105,3,358
80639,bgsmws,sv1,2,0.9469498943155186,267,105,5,377
80639,bgsmws,sv1,3,0.9631311670651811,202,103,3,308
80639,bgsmws,sv1,4,0.9653695108719539,270,84,3,357
80639,bgsmws,sv1,5,0.9651825982767811,271,92,3,366
80639,bgsmws,sv1,6,0.9521232442879037,294,78,5,377
80639,bgsmws,sv1,7,0.9721505975095991,263,71,4,338
80639,bgsmws,sv1,8,0.9509488049756503,291,78,4,373
80639,bgsmws,sv1,9,0.9667776249392953,307,67,5,379
80640,bgsmws,sv1,0,0.9475001018289965,270,99,4,373
80640,bgsmws,sv1,1,0.9605147428964667,261,69,1,331
80640,bgsmws,sv1,2,0.959007626153255,265,94,5,364
80640,bgsmws,sv1,3,0.959007626153255,265,94,5,364
80640,bgsmws,sv1,4,0.9725812188824688,185,155,1,341
80640,bgsmws,sv1,5,0.9363887581088653,236,121,4,361
80640,bgsmws,sv1,6,0.9693081480786992,278,92,5,375
80640,bgsmws,sv1,7,0.9492334588787494,214,100,1,315
80640,bgsmws,sv1,8,0.9758847119165848,233,130,3,366
80640,bgsmws,sv1,9,0.964026380452652,275,80,5,360
80641,bgsmws,sv1,0,0.9543128547951044,261,109,5,375
80641,bgsmws,sv1,1,0.9668313893263565,223,107,3,333
80641,bgsmws,sv1,2,0.94935290628642,249,111,4,364
80641,bgsmws,sv1,3,0.94935290628642,249,111,4,364
80641,bgsmws,sv1,4,0.9544003570746441,225,109,5,339
80641,bgsmws,sv1,5,0.9553984578082416,230,121,5,356
80641,bgsmws,sv1,6,0.9670650244317285,244,123,2,369
80641,bgsmws,sv1,7,0.9544118556610727,217,90,2,309
80641,bgsmws,sv1,8,0.945695519568161,271,74,5,350
80641,bgsmws,sv1,9,0.9653232064548664,283,75,6,364
80642,bgsmws,sv1,0,0.9657344526857522,212,157,2,371
80642,bgsmws,sv1,1,0.9666747265253075,188,147,3,338
80642,bgsmws,sv1,2,0.9734642074967872,189,168,5,362
80642,bgsmws,sv1,3,0.9734642074967872,189,168,5,362
80642,bgsmws,sv1,4,0.9615751804915416,207,131,4,342
80642,bgsmws,sv1,5,0.9562793652352828,237,114,8,359
80642,bgsmws,sv1,6,0.9603066217784525,244,123,4,371
80642,bgsmws,sv1,7,0.9382610969124168,231,70,3,304
80642,bgsmws,sv1,8,0.9630392249614914,225,123,1,349
80642,bgsmws,sv1,9,0.9688642974444907,212,143,6,361
80643,bgsmws,sv1,0,0.944285012230127,286,93,0,379
80643,bgsmws,sv1,1,0.9444106416993011,271,59,2,332
80643,bgsmws,sv1,2,0.9542828386880075,306,59,3,368
80643,bgsmws,sv1,3,0.7633650219493605,38,29,2,69
80643,bgsmws,sv1,4,0.944029127799468,229,108,4,341
80643,bgsmws,sv1,5,0.958391932252223,212,133,5,350
80643,bgsmws,sv1,6,0.9510420782046051,254,104,9,367
80643,bgsmws,sv1,7,0.9240336409651272,215,95,4,314
80643,bgsmws,sv1,8,0.9726473763080362,264,97,3,364
80643,bgsmws,sv1,9,0.9793804178244421,290,83,1,374
80644,bgsmws,sv1,0,0.9418082408256989,246,135,1,382
80644,bgsmws,sv1,1,0.9513063322980041,214,124,0,338
80644,bgsmws,sv1,2,0.963415817915774,222,140,5,367
80644,bgsmws,sv1,3,0.9555805802668731,195,135,1,331
80644,bgsmws,sv1,4,0.9425725150386196,241,109,4,354
80644,bgsmws,sv1,5,0.9623124741243102,245,115,4,364
80644,bgsmws,sv1,6,0.933464567554451,221,146,5,372
80644,bgsmws,sv1,7,0.9366991798427523,209,104,0,313
80644,bgsmws,sv1,8,0.9629472025527578,244,119,1,364
80644,bgsmws,sv1,9,0.9806299208965312,256,130,3,389
80645,bgsmws,sv1,0,0.9432819328999539,311,54,5,370
80645,bgsmws,sv1,1,0.9556885519613293,274,56,8,338
80645,bgsmws,sv1,2,0.9648054349065228,270,94,4,368
80645,bgsmws,sv1,3,0.9648054349065228,270,94,4,368
80645,bgsmws,sv1,4,0.9739400462600112,242,103,2,347
80645,bgsmws,sv1,5,0.9735479122856237,252,107,7,366
80645,bgsmws,sv1,6,0.9626330829241369,267,99,6,372
80645,bgsmws,sv1,7,0.9586092357234638,245,68,2,315
80645,bgsmws,sv1,8,0.9477640257308217,283,72,1,356
80645,bgsmws,sv1,9,0.95236891933909,292,79,3,374
80646,bgsmws,sv1,0,0.9585560929331987,300,80,5,385
80646,bgsmws,sv1,1,0.9670873849354429,266,73,1,340
80646,bgsmws,sv1,2,0.9633461809152383,272,93,5,370
80646,bgsmws,sv1,3,0.9633461809152383,272,93,5,370
80646,bgsmws,sv1,4,0.9626143248338868,236,108,6,350
80646,bgsmws,sv1,5,0.9466017758494958,239,121,3,363
80646,bgsmws,sv1,6,0.9729421036226201,269,103,3,375
80646,bgsmws,sv1,7,0.9431989714238678,237,66,7,310
80646,bgsmws,sv1,8,0.9416986197753533,285,79,2,366
80646,bgsmws,sv1,9,0.9420063006835191,297,67,5,369
80647,bgsmws,sv1,0,0.97236692117775,272,99,7,378
80647,bgsmws,sv1,1,0.9241883925948042,257,88,4,349
80647,bgsmws,sv1,2,0.9772454766001033,272,91,4,367
80647,bgsmws,sv1,3,0.9746351892785947,217,117,3,337
80647,bgsmws,sv1,4,0.9294483425939407,223,122,4,349
80647,bgsmws,sv1,5,0.9453937011795208,238,122,3,363
80647,bgsmws,sv1,6,0.9551999276596643,251,119,4,374
80647,bgsmws,sv1,7,0.933879791067918,221,94,2,317
80647,bgsmws,sv1,8,0.951882786334234,238,120,4,362
80647,bgsmws,sv1,9,0.9726340606919329,263,125,0,388
80648,bgsmws,sv1,0,0.9709079316820407,227,148,3,378
80648,bgsmws,sv1,1,0.9574534701522803,229,102,1,332
80648,bgsmws,sv1,2,0.9735479122856237,234,127,4,365
80648,bgsmws,sv1,3,0.9735479122856237,234,127,4,365
80648,bgsmws,sv1,4,0.9280223576464409,226,114,2,342
80648,bgsmws,sv1,5,0.9543830623104816,264,94,5,363
80648,bgsmws,sv1,6,0.9825585624076696,238,129,4,371
80648,bgsmws,sv1,7,0.9341466406506097,227,83,1,311
80648,bgsmws,sv1,8,0.9668489627152542,259,95,1,355
80648,bgsmws,sv1,9,0.9448858930938008,253,104,2,359
80649,bgsmws,sv1,0,0.9498746956134879,300,78,0,378
80649,bgsmws,sv1,1,0.9699339780160249,241,97,3,341
80649,bgsmws,sv1,2,0.947887550811389,251,120,2,373
80649,bgsmws,sv1,3,0.9542166979078002,226,76,2,304
80649,bgsmws,sv1,4,0.95092283851979,228,107,5,340
80649,bgsmws,sv1,5,0.9485637844196954,249,107,2,358
80649,bgsmws,sv1,6,0.9482904575324991,260,90,4,354
80649,bgsmws,sv1,7,0.9155674624518619,221,87,1,309
80649,bgsmws,sv1,8,0.9665645446906808,275,83,3,361
80649,bgsmws,sv1,9,0.9507569226302558,286,95,1,382
80650,bgsmws,sv1,0,0.9515215063553101,283,85,5,373
80650,bgsmws,sv1,1,0.9497948502999132,272,71,2,345
80650,bgsmws,sv1,2,0.9562160632871876,274,88,1,363
80650,bgsmws,sv1,3,0.9644757471188805,237,89,1,327
80650,bgsmws,sv1,4,0.9456699327384134,227,111,4,342
80650,bgsmws,sv1,5,0.9757382717678981,216,139,3,358
80650,bgsmws,sv1,6,0.9589985543024729,272,86,5,363
80650,bgsmws,sv1,7,0.923118661107724,220,92,6,318
80650,bgsmws,sv1,8,0.9404924811349022,257,97,6,360
80650,bgsmws,sv1,9,0.9594301297821309,313,64,8,385
80651,bgsmws,sv1,0,0.9690769835542392,284,87,6,377
80651,bgsmws,sv1,1,0.9266146245601975,256,80,2,338
80651,bgsmws,sv1,2,0.9452884875639015,290,80,5,375
80651,bgsmws,sv1,3,0.9699283544185189,232,87,6,325
80651,bgsmws,sv1,4,0.9464584861495203,238,93,7,338
80651,bgsmws,sv1,5,0.9562803222190089,263,84,5,352
80651,bgsmws,sv1,6,0.97351217756217,276,87,5,368
80651,bgsmws,sv1,7,0.9372196190975985,213,75,4,292
80651,bgsmws,sv1,8,0.9776514922775922,286,76,2,364
80651,bgsmws,sv1,9,0.9641390767541942,286,87,8,381
80652,bgsmws,sv1,0,0.9422407365112229,298,70,4,372
80652,bgsmws,sv1,1,0.9463989024311309,251,75,3,329
80652,bgsmws,sv1,2,0.9321530558139218,239,97,5,341
80652,bgsmws,sv1,3,0.9555300759463807,244,77,7,328
80652,bgsmws,sv1,4,0.9318280728016922,256,79,3,338
80652,bgsmws,sv1,5,0.9658145257021705,266,72,2,340
80652,bgsmws,sv1,6,0.9741524368562978,280,78,2,360
80652,bgsmws,sv1,7,0.973059487519017,227,51,5,283
80652,bgsmws,sv1,8,0.9539186764021819,230,92,10,332
80652,bgsmws,sv1,9,0.9540287302628969,235,106,2,343
80653,bgsmws,sv1,0,0.9683282875801624,259,89,4,352
80653,bgsmws,sv1,1,0.9689886935558817,256,77,3,336
80653,bgsmws,sv1,2,0.9353863465244188,279,83,2,364
80653,bgsmws,sv1,3,0.9353863465244188,279,83,2,364
80653,bgsmws,sv1,4,0.9543085590702689,261,74,3,338
80653,bgsmws,sv1,5,0.9506455979851065,252,87,4,343
80653,bgsmws,sv1,6,0.9465093375998914,272,81,5,358
80653,bgsmws,sv1,7,0.9184271036507666,250,52,6,308
80653,bgsmws,sv1,8,0.9416915355674205,254,74,4,332
80653,bgsmws,sv1,9,0.974404414793474,286,54,5,345
80654,bgsmws,sv1,0,0.9594683837094937,303,75,1,379
80654,bgsmws,sv1,1,0.9471969078170456,282,61,3,346
80654,bgsmws,sv1,2,0.9388436732476263,277,75,0,352
80654,bgsmws,sv1,3,0.9388436732476263,277,75,0,352
80654,bgsmws,sv1,4,0.9536346739032378,263,66,5,334
80654,bgsmws,sv1,5,0.9640467032232014,265,75,3,343
80654,bgsmws,sv1,6,0.9708097988688748,300,75,3,378
80654,bgsmws,sv1,7,0.9552767661244046,268,36,2,306
80654,bgsmws,sv1,8,0.9656538903313225,289,68,4,361
80654,bgsmws,sv1,9,0.965329415594644,282,71,4,357
80655,bgsmws,sv1,0,0.9678876423622568,267,105,3,375
80655,bgsmws,sv1,1,0.9721936212405536,264,83,3,350
80655,bgsmws,sv1,2,0.9435279998218873,264,99,2,365
80655,bgsmws,sv1,3,0.9365158001340943,234,92,3,329
80655,bgsmws,sv1,4,0.9544142198136406,249,95,3,347
80655,bgsmws,sv1,5,0.9637922913579492,245,103,4,352
80655,bgsmws,sv1,6,0.9506035934088772,268,71,4,343
80655,bgsmws,sv1,7,0.9466719338636023,238,67,3,308
80655,bgsmws,sv1,8,0.9502362964669235,224,138,3,365
80655,bgsmws,sv1,9,0.9433319856938932,277,96,6,379
80656,bgsmws,sv1,0,0.9595120797752221,310,48,5,363
80656,bgsmws,sv1,1,0.9414165752795195,258,64,5,327
80656,bgsmws,sv1,2,0.9780181529427929,277,80,6,363
80656,bgsmws,sv1,3,0.9780181529427929,277,80,6,363
80656,bgsmws,sv1,4,0.9569644582319948,272,65,7,344
80656,bgsmws,sv1,5,0.9371231599736213,246,77,6,329
80656,bgsmws,sv1,6,0.9716772554510749,266,81,7,354
80656,bgsmws,sv1,7,0.9498353484680578,216,82,5,303
80656,bgsmws,sv1,8,0.9722851635312909,283,74,4,361
80656,bgsmws,sv1,9,0.9706707384163842,306,58,3,367
80657,bgsmws,sv1,0,0.9661360066524991,270,95,3,368
80657,bgsmws,sv1,1,0.9612492217855297,228,93,1,322
80657,bgsmws,sv1,2,0.9754670941583093,269,98,3,370
80657,bgsmws,sv1,3,0.963703824032935,291,51,1,343
80657,bgsmws,sv1,4,0.9695814182185525,248,85,5,338
80657,bgsmws,sv1,5,0.9489121426674029,271,90,2,363
80657,bgsmws,sv1,6,0.9672151861869281,289,73,5,367
80657,bgsmws,sv1,7,0.9660746130128999,214,84,4,302
80657,bgsmws,sv1,8,0.9435099609473933,257,96,5,358
80657,bgsmws,sv1,9,0.9339447207694306,255,116,5,376
80658,bgsmws,sv1,0,0.9673836861087767,258,82,6,346
80658,bgsmws,sv1,1,0.9807359053691748,253,76,1,330
80658,bgsmws,sv1,2,0.95139831297092,267,78,5,350
80658,bgsmws,sv1,3,0.9167606076600756,220,67,1,288
80658,bgsmws,sv1,4,0.9717357080676738,261,75,3,339
80658,bgsmws,sv1,5,0.9363358415075176,277,68,5,350
80658,bgsmws,sv1,6,0.9549171686725483,289,78,3,370
80658,bgsmws,sv1,7,0.9229330853850792,189,82,4,275
80658,bgsmws,sv1,8,0.935270213474032,237,82,4,323
80658,bgsmws,sv1,9,0.9689438237157751,236,80,6,322
80659,bgsmws,sv1,0,0.9512336402582576,231,118,2,351
80659,bgsmws,sv1,1,0.9605120515732957,225,78,2,305
80659,bgsmws,sv1,2,0.9413262243161349,289,60,4,353
80659,bgsmws,sv1,3,0.9404544037643574,253,64,1,318
80659,bgsmws,sv1,4,0.94978963478136,262,56,7,325
80659,bgsmws,sv1,5,0.961268338459644,250,86,8,344
80659,bgsmws,sv1,6,0.9030129517343998,279,72,2,353
80659,bgsmws,sv1,7,0.9565699504010619,270,41,3,314
80659,bgsmws,sv1,8,0.9355482350974467,298,56,3,357
80659,bgsmws,sv1,9,0.9440332289448707,289,72,2,363
80660,bgsmws,sv1,0,0.960907619864376,283,71,3,357
80660,bgsmws,sv1,1,0.9227552071297327,261,58,6,325
80660,bgsmws,sv1,2,0.9594519063051249,271,83,2,356
80660,bgsmws,sv1,3,0.9594519063051249,271,83,2,356
80660,bgsmws,sv1,4,0.950713179094835,220,98,4,322
80660,bgsmws,sv1,5,0.9221672291344161,257,70,3,330
80660,bgsmws,sv1,6,0.9268943523943421,285,72,4,361
80660,bgsmws,sv1,7,0.9340380342718805,234,61,1,296
80660,bgsmws,sv1,8,0.973902388292831,278,73,0,351
80660,bgsmws,sv1,9,0.9565073776378054,265,73,5,343
80661,bgsmws,sv1,0,0.9639478963046659,319,61,4,384
80661,bgsmws,sv1,1,0.9081805003574918,225,116,1,342
80661,bgsmws,sv1,2,0.9611715763639407,217,133,3,353
80661,bgsmws,sv1,3,0.9178907817704848,205,116,5,326
80661,bgsmws,sv1,4,0.9353087039109041,255,93,3,351
80661,bgsmws,sv1,5,0.9504003000593888,267,93,6,366
80661,bgsmws,sv1,6,0.9235454961356503,254,109,5,368
80661,bgsmws,sv1,7,0.955319941281154,213,95,4,312
80661,bgsmws,sv1,8,0.9767055024115614,254,110,2,366
80661,bgsmws,sv1,9,0.9578089641473689,295,86,5,386
80662,bgsmws,sv1,0,0.9680318722215775,291,81,4,376
80662,bgsmws,sv1,1,0.9515008758637232,257,79,2,338
80662,bgsmws,sv1,2,0.9690881701883236,276,91,5,372
80662,bgsmws,sv1,3,0.9654123339491097,253,80,3,336
80662,bgsmws,sv1,4,0.9515167877785612,261,88,4,353
80662,bgsmws,sv1,5,0.970589865385406,309,59,1,369
80662,bgsmws,sv1,6,0.9492637775342962,307,66,5,378
80662,bgsmws,sv1,7,0.9586042100691539,235,72,4,311
80662,bgsmws,sv1,8,0.9637525842407032,263,95,6,364
80662,bgsmws,sv1,9,0.9801003843533129,285,101,1,387
80663,bgsmws,sv1,0,0.9337775310283362,296,81,1,378
80663,bgsmws,sv1,1,0.9326367732059919,247,92,4,343
80663,bgsmws,sv1,2,0.9406777449285475,275,94,5,374
80663,bgsmws,sv1,3,0.9715801974937853,271,72,3,346
80663,bgsmws,sv1,4,0.9561175422961473,263,88,1,352
80663,bgsmws,sv1,5,0.9724442854783579,282,79,2,363
80663,bgsmws,sv1,6,0.955049726543989,301,72,3,376
80663,bgsmws,sv1,7,0.9552467728175507,245,65,4,314
80663,bgsmws,sv1,8,0.9471410927813597,281,82,0,363
80663,bgsmws,sv1,9,0.9597187093542315,271,113,3,387
80664,bgsmws,sv1,0,0.955211312949897,245,90,8,343
80664,bgsmws,sv1,1,0.9603513524067435,255,79,3,337
80664,bgsmws,sv1,2,0.9562648053695113,276,71,4,351
80664,bgsmws,sv1,3,0.9498353484680581,229,68,3,300
80664,bgsmws,sv1,4,0.9576132247630226,261,66,4,331
80664,bgsmws,sv1,5,0.9695663540455578,299,55,3,357
80664,bgsmws,sv1,6,0.9683182561302344,288,68,5,361
80664,bgsmws,sv1,7,0.9287677784845374,253,51,6,310
80664,bgsmws,sv1,8,0.9655432652923176,279,67,3,349
80664,bgsmws,sv1,9,0.9588387518152293,306,77,1,384
80665,bgsmws,sv1,0,0.9393955522961414,297,81,5,383
80665,bgsmws,sv1,1,0.9083888259885634,264,71,2,337
80665,bgsmws,sv1,2,0.9683182561302346,261,95,4,360
80665,bgsmws,sv1,3,0.9583616361837536,270,62,1,333
80665,bgsmws,sv1,4,0.9548394106832225,291,66,1,358
80665,bgsmws,sv1,5,0.9724053642230127,271,88,5,364
80665,bgsmws,sv1,6,0.9564996549599096,266,107,2,375
80665,bgsmws,sv1,7,0.973846670018187,232,84,2,318
80665,bgsmws,sv1,8,0.9529340579366667,294,66,5,365
80665,bgsmws,sv1,9,0.9569383796852851,287,90,4,381
80666,bgsmws,sv1,0,0.957506165752568,252,130,3,385
80666,bgsmws,sv1,1,0.9315861494683594,253,91,2,346
80666,bgsmws,sv1,2,0.9612805939528454,269,100,1,370
80666,bgsmws,sv1,3,0.9281227315342183,239,95,2,336
80666,bgsmws,sv1,4,0.9656548159147078,234,110,2,346
80666,bgsmws,sv1,5,0.9774319958888267,258,102,8,368
80666,bgsmws,sv1,6,0.975211721552242,268,104,2,374
80666,bgsmws,sv1,7,0.9155203087865104,225,90,0,315
80666,bgsmws,sv1,8,0.9543636719230082,254,107,5,366
80666,bgsmws,sv1,9,0.9745389903347045,283,101,3,387
80669,elgqso,sv1,0,0.9421187771416561,264,23,50,337
80669,elgqso,sv1,1,0.972808805002144,242,23,28,293
80669,elgqso,sv1,2,0.953119342548057,241,32,46,319
80669,elgqso,sv1,3,0.953119342548057,241,32,46,319
80669,elgqso,sv1,4,0.9350523377056643,239,21,45,305
80669,elgqso,sv1,5,0.953113764882429,252,23,52,327
80669,elgqso,sv1,6,0.9516268177546023,253,32,49,334
80669,elgqso,sv1,7,0.922528816617985,201,21,43,265
80669,elgqso,sv1,8,0.972113213110253,264,19,39,322
80669,elgqso,sv1,9,0.9563942402344111,250,30,45,325
80670,lrgqso,sv1,0,0.9720626215574183,293,15,35,343
80670,lrgqso,sv1,1,0.9478667995761729,253,19,32,304
80670,lrgqso,sv1,2,0.9632970346552365,275,21,39,335
80670,lrgqso,sv1,3,0.9632970346552365,275,21,39,335
80670,lrgqso,sv1,4,0.9361684158138484,233,12,53,298
80670,lrgqso,sv1,5,0.9675075449270759,268,19,43,330
80670,lrgqso,sv1,6,0.9581665530736267,272,16,52,340
80670,lrgqso,sv1,7,0.9400032161110653,217,20,48,285
80670,lrgqso,sv1,8,0.9549732204273462,273,27,30,330
80670,lrgqso,sv1,9,0.9547842524345449,269,19,46,334
80673,elgqso,sv1,0,0.9736198025424413,265,56,35,356
80673,elgqso,sv1,1,0.9323778424372753,223,49,34,306
80673,elgqso,sv1,2,0.9548334045558619,231,58,47,336
80673,elgqso,sv1,3,0.9548334045558619,231,58,47,336
80673,elgqso,sv1,4,0.9631540616703287,230,47,43,320
80673,elgqso,sv1,5,0.9690644286562586,244,54,49,347
80673,elgqso,sv1,6,0.9649357491760325,238,55,55,348
80673,elgqso,sv1,7,0.9549991605133212,211,44,29,284
80673,elgqso,sv1,8,0.9422197293689868,231,66,46,343
80673,elgqso,sv1,9,0.9597695393201732,225,65,42,332
80674,lrgqso,sv1,0,0.9557489069654063,264,57,42,363
80674,lrgqso,sv1,1,0.9376624474384062,232,58,36,326
80674,lrgqso,sv1,2,0.9679032234039334,248,67,44,359
80674,lrgqso,sv1,3,0.9679032234039334,248,67,44,359
80674,lrgqso,sv1,4,0.9383607112010373,240,51,29,320
80674,lrgqso,sv1,5,0.96331439581038,252,49,51,352
80674,lrgqso,sv1,6,0.96023443232572,272,58,36,366
80674,lrgqso,sv1,7,0.9359103768813878,205,58,31,294
80674,lrgqso,sv1,8,0.9701726147255678,245,51,52,348
80674,lrgqso,sv1,9,0.9477046756294346,268,56,42,366
80675,elgqso,sv1,0,0.9342940727425244,205,87,46,338
80675,elgqso,sv1,1,0.9474542203261354,191,80,36,307
80675,elgqso,sv1,2,0.9514212266528076,214,85,31,330
80675,elgqso,sv1,3,0.9514212266528076,214,85,31,330
80675,elgqso,sv1,4,0.9482671521542835,196,70,36,302
80675,elgqso,sv1,5,0.9439536549436764,230,60,31,321
80675,elgqso,sv1,6,0.9542100737785426,243,62,26,331
80675,elgqso,sv1,7,0.9567336257850446,179,59,24,262
80675,elgqso,sv1,8,0.9536484963039202,202,78,34,314
80675,elgqso,sv1,9,0.9578448218246522,212,73,40,325
80676,lrgqso,sv1,0,0.9688872123080293,241,88,37,366
80676,lrgqso,sv1,1,0.9483150570255418,216,90,28,334
80676,lrgqso,sv1,2,0.9425551918517081,251,77,27,355
80676,lrgqso,sv1,3,0.9425551918517081,251,77,27,355
80676,lrgqso,sv1,4,0.9217421041549468,226,60,38,324
80676,lrgqso,sv1,5,0.9445583820801324,245,58,46,349
80676,lrgqso,sv1,6,0.9568564885390859,263,70,31,364
80676,lrgqso,sv1,7,0.9454194076322037,213,48,37,298
80676,lrgqso,sv1,8,0.9606200122273832,270,51,38,359
80676,lrgqso,sv1,9,0.9650007544967935,236,84,36,356
80677,elgqso,sv1,0,0.9538427961152555,217,67,42,326
80677,elgqso,sv1,1,0.9410891123441847,170,86,31,287
80677,elgqso,sv1,2,0.9449600488201996,196,93,33,322
80677,elgqso,sv1,3,0.9449600488201996,196,93,33,322
80677,elgqso,sv1,4,0.9487923526038801,199,68,41,308
80677,elgqso,sv1,5,0.959957692738115,191,76,40,307
80677,elgqso,sv1,6,0.9375019704733117,212,62,41,315
80677,elgqso,sv1,7,0.950258196155061,176,53,33,262
80677,elgqso,sv1,8,0.9435518212832975,215,51,43,309
80677,elgqso,sv1,9,0.9677505025392376,214,58,38,310
80678,lrgqso,sv1,0,0.9638543881973779,262,68,37,367
80678,lrgqso,sv1,1,0.9765839402740338,222,70,36,328
80678,lrgqso,sv1,2,0.9513682240047548,227,80,37,344
80678,lrgqso,sv1,3,0.9513682240047548,227,80,37,344
80678,lrgqso,sv1,4,0.9662602708722531,219,76,42,337
80678,lrgqso,sv1,5,0.9592887606875219,248,61,32,341
80678,lrgqso,sv1,6,0.9422914847146473,218,88,42,348
80678,lrgqso,sv1,7,0.9276870254592695,216,56,26,298
80678,lrgqso,sv1,8,0.9567307332227352,245,73,30,348
80678,lrgqso,sv1,9,0.962949081007126,244,64,37,345
80679,elgqso,sv1,0,0.9313301055810067,235,56,35,326
80679,elgqso,sv1,1,0.9553089256738886,228,32,38,298
80679,elgqso,sv1,2,0.9796461020685168,226,45,48,319
80679,elgqso,sv1,3,0.8145152036014164,58,8,8,74
80679,elgqso,sv1,4,0.9662003520564859,231,57,33,321
80679,elgqso,sv1,5,0.9751091902496078,248,30,29,307
80679,elgqso,sv1,6,0.9401801667957357,245,37,31,313
80679,elgqso,sv1,7,0.8803502268186724,217,33,29,279
80679,elgqso,sv1,8,0.9458452133408145,233,39,40,312
80679,elgqso,sv1,9,0.9565546469237651,251,45,41,337
80680,lrgqso,sv1,0,0.9499465173619313,276,45,36,357
80680,lrgqso,sv1,1,0.9479425986789578,259,22,39,320
80680,lrgqso,sv1,2,0.9714158725813222,272,44,34,350
80680,lrgqso,sv1,3,0.9714158725813222,272,44,34,350
80680,lrgqso,sv1,4,0.9248580820191575,255,51,31,337
80680,lrgqso,sv1,5,0.9712511998686598,265,45,38,348
80680,lrgqso,sv1,6,0.9477964017546867,264,64,35,363
80680,lrgqso,sv1,7,0.9403393302249631,254,24,32,310
80680,lrgqso,sv1,8,0.957321585994415,277,33,31,341
80680,lrgqso,sv1,9,0.961230877838658,267,44,37,348
80681,elgqso,sv1,0,0.9656204022381647,248,54,32,334
80681,elgqso,sv1,1,0.9619376539145604,226,50,30,306
80681,elgqso,sv1,2,0.950254206202257,215,81,37,333
80681,elgqso,sv1,3,0.950254206202257,215,81,37,333
80681,elgqso,sv1,4,0.9336267353643993,218,43,43,304
80681,elgqso,sv1,5,0.92478330367413,247,32,34,313
80681,elgqso,sv1,6,0.9401373491147744,249,40,41,330
80681,elgqso,sv1,7,0.9576633304217805,216,31,33,280
80681,elgqso,sv1,8,0.947516658318048,237,37,39,313
80681,elgqso,sv1,9,0.9766470392668752,240,44,41,325
80682,lrgqso,sv1,0,0.9308320309343576,277,39,42,358
80682,lrgqso,sv1,1,0.9397141311452762,247,30,46,323
80682,lrgqso,sv1,2,0.9501651826181375,289,26,37,352
80682,lrgqso,sv1,3,0.9501651826181375,289,26,37,352
80682,lrgqso,sv1,4,0.9551281626856929,260,26,41,327
80682,lrgqso,sv1,5,0.9724126253909334,276,28,39,343
80682,lrgqso,sv1,6,0.9520109702607883,284,32,35,351
80682,lrgqso,sv1,7,0.9329789519962103,241,26,33,300
80682,lrgqso,sv1,8,0.9240029346136901,270,27,42,339
80682,lrgqso,sv1,9,0.9555926254846709,277,35,43,355
80683,elgqso,sv1,0,0.9386615601376598,213,85,30,328
80683,elgqso,sv1,1,0.937443884596969,185,77,32,294
80683,elgqso,sv1,2,0.9384605851417465,213,69,37,319
80683,elgqso,sv1,3,0.9384605851417465,213,69,37,319
80683,elgqso,sv1,4,0.9361865652278908,219,65,29,313
80683,elgqso,sv1,5,0.9459935514533109,218,61,42,321
80683,elgqso,sv1,6,0.9632508336176644,227,63,46,336
80683,elgqso,sv1,7,0.9415318216036856,193,57,30,280
80683,elgqso,sv1,8,0.939733674131897,201,73,42,316
80683,elgqso,sv1,9,0.956352475258366,224,53,35,312
80684,lrgqso,sv1,0,0.9619384579128858,247,82,40,369
80684,lrgqso,sv1,1,0.9453959453224757,211,78,34,323
80684,lrgqso,sv1,2,0.95621534282963,234,84,38,356
80684,lrgqso,sv1,3,0.949128256521164,215,72,34,321
80684,lrgqso,sv1,4,0.9607122715401714,247,58,35,340
80684,lrgqso,sv1,5,0.9631672848357268,238,69,34,341
80684,lrgqso,sv1,6,0.9496575180569707,259,74,34,367
80684,lrgqso,sv1,7,0.9482671521542834,214,60,28,302
80684,lrgqso,sv1,8,0.9355760361243044,244,66,38,348
80684,lrgqso,sv1,9,0.960421332326058,223,100,50,373
80685,elgqso,sv1,0,0.9694082560477256,267,36,39,342
80685,elgqso,sv1,1,0.9517077490247956,213,33,36,282
80685,elgqso,sv1,2,0.9705358253806288,245,36,45,326
80685,elgqso,sv1,3,0.9705358253806288,245,36,45,326
80685,elgqso,sv1,4,0.9695834902986885,238,31,36,305
80685,elgqso,sv1,5,0.9316341840365675,239,31,49,319
80685,elgqso,sv1,6,0.9643806847782137,257,33,39,329
80685,elgqso,sv1,7,0.9294957863387815,216,27,29,272
80685,elgqso,sv1,8,0.9595296983398875,269,16,35,320
80685,elgqso,sv1,9,0.9645369160871973,241,33,54,328
80686,lrgqso,sv1,0,0.9409361531381041,280,37,42,359
80686,lrgqso,sv1,1,0.9675771001332173,257,31,42,330
80686,lrgqso,sv1,2,0.9426778663220422,276,32,39,347
80686,lrgqso,sv1,3,0.9525657803158853,256,33,34,323
80686,lrgqso,sv1,4,0.936692193506279,281,17,41,339
80686,lrgqso,sv1,5,0.9560115369084401,274,26,49,349
80686,lrgqso,sv1,6,0.9672275487714068,258,42,50,350
80686,lrgqso,sv1,7,0.9468447946591566,230,26,39,295
80686,lrgqso,sv1,8,0.959506652465071,288,32,35,355
80686,lrgqso,sv1,9,0.9426114124312506,293,32,50,375
80687,elg,sv1,0,0.9335801702987061,253,38,16,307
80687,elg,sv1,1,0.9780953254086091,255,20,11,286
80687,elg,sv1,2,0.8889454315919291,263,42,7,312
80687,elg,sv1,3,0.9437010237457961,245,25,6,276
80687,elg,sv1,4,0.9254804033137094,240,37,13,290
80687,elg,sv1,5,0.9753698670195933,258,37,16,311
80687,elg,sv1,6,0.9161794005323215,237,16,9,262
80687,elg,sv1,7,0.9340854478421257,242,24,8,274
80687,elg,sv1,8,0.9699168736469755,282,14,12,308
80687,elg,sv1,9,0.9373708948210351,293,23,8,324
80688,lrgqso,sv1,0,0.9586580040862521,286,30,44,360
80688,lrgqso,sv1,1,0.9460377587941586,252,37,32,321
80688,lrgqso,sv1,2,0.9621553559345339,264,29,56,349
80688,lrgqso,sv1,3,0.9621553559345339,264,29,56,349
80688,lrgqso,sv1,4,0.9384351334203198,254,33,40,327
80688,lrgqso,sv1,5,0.9378226078957318,269,23,49,341
80688,lrgqso,sv1,6,0.9630131828166149,288,24,50,362
80688,lrgqso,sv1,7,0.9387592192653013,226,36,29,291
80688,lrgqso,sv1,8,0.9404229032953696,272,32,35,339
80688,lrgqso,sv1,9,0.9279684162833705,280,21,43,344
80689,elg,sv1,0,0.9343131503351844,266,31,11,308
80689,elg,sv1,1,0.9129357572405968,263,16,9,288
80689,elg,sv1,2,0.9410509033983171,256,33,11,300
80689,elg,sv1,3,0.9548054454583611,228,14,5,247
80689,elg,sv1,4,0.9191372843957284,249,30,8,287
80689,elg,sv1,5,0.9401475198818625,258,37,6,301
80689,elg,sv1,6,0.9410171766061196,269,7,10,286
80689,elg,sv1,7,0.951367901273941,257,13,8,278
80689,elg,sv1,8,0.9591312464202942,255,21,6,282
80689,elg,sv1,9,0.9526981137533811,284,19,8,311
80690,lrgqso,sv1,0,0.97610142414285,289,34,46,369
80690,lrgqso,sv1,1,0.9656891092100848,269,24,39,332
80690,lrgqso,sv1,2,0.9564628551893133,288,32,36,356
80690,lrgqso,sv1,3,0.9564628551893133,288,32,36,356
80690,lrgqso,sv1,4,0.975019545205129,261,27,40,328
80690,lrgqso,sv1,5,0.9547682790526857,286,20,44,350
80690,lrgqso,sv1,6,0.9580466135598699,286,19,52,357
80690,lrgqso,sv1,7,0.9248593197237893,258,13,32,303
80690,lrgqso,sv1,8,0.9415343915698356,294,14,37,345
80690,lrgqso,sv1,9,0.9590045895420912,282,27,42,351
80691,elg,sv1,0,0.9299557761463935,267,39,6,312
80691,elg,sv1,1,0.9620501474469819,271,13,8,292
80691,elg,sv1,2,0.9528662151891676,261,35,8,304
80691,elg,sv1,3,0.9639644198757515,268,15,9,292
80691,elg,sv1,4,0.9107329361817434,267,26,5,298
80691,elg,sv1,5,0.9607701494987456,252,32,11,295
80691,elg,sv1,6,0.9607701494987456,252,32,11,295
80691,elg,sv1,7,0.9226548301623052,245,11,7,263
80691,elg,sv1,8,0.9508671050340032,282,8,6,296
80691,elg,sv1,9,0.9650202743101836,295,17,14,326
80692,lrgqso,sv1,0,0.9520473302234983,226,46,73,345
80692,lrgqso,sv1,1,0.9685980547021048,267,22,30,319
80692,lrgqso,sv1,2,0.9629459002194071,199,51,86,336
80692,lrgqso,sv1,3,0.9629459002194071,199,51,86,336
80692,lrgqso,sv1,4,0.9300263604871686,199,38,73,310
80692,lrgqso,sv1,5,0.9366003955019038,223,35,79,337
80692,lrgqso,sv1,6,0.9461814054202152,276,24,40,340
80692,lrgqso,sv1,7,0.938284984545762,245,19,39,303
80692,lrgqso,sv1,8,0.9609276539762661,286,20,41,347
80692,lrgqso,sv1,9,0.9527707756440017,294,19,36,349
80693,elgqso,sv1,0,0.9532999634947992,276,22,43,341
80693,elgqso,sv1,1,0.9461507827328797,249,16,40,305
80693,elgqso,sv1,2,0.9444905913094147,263,36,31,330
80693,elgqso,sv1,3,0.9444905913094147,263,36,31,330
80693,elgqso,sv1,4,0.9709799057797122,237,28,33,298
80693,elgqso,sv1,5,0.9487581379790747,244,25,38,307
80693,elgqso,sv1,6,0.9504936955479978,267,29,42,338
80693,elgqso,sv1,7,0.9616722465597155,220,28,36,284
80693,elgqso,sv1,8,0.9510557123300782,270,25,30,325
80693,elgqso,sv1,9,0.9472379946397159,268,28,49,345
80694,lrgqso,sv1,0,0.9533472443150101,297,33,38,368
80694,lrgqso,sv1,1,0.9603585115874829,274,21,35,330
80694,lrgqso,sv1,2,0.9636763148724565,281,29,36,346
80694,lrgqso,sv1,3,0.9292832683780936,247,24,36,307
80694,lrgqso,sv1,4,0.969471586781344,273,22,30,325
80694,lrgqso,sv1,5,0.93479499940082,284,18,35,337
80694,lrgqso,sv1,6,0.9632268184039073,290,22,40,352
80694,lrgqso,sv1,7,0.951788876939538,231,23,35,289
80694,lrgqso,sv1,8,0.960977609377587,274,29,46,349
80694,lrgqso,sv1,9,0.9493412112995578,296,35,44,375
80695,elg,sv1,0,0.9561731122632583,305,13,8,326
80695,elg,sv1,1,0.940868452158612,295,9,3,307
80695,elg,sv1,2,0.9454742591496899,286,11,9,306
80695,elg,sv1,3,0.9391453468617741,277,6,5,288
80695,elg,sv1,4,0.9409580407103234,273,10,8,291
80695,elg,sv1,5,0.9650201523246172,269,11,13,293
80695,elg,sv1,6,0.9409594753363814,264,4,10,278
80695,elg,sv1,7,0.9087389728123741,253,4,7,264
80695,elg,sv1,8,0.9554384653282245,300,2,12,314
80695,elg,sv1,9,0.9375914094008658,308,9,11,328
80696,lrgqso,sv1,0,0.9376719562763547,244,39,58,341
80696,lrgqso,sv1,1,0.9590771435025895,220,20,71,311
80696,lrgqso,sv1,2,0.9556427469540896,238,33,57,328
80696,lrgqso,sv1,3,0.9632414147219305,220,21,56,297
80696,lrgqso,sv1,4,0.9552422420809984,244,25,57,326
80696,lrgqso,sv1,5,0.9631540616703289,228,28,66,322
80696,lrgqso,sv1,6,0.9631540616703289,228,28,66,322
80696,lrgqso,sv1,7,0.9218532433585426,198,27,55,280
80696,lrgqso,sv1,8,0.9325961831297247,210,40,76,326
80696,lrgqso,sv1,9,0.948957600036867,236,40,59,335
80697,elg,sv1,0,0.918589807100138,287,22,11,320
80697,elg,sv1,1,0.9183811512833064,276,27,8,311
80697,elg,sv1,2,0.9420036399978485,270,26,9,305
80697,elg,sv1,3,0.9011146015124022,276,10,8,294
80697,elg,sv1,4,0.9173244638699487,255,29,6,290
80697,elg,sv1,5,0.95313466360905,259,30,11,300
80697,elg,sv1,6,0.9179981950990395,164,9,8,181
80697,elg,sv1,7,0.9070453774525452,251,11,11,273
80697,elg,sv1,8,0.9451838446476616,278,13,16,307
80697,elg,sv1,9,0.9517847435629044,300,16,11,327
80698,lrgqso,sv1,0,0.9382614029639242,206,55,76,337
80698,lrgqso,sv1,1,0.9657360244411701,190,59,66,315
80698,lrgqso,sv1,2,0.9511945731421446,220,55,69,344
80698,lrgqso,sv1,3,0.9445726284739422,192,39,68,299
80698,lrgqso,sv1,4,0.9612277699497167,192,58,83,333
80698,lrgqso,sv1,5,0.9716285319734748,237,40,71,348
80698,lrgqso,sv1,6,0.9716285319734748,237,40,71,348
80698,lrgqso,sv1,7,0.9555111987082527,187,38,58,283
80698,lrgqso,sv1,8,0.9487533855736038,213,56,64,333
80698,lrgqso,sv1,9,0.9292673875248044,213,49,83,345
80699,elgqso,sv1,0,0.943502475667828,262,30,40,332
80699,elgqso,sv1,1,0.9406313751076729,246,24,29,299
80699,elgqso,sv1,2,0.9696420869133061,273,20,44,337
80699,elgqso,sv1,3,0.9192590062386058,209,14,39,262
80699,elgqso,sv1,4,0.9369591559315638,248,14,34,296
80699,elgqso,sv1,5,0.9403393302249631,247,25,37,309
80699,elgqso,sv1,6,0.9326793527767021,249,20,54,323
80699,elgqso,sv1,7,0.9352029626329599,209,20,38,267
80699,elgqso,sv1,8,0.9586886677607858,263,20,52,335
80699,elgqso,sv1,9,0.9621404739517245,280,19,37,336
80700,lrgqso,sv1,0,0.9564607946091214,299,14,49,362
80700,lrgqso,sv1,1,0.9503515204157204,279,16,34,329
80700,lrgqso,sv1,2,0.9328356449709557,275,25,54,354
80700,lrgqso,sv1,3,0.9328356449709557,275,25,54,354
80700,lrgqso,sv1,4,0.9498568315839024,275,13,41,329
80700,lrgqso,sv1,5,0.9607916103702856,285,15,38,338
80700,lrgqso,sv1,6,0.9406886407784211,309,16,34,359
80700,lrgqso,sv1,7,0.9314554194892176,240,15,43,298
80700,lrgqso,sv1,8,0.9408765951923593,280,29,42,351
80700,lrgqso,sv1,9,0.9454942146036294,267,21,54,342
80701,elg,sv1,0,0.9568849488436395,293,36,7,336
80701,elg,sv1,1,0.9210774767229604,252,34,7,293
80701,elg,sv1,2,0.945111148550344,320,28,5,353
80701,elg,sv1,3,0.945111148550344,320,28,5,353
80701,elg,sv1,4,0.9655849397173742,283,28,7,318
80701,elg,sv1,5,0.9480961422079636,265,28,8,301
80701,elg,sv1,6,0.9342142533212524,278,44,9,331
80701,elg,sv1,7,0.939461341653889,240,31,10,281
80701,elg,sv1,8,0.9715297181178068,283,35,12,330
80701,elg,sv1,9,0.950999959100609,254,40,13,307
80702,lrgqso,sv1,0,0.9687148760872049,187,72,69,328
80702,lrgqso,sv1,1,0.9375115380946578,163,99,44,306
80702,lrgqso,sv1,2,0.9460824218878707,154,117,49,320
80702,lrgqso,sv1,3,0.9759739384338459,150,85,52,287
80702,lrgqso,sv1,4,0.9660770320340568,227,62,38,327
80702,lrgqso,sv1,5,0.9436512919696727,149,102,72,323
80702,lrgqso,sv1,6,0.9436512919696727,149,102,72,323
80702,lrgqso,sv1,7,0.9388585471520288,146,79,53,278
80702,lrgqso,sv1,8,0.9502402102239391,193,77,44,314
80702,lrgqso,sv1,9,0.9709490025741709,198,86,71,355
80703,elg,sv1,0,0.9660377515242148,267,24,16,307
80703,elg,sv1,1,0.9337217737696647,264,13,9,286
80703,elg,sv1,2,0.9667043825886412,272,29,8,309
80703,elg,sv1,3,0.949982654681311,257,9,2,268
80703,elg,sv1,4,0.9385317950969259,253,28,9,290
80703,elg,sv1,5,0.9723238856458337,259,29,22,310
80703,elg,sv1,6,0.9446976469893452,282,10,5,297
80703,elg,sv1,7,0.9437517467959258,254,6,2,262
80703,elg,sv1,8,0.9404737257805279,290,13,13,316
80703,elg,sv1,9,0.9317176829691538,321,12,6,339
80705,elg,sv1,0,0.9598151148228754,279,37,9,325
80705,elg,sv1,1,0.8915478611425218,243,32,9,284
80705,elg,sv1,2,0.9336528125578442,296,30,9,335
80705,elg,sv1,3,0.9336528125578442,296,30,9,335
80705,elg,sv1,4,0.9522312800925954,257,33,10,300
80705,elg,sv1,5,0.9334794924366233,265,22,21,308
80705,elg,sv1,6,0.9496189616059674,297,26,12,335
80705,elg,sv1,7,0.9660073786194067,252,16,8,276
80705,elg,sv1,8,0.954789361240919,256,32,10,298
80705,elg,sv1,9,0.9415055337495652,275,31,4,310
80706,lrgqso,sv1,0,0.9559116492707825,185,69,74,328
80706,lrgqso,sv1,1,0.9522993115264908,240,32,38,310
80706,lrgqso,sv1,2,0.9379252704516254,202,51,67,320
80706,lrgqso,sv1,3,0.9418418055860225,218,29,40,287
80706,lrgqso,sv1,4,0.940610236453734,183,59,56,298
80706,lrgqso,sv1,5,0.9470421211357813,181,62,62,305
80706,lrgqso,sv1,6,0.9763527369086535,263,24,35,322
80706,lrgqso,sv1,7,0.9643552571216302,225,32,31,288
80706,lrgqso,sv1,8,0.9538148428942971,253,39,45,337
80706,lrgqso,sv1,9,0.9579718845228047,256,28,39,323
80707,elgqso,sv1,0,0.9350405786730327,247,35,44,326
80707,elgqso,sv1,1,0.9056721839981127,215,20,53,288
80707,elgqso,sv1,2,0.9485318812224799,248,30,32,310
80707,elgqso,sv1,3,0.9485318812224799,248,30,32,310
80707,elgqso,sv1,4,0.9416993476351767,231,19,47,297
80707,elgqso,sv1,5,0.9783815227767487,240,27,47,314
80707,elgqso,sv1,6,0.9286675256722159,259,28,46,333
80707,elgqso,sv1,7,0.9471572438753401,206,22,48,276
80707,elgqso,sv1,8,0.9332908937627712,247,25,40,312
80707,elgqso,sv1,9,0.9583258670913336,263,23,43,329
80708,lrgqso,sv1,0,0.9482423313614788,170,47,66,283
80708,lrgqso,sv1,1,0.9628626675724982,231,22,25,278
80708,lrgqso,sv1,2,0.9547572994553596,168,35,68,271
80708,lrgqso,sv1,3,0.9438641931495916,197,20,25,242
80708,lrgqso,sv1,4,0.9437517467959258,171,37,53,261
80708,lrgqso,sv1,5,0.8938639733915215,169,43,69,281
80708,lrgqso,sv1,6,0.9331453764943336,237,23,34,294
80708,lrgqso,sv1,7,0.9528093828844815,224,15,41,280
80708,lrgqso,sv1,8,0.9370069967524812,230,30,39,299
80708,lrgqso,sv1,9,0.9202972285238689,119,8,14,141
80709,elg,sv1,0,0.9587242936431598,264,41,5,310
80709,elg,sv1,1,0.9425360581141481,265,17,5,287
80709,elg,sv1,2,0.8898433993618999,283,25,8,316
80709,elg,sv1,3,0.9634792175596886,270,19,11,300
80709,elg,sv1,4,0.9477161597192211,280,32,7,319
80709,elg,sv1,5,0.9232652274008144,284,30,7,321
80709,elg,sv1,6,0.9478197544507962,263,36,8,307
80709,elg,sv1,7,0.9403480501505207,253,19,6,278
80709,elg,sv1,8,0.9696302803883949,271,29,10,310
80709,elg,sv1,9,0.9491749852772231,308,27,11,346
80710,lrgqso,sv1,0,0.961062919485674,152,80,68,300
80710,lrgqso,sv1,1,0.9546627798174403,248,48,41,337
80710,lrgqso,sv1,2,0.9593909697594157,154,74,67,295
80710,lrgqso,sv1,3,0.9421452610634747,238,46,37,321
80710,lrgqso,sv1,4,0.9585674932580476,153,59,73,285
80710,lrgqso,sv1,5,0.9718459945310975,155,74,71,300
80710,lrgqso,sv1,6,0.9557527240474872,241,38,43,322
80710,lrgqso,sv1,7,0.9380924451784505,256,38,33,327
80710,lrgqso,sv1,8,0.9645204366761865,258,42,37,337
80710,lrgqso,sv1,9,0.9523488127868664,244,53,39,336
80711,elgqso,sv1,0,0.9662863421179813,297,29,41,367
80711,elgqso,sv1,1,0.9541040586402463,303,30,29,362
80711,elgqso,sv1,2,0.9530721623586355,285,21,51,357
80711,elgqso,sv1,3,0.9358316498061938,275,24,42,341
80711,elgqso,sv1,4,0.9453420908248797,278,22,44,344
80711,elgqso,sv1,5,0.9518573641534435,271,27,48,346
80711,elgqso,sv1,6,0.9549809384448381,283,27,40,350
80711,elgqso,sv1,7,0.9660401655244899,243,26,52,321
80711,elgqso,sv1,8,0.9512262881512153,275,32,46,353
80711,elgqso,sv1,9,0.9724913827557169,288,33,35,356
80712,lrgqso,sv1,0,0.9382580533177587,197,64,80,341
80712,lrgqso,sv1,1,0.921296646988616,256,14,50,320
80712,lrgqso,sv1,2,0.9422160311585638,216,42,66,324
80712,lrgqso,sv1,3,0.9504254168454391,227,29,31,287
80712,lrgqso,sv1,4,0.9597165378756073,203,45,73,321
80712,lrgqso,sv1,5,0.9553374825105377,206,52,68,326
80712,lrgqso,sv1,6,0.9372261844572184,292,20,41,353
80712,lrgqso,sv1,7,0.9516416895303356,233,19,34,286
80712,lrgqso,sv1,8,0.9565593308945857,280,24,42,346
80712,lrgqso,sv1,9,0.9534803478541196,275,17,40,332
80713,m31,sv1,2,0.886611289490663,81,62,7,150
80713,m31,sv1,3,0.886611289490663,81,62,7,150
80713,m31,sv1,4,0.8880294195396095,79,63,3,145
80713,m31,sv1,5,0.878429969074475,78,88,4,170
80713,m31,sv1,6,0.878429969074475,78,88,4,170
80713,m31,sv1,7,0.878429969074475,78,88,4,170
80713,m31,sv1,8,0.878429969074475,78,88,4,170
80713,m31,sv1,9,0.878429969074475,78,88,4,170
80715,m31,sv1,2,0.9627259881320711,24,308,6,338
80715,m31,sv1,3,0.9627259881320711,24,308,6,338
80715,m31,sv1,4,0.9499246653416725,35,279,4,318
80715,m31,sv1,5,0.9424315074086917,29,299,3,331
80715,m31,sv1,6,0.9424315074086917,29,299,3,331
80715,m31,sv1,7,0.9424315074086917,29,299,3,331
80715,m31,sv1,8,0.9424315074086917,29,299,3,331
80715,m31,sv1,9,0.9424315074086917,29,299,3,331
80718,rosette,sv1,0,0.9677485565317744,109,251,0,360
80718,rosette,sv1,1,0.936651733142167,101,243,0,344
80718,rosette,sv1,2,0.9641645283282141,67,302,0,369
80718,rosette,sv1,3,0.9641645283282141,67,302,0,369
80718,rosette,sv1,4,0.9364419618752438,57,293,0,350
80718,rosette,sv1,5,0.9338438694884448,96,267,0,363
80718,rosette,sv1,6,0.9765481484861284,184,183,0,367
80718,rosette,sv1,7,0.9288500737055784,120,193,0,313
80718,rosette,sv1,8,0.9596723996631148,81,284,0,365
80718,rosette,sv1,9,0.9310758515684241,74,293,0,367
80719,praesepe,sv1,0,0.9449150790023626,3,336,0,339
80719,praesepe,sv1,1,0.9169076935956452,4,212,4,220
80719,praesepe,sv1,2,0.9419944571690415,9,266,2,277
80719,praesepe,sv1,3,0.9419944571690415,9,266,2,277
80719,praesepe,sv1,4,0.9010182680648618,1,243,3,247
80719,praesepe,sv1,5,0.9353791678987375,5,232,1,238
80719,praesepe,sv1,6,0.953137296794831,15,253,3,271
80719,praesepe,sv1,7,0.9013119444835785,2,199,2,203
80719,praesepe,sv1,8,0.9417252921756898,5,247,1,253
80719,praesepe,sv1,9,0.9124892158180372,8,248,0,256
80720,umaii,sv1,0,0.9655127093109969,16,299,4,319
80720,umaii,sv1,1,0.9076564605537616,11,209,3,223
80720,umaii,sv1,2,0.9076564605537616,11,209,3,223
80720,umaii,sv1,3,0.9076564605537616,11,209,3,223
80720,umaii,sv1,4,0.9347770191863893,9,232,3,244
80720,umaii,sv1,5,0.9347770191863893,9,232,3,244
80720,umaii,sv1,6,0.9288455176048148,43,206,4,253
80720,umaii,sv1,7,0.9355577935186637,19,192,0,211
80720,umaii,sv1,8,0.9095696237073269,6,240,3,249
80720,umaii,sv1,9,0.9313509355227481,55,204,7,266
80721,ssv,sv1,0,0.9727659260120582,1,363,0,364
80721,ssv,sv1,1,0.9418449730530205,0,334,3,337
80721,ssv,sv1,2,0.9476542137094319,1,362,0,363
80721,ssv,sv1,3,0.9653865316386223,0,337,0,337
80721,ssv,sv1,4,0.9626335917210477,2,342,0,344
80721,ssv,sv1,5,0.9462545012508828,0,356,4,360
80721,ssv,sv1,6,0.959204045400508,4,358,0,362
80721,ssv,sv1,7,0.9364779400469294,2,301,3,306
80721,ssv,sv1,8,0.9564976637400932,1,364,2,367
80721,ssv,sv1,9,0.9686390600977414,4,383,1,388
80722,ssv,sv1,0,0.9660271842358736,1,364,0,365
80722,ssv,sv1,1,0.956675971129341,3,339,0,342
80722,ssv,sv1,2,0.9753213423136629,0,365,0,365
80722,ssv,sv1,3,0.962210733592329,0,345,0,345
80722,ssv,sv1,4,0.9597360515774729,2,344,0,346
80722,ssv,sv1,5,0.9596538632758,1,359,0,360
80722,ssv,sv1,6,0.9553740578224222,0,366,3,369
80722,ssv,sv1,7,0.9224807200349641,0,314,0,314
80722,ssv,sv1,8,0.9481922851291497,0,371,0,371
80722,ssv,sv1,9,0.9654976464053908,1,388,0,389
80724,ssv,sv1,0,0.9573541105219902,5,356,0,361
80724,ssv,sv1,1,0.9668384629000395,8,320,1,329
80724,ssv,sv1,2,0.9632907277820306,5,350,1,356
80724,ssv,sv1,3,0.9606074083138466,5,316,1,322
80724,ssv,sv1,4,0.9648235331777212,13,320,0,333
80724,ssv,sv1,5,0.9465588884209724,10,335,1,346
80724,ssv,sv1,6,0.9465588884209724,10,335,1,346
80724,ssv,sv1,7,0.9465588884209724,10,335,1,346
80724,ssv,sv1,8,0.9504328696959864,13,332,2,347
80724,ssv,sv1,9,0.9689103991751805,10,343,3,356
80726,ssv,sv1,0,0.960302447866735,2,357,3,362
80726,ssv,sv1,1,0.959655882182729,7,329,3,339
80726,ssv,sv1,2,0.9664803951843876,5,351,3,359
80726,ssv,sv1,3,0.9496796764617239,7,315,0,322
80726,ssv,sv1,4,0.9682931730770792,6,332,3,341
80726,ssv,sv1,5,0.9600880655643179,3,348,1,352
80726,ssv,sv1,6,0.9600880655643179,3,348,1,352
80726,ssv,sv1,7,0.9488798226674003,1,303,1,305
80726,ssv,sv1,8,0.9536791282441472,3,347,1,351
80726,ssv,sv1,9,0.9083274354933516,6,346,1,353
80728,ssv,sv1,0,0.96989111741167,1,366,5,372
80728,ssv,sv1,1,0.9204383941636524,4,190,3,197
80728,ssv,sv1,2,0.9356372256965744,3,354,3,360
80728,ssv,sv1,3,0.9579130661042954,3,210,1,214
80728,ssv,sv1,4,0.9514105278051603,0,337,5,342
80728,ssv,sv1,5,0.9488559304865414,2,346,6,354
80728,ssv,sv1,6,0.9330195295922911,3,207,4,214
80728,ssv,sv1,7,0.8940375893183837,1,159,3,163
80728,ssv,sv1,8,0.9143742860868723,2,211,6,219
80728,ssv,sv1,9,0.9382936555332152,1,229,3,233
80729,ssv,sv1,0,0.9617564343852417,9,311,1,321
80729,ssv,sv1,1,0.9195698199167381,4,184,3,191
80729,ssv,sv1,2,0.9555967539569541,7,322,8,337
80729,ssv,sv1,3,0.91175557347707,3,163,4,170
80729,ssv,sv1,4,0.9663243538063745,1,320,13,334
80729,ssv,sv1,5,0.9263880017546126,8,331,5,344
80729,ssv,sv1,6,0.9274713045037976,7,173,5,185
80729,ssv,sv1,7,0.8752767629162927,1,150,3,154
80729,ssv,sv1,8,0.9514816031922502,1,174,6,181
80729,ssv,sv1,9,0.9686214047588897,5,178,2,185
80730,ssv,sv1,0,0.9680087459366881,7,311,3,321
80730,ssv,sv1,1,0.9149271569939971,3,154,5,162
80730,ssv,sv1,2,0.9179671991047686,5,306,1,312
80730,ssv,sv1,3,0.9236225436523948,2,186,2,190
80730,ssv,sv1,4,0.9427077982443094,6,312,12,330
80730,ssv,sv1,5,0.9544557302183847,10,332,4,346
80730,ssv,sv1,6,0.9565518767685354,1,182,4,187
80730,ssv,sv1,7,0.8870661841047,3,146,6,155
80730,ssv,sv1,8,0.8515420511455344,3,161,4,168
80730,ssv,sv1,9,0.8712452106855931,2,192,7,201
80731,ssv,sv1,0,0.9668764879131014,0,323,2,325
80731,ssv,sv1,1,0.8862019073387758,0,157,2,159
80731,ssv,sv1,2,0.9553172832980753,0,316,7,323
80731,ssv,sv1,3,0.858203204035881,2,159,4,165
80731,ssv,sv1,4,0.952568525813809,3,309,5,317
80731,ssv,sv1,5,0.9178782006275823,2,312,7,321
80731,ssv,sv1,6,0.8760672691764281,2,172,0,174
80731,ssv,sv1,7,0.8934510029311468,7,154,3,164
80731,ssv,sv1,8,0.8584742247018919,0,165,5,170
80731,ssv,sv1,9,0.9007667361411686,2,183,1,186
80732,ssv,sv1,0,0.9445571694628037,1,369,1,371
80732,ssv,sv1,1,0.9371026817996774,2,226,1,229
80732,ssv,sv1,2,0.9517023868125231,0,349,4,353
80732,ssv,sv1,3,0.9364658247505511,1,203,2,206
80732,ssv,sv1,4,0.9514755928473954,1,338,5,344
80732,ssv,sv1,5,0.945400425561913,0,355,6,361
80732,ssv,sv1,6,0.9357390863296096,0,240,5,245
80732,ssv,sv1,7,0.9217041860905973,2,201,2,205
80732,ssv,sv1,8,0.9364708273195737,0,239,3,242
80732,ssv,sv1,9,0.9482029950728453,1,263,3,267
80733,ssv,sv1,0,0.9661210466531038,0,358,5,363
80733,ssv,sv1,1,0.95332579975036,1,182,5,188
80733,ssv,sv1,2,0.9515290905144278,2,241,5,248
80733,ssv,sv1,3,0.9282469977602243,0,202,6,208
80733,ssv,sv1,4,0.9360189235466941,0,177,4,181
80733,ssv,sv1,5,0.9496276222732829,0,195,5,200
80733,ssv,sv1,6,0.932018460094925,0,203,1,204
80733,ssv,sv1,7,0.8513064307578864,0,138,5,143
80733,ssv,sv1,8,0.9010604525691662,3,193,3,199
80733,ssv,sv1,9,0.9097676951352985,1,213,3,217
80734,ssv,sv1,0,0.9489656781469615,6,363,1,370
80734,ssv,sv1,1,0.9593074117363376,2,327,1,330
80734,ssv,sv1,2,0.9728088985234601,3,356,1,360
80734,ssv,sv1,3,0.9155604656224821,4,314,6,324
80734,ssv,sv1,4,0.9483703558424561,1,344,0,345
80734,ssv,sv1,5,0.9289038524587595,1,355,2,358
80734,ssv,sv1,6,0.9595488140504833,0,356,1,357
80734,ssv,sv1,7,0.9371338886736184,0,302,3,305
80734,ssv,sv1,8,0.958842993809904,2,330,2,334
80734,ssv,sv1,9,0.9721642138477478,3,385,1,389
80735,ssv,sv1,0,0.9445505928690358,3,366,0,369
80735,ssv,sv1,1,0.974320486816841,1,331,0,332
80735,ssv,sv1,2,0.9657545792537833,3,338,0,341
80735,ssv,sv1,3,0.9288310623868656,1,318,1,320
80735,ssv,sv1,4,0.9487521271485044,0,347,0,347
80735,ssv,sv1,5,0.9791929870042285,0,356,1,357
80735,ssv,sv1,6,0.9600119339837639,4,360,6,370
80735,ssv,sv1,7,0.9553518857470372,1,304,0,305
80735,ssv,sv1,8,0.9732685816415713,2,353,3,358
80735,ssv,sv1,9,0.9620583570952489,4,373,3,380
80736,ssv,sv1,0,0.9432223533104004,3,356,0,359
80736,ssv,sv1,1,0.968207211079814,9,365,0,374
80736,ssv,sv1,2,0.9711239057916564,2,367,0,369
80736,ssv,sv1,3,0.9368559144306465,6,352,2,360
80736,ssv,sv1,4,0.9574943672306789,4,352,0,356
80736,ssv,sv1,5,0.9700126145735564,1,365,1,367
80736,ssv,sv1,6,0.9767018192012701,3,385,0,388
80736,ssv,sv1,7,0.9647675892525261,6,340,1,347
80736,ssv,sv1,8,0.9652697757019146,3,377,1,381
80736,ssv,sv1,9,0.9564432461702229,0,389,1,390
80737,ssv,sv1,0,0.9444905913094147,23,304,3,330
80737,ssv,sv1,1,0.9562790140808863,16,303,1,320
80737,ssv,sv1,2,0.9662032051651893,8,343,4,355
80737,ssv,sv1,3,0.9625896041253719,6,310,3,319
80737,ssv,sv1,4,0.9399250919186195,10,318,4,332
80737,ssv,sv1,5,0.9614167941249547,4,341,2,347
80737,ssv,sv1,6,0.9614167941249547,4,341,2,347
80737,ssv,sv1,7,0.9514182447754923,5,290,0,295
80737,ssv,sv1,8,0.9232177932657155,15,316,3,334
80737,ssv,sv1,9,0.9573334370796682,24,329,3,356
80738,ssv,sv1,0,0.9501236677497892,6,363,1,370
80738,ssv,sv1,1,0.972612626771194,13,342,1,356
80738,ssv,sv1,2,0.94451221506764,12,355,1,368
80738,ssv,sv1,3,0.9604309008892732,4,328,1,333
80738,ssv,sv1,4,0.9738276287665903,10,347,0,357
80738,ssv,sv1,5,0.9525908086789294,1,366,2,369
80738,ssv,sv1,6,0.9593065886771869,6,352,3,361
80738,ssv,sv1,7,0.9541479070913261,9,320,2,331
80738,ssv,sv1,8,0.9489817790312066,4,382,2,388
80738,ssv,sv1,9,0.957663663821815,3,370,3,376
80740,bgsmws,sv1,0,0.9455883348955405,270,86,1,357
80740,bgsmws,sv1,1,0.9228481716895737,278,52,3,333
80740,bgsmws,sv1,2,0.9555661887550809,304,52,3,359
80740,bgsmws,sv1,3,0.9637467158860543,277,46,4,327
80740,bgsmws,sv1,4,0.9429386243739867,296,42,0,338
80740,bgsmws,sv1,5,0.9302728093064245,296,53,5,354
80740,bgsmws,sv1,6,0.9302728093064245,296,53,5,354
80740,bgsmws,sv1,7,0.971507874869723,218,75,1,294
80740,bgsmws,sv1,8,0.9628235577911026,254,89,1,344
80740,bgsmws,sv1,9,0.9533768963281429,260,96,3,359
80741,bgsmws,sv1,0,0.9643107565431619,280,81,1,362
80741,bgsmws,sv1,1,0.9551637064757361,249,87,1,337
80741,bgsmws,sv1,2,0.9664803951843876,268,85,3,356
80741,bgsmws,sv1,3,0.9520025915874678,242,84,4,330
80741,bgsmws,sv1,4,0.9723216143373286,240,82,4,326
80741,bgsmws,sv1,5,0.9566489689459166,257,82,5,344
80741,bgsmws,sv1,6,0.9566489689459166,257,82,5,344
80741,bgsmws,sv1,7,0.9647661424951016,229,59,4,292
80741,bgsmws,sv1,8,0.9459801102209527,296,47,1,344
80741,bgsmws,sv1,9,0.9398468994512269,269,84,0,353
80742,bgsmws,sv1,0,0.9748469860535238,292,67,3,362
80742,bgsmws,sv1,1,0.936774596016722,243,94,3,340
80742,bgsmws,sv1,2,0.9696926488138041,274,93,4,371
80742,bgsmws,sv1,3,0.9533003439111698,260,73,1,334
80742,bgsmws,sv1,4,0.9478226464508729,264,83,1,348
80742,bgsmws,sv1,5,0.9353984806354867,326,24,4,354
80742,bgsmws,sv1,6,0.929091561871473,251,106,4,361
80742,bgsmws,sv1,7,0.9428109772865781,195,118,0,313
80742,bgsmws,sv1,8,0.955807808650382,270,95,6,371
80742,bgsmws,sv1,9,0.9558419542057104,269,115,6,390
80782,backup1,sv1,0,0.9656628559775668,4,309,2,315
80782,backup1,sv1,1,0.8716405737325934,0,166,0,166
80782,backup1,sv1,2,0.9604839879183117,2,303,6,311
80782,backup1,sv1,3,0.9010007785435881,0,157,4,161
80782,backup1,sv1,4,0.9468079785480639,0,247,5,252
80782,backup1,sv1,5,0.9042543403459379,2,276,2,280
80782,backup1,sv1,6,0.9048275116480926,5,153,0,158
80782,backup1,sv1,7,0.928415779763434,2,246,3,251
80782,backup1,sv1,8,0.9416381058731879,4,297,5,306
80782,backup1,sv1,9,0.8689675693427216,0,86,1,87
80783,backup1,sv1,0,0.9564392006128822,4,311,6,321
80783,backup1,sv1,1,0.8691084186351576,0,164,1,165
80783,backup1,sv1,2,0.9415928194788518,3,281,5,289
80783,backup1,sv1,3,0.8560971297670626,2,152,2,156
80783,backup1,sv1,4,0.9220532666366922,1,233,7,241
80783,backup1,sv1,5,0.9670258668262364,3,258,5,266
80783,backup1,sv1,6,0.8171837794400247,0,185,1,186
80783,backup1,sv1,7,0.9330131481601422,1,234,3,238
80783,backup1,sv1,8,0.9276870254592691,9,287,3,299
80783,backup1,sv1,9,0.7761281826163673,1,89,0,90
80784,backup1,sv1,0,0.9351993868341462,3,310,2,315
80784,backup1,sv1,1,0.9152614321296998,1,162,1,164
80784,backup1,sv1,2,0.9624996992905656,3,295,3,301
80784,backup1,sv1,3,0.858444490134832,1,159,0,160
80784,backup1,sv1,4,0.9699258193680833,0,244,6,250
80784,backup1,sv1,5,0.9459199560764062,3,266,4,273
80784,backup1,sv1,6,0.8966239518780532,3,180,2,185
80784,backup1,sv1,7,0.9521190819089701,2,248,2,252
80784,backup1,sv1,8,0.9454883871070604,12,283,2,297
80784,backup1,sv1,9,0.7761281826163673,1,87,0,88
80785,backup1,sv1,0,0.9203413202677428,1,323,4,328
80785,backup1,sv1,1,0.9274782651812661,0,173,2,175
80785,backup1,sv1,2,0.9600063421918718,4,296,5,305
80785,backup1,sv1,3,0.9179846043134863,4,148,0,152
80785,backup1,sv1,4,0.9105477726391813,0,234,3,237
80785,backup1,sv1,5,0.9463597196302486,2,269,6,277
80785,backup1,sv1,6,0.9347888246899347,3,181,1,185
80785,backup1,sv1,7,0.9362201847665039,2,254,3,259
80785,backup1,sv1,8,0.9620771725088885,9,294,6,309
80785,backup1,sv1,9,0.7631965454838449,1,89,1,91
80786,backup1,sv1,0,0.9582509533561333,14,297,6,317
80786,backup1,sv1,1,0.9340839442752675,1,178,2,181
80786,backup1,sv1,2,0.9545742524320221,5,292,8,305
80786,backup1,sv1,3,0.9335889195559014,11,170,0,181
80786,backup1,sv1,4,0.9248383759605243,3,233,3,239
80786,backup1,sv1,5,0.9446405847829838,6,263,2,271
80786,backup1,sv1,6,0.8896743983746251,5,203,1,209
80786,backup1,sv1,7,0.933285422418625,12,246,4,262
80786,backup1,sv1,8,0.9498524349352953,8,309,1,318
80786,backup1,sv1,9,0.9498524349352953,8,309,1,318
80787,backup1,sv1,0,0.9666185805282712,8,293,6,307
80787,backup1,sv1,1,0.8259923521953494,1,155,0,156
80787,backup1,sv1,2,0.9465907848296408,10,280,2,292
80787,backup1,sv1,3,0.942585949255962,5,140,2,147
80787,backup1,sv1,4,0.9234963020255524,2,233,5,240
80787,backup1,sv1,5,0.9544680501541631,15,238,5,258
80787,backup1,sv1,6,0.9542484105524457,3,216,3,222
80787,backup1,sv1,7,0.9375842367391818,11,234,3,248
80787,backup1,sv1,8,0.9352780188546529,11,304,4,319
80787,backup1,sv1,9,0.7335473133023558,1,86,1,88
80788,backup1,sv1,0,0.9673343009548007,2,307,3,312
80788,backup1,sv1,1,0.942998577525367,2,160,1,163
80788,backup1,sv1,2,0.9097622942320033,1,288,3,292
80788,backup1,sv1,3,0.8784628042841327,2,145,1,148
80788,backup1,sv1,4,0.93992625504305,1,248,2,251
80788,backup1,sv1,5,0.9475684420465276,1,268,5,274
80788,backup1,sv1,6,0.912352239961476,1,183,1,185
80788,backup1,sv1,7,0.9370259340342482,2,249,3,254
80788,backup1,sv1,8,0.9110182261792983,12,292,1,305
80788,backup1,sv1,9,0.7899580627579132,0,84,0,84
80789,backup1,sv1,0,0.967969063246904,0,302,4,306
80789,backup1,sv1,1,0.9247355041008068,0,152,0,152
80789,backup1,sv1,2,0.9441938656458524,4,276,6,286
80789,backup1,sv1,3,0.9178873635885203,0,161,0,161
80789,backup1,sv1,4,0.9002750608030674,1,234,3,238
80789,backup1,sv1,5,0.9380067585330488,4,250,4,258
80789,backup1,sv1,6,0.880304158679875,4,171,2,177
80789,backup1,sv1,7,0.9114046590517987,7,234,2,243
80789,backup1,sv1,8,0.9257920742697517,8,293,5,306
80789,backup1,sv1,9,0.8255120574797109,3,85,0,88
80790,backup1,sv1,0,0.939512927052662,3,293,3,299
80790,backup1,sv1,1,0.8850358073689402,0,159,1,160
80790,backup1,sv1,2,0.9480433782341078,1,288,1,290
80790,backup1,sv1,3,0.9171525174769606,1,138,2,141
80790,backup1,sv1,4,0.9148325179421599,1,242,2,245
80790,backup1,sv1,5,0.9181867573388318,3,257,4,264
80790,backup1,sv1,6,0.9261119924804345,0,159,1,160
80790,backup1,sv1,7,0.9314033791986832,1,236,6,243
80790,backup1,sv1,8,0.9173953864286042,3,282,4,289
80790,backup1,sv1,9,0.8048302504138817,1,71,0,72
80856,lrgqso,sv1,0,0.9555483301746431,197,55,71,323
80856,lrgqso,sv1,1,0.9366998581006538,192,47,72,311
80856,lrgqso,sv1,2,0.9419275306988045,219,38,74,331
80856,lrgqso,sv1,3,0.9427732937124248,193,49,64,306
80856,lrgqso,sv1,4,0.958973225612036,206,37,73,316
80856,lrgqso,sv1,5,0.9588740004967585,205,44,69,318
80856,lrgqso,sv1,6,0.9588740004967585,205,44,69,318
80856,lrgqso,sv1,7,0.9328166594797984,173,53,58,284
80856,lrgqso,sv1,8,0.947319910497727,210,38,70,318
80856,lrgqso,sv1,9,0.9478097320158193,206,54,84,344
80857,lrgqso,sv1,0,0.9295925533096262,174,61,96,331
80857,lrgqso,sv1,1,0.9437226080671088,195,51,76,322
80857,lrgqso,sv1,2,0.9374134660407809,208,67,64,339
80857,lrgqso,sv1,3,0.9513917358388224,201,58,55,314
80857,lrgqso,sv1,4,0.9557985080049971,215,50,71,336
80857,lrgqso,sv1,5,0.9617348054696989,195,53,87,335
80857,lrgqso,sv1,6,0.9544173096887656,150,35,58,243
80857,lrgqso,sv1,7,0.9318817736192899,175,52,61,288
80857,lrgqso,sv1,8,0.9655776160184898,192,57,71,320
80857,lrgqso,sv1,9,0.9354530361886887,184,64,93,341
80858,lrgqso,sv1,0,0.9492137444617326,203,57,70,330
80858,lrgqso,sv1,1,0.9479425986789578,183,68,72,323
80858,lrgqso,sv1,2,0.9580887147485704,202,64,69,335
80858,lrgqso,sv1,3,0.9338839815887249,187,57,71,315
80858,lrgqso,sv1,4,0.9592954034148938,177,56,91,324
80858,lrgqso,sv1,5,0.9316831590836322,194,59,87,340
80858,lrgqso,sv1,6,0.9458672930863525,169,42,44,255
80858,lrgqso,sv1,7,0.9319785565778121,161,46,73,280
80858,lrgqso,sv1,8,0.9232581770407613,198,58,83,339
80858,lrgqso,sv1,9,0.9655059366673231,219,53,75,347
80859,lrgqso,sv1,0,0.9564063381026003,195,69,65,329
80859,lrgqso,sv1,1,0.9231691965835134,182,50,55,287
80859,lrgqso,sv1,2,0.9455921954810526,180,75,74,329
80859,lrgqso,sv1,3,0.9463837638217294,172,64,67,303
80859,lrgqso,sv1,4,0.9670256773996686,160,60,81,301
80859,lrgqso,sv1,5,0.9540950132194745,187,62,58,307
80859,lrgqso,sv1,6,0.9540950132194745,187,62,58,307
80859,lrgqso,sv1,7,0.9686945162904701,151,55,56,262
80859,lrgqso,sv1,8,0.9606040714923172,166,75,68,309
80859,lrgqso,sv1,9,0.9685918522235828,213,67,45,325
80860,lrgqso,sv1,0,0.9425640409953067,191,90,59,340
80860,lrgqso,sv1,1,0.9240009378038256,134,102,69,305
80860,lrgqso,sv1,2,0.9401564000004234,157,94,79,330
80860,lrgqso,sv1,3,0.9421252968610918,168,84,48,300
80860,lrgqso,sv1,4,0.904453046422516,157,76,80,313
80860,lrgqso,sv1,5,0.9647622581026154,151,97,81,329
80860,lrgqso,sv1,6,0.9380478372647423,128,72,55,255
80860,lrgqso,sv1,7,0.9509441471852498,149,69,63,281
80860,lrgqso,sv1,8,0.9491821638192505,148,92,84,324
80860,lrgqso,sv1,9,0.9507952604273388,181,96,54,331
80861,lrgqso,sv1,0,0.9239516059273475,157,116,70,343
80861,lrgqso,sv1,1,0.9509175729676791,154,119,50,323
80861,lrgqso,sv1,2,0.9538755115890508,165,109,62,336
80861,lrgqso,sv1,3,0.9395430267686918,175,91,59,325
80861,lrgqso,sv1,4,0.952379290899426,170,90,56,316
80861,lrgqso,sv1,5,0.9452167620394828,161,106,60,327
80861,lrgqso,sv1,6,0.9533566738268006,131,65,42,238
80861,lrgqso,sv1,7,0.9319143838850316,125,98,70,293
80861,lrgqso,sv1,8,0.9324719181770336,157,94,67,318
80861,lrgqso,sv1,9,0.9445847770824882,163,118,57,338
80862,mwclusgaldeep,sv1,0,0.9766040985046232,14,331,22,367
80862,mwclusgaldeep,sv1,1,0.9513670009927577,16,301,20,337
80862,mwclusgaldeep,sv1,2,0.9609974016086378,16,320,24,360
80862,mwclusgaldeep,sv1,3,0.9484678252242349,14,303,26,343
80862,mwclusgaldeep,sv1,4,0.9525636434587356,12,306,22,340
80862,mwclusgaldeep,sv1,5,0.9383333449162018,38,287,24,349
80862,mwclusgaldeep,sv1,6,0.9181405103921862,26,254,29,309
80862,mwclusgaldeep,sv1,7,0.9399846194846527,14,263,16,293
80862,mwclusgaldeep,sv1,8,0.9295960914937501,9,306,27,342
80862,mwclusgaldeep,sv1,9,0.9311150558395714,11,322,31,364
80863,mwclusgaldeep,sv1,0,0.9503255008533459,5,309,31,345
80863,mwclusgaldeep,sv1,1,0.9453990348454336,6,301,27,334
80863,mwclusgaldeep,sv1,2,0.9329832401075167,11,332,22,365
80863,mwclusgaldeep,sv1,3,0.914843709090414,10,289,21,320
80863,mwclusgaldeep,sv1,4,0.9336016331819785,6,312,22,340
80863,mwclusgaldeep,sv1,5,0.9535524201515008,18,292,29,339
80863,mwclusgaldeep,sv1,6,0.9535524201515008,18,292,29,339
80863,mwclusgaldeep,sv1,7,0.9611680001999846,4,271,29,304
80863,mwclusgaldeep,sv1,8,0.9606816543266177,4,310,23,337
80863,mwclusgaldeep,sv1,9,0.9616811921091455,7,333,24,364
80865,unwisegreen,sv1,0,0.9419021414911931,325,21,6,352
80865,unwisegreen,sv1,1,0.9299725128882242,296,16,9,321
80865,unwisegreen,sv1,2,0.9711502985411502,312,19,13,344
80865,unwisegreen,sv1,3,0.9447807848545167,298,18,6,322
80865,unwisegreen,sv1,4,0.9269965049418203,291,19,8,318
80865,unwisegreen,sv1,5,0.9036912412771934,308,17,15,340
80865,unwisegreen,sv1,6,0.9699490244233494,277,22,5,304
80865,unwisegreen,sv1,7,0.950425416845439,265,13,6,284
80865,unwisegreen,sv1,8,0.9613800847807231,327,19,11,357
80865,unwisegreen,sv1,9,0.9283112051059121,327,19,4,350
80866,unwisebluebright,sv1,0,0.9482881556473959,320,29,1,350
80866,unwisebluebright,sv1,1,0.9336588374243928,316,20,0,336
80866,unwisebluebright,sv1,2,0.9644675509526611,348,23,1,372
80866,unwisebluebright,sv1,3,0.9447124891273487,330,18,1,349
80866,unwisebluebright,sv1,4,0.9417604642193167,329,22,0,351
80866,unwisebluebright,sv1,5,0.9226658978218791,179,14,3,196
80866,unwisebluebright,sv1,6,0.9226658978218791,179,14,3,196
80866,unwisebluebright,sv1,7,0.9820996465665136,303,21,0,324
80866,unwisebluebright,sv1,8,0.9664306944471878,338,32,0,370
80866,unwisebluebright,sv1,9,0.9783592933589859,354,24,1,379
80867,unwisebluefaint,sv1,0,0.9488334691171969,301,17,4,322
80867,unwisebluefaint,sv1,1,0.9491804951849129,304,17,0,321
80867,unwisebluefaint,sv1,2,0.9443021972328625,335,18,1,354
80867,unwisebluefaint,sv1,3,0.9402209223770196,310,15,0,325
80867,unwisebluefaint,sv1,4,0.9137677488331261,310,17,1,328
80867,unwisebluefaint,sv1,5,0.9137677488331261,310,17,1,328
80867,unwisebluefaint,sv1,6,0.9137677488331261,310,17,1,328
80867,unwisebluefaint,sv1,7,0.9165908010967686,277,14,0,291
80867,unwisebluefaint,sv1,8,0.9401691383084321,326,19,0,345
80867,unwisebluefaint,sv1,9,0.9529424073105353,328,19,1,348
80869,scndhetdex,sv1,0,0.9340327727209411,229,73,19,321
80869,scndhetdex,sv1,1,0.9107276694054286,153,62,31,246
80869,scndhetdex,sv1,2,0.9292934468318012,186,56,23,265
80869,scndhetdex,sv1,3,0.9502982466351388,197,55,22,274
80869,scndhetdex,sv1,4,0.9408348473807665,190,77,26,293
80869,scndhetdex,sv1,5,0.9390977356931602,192,86,19,297
80869,scndhetdex,sv1,6,0.9169627812323485,148,63,17,228
80869,scndhetdex,sv1,7,0.907084100567159,147,52,24,223
80869,scndhetdex,sv1,8,0.9550001755941682,184,77,30,291
80869,scndhetdex,sv1,9,0.9700420037582586,217,45,21,283
80870,scndhetdex,sv1,0,0.935154690035748,176,119,26,321
80870,scndhetdex,sv1,1,0.959605422164937,157,84,16,257
80870,scndhetdex,sv1,2,0.915175197576415,143,65,25,233
80870,scndhetdex,sv1,3,0.8917146822478845,177,61,12,250
80870,scndhetdex,sv1,4,0.9436181712208336,159,106,13,278
80870,scndhetdex,sv1,5,0.9528403245867241,161,121,18,300
80870,scndhetdex,sv1,6,0.9464433630232887,147,101,13,261
80870,scndhetdex,sv1,7,0.9066499088292423,136,60,21,217
80870,scndhetdex,sv1,8,0.9444324057850545,186,63,12,261
80870,scndhetdex,sv1,9,0.9394903663471954,161,97,20,278
80871,scndcosmos,sv1,0,0.9748580904647403,215,21,53,289
80871,scndcosmos,sv1,1,0.8793293150328381,190,17,26,233
80871,scndcosmos,sv1,2,0.8860310387772153,207,18,22,247
80871,scndcosmos,sv1,3,0.9365130357071105,202,21,27,250
80871,scndcosmos,sv1,4,0.9411455673218009,200,17,35,252
80871,scndcosmos,sv1,5,0.9547572994553596,209,23,37,269
80871,scndcosmos,sv1,6,0.9155333168494451,144,17,33,194
80871,scndcosmos,sv1,7,0.9420144289770203,181,16,12,209
80871,scndcosmos,sv1,8,0.9440615563563618,195,21,36,252
80871,scndcosmos,sv1,9,0.9617313120363806,231,19,32,282
80872,scndcosmos,sv1,0,0.9653968403112355,207,17,29,253
80872,scndcosmos,sv1,1,0.9076825268334916,192,22,20,234
80872,scndcosmos,sv1,2,0.861578493214344,189,21,29,239
80872,scndcosmos,sv1,3,0.9133864658148381,201,18,17,236
80872,scndcosmos,sv1,4,0.9359134209557357,172,18,22,212
80872,scndcosmos,sv1,5,0.9353922855842892,186,31,38,255
80872,scndcosmos,sv1,6,0.9403310982307981,189,11,28,228
80872,scndcosmos,sv1,7,0.9279120265529271,155,18,7,180
80872,scndcosmos,sv1,8,0.9280625742174822,216,23,59,298
80872,scndcosmos,sv1,9,0.910772619370388,211,26,23,260
80873,lrgqso2,sv1,0,0.9394993720196042,205,41,80,326
80873,lrgqso2,sv1,1,0.9322583597855592,208,41,66,315
80873,lrgqso2,sv1,2,0.9537227734656496,222,50,59,331
80873,lrgqso2,sv1,3,0.9577864045508578,203,34,75,312
80873,lrgqso2,sv1,4,0.9306836636079158,219,31,70,320
80873,lrgqso2,sv1,5,0.9646910614146078,209,38,90,337
80873,lrgqso2,sv1,6,0.9152676092171843,157,38,55,250
80873,lrgqso2,sv1,7,0.9661456935943087,189,26,72,287
80873,lrgqso2,sv1,8,0.9389834472390333,195,42,86,323
80873,lrgqso2,sv1,9,0.960696969110317,216,39,75,330
80875,lrgqso2,sv1,0,0.8913537607533472,148,28,58,234
80875,lrgqso2,sv1,1,0.9046074938095376,144,26,52,222
80875,lrgqso2,sv1,2,0.9029919068994069,145,26,54,225
80875,lrgqso2,sv1,3,0.8929576457873935,117,36,52,205
80875,lrgqso2,sv1,4,0.9515805967124459,139,29,47,215
80875,lrgqso2,sv1,5,0.9238940072525442,158,15,52,225
80875,lrgqso2,sv1,6,0.9238940072525442,158,15,52,225
80875,lrgqso2,sv1,7,0.8905891878828758,134,17,36,187
80875,lrgqso2,sv1,8,0.9419353688869186,137,33,43,213
80875,lrgqso2,sv1,9,0.897969254511489,162,21,53,236
80876,elg,sv1,0,0.9503533134505864,236,31,9,276
80876,elg,sv1,1,0.9583434361927887,218,29,9,256
80876,elg,sv1,2,0.9385478275306708,238,29,8,275
80876,elg,sv1,3,0.9278265512234161,217,22,11,250
80876,elg,sv1,4,0.9617362032326454,213,26,11,250
80876,elg,sv1,5,0.9708003670278191,243,14,14,271
80876,elg,sv1,6,0.9708003670278191,243,14,14,271
80876,elg,sv1,7,0.9183800105631511,200,14,6,220
80876,elg,sv1,8,0.934461252865044,223,27,5,255
80876,elg,sv1,9,0.948043378234108,260,20,9,289
80879,lrgqso2,sv1,0,0.9569274594991004,227,30,79,336
80879,lrgqso2,sv1,1,0.9643474507321456,200,30,82,312
80879,lrgqso2,sv1,2,0.9604458482343975,237,32,72,341
80879,lrgqso2,sv1,3,0.9146414260752714,215,14,80,309
80879,lrgqso2,sv1,4,0.9460894247994037,198,33,71,302
80879,lrgqso2,sv1,5,0.9502684677688095,231,29,56,316
80879,lrgqso2,sv1,6,0.9502684677688095,231,29,56,316
80879,lrgqso2,sv1,7,0.9547500699084178,186,26,64,276
80879,lrgqso2,sv1,8,0.9507542450282546,222,35,85,342
80879,lrgqso2,sv1,9,0.9576506052746552,239,24,83,346
80882,elg,sv1,0,0.9561215394616128,258,39,10,307
80882,elg,sv1,1,0.948062715278564,225,34,10,269
80882,elg,sv1,2,0.9634376392701018,247,38,10,295
80882,elg,sv1,3,0.9631175762711632,239,37,5,281
80882,elg,sv1,4,0.9470049714754936,220,35,6,261
80882,elg,sv1,5,0.9455948652159267,232,30,11,273
80882,elg,sv1,6,0.9455948652159267,232,30,11,273
80882,elg,sv1,7,0.9128034774382973,185,33,8,226
80882,elg,sv1,8,0.9578332939822458,223,34,5,262
80882,elg,sv1,9,0.9646620330040544,239,41,9,289
80885,lrgqso2,sv1,0,0.9810503614015337,202,45,92,339
80885,lrgqso2,sv1,1,0.9578295767044678,208,33,65,306
80885,lrgqso2,sv1,2,0.9607237311932079,223,25,88,336
80885,lrgqso2,sv1,3,0.9652184238197828,180,26,97,303
80885,lrgqso2,sv1,4,0.9517931311541027,189,34,90,313
80885,lrgqso2,sv1,5,0.9483810426067876,209,40,81,330
80885,lrgqso2,sv1,6,0.8929444653394941,164,25,54,243
80885,lrgqso2,sv1,7,0.9307533302312926,177,19,85,281
80885,lrgqso2,sv1,8,0.9408946665069771,210,34,90,334
80885,lrgqso2,sv1,9,0.96258161641904,214,46,82,342
80886,elg,sv1,0,0.9632976767497557,262,37,12,311
80886,elg,sv1,1,0.9284452280017588,251,27,8,286
80886,elg,sv1,2,0.9541621532416684,278,25,4,307
80886,elg,sv1,3,0.9579954660413538,241,27,7,275
80886,elg,sv1,4,0.9590884546531363,252,32,8,292
80886,elg,sv1,5,0.9335960839232159,250,35,17,302
80886,elg,sv1,6,0.9228286972634149,213,26,6,245
80886,elg,sv1,7,0.9428571235353866,226,14,4,244
80886,elg,sv1,8,0.934903649771456,262,25,7,294
80886,elg,sv1,9,0.9556844744321019,250,40,6,296
80887,lrgqso2,sv1,0,0.9496048842298582,225,35,86,346
80887,lrgqso2,sv1,1,0.9444952116820678,189,45,90,324
80887,lrgqso2,sv1,2,0.9644965178488888,217,49,73,339
80887,lrgqso2,sv1,3,0.9704875367257245,212,27,59,298
80887,lrgqso2,sv1,4,0.9597165378756073,214,41,67,322
80887,lrgqso2,sv1,5,0.9517381147256322,219,41,75,335
80887,lrgqso2,sv1,6,0.9480522413978386,189,36,50,275
80887,lrgqso2,sv1,7,0.9734315242126638,166,37,87,290
80887,lrgqso2,sv1,8,0.9418028325384504,229,38,67,334
80887,lrgqso2,sv1,9,0.9506925347503191,205,38,90,333
80888,elg,sv1,0,0.932043154977292,222,32,9,263
80888,elg,sv1,1,0.9353063191141711,193,31,9,233
80888,elg,sv1,2,0.9381734652791996,210,36,5,251
80888,elg,sv1,3,0.9101888972990351,199,25,8,232
80888,elg,sv1,4,0.9265576941018497,230,24,7,261
80888,elg,sv1,5,0.9016149246073054,220,31,9,260
80888,elg,sv1,6,0.9016149246073054,220,31,9,260
80888,elg,sv1,7,0.9359134209557357,177,29,6,212
80888,elg,sv1,8,0.8990586270239483,175,23,5,203
80888,elg,sv1,9,0.9485380887290318,221,35,10,266
80889,lrgqso2,sv1,0,0.9658981062299117,221,46,75,342
80889,lrgqso2,sv1,1,0.9566731675670365,193,43,82,318
80889,lrgqso2,sv1,2,0.9631473331053102,228,36,92,356
80889,lrgqso2,sv1,3,0.9472399530148463,213,26,62,301
80889,lrgqso2,sv1,4,0.9245012928699103,201,38,71,310
80889,lrgqso2,sv1,5,0.9734306407205982,214,42,73,329
80889,lrgqso2,sv1,6,0.9445548634404888,177,34,53,264
80889,lrgqso2,sv1,7,0.9161627156967045,175,35,73,283
80889,lrgqso2,sv1,8,0.9449586656990197,172,43,95,310
80889,lrgqso2,sv1,9,0.9310178379662488,201,42,85,328
80890,elg,sv1,0,0.9555211806700925,239,40,6,285
80890,elg,sv1,1,0.9411570001247963,226,34,7,267
80890,elg,sv1,2,0.9247098647590396,258,30,9,297
80890,elg,sv1,3,0.9634034875252818,244,23,7,274
80890,elg,sv1,4,0.9373315740235139,240,35,8,283
80890,elg,sv1,5,0.955327796736837,238,33,12,283
80890,elg,sv1,6,0.9338572637327573,170,33,11,214
80890,elg,sv1,7,0.9583229838967056,214,30,7,251
80890,elg,sv1,8,0.9758429551065192,239,35,7,281
80890,elg,sv1,9,0.9687672715184192,254,37,13,304
80891,lrgqso2,sv1,0,0.9608808650317069,206,46,89,341
80891,lrgqso2,sv1,1,0.9384867224427342,204,43,82,329
80891,lrgqso2,sv1,2,0.9427298171276983,189,49,95,333
80891,lrgqso2,sv1,3,0.963493512168008,203,37,80,320
80891,lrgqso2,sv1,4,0.9275798348227391,215,39,68,322
80891,lrgqso2,sv1,5,0.9470870353438161,213,43,74,330
80891,lrgqso2,sv1,6,0.9540938969115794,168,43,72,283
80891,lrgqso2,sv1,7,0.9375221342038782,198,37,57,292
80891,lrgqso2,sv1,8,0.9731384051242828,198,47,82,327
80891,lrgqso2,sv1,9,0.967964269705019,216,40,92,348
80892,elg,sv1,0,0.946199000430167,263,37,9,309
80892,elg,sv1,1,0.9424648130255745,233,31,8,272
80892,elg,sv1,2,0.9280644067811369,244,38,10,292
80892,elg,sv1,3,0.9637936335344787,237,34,14,285
80892,elg,sv1,4,0.9472172472885545,252,36,5,293
80892,elg,sv1,5,0.9584406961586015,252,33,15,300
80892,elg,sv1,6,0.9618106755187836,201,34,6,241
80892,elg,sv1,7,0.9606333415971813,204,29,3,236
80892,elg,sv1,8,0.9324250157748044,245,38,3,286
80892,elg,sv1,9,0.956499214488689,254,33,5,292
80893,lrgqso2,sv1,0,0.9627409605636882,193,45,109,347
80893,lrgqso2,sv1,1,0.9522781351297088,197,41,89,327
80893,lrgqso2,sv1,2,0.9554867979132863,182,45,110,337
80893,lrgqso2,sv1,3,0.950764508931067,192,39,78,309
80893,lrgqso2,sv1,4,0.973430640720598,220,41,68,329
80893,lrgqso2,sv1,5,0.9576722170720292,210,45,82,337
80893,lrgqso2,sv1,6,0.9569681264400558,169,43,75,287
80893,lrgqso2,sv1,7,0.9314196048516489,154,39,94,287
80893,lrgqso2,sv1,8,0.9227207512703041,210,45,88,343
80893,lrgqso2,sv1,9,0.9497948502999134,197,46,104,347
80894,elg,sv1,0,0.9412127007729476,261,39,12,312
80894,elg,sv1,1,0.9337954651781015,254,37,13,304
80894,elg,sv1,2,0.9424357614808587,241,35,8,284
80894,elg,sv1,3,0.948729599398794,226,40,11,277
80894,elg,sv1,4,0.9395888383767363,230,34,7,271
80894,elg,sv1,5,0.9553863031906408,251,32,8,291
80894,elg,sv1,6,0.8887961977044716,206,30,5,241
80894,elg,sv1,7,0.9530510959203409,227,30,9,266
80894,elg,sv1,8,0.9262230023475818,241,41,7,289
80894,elg,sv1,9,0.9275733961208503,262,40,6,308
80895,lrgqso2,sv1,0,0.9548306954310963,213,45,97,355
80895,lrgqso2,sv1,1,0.9373876637302934,200,60,77,337
80895,lrgqso2,sv1,2,0.9639475775616368,225,49,77,351
80895,lrgqso2,sv1,3,0.9312621923050637,193,37,90,320
80895,lrgqso2,sv1,4,0.9380487904293631,215,41,68,324
80895,lrgqso2,sv1,5,0.9639395776665617,212,45,78,335
80895,lrgqso2,sv1,6,0.9363115919275591,179,36,67,282
80895,lrgqso2,sv1,7,0.9687245057223409,197,39,60,296
80895,lrgqso2,sv1,8,0.9587161472552106,224,47,66,337
80895,lrgqso2,sv1,9,0.9422780205342383,198,53,87,338
80896,elg,sv1,0,0.9771156215949295,260,41,6,307
80896,elg,sv1,1,0.9595096939772227,240,33,6,279
80896,elg,sv1,2,0.9188645315204756,236,32,13,281
80896,elg,sv1,3,0.9463041173772534,244,34,3,281
80896,elg,sv1,4,0.9437523307990445,252,33,2,287
80896,elg,sv1,5,0.9533325172042623,240,36,16,292
80896,elg,sv1,6,0.9210466943368336,210,30,4,244
80896,elg,sv1,7,0.9434318345707514,211,29,11,251
80896,elg,sv1,8,0.9559472698497338,229,38,6,273
80896,elg,sv1,9,0.9659369812909292,261,36,12,309
80897,lrgqso2,sv1,0,0.9510788072856238,202,39,69,310
80897,lrgqso2,sv1,1,0.9156532986483402,174,48,71,293
80897,lrgqso2,sv1,2,0.9576243467194069,195,43,73,311
80897,lrgqso2,sv1,3,0.9761365842624898,173,46,71,290
80897,lrgqso2,sv1,4,0.966328166026243,194,45,66,305
80897,lrgqso2,sv1,5,0.9374163235752081,194,39,73,306
80897,lrgqso2,sv1,6,0.9544921262208684,162,37,66,265
80897,lrgqso2,sv1,7,0.9455833308284524,171,41,55,267
80897,lrgqso2,sv1,8,0.9035770867931768,176,53,65,294
80897,lrgqso2,sv1,9,0.9292695682779202,181,49,87,317
80898,elg,sv1,0,0.9608620222135574,229,37,9,275
80898,elg,sv1,1,0.9375715988608334,212,34,11,257
80898,elg,sv1,2,0.9338805111166667,247,33,4,284
80898,elg,sv1,3,0.9212926997255313,210,31,6,247
80898,elg,sv1,4,0.9530501146282153,210,37,6,253
80898,elg,sv1,5,0.9380024333370293,224,35,13,272
80898,elg,sv1,6,0.9437607279368277,193,30,5,228
80898,elg,sv1,7,0.929702190793982,194,31,6,231
80898,elg,sv1,8,0.9529416488500531,235,35,11,281
80898,elg,sv1,9,0.9389591060242429,218,34,13,265
80899,lrgqso2,sv1,0,0.9693117849934317,190,52,95,337
80899,lrgqso2,sv1,1,0.945806711917591,199,52,72,323
80899,lrgqso2,sv1,2,0.9386453978585079,189,58,87,334
80899,lrgqso2,sv1,3,0.9315735927102855,177,53,79,309
80899,lrgqso2,sv1,4,0.95756272044253,172,53,103,328
80899,lrgqso2,sv1,5,0.9318065808733622,199,45,88,332
80899,lrgqso2,sv1,6,0.9687489270288213,162,49,65,276
80899,lrgqso2,sv1,7,0.9192842153043468,163,56,62,281
80899,lrgqso2,sv1,8,0.9575289034799136,188,65,72,325
80899,lrgqso2,sv1,9,0.9546143986795836,214,52,76,342
80900,elg,sv1,0,0.9559042748031876,244,36,7,287
80900,elg,sv1,1,0.9407682197641397,237,35,9,281
80900,elg,sv1,2,0.9430193857309285,249,34,7,290
80900,elg,sv1,3,0.9323834844718563,221,34,7,262
80900,elg,sv1,4,0.9347821008067283,242,33,3,278
80900,elg,sv1,5,0.9515884944041666,214,38,9,261
80900,elg,sv1,6,0.9035514258675351,211,30,6,247
80900,elg,sv1,7,0.9288036771181872,200,30,6,236
80900,elg,sv1,8,0.9166044423926458,245,34,6,285
80900,elg,sv1,9,0.9544939369893639,250,31,10,291
80901,lrgqso2,sv1,0,0.9375288579249438,200,45,97,342
80901,lrgqso2,sv1,1,0.9621523035404873,177,47,75,299
80901,lrgqso2,sv1,2,0.9358222931706328,179,59,95,333
80901,lrgqso2,sv1,3,0.9162147801755683,180,48,81,309
80901,lrgqso2,sv1,4,0.9405541974131874,191,47,59,297
80901,lrgqso2,sv1,5,0.9594838203351757,181,46,81,308
80901,lrgqso2,sv1,6,0.9186305153472194,170,47,66,283
80901,lrgqso2,sv1,7,0.9436181712208337,162,39,78,279
80901,lrgqso2,sv1,8,0.9674450526637816,187,55,73,315
80901,lrgqso2,sv1,9,0.9210664081919402,183,51,74,308
80902,elg,sv1,0,0.9406273852850838,259,39,14,312
80902,elg,sv1,1,0.9530886353002992,244,33,10,287
80902,elg,sv1,2,0.9488638104520947,225,44,7,276
80902,elg,sv1,3,0.9377463997032485,254,34,7,295
80902,elg,sv1,4,0.9404452653075341,242,37,6,285
80902,elg,sv1,5,0.941153866024846,254,36,10,300
80902,elg,sv1,6,0.9364708273195737,215,20,5,240
80902,elg,sv1,7,0.9221070464741454,232,27,5,264
80902,elg,sv1,8,0.9324411644906813,251,33,8,292
80902,elg,sv1,9,0.9481671767435623,253,36,10,299
80938,backup1,sv1,0,0.9741181105326526,0,300,2,302
80938,backup1,sv1,1,0.9470780655621194,3,288,5,296
80938,backup1,sv1,2,0.9695344360046358,4,347,3,354
80938,backup1,sv1,3,0.9662511449339197,4,288,1,293
80938,backup1,sv1,4,0.9519116552011732,2,305,6,313
80938,backup1,sv1,5,0.9592782232295962,3,262,4,269
80938,backup1,sv1,6,0.9384555079451056,1,293,7,301
80938,backup1,sv1,7,0.9384555079451056,1,293,7,301
80938,backup1,sv1,8,0.9581731437303247,6,332,1,339
80938,backup1,sv1,9,0.9324264904803709,7,269,5,281
80944,backup1,sv1,0,0.9485614911766093,11,287,5,303
80944,backup1,sv1,1,0.9706978401665828,10,280,5,295
80944,backup1,sv1,2,0.914349290224081,4,221,5,230
80944,backup1,sv1,3,0.9474707570558999,19,271,3,293
80944,backup1,sv1,4,0.9575580901185577,3,302,3,308
80944,backup1,sv1,5,0.894040285672152,4,259,3,266
80944,backup1,sv1,6,0.9263431133559134,2,286,2,290
80944,backup1,sv1,7,0.8224587270136705,2,114,1,117
80944,backup1,sv1,8,0.9458729719691736,3,335,1,339
80944,backup1,sv1,9,0.9467527575410424,2,259,3,264
80949,backup1,sv1,0,0.9678581493372931,132,211,7,350
80949,backup1,sv1,1,0.9464155492539047,122,151,12,285
80949,backup1,sv1,2,0.9669857153754745,132,188,13,333
80949,backup1,sv1,3,0.9537518450607912,125,144,22,291
80949,backup1,sv1,4,0.9681762056151115,138,156,6,300
80949,backup1,sv1,5,0.9169484319213573,185,113,21,319
80949,backup1,sv1,6,0.9357626754344642,123,155,9,287
80949,backup1,sv1,7,0.9628845399304898,107,132,2,241
80949,backup1,sv1,8,0.9562076979834502,144,170,6,320
80949,backup1,sv1,9,0.9486919770167193,130,201,4,335
80950,backup1,sv1,0,0.938176827626791,2,279,1,282
80950,backup1,sv1,1,0.9406135897154153,2,274,4,280
80950,backup1,sv1,2,0.9496408780864024,5,222,1,228
80950,backup1,sv1,3,0.9559192627943783,3,272,2,277
80950,backup1,sv1,4,0.9590551728113911,2,273,3,278
80950,backup1,sv1,5,0.9227772337865184,2,260,4,266
80950,backup1,sv1,6,0.9611439584669998,4,285,1,290
80950,backup1,sv1,7,0.9611439584669998,4,285,1,290
80950,backup1,sv1,8,0.9536101024579405,2,324,4,330
80950,backup1,sv1,9,0.9358042430414204,2,262,4,268
80951,backup1,sv1,0,0.9609528491735659,2,340,3,345
80951,backup1,sv1,1,0.9532268781648421,0,291,5,296
80951,backup1,sv1,2,0.9649385085582403,5,353,1,359
80951,backup1,sv1,3,0.9533518966802451,3,291,4,298
80951,backup1,sv1,4,0.9372190992051026,1,308,6,315
80951,backup1,sv1,5,0.9425788219474666,2,345,4,351
80951,backup1,sv1,6,0.9348089683290128,4,297,3,304
80951,backup1,sv1,7,0.9140969333402187,3,252,2,257
80951,backup1,sv1,8,0.9338108131251216,4,307,4,315
80951,backup1,sv1,9,0.9140233875536218,7,334,4,345
80952,backup1,sv1,0,0.9583264209534156,38,307,6,351
80952,backup1,sv1,1,0.9603309439797717,25,263,3,291
80952,backup1,sv1,2,0.9478367641377364,40,308,4,352
80952,backup1,sv1,3,0.9265094668192003,67,224,4,295
80952,backup1,sv1,4,0.9344419517870537,26,282,5,313
80952,backup1,sv1,5,0.9611401636942322,50,288,4,342
80952,backup1,sv1,6,0.947407655260442,49,257,1,307
80952,backup1,sv1,7,0.933224721852534,26,216,7,249
80952,backup1,sv1,8,0.952559002606795,31,292,6,329
80952,backup1,sv1,9,0.9395677558899022,55,281,3,339
80954,backup1,sv1,0,0.9760572590362454,5,329,3,337
80954,backup1,sv1,1,0.9440020917427315,1,302,2,305
80954,backup1,sv1,2,0.9446147962161545,21,318,3,342
80954,backup1,sv1,3,0.9526779768583045,16,279,1,296
80954,backup1,sv1,4,0.9477995295862575,2,310,3,315
80954,backup1,sv1,5,0.9681225985934458,12,321,4,337
80954,backup1,sv1,6,0.9616472394125324,1,304,1,306
80954,backup1,sv1,7,0.9515290905144278,25,224,1,250
80954,backup1,sv1,8,0.9516901289695002,1,328,2,331
80954,backup1,sv1,9,0.9472822954672455,74,253,0,327
80955,backup1,sv1,0,0.9583652623359705,20,332,3,355
80955,backup1,sv1,1,0.9466309085207177,10,289,2,301
80955,backup1,sv1,2,0.9367358394052332,28,318,3,349
80955,backup1,sv1,3,0.9273308995540184,22,277,3,302
80955,backup1,sv1,4,0.9453052534364177,4,306,2,312
80955,backup1,sv1,5,0.9463437271536179,10,331,3,344
80955,backup1,sv1,6,0.9636041004986166,18,287,3,308
80955,backup1,sv1,7,0.9549787422350309,6,241,6,253
80955,backup1,sv1,8,0.9728928360872126,10,316,4,330
80955,backup1,sv1,9,0.9628409150815652,12,328,1,341
80956,backup1,sv1,0,0.950391620146097,1,328,4,333
80956,backup1,sv1,1,0.9533818083080381,1,295,4,300
80956,backup1,sv1,2,0.9286661688479749,1,332,5,338
80956,backup1,sv1,3,0.9266769149580169,5,286,4,295
80956,backup1,sv1,4,0.9769003267155336,7,290,7,304
80956,backup1,sv1,5,0.9836131719275617,12,314,0,326
80956,backup1,sv1,6,0.9150436842260034,2,299,3,304
80956,backup1,sv1,7,0.9184547301274393,3,242,1,246
80956,backup1,sv1,8,0.9404544037643576,1,314,4,319
80956,backup1,sv1,9,0.9623911560836321,2,322,6,330
80958,backup1,sv1,0,0.9343968183038681,146,185,7,338
80958,backup1,sv1,1,0.9488736672354531,119,162,2,283
80958,backup1,sv1,2,0.9555811214949885,146,178,11,335
80958,backup1,sv1,3,0.9379462047780731,134,149,6,289
80958,backup1,sv1,4,0.9646121491829498,148,150,7,305
80958,backup1,sv1,5,0.9743074769533292,170,123,24,317
80958,backup1,sv1,6,0.9263238410269956,174,104,7,285
80958,backup1,sv1,7,0.9374492006855601,116,116,8,240
80958,backup1,sv1,8,0.9425719579335504,114,185,9,308
80958,backup1,sv1,9,0.934531953997752,138,164,20,322
80959,backup1,sv1,0,0.9665738550160314,0,337,7,344
80959,backup1,sv1,1,0.9253066068864949,1,293,4,298
80959,backup1,sv1,2,0.9456283567869017,5,333,3,341
80959,backup1,sv1,3,0.9379225982036449,0,298,3,301
80959,backup1,sv1,4,0.9577372380307839,2,314,2,318
80959,backup1,sv1,5,0.9630376982237822,6,330,3,339
80959,backup1,sv1,6,0.9587827160512419,0,297,5,302
80959,backup1,sv1,7,0.9478983205197119,0,241,6,247
80959,backup1,sv1,8,0.9412858692365508,0,312,3,315
80959,backup1,sv1,9,0.9500029707433514,7,334,4,345
80960,backup1,sv1,0,0.9455890440979131,2,352,0,354
80960,backup1,sv1,1,0.9178186460715231,2,290,4,296
80960,backup1,sv1,2,0.9553619875982174,2,356,2,360
80960,backup1,sv1,3,0.9570987915473619,0,301,2,303
80960,backup1,sv1,4,0.9334094178098417,0,312,3,315
80960,backup1,sv1,5,0.9463738986274692,10,324,4,338
80960,backup1,sv1,6,0.9585436587851308,0,300,2,302
80960,backup1,sv1,7,0.9293785664926698,1,251,2,254
80960,backup1,sv1,8,0.9518984509761139,2,338,4,344
80960,backup1,sv1,9,0.9535614627322867,5,338,4,347
80962,backup1,sv1,0,0.9516897963712811,2,292,6,300
80962,backup1,sv1,1,0.9578626967949876,2,293,2,297
80962,backup1,sv1,2,0.9136648643657806,0,233,4,237
80962,backup1,sv1,3,0.9090090768894167,6,286,3,295
80962,backup1,sv1,4,0.9388662292083918,3,304,2,309
80962,backup1,sv1,5,0.9644928790694964,14,248,5,267
80962,backup1,sv1,6,0.9465597248952928,2,306,2,310
80962,backup1,sv1,7,0.9465597248952928,2,306,2,310
80962,backup1,sv1,8,0.9511221907339278,5,333,2,340
80962,backup1,sv1,9,0.9420527337912377,1,278,2,281
80963,backup1,sv1,0,0.9655769279543273,0,354,2,356
80963,backup1,sv1,1,0.961062919485674,1,297,3,301
80963,backup1,sv1,2,0.9300083451171407,6,343,8,357
80963,backup1,sv1,3,0.9213653535202257,0,294,2,296
80963,backup1,sv1,4,0.9360705172976412,2,312,3,317
80963,backup1,sv1,5,0.9393493494267179,3,330,2,335
80963,backup1,sv1,6,0.9505958395106937,0,303,1,304
80963,backup1,sv1,7,0.9400007732144817,1,247,5,253
80963,backup1,sv1,8,0.9421344830411787,3,307,3,313
80963,backup1,sv1,9,0.9727647590686623,1,339,6,346
80966,backup1,sv1,0,0.9490350945557628,0,296,1,297
80966,backup1,sv1,1,0.9495607897072762,0,292,1,293
80966,backup1,sv1,2,0.934323712579424,0,235,1,236
80966,backup1,sv1,3,0.9381971019395556,6,286,2,294
80966,backup1,sv1,4,0.9250003481805262,1,306,3,310
80966,backup1,sv1,5,0.9432880705045154,0,265,4,269
80966,backup1,sv1,6,0.9208951917854772,0,297,5,302
80966,backup1,sv1,7,0.9208951917854772,0,297,5,302
80966,backup1,sv1,8,0.9613395159083697,2,337,3,342
80966,backup1,sv1,9,0.9613395159083697,2,337,3,342
80968,backup1,sv1,0,0.9548738698691447,1,295,5,301
80968,backup1,sv1,1,0.9612843857282869,1,294,2,297
80968,backup1,sv1,2,0.9458471989938861,2,241,2,245
80968,backup1,sv1,3,0.9568128694427174,30,254,4,288
80968,backup1,sv1,4,0.8911847396069988,4,145,1,150
80968,backup1,sv1,5,0.9250186800310463,13,194,2,209
80968,backup1,sv1,6,0.8649884187554017,0,176,0,176
80968,backup1,sv1,7,0.8649884187554017,0,176,0,176
80968,backup1,sv1,8,0.9372387938862304,0,319,2,321
80968,backup1,sv1,9,0.9434839601675334,1,274,2,277
80970,backup1,sv1,0,0.9460427374926754,5,346,2,353
80970,backup1,sv1,1,0.9474109629611666,4,295,4,303
80970,backup1,sv1,2,0.948939341590684,5,350,3,358
80970,backup1,sv1,3,0.9546915381044979,6,288,3,297
80970,backup1,sv1,4,0.9595964141172082,20,285,7,312
80970,backup1,sv1,5,0.9468330087054817,33,289,4,326
80970,backup1,sv1,6,0.9396866992536816,3,300,2,305
80970,backup1,sv1,7,0.9327018742215856,2,237,3,242
80970,backup1,sv1,8,0.9302888646400395,2,312,4,318
80970,backup1,sv1,9,0.9315821096161917,9,307,5,321
80971,dc3r2,sv1,0,0.9802372949105278,398,22,8,428
80971,dc3r2,sv1,1,0.9555951539706691,343,29,13,385
80971,dc3r2,sv1,2,0.954657416487456,386,24,5,415
80971,dc3r2,sv1,3,0.9583639592147895,335,36,16,387
80971,dc3r2,sv1,4,0.9614736658625993,335,31,26,392
80971,dc3r2,sv1,5,0.9498051073218933,375,22,14,411
80971,dc3r2,sv1,6,0.9603657509195151,311,31,21,363
80971,dc3r2,sv1,7,0.9600581210894781,314,33,15,362
80971,dc3r2,sv1,8,0.9654507289452664,368,32,17,417
80971,dc3r2,sv1,9,0.9647417378784118,383,28,16,427
80972,dc3r2,sv1,0,0.9706788891837708,318,19,8,345
80972,dc3r2,sv1,1,0.9817761829804963,347,30,16,393
80972,dc3r2,sv1,2,0.969151501433533,398,24,5,427
80972,dc3r2,sv1,3,0.9813630923065042,364,17,12,393
80972,dc3r2,sv1,4,0.9444820219928997,367,24,13,404
80972,dc3r2,sv1,5,0.9581368868136318,361,31,18,410
80972,dc3r2,sv1,6,0.9663080005423083,332,24,9,365
80972,dc3r2,sv1,7,0.9315900813409258,335,20,8,363
80972,dc3r2,sv1,8,0.9510435500184389,361,35,20,416
80972,dc3r2,sv1,9,0.968819453664377,374,32,12,418
80974,dc3r2,sv1,0,0.9483102040637811,411,29,1,441
80974,dc3r2,sv1,1,0.9667702065020526,373,19,2,394
80974,dc3r2,sv1,2,0.972741419849155,396,30,0,426
80974,dc3r2,sv1,3,0.9502959854575802,371,27,1,399
80974,dc3r2,sv1,4,0.9620535763216466,382,23,2,407
80974,dc3r2,sv1,5,0.9699103439366714,323,16,2,341
80974,dc3r2,sv1,6,0.9737507200995,343,22,2,367
80974,dc3r2,sv1,7,0.95805741304121,338,30,0,368
80974,dc3r2,sv1,8,0.9590101552295826,392,31,0,423
80974,dc3r2,sv1,9,0.9615999580840395,392,32,1,425
80975,dc3r2,sv1,0,0.9730502306768203,417,21,1,439
80975,dc3r2,sv1,1,0.9663184139447838,380,24,0,404
80975,dc3r2,sv1,2,0.9658208470728495,408,18,0,426
80975,dc3r2,sv1,3,0.960127326583116,383,17,0,400
80975,dc3r2,sv1,4,0.9598424654131491,393,16,0,409
80975,dc3r2,sv1,5,0.9727394344697846,396,20,3,419
80975,dc3r2,sv1,6,0.951908322588025,340,23,1,364
80975,dc3r2,sv1,7,0.9605559898217305,337,21,1,359
80975,dc3r2,sv1,8,0.9796845348505322,392,29,2,423
80975,dc3r2,sv1,9,0.9505417710674651,407,23,1,431
80977,dark,special,0,0.9443112402574738,267,18,84,369
80977,dark,special,1,0.9646012426754309,255,16,82,353
80977,dark,special,2,0.9631451917138363,275,18,85,378
80977,dark,special,3,0.9781995812119466,251,19,92,362
80977,dark,special,4,0.9514396928413345,254,21,87,362
80977,dark,special,5,0.9708292179969676,256,26,87,369
80977,dark,special,6,0.9259445649243726,233,21,75,329
80977,dark,special,7,0.9723698380132941,209,20,79,308
80977,dark,special,8,0.96556521853989,246,17,104,367
80977,dark,special,9,0.9511434821115432,266,17,84,367
80978,bright,special,0,0.9644092034830287,307,85,4,396
80978,bright,special,1,0.9512300216888245,298,71,6,375
80978,bright,special,2,0.9632827415252924,324,64,3,391
80978,bright,special,3,0.9592211732755966,328,50,0,378
80978,bright,special,4,0.9777533664289529,337,48,2,387
80978,bright,special,5,0.9636058265518728,322,70,2,394
80978,bright,special,6,0.948530348639307,291,52,4,347
80978,bright,special,7,0.9677583739156046,272,60,3,335
80978,bright,special,8,0.9605754106968384,349,57,3,409
80978,bright,special,9,0.9679356509670656,328,66,2,396
80979,bright,special,0,0.9729765329605831,345,85,4,434
80979,bright,special,1,0.9732755809223762,315,88,2,405
80979,bright,special,2,0.9688617519738041,327,108,1,436
80979,bright,special,3,0.958486541644389,299,106,2,407
80979,bright,special,4,0.9724193843362612,343,68,2,413
80979,bright,special,5,0.9596023437866121,313,109,4,426
80979,bright,special,6,0.9470103545471377,280,93,1,374
80979,bright,special,7,0.968780588416306,271,96,4,371
80979,bright,special,8,0.9686747641959911,300,128,3,431
80979,bright,special,9,0.9482132987515715,341,90,1,432
81000,dark,sv2,1,0.9535442128013364,190,33,60,283
81000,dark,sv2,2,0.9534645761313363,216,22,77,315
81000,dark,sv2,3,0.9449743142810235,201,28,45,274
81000,dark,sv2,4,0.9352800084270959,196,27,78,301
81000,dark,sv2,5,0.9359295812828393,207,32,81,320
81000,dark,sv2,6,0.9333309549573172,163,22,80,265
81000,dark,sv2,7,0.9429591012891018,146,28,61,235
81000,dark,sv2,8,0.9658272031987057,210,21,82,313
81000,dark,sv2,9,0.9589720041947437,210,27,89,326
81001,dark,sv2,1,0.942975556546473,189,27,77,293
81001,dark,sv2,2,0.9049016428546379,213,37,60,310
81001,dark,sv2,3,0.9421918472386324,192,21,61,274
81001,dark,sv2,4,0.9457890622102908,175,29,88,292
81001,dark,sv2,5,0.9244550768224533,218,18,77,313
81001,dark,sv2,6,0.9303019215334815,174,19,63,256
81001,dark,sv2,7,0.9153353090084225,161,17,57,235
81001,dark,sv2,8,0.952379290899426,220,24,74,318
81001,dark,sv2,9,0.913401091344124,195,29,87,311
81002,dark,sv2,0,0.9166529781767535,91,7,37,135
81002,dark,sv2,1,0.9555211806700925,188,19,77,284
81002,dark,sv2,2,0.941285869236551,212,28,75,315
81002,dark,sv2,3,0.970849855213174,190,28,60,278
81002,dark,sv2,4,0.9550121287998499,178,25,80,283
81002,dark,sv2,5,0.9485491922952602,208,26,80,314
81002,dark,sv2,6,0.9422319147566103,176,18,82,276
81002,dark,sv2,7,0.943372247523329,161,24,60,245
81002,dark,sv2,8,0.9276990156812956,215,21,78,314
81002,dark,sv2,9,0.9556264149001675,208,30,81,319
81003,dark,sv2,1,0.9490875849647558,181,24,75,280
81003,dark,sv2,2,0.9170531891746274,208,23,84,315
81003,dark,sv2,3,0.9551225524862721,183,35,65,283
81003,dark,sv2,4,0.927994469258018,193,27,75,295
81003,dark,sv2,5,0.9239082553370206,200,24,76,300
81003,dark,sv2,6,0.9154498741042366,166,27,72,265
81003,dark,sv2,7,0.9163480112644437,161,24,48,233
81003,dark,sv2,8,0.948365371537905,198,27,85,310
81003,dark,sv2,9,0.967801092395594,214,19,82,315
81004,dark,sv2,0,0.9335697674620772,205,26,91,322
81004,dark,sv2,1,0.9253602923053781,178,37,76,291
81004,dark,sv2,2,0.9241114347453415,214,27,79,320
81004,dark,sv2,3,0.9192926939831731,162,20,85,267
81004,dark,sv2,4,0.951254676888738,174,33,83,290
81004,dark,sv2,5,0.9476721014467383,203,29,79,311
81004,dark,sv2,6,0.9339705997671408,171,25,68,264
81004,dark,sv2,7,0.9429000055534112,148,24,64,236
81004,dark,sv2,8,0.9520885818741528,215,26,64,305
81004,dark,sv2,9,0.9313994112906505,219,24,86,329
81005,dark,sv2,0,0.9540387747290696,217,29,92,338
81005,dark,sv2,1,0.9639644198757517,196,19,78,293
81005,dark,sv2,2,0.959331210772111,213,23,97,333
81005,dark,sv2,3,0.9363543980563755,177,30,80,287
81005,dark,sv2,4,0.951254676888738,183,26,81,290
81005,dark,sv2,5,0.9197571681290732,211,24,78,313
81005,dark,sv2,6,0.9537276147727519,186,20,77,283
81005,dark,sv2,7,0.9305204968784161,149,24,67,240
81005,dark,sv2,8,0.92624878060046,224,25,70,319
81005,dark,sv2,9,0.9743167231188727,211,31,84,326
81006,dark,sv2,0,0.9543386254714477,220,30,84,334
81006,dark,sv2,1,0.9625278522987007,178,27,91,296
81006,dark,sv2,2,0.9399493024389332,236,17,81,334
81006,dark,sv2,3,0.937259512346242,176,26,84,286
81006,dark,sv2,4,0.9151187177810822,212,22,62,296
81006,dark,sv2,5,0.9455057303390003,194,27,87,308
81006,dark,sv2,6,0.9506233374956182,177,27,68,272
81006,dark,sv2,7,0.9294233829964818,137,32,69,238
81006,dark,sv2,8,0.9176902652911606,207,25,68,300
81006,dark,sv2,9,0.9166372141846799,210,33,87,330
81007,dark,sv2,0,0.9629884108748678,244,33,61,338
81007,dark,sv2,1,0.9289371683400416,187,18,82,287
81007,dark,sv2,2,0.968878737512214,224,31,83,338
81007,dark,sv2,3,0.9474057512369395,193,18,71,282
81007,dark,sv2,4,0.9392917336834203,188,20,89,297
81007,dark,sv2,5,0.9393228977367124,202,30,90,322
81007,dark,sv2,6,0.9427434804902567,173,25,72,270
81007,dark,sv2,7,0.9596263464581045,161,29,61,251
81007,dark,sv2,8,0.9817317323589847,216,23,84,323
81007,dark,sv2,9,0.9718375031399733,222,21,78,321
81008,dark,sv2,0,0.9720626215574185,232,17,92,341
81008,dark,sv2,1,0.9362196227285352,194,23,51,268
81008,dark,sv2,2,0.9698142750232136,231,31,65,327
81008,dark,sv2,3,0.9722229073944778,208,19,53,280
81008,dark,sv2,4,0.9442336374274567,200,21,60,281
81008,dark,sv2,5,0.9315540526600238,217,30,68,315
81008,dark,sv2,6,0.9536234345208996,198,18,62,278
81008,dark,sv2,7,0.9555210282359768,151,21,57,229
81008,dark,sv2,8,0.956753870573646,214,27,72,313
81008,dark,sv2,9,0.8979312819899018,212,27,91,330
81009,dark,sv2,0,0.9541780034817139,227,34,63,324
81009,dark,sv2,1,0.9310250490978369,184,33,48,265
81009,dark,sv2,2,0.9624189171187247,215,32,66,313
81009,dark,sv2,3,0.9102110109181835,186,22,53,261
81009,dark,sv2,4,0.9317721302907129,209,19,51,279
81009,dark,sv2,5,0.9488558301989352,220,23,58,301
81009,dark,sv2,6,0.9616965369041954,191,26,51,268
81009,dark,sv2,7,0.9113352703333568,152,21,60,233
81009,dark,sv2,8,0.9640207012810026,197,29,75,301
81009,dark,sv2,9,0.9588299103745794,228,21,52,301
81010,dark,sv2,0,0.9152235994028531,232,22,68,322
81010,dark,sv2,1,0.9613984840186484,189,32,54,275
81010,dark,sv2,2,0.9504374691245551,221,26,75,322
81010,dark,sv2,3,0.944649223420544,204,29,39,272
81010,dark,sv2,4,0.9527169955107181,226,24,52,302
81010,dark,sv2,5,0.951684013352423,225,26,65,316
81010,dark,sv2,6,0.9259357854607516,177,19,51,247
81010,dark,sv2,7,0.9542063964426762,177,21,46,244
81010,dark,sv2,8,0.9251178286218645,223,30,67,320
81010,dark,sv2,9,0.9559998547732874,215,38,51,304
81011,dark,sv2,0,0.953484540974423,248,18,70,336
81011,dark,sv2,1,0.9325203622353377,197,17,53,267
81011,dark,sv2,2,0.9609671129762883,225,24,77,326
81011,dark,sv2,3,0.937984367558233,184,24,58,266
81011,dark,sv2,4,0.9215698297655218,206,25,53,284
81011,dark,sv2,5,0.9547392700361709,207,28,60,295
81011,dark,sv2,6,0.9515884944041666,180,24,57,261
81011,dark,sv2,7,0.9374916297934652,159,28,43,230
81011,dark,sv2,8,0.951609342661605,203,25,78,306
81011,dark,sv2,9,0.9404253023171161,224,21,84,329
81012,dark,sv2,0,0.9473199104977268,203,31,82,316
81012,dark,sv2,1,0.9320372516505057,197,25,52,274
81012,dark,sv2,2,0.9407784225794743,226,31,61,318
81012,dark,sv2,3,0.9465374602679828,200,26,64,290
81012,dark,sv2,4,0.9387367041878006,193,31,49,273
81012,dark,sv2,5,0.9237856429244301,195,29,81,305
81012,dark,sv2,6,0.9465000889557555,176,21,46,243
81012,dark,sv2,7,0.9489668166440731,174,18,32,224
81012,dark,sv2,8,0.9599804385900224,213,20,70,303
81012,dark,sv2,9,0.9523796057945767,204,28,66,298
81013,dark,sv2,0,0.966328166026243,230,22,53,305
81013,dark,sv2,1,0.9604974122111232,197,24,60,281
81013,dark,sv2,2,0.9211259819997242,228,22,45,295
81013,dark,sv2,3,0.9245550591823137,201,27,54,282
81013,dark,sv2,4,0.9207050240935625,211,20,63,294
81013,dark,sv2,5,0.975677543822303,209,27,77,313
81013,dark,sv2,6,0.9596263464581045,189,11,49,249
81013,dark,sv2,7,0.9025090649528018,163,27,52,242
81013,dark,sv2,8,0.9063372995655876,218,27,61,306
81013,dark,sv2,9,0.9655841314314996,216,31,63,310
81014,dark,sv2,0,0.9548366100683222,221,30,76,327
81014,dark,sv2,1,0.9158179153261226,190,26,50,266
81014,dark,sv2,2,0.9531085363995239,235,18,61,314
81014,dark,sv2,3,0.9436899878815362,178,25,62,265
81014,dark,sv2,4,0.9640358081594333,197,27,58,282
81014,dark,sv2,5,0.9756900192536645,198,35,71,304
81014,dark,sv2,6,0.9474510399955489,191,23,71,285
81014,dark,sv2,7,0.9401521573542576,126,21,77,224
81014,dark,sv2,8,0.955319941281154,206,28,81,315
81014,dark,sv2,9,0.9475552847710603,213,28,87,328
81015,dark,sv2,0,0.9591218503383253,218,23,73,314
81015,dark,sv2,1,0.9571042447012479,220,22,50,292
81015,dark,sv2,2,0.9574854496220447,243,26,49,318
81015,dark,sv2,3,0.9641557943992501,202,19,70,291
81015,dark,sv2,4,0.9075792962864215,207,31,46,284
81015,dark,sv2,5,0.9712673672596988,214,28,75,317
81015,dark,sv2,6,0.9466183504303984,160,27,70,257
81015,dark,sv2,7,0.947441402863886,166,18,61,245
81015,dark,sv2,8,0.9398301103364243,206,29,88,323
81015,dark,sv2,9,0.954872722791806,207,25,83,315
81022,dark,sv2,0,0.911787739623855,218,28,37,283
81022,dark,sv2,1,0.9586608112037931,214,27,38,279
81022,dark,sv2,2,0.9492582746009973,209,39,47,295
81022,dark,sv2,3,0.9426905656428779,198,15,57,270
81022,dark,sv2,4,0.9488979857655122,202,20,65,287
81022,dark,sv2,5,0.9387398298552355,208,28,81,317
81022,dark,sv2,6,0.9000669747539709,165,25,63,253
81022,dark,sv2,7,0.9454654717546451,160,16,58,234
81022,dark,sv2,8,0.9576142818250721,226,22,56,304
81022,dark,sv2,9,0.9504407619335358,217,21,54,292
81056,bright,sv2,0,0.9587450968470645,303,37,3,343
81056,bright,sv2,1,0.9524255614418743,274,27,6,307
81056,bright,sv2,2,0.9661384468698166,324,27,4,355
81056,bright,sv2,3,0.9580120115264182,261,21,6,288
81056,bright,sv2,4,0.9618167011274885,278,26,4,308
81056,bright,sv2,5,0.9605165199664711,298,29,6,333
81056,bright,sv2,6,0.9605165199664711,298,29,6,333
81056,bright,sv2,7,0.9051177486289173,216,29,3,248
81056,bright,sv2,8,0.9617773954688082,315,16,2,333
81056,bright,sv2,9,0.9698201848506417,321,29,1,351
81057,bright,sv2,0,0.9462484765118514,280,58,4,342
81057,bright,sv2,1,0.9563454604833864,279,26,3,308
81057,bright,sv2,2,0.9631859543981357,311,35,4,350
81057,bright,sv2,3,0.9408042344439936,272,21,3,296
81057,bright,sv2,4,0.9397587309384096,292,23,0,315
81057,bright,sv2,5,0.9502388494080113,309,13,9,331
81057,bright,sv2,6,0.9502388494080113,309,13,9,331
81057,bright,sv2,7,0.9372271697284913,232,18,1,251
81057,bright,sv2,8,0.949884584626115,312,20,0,332
81057,bright,sv2,9,0.9511405612308034,309,31,3,343
81058,bright,sv2,0,0.9435590049385996,301,33,5,339
81058,bright,sv2,1,0.9239542282299297,284,21,4,309
81058,bright,sv2,2,0.9726591304370767,325,23,3,351
81058,bright,sv2,3,0.9659486298276404,265,25,4,294
81058,bright,sv2,4,0.9435152844121134,289,20,3,312
81058,bright,sv2,5,0.9746901083929831,307,25,1,333
81058,bright,sv2,6,0.9746901083929831,307,25,1,333
81058,bright,sv2,7,0.9406078437748294,227,22,2,251
81058,bright,sv2,8,0.955642530051873,309,24,1,334
81058,bright,sv2,9,0.9497948502999132,315,29,0,344
81059,bright,sv2,0,0.9647173846036826,325,15,3,343
81059,bright,sv2,1,0.9620109159080393,283,22,4,309
81059,bright,sv2,2,0.9293585435510042,326,24,4,354
81059,bright,sv2,3,0.9311888701403929,251,35,3,289
81059,bright,sv2,4,0.9506220325877739,277,35,2,314
81059,bright,sv2,5,0.9516715225835582,293,36,2,331
81059,bright,sv2,6,0.9516715225835582,293,36,2,331
81059,bright,sv2,7,0.9635347748727449,219,30,6,255
81059,bright,sv2,8,0.934302653984205,284,44,4,332
81059,bright,sv2,9,0.9682175381660901,330,17,2,349
81060,bright,sv2,0,0.987146536310688,309,28,4,341
81060,bright,sv2,1,0.9536358689037439,258,43,6,307
81060,bright,sv2,2,0.9375941282748518,280,63,2,345
81060,bright,sv2,3,0.9528323322472755,254,37,7,298
81060,bright,sv2,4,0.9522914369207947,274,32,3,309
81060,bright,sv2,5,0.9622566766139553,266,28,2,296
81060,bright,sv2,6,0.9622566766139553,266,28,2,296
81060,bright,sv2,7,0.9291404967616714,233,19,1,253
81060,bright,sv2,8,0.9543386254714477,298,33,3,334
81060,bright,sv2,9,0.9613757073022843,289,49,6,344
81061,bright,sv2,0,0.9386620466235601,306,29,9,344
81061,bright,sv2,1,0.9347401314011593,286,22,2,310
81061,bright,sv2,2,0.9303478676546008,327,24,2,353
81061,bright,sv2,3,0.9626240271525396,271,24,4,299
81061,bright,sv2,4,0.9274419270451084,286,25,1,312
81061,bright,sv2,5,0.9563867844267047,275,25,2,302
81061,bright,sv2,6,0.9563867844267047,275,25,2,302
81061,bright,sv2,7,0.9672267340535248,232,14,2,248
81061,bright,sv2,8,0.9480685799888201,310,19,1,330
81061,bright,sv2,9,0.9526809970187616,318,31,6,355
81062,bright,sv2,0,0.9522259167383993,330,26,3,359
81062,bright,sv2,1,0.9493137291203377,295,23,1,319
81062,bright,sv2,2,0.9651659331875024,328,19,3,350
81062,bright,sv2,3,0.9517310273499309,276,25,6,307
81062,bright,sv2,4,0.9485538938596869,298,18,3,319
81062,bright,sv2,5,0.9604945488291582,310,27,6,343
81062,bright,sv2,6,0.9604945488291582,310,27,6,343
81062,bright,sv2,7,0.9124337812160217,225,32,2,259
81062,bright,sv2,8,0.9415071957582455,315,31,5,351
81062,bright,sv2,9,0.941441684459438,311,36,1,348
81063,bright,sv2,0,0.9619645875362177,317,36,2,355
81063,bright,sv2,1,0.9362324000097073,289,26,5,320
81063,bright,sv2,2,0.9587490553616096,272,83,2,357
81063,bright,sv2,3,0.9470780655621194,277,17,3,297
81063,bright,sv2,4,0.9682844559069682,300,19,3,322
81063,bright,sv2,5,0.9641137743148376,315,25,2,342
81063,bright,sv2,6,0.9641137743148376,315,25,2,342
81063,bright,sv2,7,0.9264696632940772,227,33,1,261
81063,bright,sv2,8,0.961785778559306,301,39,3,343
81063,bright,sv2,9,0.9365382845361794,337,18,3,358
81064,bright,sv2,0,0.9609212190346061,333,18,4,355
81064,bright,sv2,1,0.9259802115302731,257,48,5,310
81064,bright,sv2,2,0.9772072617324901,242,102,5,349
81064,bright,sv2,3,0.9363849922245248,268,13,4,285
81064,bright,sv2,4,0.9590564542128117,280,24,10,314
81064,bright,sv2,5,0.9567014662694654,257,79,5,341
81064,bright,sv2,6,0.9567014662694654,257,79,5,341
81064,bright,sv2,7,0.9365659163165374,234,20,5,259
81064,bright,sv2,8,0.9528229421212605,293,42,7,342
81064,bright,sv2,9,0.9520113889174892,320,26,5,351
81065,bright,sv2,0,0.9554941900126275,264,83,5,352
81065,bright,sv2,1,0.9466309085207177,216,84,1,301
81065,bright,sv2,2,0.9413600476649003,235,107,9,351
81065,bright,sv2,3,0.9517077490247956,240,34,6,280
81065,bright,sv2,4,0.9778228313859118,275,30,6,311
81065,bright,sv2,5,0.9515079027556499,292,38,1,331
81065,bright,sv2,6,0.9515079027556499,292,38,1,331
81065,bright,sv2,7,0.9452463129240506,213,45,3,261
81065,bright,sv2,8,0.9330646653600526,256,84,2,342
81065,bright,sv2,9,0.9492837616957256,266,83,7,356
81066,bright,sv2,0,0.9574514104251047,279,69,5,353
81066,bright,sv2,1,0.9487182213973345,269,38,1,308
81066,bright,sv2,2,0.9354346656918132,318,22,2,342
81066,bright,sv2,3,0.9681329078382658,241,16,6,263
81066,bright,sv2,4,0.9681820218685908,294,24,0,318
81066,bright,sv2,5,0.9817613494068104,322,18,3,343
81066,bright,sv2,6,0.9817613494068104,322,18,3,343
81066,bright,sv2,7,0.9474546762546633,227,30,2,259
81066,bright,sv2,8,0.938576869803954,281,57,5,343
81066,bright,sv2,9,0.9542848265801446,281,66,3,350
81067,bright,sv2,0,0.9711523386395988,294,55,5,354
81067,bright,sv2,1,0.952379290899426,264,47,5,316
81067,bright,sv2,2,0.9394164171732001,273,80,4,357
81067,bright,sv2,3,0.9142634394880224,236,54,1,291
81067,bright,sv2,4,0.9564709993054367,235,71,6,312
81067,bright,sv2,5,0.9259983079544809,238,90,6,334
81067,bright,sv2,6,0.9259983079544809,238,90,6,334
81067,bright,sv2,7,0.9669645276144706,200,52,5,257
81067,bright,sv2,8,0.9651904473812449,321,23,1,345
81067,bright,sv2,9,0.9759815284960528,316,30,4,350
81068,bright,sv2,0,0.8459359922224301,115,30,0,145
81068,bright,sv2,1,0.9235935037648041,220,86,4,310
81068,bright,sv2,2,0.9473391939783318,256,88,4,348
81068,bright,sv2,3,0.9319517528567733,267,32,2,301
81068,bright,sv2,4,0.9493442105877303,270,41,2,313
81068,bright,sv2,5,0.9612671685069645,283,52,3,338
81068,bright,sv2,6,0.9746745721541502,203,92,0,295
81068,bright,sv2,7,0.9454347674522128,179,71,5,255
81068,bright,sv2,8,0.9780170053196475,294,42,2,338
81068,bright,sv2,9,0.9406246183727681,305,49,2,356
81069,bright,sv2,0,0.9463132299327158,255,75,6,336
81069,bright,sv2,1,0.9498357317209767,244,47,4,295
81069,bright,sv2,2,0.9639603756073577,263,45,8,316
81069,bright,sv2,3,0.9025588160137066,216,62,2,280
81069,bright,sv2,4,0.9517981673721246,242,62,3,307
81069,bright,sv2,5,0.9494140866057639,250,49,7,306
81069,bright,sv2,6,0.915591189307312,223,55,3,281
81069,bright,sv2,7,0.9322372121987116,194,41,6,241
81069,bright,sv2,8,0.9587101439990846,277,41,4,322
81069,bright,sv2,9,0.9506311261934345,285,45,5,335
81072,bright,sv2,0,0.9417999342326308,214,137,8,359
81072,bright,sv2,1,0.9381813404282577,245,69,2,316
81072,bright,sv2,2,0.9622956433061299,299,50,3,352
81072,bright,sv2,3,0.9617561093403388,228,69,1,298
81072,bright,sv2,4,0.9503132418704376,209,108,2,319
81072,bright,sv2,5,0.9422197293689872,209,127,4,340
81072,bright,sv2,6,0.9634471218778577,196,118,2,316
81072,bright,sv2,7,0.9578723636464821,167,85,3,255
81072,bright,sv2,8,0.9496874814572729,251,90,3,344
81072,bright,sv2,9,0.9290507207367469,255,95,2,352
81073,bright,sv2,0,0.9772007861229777,210,146,3,359
81073,bright,sv2,1,0.9473981342709777,213,97,5,315
81073,bright,sv2,2,0.9699576702237376,272,86,1,359
81073,bright,sv2,3,0.9514715921016237,257,44,2,303
81073,bright,sv2,4,0.9253577868733868,296,25,3,324
81073,bright,sv2,5,0.9584258517361517,315,25,2,342
81073,bright,sv2,6,0.9590864492320306,264,41,2,307
81073,bright,sv2,7,0.9005903708993594,221,28,5,254
81073,bright,sv2,8,0.9582935706136502,277,61,4,342
81073,bright,sv2,9,0.9472065328883216,257,97,1,355
81074,bright,sv2,0,0.9698654917745477,285,67,2,354
81074,bright,sv2,1,0.9225473838142076,260,46,2,308
81074,bright,sv2,2,0.9408896662067416,307,50,0,357
81074,bright,sv2,3,0.9540947959770426,274,22,1,297
81074,bright,sv2,4,0.939083632282372,289,26,3,318
81074,bright,sv2,5,0.9598673044609597,315,22,5,342
81074,bright,sv2,6,0.9778640342013071,248,52,3,303
81074,bright,sv2,7,0.9374821707386519,227,29,3,259
81074,bright,sv2,8,0.9552922543475673,284,53,2,339
81074,bright,sv2,9,0.9620618543449445,284,59,2,345
81075,bright,sv2,0,0.9605291876274891,189,145,3,337
81075,bright,sv2,1,0.9318525901265581,174,105,7,286
81075,bright,sv2,2,0.9476536954564417,221,111,3,335
81075,bright,sv2,3,0.9226109844385418,187,107,1,295
81075,bright,sv2,4,0.9435023371521227,203,85,4,292
81075,bright,sv2,5,0.9477883901255986,232,83,1,316
81075,bright,sv2,6,0.9637696668027775,207,81,3,291
81075,bright,sv2,7,0.8981564538263425,147,95,1,243
81075,bright,sv2,8,0.9598642672553721,208,116,4,328
81075,bright,sv2,9,0.9545206917235832,219,105,3,327
81088,backup,sv2,0,0.9378638363318863,6,319,2,327
81088,backup,sv2,1,0.9278512721069225,5,280,0,285
81088,backup,sv2,2,0.9538146200950596,13,301,2,316
81088,backup,sv2,3,0.965190688162628,3,282,1,286
81088,backup,sv2,4,0.9501142584504089,4,279,2,285
81088,backup,sv2,5,0.9449848356415257,13,314,1,328
81088,backup,sv2,6,0.9342190169356741,9,256,0,265
81088,backup,sv2,7,0.8778555996910239,7,217,1,225
81088,backup,sv2,8,0.9613863831415129,4,305,4,313
81088,backup,sv2,9,0.929480072689052,13,291,1,305
81097,dark,sv2,0,0.9267435546377149,215,10,53,278
81097,dark,sv2,1,0.9753516216437855,224,11,50,285
81097,dark,sv2,2,0.9187249479550208,218,10,64,292
81097,dark,sv2,3,0.9488072042716603,224,11,53,288
81097,dark,sv2,4,0.9541342398236123,234,10,50,294
81097,dark,sv2,5,0.9407000546900889,256,10,43,309
81097,dark,sv2,6,0.951624044807942,194,12,58,264
81097,dark,sv2,7,0.9055298489816918,205,9,55,269
81097,dark,sv2,8,0.9383539581512594,227,10,50,287
81097,dark,sv2,9,0.9216251895127947,220,10,62,292
81098,dark,sv2,0,0.925210432032656,219,9,68,296
81098,dark,sv2,1,0.937798132323746,225,10,56,291
81098,dark,sv2,2,0.9298945846957227,220,10,67,297
81098,dark,sv2,3,0.9556891797855489,222,11,60,293
81098,dark,sv2,4,0.9391453468617743,221,11,57,289
81098,dark,sv2,5,0.9213890478222692,235,10,41,286
81098,dark,sv2,6,0.9557300361263115,189,10,58,257
81098,dark,sv2,7,0.8837877501644673,187,10,61,258
81098,dark,sv2,8,0.9268630883717676,174,8,54,236
81098,dark,sv2,9,0.9531648028073426,201,9,64,274
81099,dark,sv2,0,0.9304350623942239,241,10,71,322
81099,dark,sv2,1,0.9354304000060281,250,10,61,321
81099,dark,sv2,2,0.9637692221382876,238,10,73,321
81099,dark,sv2,3,0.9275346684601568,244,12,58,314
81099,dark,sv2,4,0.9318601859688657,237,11,60,308
81099,dark,sv2,5,0.9457923235975808,254,9,47,310
81099,dark,sv2,6,0.9372033391036121,203,10,65,278
81099,dark,sv2,7,0.9285540742069465,215,9,61,285
81099,dark,sv2,8,0.9115301561039616,225,10,67,302
81099,dark,sv2,9,0.9705244563693348,228,11,64,303
81100,dark,special,0,0.9564721456554378,187,10,67,264
81100,dark,special,1,0.944639126461968,164,14,68,246
81100,dark,special,2,0.9568471593742621,169,10,77,256
81100,dark,special,3,0.9218765473186051,157,10,65,232
81100,dark,special,4,0.9409649107855199,177,10,62,249
81100,dark,special,5,0.9476664439760364,169,10,72,251
81100,dark,special,6,0.8989333827898367,166,10,53,229
81100,dark,special,7,0.9234963020255527,189,10,44,243
81100,dark,special,8,0.9641577854133102,186,11,69,266
81100,dark,special,9,0.9661378048478794,189,10,67,266
81101,dark,special,0,0.8589108185985069,112,10,37,159
81101,dark,special,1,0.9224344476699213,97,12,44,153
81101,dark,special,2,0.9052224248048212,96,10,55,161
81101,dark,special,3,0.8972954964122095,93,10,49,152
81101,dark,special,4,0.8744943843803558,96,9,43,148
81101,dark,special,5,0.8925574860211221,102,9,52,163
81101,dark,special,6,0.8429072921663139,91,10,27,128
81101,dark,special,7,0.9020138228166481,118,9,29,156
81101,dark,special,8,0.8859547415578889,132,9,42,183
81101,dark,special,9,0.8942942052525669,105,10,42,157
81102,dark,special,0,0.9310835638242979,159,10,53,222
81102,dark,special,1,0.9347298915824426,133,11,53,197
81102,dark,special,2,0.9034418295914212,134,10,67,211
81102,dark,special,3,0.9335273076534175,129,10,60,199
81102,dark,special,4,0.9026049648976735,136,10,57,203
81102,dark,special,5,0.8585798081120055,138,10,63,211
81102,dark,special,6,0.8765359348233673,129,10,42,181
81102,dark,special,7,0.9013855975906286,145,9,37,191
81102,dark,special,8,0.9616053298754613,160,10,56,226
81102,dark,special,9,0.9216798922685846,144,10,54,208
81103,dark,special,0,0.920639427125965,109,9,39,157
81103,dark,special,1,0.8703899918609032,104,11,44,159
81103,dark,special,2,0.922363864577275,87,10,48,145
81103,dark,special,3,0.8729118468932603,78,10,41,129
81103,dark,special,4,0.8969381605121686,92,10,36,138
81103,dark,special,5,0.8747227340763795,98,9,52,159
81103,dark,special,6,0.8782229502541663,86,10,32,128
81103,dark,special,7,0.851836642418615,99,9,24,132
81103,dark,special,8,0.8499967340652747,113,9,47,169
81103,dark,special,9,0.9014406362994871,107,10,42,159
81104,dark,special,0,0.9179756802537933,147,10,50,207
81104,dark,special,1,0.9350756868152699,149,11,55,215
81104,dark,special,2,0.9319381692886979,126,10,67,203
81104,dark,special,3,0.9076002321572589,119,10,58,187
81104,dark,special,4,0.8811651367963824,131,10,50,191
81104,dark,special,5,0.9372271873998943,136,9,63,208
81104,dark,special,6,0.9161912606389185,132,10,40,182
81104,dark,special,7,0.923622543652395,149,10,32,191
81104,dark,special,8,0.933263313090441,156,8,53,217
81104,dark,special,9,0.9555210282359771,163,10,57,230
81105,dark,special,0,0.9457802968895231,149,10,49,208
81105,dark,special,1,0.9328672134313369,132,11,52,195
81105,dark,special,2,0.8760249197292017,126,10,60,196
81105,dark,special,3,0.8935587016771448,113,10,54,177
81105,dark,special,4,0.923812544410729,126,10,50,186
81105,dark,special,5,0.9237763662998567,139,9,61,209
81105,dark,special,6,0.897567108035849,114,10,43,167
81105,dark,special,7,0.9170527663937393,131,10,35,176
81105,dark,special,8,0.8959933077150494,164,11,54,229
81105,dark,special,9,0.9217676570800627,160,10,53,223
81106,dark,special,0,0.9087032073873808,150,10,46,206
81106,dark,special,1,0.9132584194963624,130,12,50,192
81106,dark,special,2,0.9107192784716793,123,10,63,196
81106,dark,special,3,0.909480631076027,132,10,59,201
81106,dark,special,4,0.9369208084812164,147,10,45,202
81106,dark,special,5,0.9098752230603913,117,10,65,192
81106,dark,special,6,0.9423028812720106,126,10,38,174
81106,dark,special,7,0.9098752230603913,146,10,38,194
81106,dark,special,8,0.9336031419423898,162,9,53,224
81106,dark,special,9,0.9438221915873767,171,10,52,233
81107,dark,special,0,0.8937465047352433,143,9,47,199
81107,dark,special,1,0.9214365405086206,128,12,46,186
81107,dark,special,2,0.8835295424797039,123,10,61,194
81107,dark,special,3,0.8764908198977597,105,10,55,170
81107,dark,special,4,0.9006005361820566,123,10,50,183
81107,dark,special,5,0.8407473138846022,120,10,63,193
81107,dark,special,6,0.9087335489908053,126,10,36,172
81107,dark,special,7,0.9099762360593674,144,10,33,187
81107,dark,special,8,0.9035773375789358,154,10,50,214
81107,dark,special,9,0.9271151540623183,145,10,53,208
81108,dark,special,0,0.8030340056705566,50,10,21,81
81108,dark,special,1,0.8461713709310321,68,10,16,94
81108,dark,special,2,0.8335789211550196,53,9,24,86
81108,dark,special,3,0.8956677696750099,62,9,20,91
81108,dark,special,4,0.8541240950110993,60,8,20,88
81108,dark,special,5,0.8678583282870784,68,8,32,108
81108,dark,special,6,0.788309488969269,58,7,13,78
81108,dark,special,7,0.7375372181947581,48,11,13,72
81108,dark,special,8,0.8553915643266168,97,9,25,131
81108,dark,special,9,0.7549287785159828,57,8,12,77
81109,dark,special,0,0.7357873181611775,47,9,11,67
81109,dark,special,1,0.7278522650072234,53,9,11,73
81109,dark,special,2,0.7064182653823653,36,8,14,58
81109,dark,special,3,0.8367771094104983,50,10,19,79
81109,dark,special,4,0.753891610146709,41,9,17,67
81109,dark,special,5,0.7743445467630247,66,9,19,94
81109,dark,special,6,0.6411893264130305,58,4,13,75
81109,dark,special,7,0.7357873181611775,45,10,11,66
81109,dark,special,8,0.7590211903892508,79,8,11,98
81109,dark,special,9,0.7992426936150696,39,8,14,61
81110,dark,special,0,0.7817258525485088,67,7,12,86
81110,dark,special,1,0.8461713709310321,64,8,21,93
81110,dark,special,2,0.8178910949457434,47,9,13,69
81110,dark,special,3,0.7888558751325303,49,9,15,73
81110,dark,special,4,0.7278522650072236,41,10,22,73
81110,dark,special,5,0.822701430661844,66,10,26,102
81110,dark,special,6,0.7941722096708003,72,9,14,95
81110,dark,special,7,0.8426383397888147,66,16,25,107
81110,dark,special,8,0.8612631706673587,91,11,20,122
81110,dark,special,9,0.7395492289290592,62,13,18,93
81111,dark,special,0,0.8845222444923008,107,11,51,169
81111,dark,special,1,0.8899559185802374,101,10,41,152
81111,dark,special,2,0.8721232826330051,105,9,28,142
81111,dark,special,3,0.8898159430571506,107,10,45,162
81111,dark,special,4,0.9154185498276135,93,11,46,150
81111,dark,special,5,0.9121856140300256,105,12,45,162
81111,dark,special,6,0.8439712965390139,81,12,33,126
81111,dark,special,7,0.8348667226553849,78,9,34,121
81111,dark,special,8,0.8748608997994528,121,11,53,185
81111,dark,special,9,0.9063319580433797,118,12,40,170
81112,dark,special,0,0.9168926506914589,113,51,45,209
81112,dark,special,1,0.9056334948019144,139,28,47,214
81112,dark,special,2,0.9107192784716795,130,32,37,199
81112,dark,special,3,0.8986552641951168,153,34,39,226
81112,dark,special,4,0.9106586724758884,127,25,49,201
81112,dark,special,5,0.9174084896575306,147,23,54,224
81112,dark,special,6,0.9427155684171737,117,22,45,184
81112,dark,special,7,0.9062430671705579,140,32,38,210
81112,dark,special,8,0.9484303594634914,173,23,42,238
81112,dark,special,9,0.8839963430219611,145,34,50,229
81113,dark,special,0,0.8846355815167347,72,10,29,111
81113,dark,special,1,0.8349191505462481,91,10,26,127
81113,dark,special,2,0.8410529633803655,73,10,31,114
81113,dark,special,3,0.8965345393086859,82,9,27,118
81113,dark,special,4,0.8868358114592939,74,9,33,116
81113,dark,special,5,0.8729118468932603,81,10,38,129
81113,dark,special,6,0.7726303649819145,64,9,28,101
81113,dark,special,7,0.8225666030786352,84,10,26,120
81113,dark,special,8,0.8818082358205397,107,8,25,140
81113,dark,special,9,0.8648520253672494,90,9,38,137
81114,dark,special,0,0.8781664973918302,110,10,32,152
81114,dark,special,1,0.9385149620430834,115,9,40,164
81114,dark,special,2,0.8440643927581003,94,12,33,139
81114,dark,special,3,0.8511912010344257,103,12,42,157
81114,dark,special,4,0.9124485449499777,94,12,42,148
81114,dark,special,5,0.8656813505104503,126,9,38,173
81114,dark,special,6,0.8555336217089444,88,12,36,136
81114,dark,special,7,0.8544511418047948,97,9,35,141
81114,dark,special,8,0.8965693813841122,129,8,31,168
81114,dark,special,9,0.8849745573797555,98,11,36,145
81115,dark,special,0,0.8893672405355856,96,13,44,153
81115,dark,special,1,0.83590543519305,112,12,21,145
81115,dark,special,2,0.9379703959878694,108,10,39,157
81115,dark,special,3,0.8752909138733286,109,17,43,169
81115,dark,special,4,0.8708269195598579,107,15,30,152
81115,dark,special,5,0.8668877826572983,95,22,45,162
81115,dark,special,6,0.8637628453387315,102,14,20,136
81115,dark,special,7,0.907875094833642,91,20,37,148
81115,dark,special,8,0.8632435608139829,118,13,28,159
81115,dark,special,9,0.9077398611797994,137,10,21,168
