TILEID,PROGRAM,SURVEY,PETALID,H,N_GAL,N_STAR,N_QSO,N_GOOD_Z
80615,m33,cmx,0,0.9945504489347821,228,72,44,344
80615,m33,cmx,1,0.9722759661206098,177,97,13,287
80615,m33,cmx,2,0.9929642363621428,213,69,25,307
80615,m33,cmx,3,0.9907411022689037,182,73,34,289
80615,m33,cmx,4,0.9885610433688552,240,46,37,323
80615,m33,cmx,5,0.9812934471107857,226,60,38,324
80615,m33,cmx,6,0.9859758432134185,246,56,48,350
80615,m33,cmx,7,0.9909033434947169,212,46,32,290
80615,m33,cmx,8,0.972904883097142,249,43,35,327
80615,m33,cmx,9,0.9857187553937277,250,54,40,344
80609,lrgqso,sv1,0,0.9933169705756639,293,26,39,358
80609,lrgqso,sv1,1,0.9848827482793745,268,28,35,331
80609,lrgqso,sv1,2,0.9948151511100705,290,32,36,358
80609,lrgqso,sv1,3,0.9904452697317686,239,22,35,296
80609,lrgqso,sv1,4,0.9952314721211959,263,25,41,329
80609,lrgqso,sv1,5,0.9894969484681244,280,19,47,346
80609,lrgqso,sv1,6,0.9920593061634685,299,17,44,360
80609,lrgqso,sv1,7,0.9925867444984217,243,26,33,302
80609,lrgqso,sv1,8,0.9861324182967842,292,24,37,353
80609,lrgqso,sv1,9,0.9883160566990856,291,29,32,352
80606,elg,sv1,0,0.9841863659355,304,10,11,325
80606,elg,sv1,1,0.9880404240186609,263,9,11,283
80606,elg,sv1,2,0.9848389037994288,295,10,9,314
80606,elg,sv1,3,0.9778023454543592,263,13,6,282
80606,elg,sv1,4,0.9904491759165776,289,17,8,314
80606,elg,sv1,5,0.9880799093991658,286,14,9,309
80606,elg,sv1,6,0.9834431789784003,295,20,11,326
80606,elg,sv1,7,0.9911295025494046,246,11,9,266
80606,elg,sv1,8,0.9809096350529617,292,10,13,315
80606,elg,sv1,9,0.9905689475215392,291,8,13,312
80607,lrgqso,sv1,0,0.9899156580032976,267,51,44,362
80607,lrgqso,sv1,1,0.9818819464245838,237,62,29,328
80607,lrgqso,sv1,2,0.9856879478981646,264,51,37,352
80607,lrgqso,sv1,3,0.9767127353711278,234,33,33,300
80607,lrgqso,sv1,4,0.9875659449754907,267,40,30,337
80607,lrgqso,sv1,5,0.9895001756271997,254,37,51,342
80607,lrgqso,sv1,6,0.9883724072893537,283,51,37,371
80607,lrgqso,sv1,7,0.9865974454931569,244,28,36,308
80607,lrgqso,sv1,8,0.9916459395180336,275,35,42,352
80607,lrgqso,sv1,9,0.9951136874613861,282,35,37,354
80622,lrgqso,sv1,0,0.992134406516027,299,21,41,361
80622,lrgqso,sv1,1,0.9935951423080499,264,22,42,328
80622,lrgqso,sv1,2,0.9961419659243783,303,17,38,358
80622,lrgqso,sv1,3,0.9907029226149466,241,9,32,282
80622,lrgqso,sv1,4,0.9968476440737675,263,21,41,325
80622,lrgqso,sv1,5,0.9895969128700897,283,11,41,335
80622,lrgqso,sv1,6,0.9908886357908686,294,14,51,359
80622,lrgqso,sv1,7,0.9920710304967727,240,18,35,293
80622,lrgqso,sv1,8,0.9903642463008765,263,28,56,347
80622,lrgqso,sv1,9,0.9891572566924537,299,21,25,345
80620,lrgqso,sv1,0,0.9926657474388977,307,13,41,361
80620,lrgqso,sv1,1,0.9945886007255926,274,16,39,329
80620,lrgqso,sv1,2,0.9942227224076996,301,18,31,350
80620,lrgqso,sv1,3,0.9864513323994722,255,13,33,301
80620,lrgqso,sv1,4,0.9959187961273553,291,11,37,339
80620,lrgqso,sv1,5,0.9962018479290196,256,22,44,322
80620,lrgqso,sv1,6,0.9955269867457426,296,14,44,354
80620,lrgqso,sv1,7,0.9817525517362534,245,22,37,304
80620,lrgqso,sv1,8,0.9920814445424687,280,21,44,345
80620,lrgqso,sv1,9,0.9954798412359365,291,18,43,352
80623,elg,sv1,0,0.9814689282563108,289,18,10,317
80623,elg,sv1,1,0.9835812434519576,258,12,8,278
80623,elg,sv1,2,0.9948014436493646,289,14,9,312
80623,elg,sv1,3,0.9850978121607684,218,10,4,232
80623,elg,sv1,4,0.9933483786743688,266,12,6,284
80623,elg,sv1,5,0.995344311317951,269,11,12,292
80623,elg,sv1,6,0.9865794446480071,284,15,9,308
80623,elg,sv1,7,0.9884307382750762,241,5,9,255
80623,elg,sv1,8,0.9876042251970855,274,13,13,300
80623,elg,sv1,9,0.9843464120391716,277,11,11,299
80611,bgsmws,sv1,0,0.9915641567683093,301,79,3,383
80611,bgsmws,sv1,1,0.991961519780818,249,84,4,337
80611,bgsmws,sv1,2,0.9892703372808921,289,74,3,366
80611,bgsmws,sv1,3,0.9903277555914576,227,75,2,304
80611,bgsmws,sv1,4,0.9933141359410356,244,106,5,355
80611,bgsmws,sv1,5,0.9954056677455378,229,120,5,354
80611,bgsmws,sv1,6,0.990845622549259,270,107,2,379
80611,bgsmws,sv1,7,0.9886607196717925,219,88,1,308
80611,bgsmws,sv1,8,0.9877194418879905,285,78,2,365
80611,bgsmws,sv1,9,0.9914172243402198,272,91,1,364
80616,bgsmws,sv1,0,0.9942654290857482,312,63,2,377
80616,bgsmws,sv1,1,0.9889360784224739,273,52,4,329
80616,bgsmws,sv1,2,0.9929891928662747,286,61,2,349
80616,bgsmws,sv1,3,0.9775401035278708,240,56,3,299
80616,bgsmws,sv1,4,0.9959141909386604,255,88,3,346
80616,bgsmws,sv1,5,0.9924202114804052,243,89,4,336
80616,bgsmws,sv1,6,0.9927049192002795,288,85,0,373
80616,bgsmws,sv1,7,0.9910392066188094,207,95,1,303
80616,bgsmws,sv1,8,0.9928187875815995,220,138,3,361
80616,bgsmws,sv1,9,0.9880773435003111,255,111,1,367
80617,bgsmws,sv1,0,0.9901074641484137,250,127,6,383
80617,bgsmws,sv1,1,0.9901375466507527,258,83,2,343
80617,bgsmws,sv1,2,0.9911122783556078,241,124,3,368
80617,bgsmws,sv1,3,0.9919046620363394,222,84,1,307
80617,bgsmws,sv1,4,0.989981043541473,241,105,4,350
80617,bgsmws,sv1,5,0.985891381154234,297,55,1,353
80617,bgsmws,sv1,6,0.9920144707805196,263,107,2,372
80617,bgsmws,sv1,7,0.9940846801004796,198,109,2,309
80617,bgsmws,sv1,8,0.9891239772734962,268,95,5,368
80617,bgsmws,sv1,9,0.9908384750160654,269,109,1,379
80608,elg,sv1,0,0.9872974801299225,297,20,12,329
80608,elg,sv1,1,0.9836919776865781,269,19,11,299
80608,elg,sv1,2,0.9874720329573423,288,17,6,311
80608,elg,sv1,3,0.9902114195802414,246,13,13,272
80608,elg,sv1,4,0.9941340551728889,291,16,8,315
80608,elg,sv1,5,0.9870347330124524,295,7,9,311
80608,elg,sv1,6,0.9885225532604629,292,21,13,326
80608,elg,sv1,7,0.9904454433480332,259,10,7,276
80608,elg,sv1,8,0.9873478830564567,291,10,15,316
80608,elg,sv1,9,0.9903333194648746,301,17,11,329
80621,elg,sv1,0,0.9947047740262032,299,9,9,317
80621,elg,sv1,1,0.9864524375297059,261,3,12,276
80621,elg,sv1,2,0.9962468412301574,301,8,10,319
80621,elg,sv1,3,0.9910105362324737,234,5,4,243
80621,elg,sv1,4,0.9878383159562645,251,5,5,261
80621,elg,sv1,5,0.9941692720663462,254,9,8,271
80621,elg,sv1,6,0.9866786585498061,290,5,9,304
80621,elg,sv1,7,0.989977522075858,253,6,3,262
80621,elg,sv1,8,0.9962435541971969,287,9,12,308
80621,elg,sv1,9,0.9916953642866201,289,9,8,306
80612,bgsmws,sv1,0,0.9922407512749981,293,80,5,378
80612,bgsmws,sv1,1,0.9909925490674586,226,112,2,340
80612,bgsmws,sv1,2,0.9915197329266096,271,96,6,373
80612,bgsmws,sv1,3,0.9882784968155786,240,61,2,303
80612,bgsmws,sv1,4,0.986028990432019,258,87,3,348
80612,bgsmws,sv1,5,0.993876814601582,267,89,3,359
80612,bgsmws,sv1,6,0.9923996540598876,297,82,4,383
80612,bgsmws,sv1,7,0.9942700962082228,253,51,4,308
80612,bgsmws,sv1,8,0.9931254775719042,288,77,2,367
80612,bgsmws,sv1,9,0.9934215340580144,258,100,5,363
80638,bgsmws,sv1,0,0.9933687425110227,277,96,3,376
80638,bgsmws,sv1,1,0.9923695777887513,263,73,2,338
80638,bgsmws,sv1,2,0.9928340919295411,311,65,1,377
80638,bgsmws,sv1,3,0.9928340919295411,311,65,1,377
80638,bgsmws,sv1,4,0.9908371583867458,235,101,4,340
80638,bgsmws,sv1,5,0.984763177645695,222,102,4,328
80638,bgsmws,sv1,6,0.9904874827827468,269,96,3,368
80638,bgsmws,sv1,7,0.9927013398965469,248,58,4,310
80638,bgsmws,sv1,8,0.9892421895165487,268,91,5,364
80638,bgsmws,sv1,9,0.9921780667599136,287,63,4,354
80629,bgsmws,sv1,0,0.9912657448613958,294,67,4,365
80629,bgsmws,sv1,1,0.9908300334396839,274,68,3,345
80629,bgsmws,sv1,2,0.9883562290998137,255,88,5,348
80629,bgsmws,sv1,3,0.9883562290998137,255,88,5,348
80629,bgsmws,sv1,4,0.9917538722396273,252,84,3,339
80629,bgsmws,sv1,5,0.9910880680874655,273,74,5,352
80629,bgsmws,sv1,6,0.9939301579330766,338,37,3,378
80629,bgsmws,sv1,7,0.9901065599229076,255,53,3,311
80629,bgsmws,sv1,8,0.9899563232605828,280,78,5,363
80629,bgsmws,sv1,9,0.9824670518561105,272,89,2,363
80635,bgsmws,sv1,0,0.9929417490864919,286,77,1,364
80635,bgsmws,sv1,1,0.9828282003976658,205,63,1,269
80635,bgsmws,sv1,2,0.9919036695563596,234,88,3,325
80635,bgsmws,sv1,3,0.9919036695563596,234,88,3,325
80635,bgsmws,sv1,4,0.9759976312727172,242,68,5,315
80635,bgsmws,sv1,5,0.994695174601292,252,64,2,318
80635,bgsmws,sv1,6,0.9923553994411614,249,80,0,329
80635,bgsmws,sv1,7,0.9763886976092486,215,64,4,283
80635,bgsmws,sv1,8,0.9907716950618121,235,79,3,317
80635,bgsmws,sv1,9,0.9930300737099483,243,88,1,332
80642,bgsmws,sv1,0,0.9932590399476879,215,156,2,373
80642,bgsmws,sv1,1,0.9921071819842697,185,148,4,337
80642,bgsmws,sv1,2,0.9958095837323729,187,169,3,359
80642,bgsmws,sv1,3,0.9958095837323729,187,169,3,359
80642,bgsmws,sv1,4,0.9910102693155053,205,131,5,341
80642,bgsmws,sv1,5,0.9880926918619853,231,114,6,351
80642,bgsmws,sv1,6,0.9918349671950397,244,124,4,372
80642,bgsmws,sv1,7,0.9873708896709822,231,70,2,303
80642,bgsmws,sv1,8,0.9945347915820397,224,123,1,348
80642,bgsmws,sv1,9,0.992387576363181,210,145,5,360
80640,bgsmws,sv1,0,0.9888747172319376,270,99,5,374
80640,bgsmws,sv1,1,0.992194035452847,261,70,2,333
80640,bgsmws,sv1,2,0.9922332641354404,265,96,6,367
80640,bgsmws,sv1,3,0.9922332641354404,265,96,6,367
80640,bgsmws,sv1,4,0.9920124220168333,187,155,1,343
80640,bgsmws,sv1,5,0.9906574277242468,235,117,3,355
80640,bgsmws,sv1,6,0.9879865225088288,276,92,6,374
80640,bgsmws,sv1,7,0.9917934683873361,214,100,1,315
80640,bgsmws,sv1,8,0.9891547852966239,233,129,3,365
80640,bgsmws,sv1,9,0.990823911637721,286,80,4,370
80633,bgsmws,sv1,0,0.9950481316143575,268,88,4,360
80633,bgsmws,sv1,1,0.9920901022686277,262,62,3,327
80633,bgsmws,sv1,2,0.9839910773653685,298,65,9,372
80633,bgsmws,sv1,3,0.9839910773653685,298,65,9,372
80633,bgsmws,sv1,4,0.9869916985184792,267,62,5,334
80633,bgsmws,sv1,5,0.991508836728616,256,77,2,335
80633,bgsmws,sv1,6,0.9878092605099241,264,89,3,356
80633,bgsmws,sv1,7,0.9910665371520397,239,69,4,312
80633,bgsmws,sv1,8,0.9921049186949825,266,85,7,358
80633,bgsmws,sv1,9,0.995603816787272,239,103,2,344
80641,bgsmws,sv1,0,0.9908799101062916,265,109,3,377
80641,bgsmws,sv1,1,0.9811631469823529,226,108,1,335
80641,bgsmws,sv1,2,0.9921204575187469,250,111,4,365
80641,bgsmws,sv1,3,0.9921204575187469,250,111,4,365
80641,bgsmws,sv1,4,0.9922370235436115,221,111,4,336
80641,bgsmws,sv1,5,0.9973298500812962,220,122,3,345
80641,bgsmws,sv1,6,0.9871055477570769,242,125,3,370
80641,bgsmws,sv1,7,0.9949042080404407,218,90,2,310
80641,bgsmws,sv1,8,0.9935724169569441,271,73,5,349
80641,bgsmws,sv1,9,0.9916122252823674,282,76,3,361
80627,bgsmws,sv1,0,0.9848309981158715,253,124,5,382
80627,bgsmws,sv1,1,0.9963172004836931,231,99,2,332
80627,bgsmws,sv1,2,0.9914402866071615,246,119,3,368
80627,bgsmws,sv1,3,0.9914402866071615,246,119,3,368
80627,bgsmws,sv1,4,0.9933344788143402,255,89,4,348
80627,bgsmws,sv1,5,0.9800284775953089,254,99,1,354
80627,bgsmws,sv1,6,0.9749305083133555,262,105,5,372
80627,bgsmws,sv1,7,0.986374882270603,226,80,2,308
80627,bgsmws,sv1,8,0.9933111400392561,281,83,2,366
80627,bgsmws,sv1,9,0.9920634613746603,257,106,4,367
80681,elgqso,sv1,0,0.9894645004074476,228,57,34,319
80681,elgqso,sv1,1,0.9879667558890852,219,51,31,301
80681,elgqso,sv1,2,0.9884273143681764,205,83,36,324
80681,elgqso,sv1,3,0.9884273143681764,205,83,36,324
80681,elgqso,sv1,4,0.9885384590786577,200,48,48,296
80681,elgqso,sv1,5,0.9789577926069828,236,32,34,302
80681,elgqso,sv1,6,0.9869644344168101,233,41,41,315
80681,elgqso,sv1,7,0.9834031894434875,207,33,35,275
80681,elgqso,sv1,8,0.986076857204007,237,37,38,312
80681,elgqso,sv1,9,0.9920910724481612,228,46,32,306
80682,lrgqso,sv1,0,0.9858197947253347,274,38,44,356
80682,lrgqso,sv1,1,0.9777232469978052,243,32,49,324
80682,lrgqso,sv1,2,0.9841603704280298,292,27,36,355
80682,lrgqso,sv1,3,0.9841603704280298,292,27,36,355
80682,lrgqso,sv1,4,0.9892723313974698,254,26,40,320
80682,lrgqso,sv1,5,0.993315425214104,263,31,39,333
80682,lrgqso,sv1,6,0.9840265749801962,282,35,35,352
80682,lrgqso,sv1,7,0.9905837670093606,238,27,36,301
80682,lrgqso,sv1,8,0.9937387174235406,268,28,42,338
80682,lrgqso,sv1,9,0.9869913335992352,283,35,40,358
80676,lrgqso,sv1,0,0.9901768775965368,235,90,41,366
80676,lrgqso,sv1,1,0.9922837371406157,212,92,28,332
80676,lrgqso,sv1,2,0.9905473617954957,236,90,27,353
80676,lrgqso,sv1,3,0.9905473617954957,236,90,27,353
80676,lrgqso,sv1,4,0.9955365265007646,223,67,36,326
80676,lrgqso,sv1,5,0.9921016761395768,238,58,42,338
80676,lrgqso,sv1,6,0.9916072726739087,258,74,34,366
80676,lrgqso,sv1,7,0.982184664307789,215,52,36,303
80676,lrgqso,sv1,8,0.9913359893621798,260,55,37,352
80676,lrgqso,sv1,9,0.9890705919818458,231,88,36,355
80624,bgsmws,sv1,0,0.9940388125148198,342,22,5,369
80624,bgsmws,sv1,1,0.9932753698160373,289,46,3,338
80624,bgsmws,sv1,2,0.9902364014375045,292,76,0,368
80624,bgsmws,sv1,3,0.9902364014375045,292,76,0,368
80624,bgsmws,sv1,4,0.9879725979020945,277,72,2,351
80624,bgsmws,sv1,5,0.9972807773340921,219,105,9,333
80624,bgsmws,sv1,6,0.9888389740760439,265,102,2,369
80624,bgsmws,sv1,7,0.988590707014936,217,90,3,310
80624,bgsmws,sv1,8,0.9915395333158766,253,106,1,360
80624,bgsmws,sv1,9,0.9886231372918993,290,75,1,366
80670,lrgqso,sv1,0,0.9929673295985876,295,16,35,346
80670,lrgqso,sv1,1,0.9816130447969464,250,20,30,300
80670,lrgqso,sv1,2,0.9924524959958765,277,23,42,342
80670,lrgqso,sv1,3,0.9924524959958765,277,23,42,342
80670,lrgqso,sv1,4,0.9892812718486292,239,15,51,305
80670,lrgqso,sv1,5,0.9885058530050606,258,20,42,320
80670,lrgqso,sv1,6,0.9924548578101128,264,17,51,332
80670,lrgqso,sv1,7,0.9926819369485906,209,21,48,278
80670,lrgqso,sv1,8,0.9841527913618565,271,27,31,329
80670,lrgqso,sv1,9,0.9901324282557876,273,18,41,332
80715,m31,sv1,2,0.9933132374791047,19,317,6,342
80715,m31,sv1,3,0.9933132374791047,19,317,6,342
80715,m31,sv1,4,0.9858687470018996,32,283,4,319
80715,m31,sv1,5,0.9873183261491598,24,295,5,324
80715,m31,sv1,6,0.9873183261491598,24,295,5,324
80715,m31,sv1,7,0.9873183261491598,24,295,5,324
80715,m31,sv1,8,0.9873183261491598,24,295,5,324
80715,m31,sv1,9,0.9873183261491598,24,295,5,324
80653,bgsmws,sv1,0,0.985048015397072,256,89,5,350
80653,bgsmws,sv1,1,0.9880663156244943,257,77,4,338
80653,bgsmws,sv1,2,0.9908486294941974,279,83,2,364
80653,bgsmws,sv1,3,0.9908486294941974,279,83,2,364
80653,bgsmws,sv1,4,0.9904937885843632,262,74,3,339
80653,bgsmws,sv1,5,0.989706807521076,248,84,3,335
80653,bgsmws,sv1,6,0.990572513431425,272,81,5,358
80653,bgsmws,sv1,7,0.9930019108866088,252,52,5,309
80653,bgsmws,sv1,8,0.9833620980376634,254,74,4,332
80653,bgsmws,sv1,9,0.9949772468668385,284,54,5,343
80674,lrgqso,sv1,0,0.992813762443504,265,57,44,366
80674,lrgqso,sv1,1,0.9882070053886945,231,61,35,327
80674,lrgqso,sv1,2,0.9853151580189464,247,70,44,361
80674,lrgqso,sv1,3,0.9853151580189464,247,70,44,361
80674,lrgqso,sv1,4,0.9905043165916685,234,61,30,325
80674,lrgqso,sv1,5,0.9906520881078965,240,50,53,343
80674,lrgqso,sv1,6,0.9893995170098697,265,59,39,363
80674,lrgqso,sv1,7,0.9829393287099384,201,64,33,298
80674,lrgqso,sv1,8,0.9875214647887072,238,52,55,345
80674,lrgqso,sv1,9,0.9919675589215229,267,56,39,362
80636,bgsmws,sv1,0,0.9964140868700238,278,100,5,383
80636,bgsmws,sv1,1,0.9933515676605534,244,86,3,333
80636,bgsmws,sv1,2,0.9972156574579562,246,117,5,368
80636,bgsmws,sv1,3,0.9972156574579562,246,117,5,368
80636,bgsmws,sv1,4,0.9847246015095873,222,108,4,334
80636,bgsmws,sv1,5,0.9869001467664623,237,109,1,347
80636,bgsmws,sv1,6,0.9931274339144044,262,112,1,375
80636,bgsmws,sv1,7,0.9932724790209342,227,85,2,314
80636,bgsmws,sv1,8,0.9934016309147904,265,91,3,359
80636,bgsmws,sv1,9,0.9919344255184624,264,97,3,364
80720,umaii,sv1,0,0.9889243241161756,11,303,7,321
80720,umaii,sv1,1,0.9826657367853375,11,210,2,223
80720,umaii,sv1,2,0.9826657367853375,11,210,2,223
80720,umaii,sv1,3,0.9826657367853375,11,210,2,223
80720,umaii,sv1,4,0.9907860699805161,6,235,3,244
80720,umaii,sv1,5,0.9907860699805161,6,235,3,244
80720,umaii,sv1,6,0.9807587161530152,10,243,4,257
80720,umaii,sv1,7,0.9903298232823934,5,206,0,211
80720,umaii,sv1,8,0.9796430532816235,5,241,4,250
80720,umaii,sv1,9,0.9870126272805455,21,237,4,262
80718,rosette,sv1,0,0.9926473572883078,116,244,0,360
80718,rosette,sv1,1,0.98767248202621,100,244,0,344
80718,rosette,sv1,2,0.9957235157740888,65,303,0,368
80718,rosette,sv1,3,0.9957235157740888,65,303,0,368
80718,rosette,sv1,4,0.9933455574707746,59,291,0,350
80718,rosette,sv1,5,0.9891899604651916,104,252,0,356
80718,rosette,sv1,6,0.9923994575332579,194,174,0,368
80718,rosette,sv1,7,0.9946711771939495,132,181,0,313
80718,rosette,sv1,8,0.9958247928800953,75,290,0,365
80718,rosette,sv1,9,0.9849561068040256,75,292,0,367
80719,praesepe,sv1,0,0.9879880154765799,6,333,0,339
80719,praesepe,sv1,1,0.9799875869908568,0,218,4,222
80719,praesepe,sv1,2,0.9935726525116444,2,271,1,274
80719,praesepe,sv1,3,0.9935726525116444,2,271,1,274
80719,praesepe,sv1,4,0.9843285907955683,0,244,3,247
80719,praesepe,sv1,5,0.982834942854396,5,228,1,234
80719,praesepe,sv1,6,0.9927583869741503,2,264,3,269
80719,praesepe,sv1,7,0.9862522644999717,3,200,2,205
80719,praesepe,sv1,8,0.9816294633311226,4,246,0,250
80719,praesepe,sv1,9,0.9730725870751933,3,252,0,255
80660,bgsmws,sv1,0,0.993132678921961,283,71,3,357
80660,bgsmws,sv1,1,0.9884946332123642,262,58,6,326
80660,bgsmws,sv1,2,0.9918340683763405,273,83,2,358
80660,bgsmws,sv1,3,0.9918340683763405,273,83,2,358
80660,bgsmws,sv1,4,0.9941387342647959,221,98,5,324
80660,bgsmws,sv1,5,0.9906582371916764,254,67,2,323
80660,bgsmws,sv1,6,0.9924885076236591,286,72,5,363
80660,bgsmws,sv1,7,0.9870770663433225,235,61,1,297
80660,bgsmws,sv1,8,0.99458635247583,278,73,1,352
80660,bgsmws,sv1,9,0.9936857391265169,262,74,6,342
80675,elgqso,sv1,0,0.9850948133464267,187,87,46,320
80675,elgqso,sv1,1,0.9921035978856892,184,79,35,298
80675,elgqso,sv1,2,0.9929212192583524,209,85,35,329
80675,elgqso,sv1,3,0.9929212192583524,209,85,35,329
80675,elgqso,sv1,4,0.9893534785039023,187,76,35,298
80675,elgqso,sv1,5,0.9919574483956852,222,64,31,317
80675,elgqso,sv1,6,0.9941010201542327,240,63,27,330
80675,elgqso,sv1,7,0.9898103016125824,179,59,22,260
80675,elgqso,sv1,8,0.9927790547226377,198,86,33,317
80675,elgqso,sv1,9,0.9941905358382022,204,76,38,318
80656,bgsmws,sv1,0,0.9910319642395712,310,48,3,361
80656,bgsmws,sv1,1,0.9939025175347921,258,64,5,327
80656,bgsmws,sv1,2,0.9925785527170992,278,78,5,361
80656,bgsmws,sv1,3,0.9925785527170992,278,78,5,361
80656,bgsmws,sv1,4,0.99216222590299,271,65,7,343
80656,bgsmws,sv1,5,0.9909582729218415,244,76,5,325
80656,bgsmws,sv1,6,0.9886279731292776,268,81,7,356
80656,bgsmws,sv1,7,0.9854649207739098,218,82,4,304
80656,bgsmws,sv1,8,0.9956140763107705,284,74,3,361
80656,bgsmws,sv1,9,0.9873998146829347,309,58,2,369
80626,bgsmws,sv1,0,0.9905828125456569,222,107,1,330
80626,bgsmws,sv1,1,0.9919120727299346,204,113,8,325
80626,bgsmws,sv1,2,0.9946549852896784,263,92,2,357
80626,bgsmws,sv1,3,0.9946549852896784,263,92,2,357
80626,bgsmws,sv1,4,0.9828076087713425,222,107,3,332
80626,bgsmws,sv1,5,0.9908796783984181,220,107,4,331
80626,bgsmws,sv1,6,0.9959952201791517,241,105,4,350
80626,bgsmws,sv1,7,0.9946570703067886,204,97,3,304
80626,bgsmws,sv1,8,0.995119459942239,200,138,4,342
80626,bgsmws,sv1,9,0.9902182850485943,252,103,2,357
80693,elgqso,sv1,0,0.98915408621676,264,23,49,336
80693,elgqso,sv1,1,0.9888313501730264,240,17,36,293
80693,elgqso,sv1,2,0.9945166618783431,246,40,32,318
80693,elgqso,sv1,3,0.9945166618783431,246,40,32,318
80693,elgqso,sv1,4,0.9931196075100144,236,30,35,301
80693,elgqso,sv1,5,0.9946521122800883,235,28,38,301
80693,elgqso,sv1,6,0.9900617465136464,253,30,45,328
80693,elgqso,sv1,7,0.9885009206642701,219,31,35,285
80693,elgqso,sv1,8,0.990115084728121,261,26,32,319
80693,elgqso,sv1,9,0.9949296175115776,264,27,50,341
80677,elgqso,sv1,0,0.9947253145439702,213,68,41,322
80677,elgqso,sv1,1,0.990296485929165,170,90,30,290
80677,elgqso,sv1,2,0.9922410983140205,184,93,34,311
80677,elgqso,sv1,3,0.9922410983140205,184,93,34,311
80677,elgqso,sv1,4,0.9925867235441439,192,73,41,306
80677,elgqso,sv1,5,0.9851948124052978,193,77,40,310
80677,elgqso,sv1,6,0.985928712495182,213,64,41,318
80677,elgqso,sv1,7,0.9926935361088697,172,55,32,259
80677,elgqso,sv1,8,0.9886066700711533,211,52,43,306
80677,elgqso,sv1,9,0.9811713278502269,213,56,39,308
80645,bgsmws,sv1,0,0.989320509162979,312,54,5,371
80645,bgsmws,sv1,1,0.9929139084725512,274,56,9,339
80645,bgsmws,sv1,2,0.9881813918573882,268,94,4,366
80645,bgsmws,sv1,3,0.9881813918573882,268,94,4,366
80645,bgsmws,sv1,4,0.9896634199341673,239,102,2,343
80645,bgsmws,sv1,5,0.9899445541721401,249,103,6,358
80645,bgsmws,sv1,6,0.98955175044105,266,99,6,371
80645,bgsmws,sv1,7,0.9937174149992924,247,68,2,317
80645,bgsmws,sv1,8,0.9906217410174184,282,72,1,355
80645,bgsmws,sv1,9,0.9884385762168384,291,79,3,373
80654,bgsmws,sv1,0,0.9911113912043195,302,75,1,378
80654,bgsmws,sv1,1,0.986632784816494,283,61,3,347
80654,bgsmws,sv1,2,0.9900624348674235,277,75,0,352
80654,bgsmws,sv1,3,0.9900624348674235,277,75,0,352
80654,bgsmws,sv1,4,0.9903318303903054,263,66,5,334
80654,bgsmws,sv1,5,0.9792499208756121,263,74,2,339
80654,bgsmws,sv1,6,0.9886817780836784,301,76,2,379
80654,bgsmws,sv1,7,0.9880667079037211,268,36,2,306
80654,bgsmws,sv1,8,0.9955573401730655,286,69,4,359
80654,bgsmws,sv1,9,0.9843542994368614,282,71,4,357
80646,bgsmws,sv1,0,0.9928178529588427,300,80,5,385
80646,bgsmws,sv1,1,0.9913575173896852,267,73,1,341
80646,bgsmws,sv1,2,0.9917640619657898,272,93,5,370
80646,bgsmws,sv1,3,0.9917640619657898,272,93,5,370
80646,bgsmws,sv1,4,0.9904424771339625,236,108,6,350
80646,bgsmws,sv1,5,0.9907542856040842,237,117,3,357
80646,bgsmws,sv1,6,0.9929029285777558,267,103,3,373
80646,bgsmws,sv1,7,0.9927956659399343,237,66,8,311
80646,bgsmws,sv1,8,0.9902576518506652,286,79,2,367
80646,bgsmws,sv1,9,0.9902080625295308,297,67,5,369
80605,lrgqso,sv1,0,0.9918874439260584,304,17,36,357
80605,lrgqso,sv1,1,0.989789825757553,264,19,41,324
80605,lrgqso,sv1,2,0.9859935193172973,293,23,42,358
80605,lrgqso,sv1,3,0.9919764932778071,223,22,47,292
80605,lrgqso,sv1,4,0.9893245732865971,258,27,53,338
80605,lrgqso,sv1,5,0.9954444624154891,251,35,49,335
80605,lrgqso,sv1,6,0.9894455677428752,301,27,32,360
80605,lrgqso,sv1,7,0.9886932817849434,239,18,39,296
80605,lrgqso,sv1,8,0.9915146410702298,274,18,56,348
80605,lrgqso,sv1,9,0.9897721992186539,294,20,39,353
80648,bgsmws,sv1,0,0.9943431393174459,226,148,3,377
80648,bgsmws,sv1,1,0.9895568384030184,230,102,2,334
80648,bgsmws,sv1,2,0.9941247441680321,236,126,3,365
80648,bgsmws,sv1,3,0.9941247441680321,236,126,3,365
80648,bgsmws,sv1,4,0.9827003972501754,225,115,4,344
80648,bgsmws,sv1,5,0.990338787665684,263,90,3,356
80648,bgsmws,sv1,6,0.9931862862508305,241,130,3,374
80648,bgsmws,sv1,7,0.9861134422490991,229,83,1,313
80648,bgsmws,sv1,8,0.9939484952320984,258,93,3,354
80648,bgsmws,sv1,9,0.9892462886679343,255,104,1,360
80628,bgsmws,sv1,0,0.990723711495701,239,108,3,350
80628,bgsmws,sv1,1,0.9898597056530103,238,89,3,330
80628,bgsmws,sv1,2,0.9894395580897017,252,87,2,341
80628,bgsmws,sv1,3,0.9894395580897017,252,87,2,341
80628,bgsmws,sv1,4,0.9896102045253324,218,103,4,325
80628,bgsmws,sv1,5,0.9915895058600367,254,82,4,340
80628,bgsmws,sv1,6,0.9835740746191346,271,74,2,347
80628,bgsmws,sv1,7,0.9921638162722842,242,57,3,302
80628,bgsmws,sv1,8,0.9955099107574497,288,75,3,366
80628,bgsmws,sv1,9,0.9911604498633031,282,84,2,368
80683,elgqso,sv1,0,0.9846622721932201,209,85,29,323
80683,elgqso,sv1,1,0.9898092586098232,174,79,32,285
80683,elgqso,sv1,2,0.9904754729115158,209,70,36,315
80683,elgqso,sv1,3,0.9904754729115158,209,70,36,315
80683,elgqso,sv1,4,0.981784364070249,202,66,29,297
80683,elgqso,sv1,5,0.9915079173443702,212,63,41,316
80683,elgqso,sv1,6,0.9863871113909851,216,63,45,324
80683,elgqso,sv1,7,0.985146706970348,188,58,28,274
80683,elgqso,sv1,8,0.9906138563154698,205,74,39,318
80683,elgqso,sv1,9,0.989640154680402,228,56,34,318
80669,elgqso,sv1,0,0.9932345137006581,250,23,51,324
80669,elgqso,sv1,1,0.9868311174979515,239,24,29,292
80669,elgqso,sv1,2,0.9938606075821735,232,35,46,313
80669,elgqso,sv1,3,0.9938606075821735,232,35,46,313
80669,elgqso,sv1,4,0.9925756126819804,223,23,47,293
80669,elgqso,sv1,5,0.985126537116141,236,24,50,310
80669,elgqso,sv1,6,0.9878407046459763,238,32,52,322
80669,elgqso,sv1,7,0.9850842997419571,195,21,42,258
80669,elgqso,sv1,8,0.9931277160304883,254,20,42,316
80669,elgqso,sv1,9,0.9943056181439831,245,30,43,318
80673,elgqso,sv1,0,0.9929008365994901,248,57,38,343
80673,elgqso,sv1,1,0.9877379745140497,217,51,33,301
80673,elgqso,sv1,2,0.9949718496046052,218,58,49,325
80673,elgqso,sv1,3,0.9949718496046052,218,58,49,325
80673,elgqso,sv1,4,0.9869100106414143,218,49,45,312
80673,elgqso,sv1,5,0.9931199828744169,232,58,45,335
80673,elgqso,sv1,6,0.9892928613148304,231,55,53,339
80673,elgqso,sv1,7,0.9917194413450388,200,48,31,279
80673,elgqso,sv1,8,0.9951344338056093,221,67,47,335
80673,elgqso,sv1,9,0.989135783301061,212,66,43,321
80688,lrgqso,sv1,0,0.9934080580866042,285,32,43,360
80688,lrgqso,sv1,1,0.9898436179192295,255,38,32,325
80688,lrgqso,sv1,2,0.9905486446360477,263,29,58,350
80688,lrgqso,sv1,3,0.9905486446360477,263,29,58,350
80688,lrgqso,sv1,4,0.9858135027862426,256,34,41,331
80688,lrgqso,sv1,5,0.9805705727592955,262,24,50,336
80688,lrgqso,sv1,6,0.9863652133567927,281,25,49,355
80688,lrgqso,sv1,7,0.9803992004583097,227,36,31,294
80688,lrgqso,sv1,8,0.9868774142510116,270,34,34,338
80688,lrgqso,sv1,9,0.9865244041066008,286,23,43,352
80678,lrgqso,sv1,0,0.9883900444826426,257,68,37,362
80678,lrgqso,sv1,1,0.9897008698163288,225,71,36,332
80678,lrgqso,sv1,2,0.9885182733489141,229,83,37,349
80678,lrgqso,sv1,3,0.9885182733489141,229,83,37,349
80678,lrgqso,sv1,4,0.9930973575073683,221,75,42,338
80678,lrgqso,sv1,5,0.9920050599374546,238,61,31,330
80678,lrgqso,sv1,6,0.9919325320731811,225,87,44,356
80678,lrgqso,sv1,7,0.9864013237258553,214,58,26,298
80678,lrgqso,sv1,8,0.9892106881914173,240,75,30,345
80678,lrgqso,sv1,9,0.992815874533372,241,65,38,344
80700,lrgqso,sv1,0,0.9936708076109947,296,14,49,359
80700,lrgqso,sv1,1,0.9915854605707999,276,16,34,326
80700,lrgqso,sv1,2,0.9834517136420686,270,25,56,351
80700,lrgqso,sv1,3,0.9834517136420686,270,25,56,351
80700,lrgqso,sv1,4,0.9904895595857813,274,12,41,327
80700,lrgqso,sv1,5,0.9898127016624175,280,15,35,330
80700,lrgqso,sv1,6,0.9949212347591474,310,16,33,359
80700,lrgqso,sv1,7,0.9900984513580483,240,15,43,298
80700,lrgqso,sv1,8,0.9851265210476615,283,30,41,354
80700,lrgqso,sv1,9,0.9943172151019996,265,20,55,340
80707,elgqso,sv1,0,0.9854173405183183,247,35,48,330
80707,elgqso,sv1,1,0.9888650558781822,213,20,53,286
80707,elgqso,sv1,2,0.9898870707838012,242,28,32,302
80707,elgqso,sv1,3,0.9898870707838012,242,28,32,302
80707,elgqso,sv1,4,0.9929288901773909,218,21,46,285
80707,elgqso,sv1,5,0.9951346772959974,224,33,46,303
80707,elgqso,sv1,6,0.9938882565362889,250,29,46,325
80707,elgqso,sv1,7,0.9831965298427028,200,23,49,272
80707,elgqso,sv1,8,0.9852273092366096,245,26,40,311
80707,elgqso,sv1,9,0.9889886186749828,255,22,41,318
80680,lrgqso,sv1,0,0.9919935326959088,273,46,36,355
80680,lrgqso,sv1,1,0.9884103483051854,258,21,40,319
80680,lrgqso,sv1,2,0.9886018059218907,272,46,34,352
80680,lrgqso,sv1,3,0.9886018059218907,272,46,34,352
80680,lrgqso,sv1,4,0.9912602001765448,254,52,30,336
80680,lrgqso,sv1,5,0.9885083728881784,255,46,35,336
80680,lrgqso,sv1,6,0.9877669146245102,263,64,40,367
80680,lrgqso,sv1,7,0.9849648918688841,253,26,31,310
80680,lrgqso,sv1,8,0.9929514682154547,276,33,34,343
80680,lrgqso,sv1,9,0.9932127582870126,264,45,38,347
80610,elg,sv1,0,0.9908507018031105,315,11,11,337
80610,elg,sv1,1,0.973205151518412,277,14,10,301
80610,elg,sv1,2,0.9832399751569121,305,13,14,332
80610,elg,sv1,3,0.9882845669484088,240,11,10,261
80610,elg,sv1,4,0.9914146285280451,280,18,13,311
80610,elg,sv1,5,0.9937501358377604,303,14,8,325
80610,elg,sv1,6,0.9858723949550188,294,16,8,318
80610,elg,sv1,7,0.9825383340973818,246,10,12,268
80610,elg,sv1,8,0.9928730410431769,297,16,14,327
80610,elg,sv1,9,0.9926976563501427,310,13,18,341
80701,elg,sv1,0,0.9956931131107861,286,34,7,327
80701,elg,sv1,1,0.996051181386993,249,34,6,289
80701,elg,sv1,2,0.9893853103399904,320,27,4,351
80701,elg,sv1,3,0.9893853103399904,320,27,4,351
80701,elg,sv1,4,0.9909260573701111,278,29,4,311
80701,elg,sv1,5,0.9883348131964753,255,28,13,296
80701,elg,sv1,6,0.9841784480312726,279,44,5,328
80701,elg,sv1,7,0.9850811460689408,226,32,8,266
80701,elg,sv1,8,0.9965086975137921,289,34,13,336
80701,elg,sv1,9,0.9866602302079164,240,41,11,292
80692,lrgqso,sv1,0,0.9883164030034715,220,47,73,340
80692,lrgqso,sv1,1,0.990336888369772,271,23,30,324
80692,lrgqso,sv1,2,0.9973189369836539,200,49,83,332
80692,lrgqso,sv1,3,0.9973189369836539,200,49,83,332
80692,lrgqso,sv1,4,0.9920902771347073,200,39,74,313
80692,lrgqso,sv1,5,0.9953130375341057,213,35,75,323
80692,lrgqso,sv1,6,0.9915801845223586,280,24,38,342
80692,lrgqso,sv1,7,0.9885086506860598,241,18,41,300
80692,lrgqso,sv1,8,0.9942899020674094,285,21,40,346
80692,lrgqso,sv1,9,0.992841378635091,291,21,37,349
80690,lrgqso,sv1,0,0.988231969509894,273,36,47,356
80690,lrgqso,sv1,1,0.995849154906076,270,28,39,337
80690,lrgqso,sv1,2,0.9953408720007852,287,31,36,354
80690,lrgqso,sv1,3,0.9953408720007852,287,31,36,354
80690,lrgqso,sv1,4,0.9896378349715838,263,28,39,330
80690,lrgqso,sv1,5,0.9889883165524289,281,20,40,341
80690,lrgqso,sv1,6,0.9928376627686596,280,21,53,354
80690,lrgqso,sv1,7,0.9915512383749616,248,15,33,296
80690,lrgqso,sv1,8,0.9868255782161928,287,17,37,341
80690,lrgqso,sv1,9,0.9927256687273288,281,26,41,348
80685,elgqso,sv1,0,0.985149726178829,264,38,37,339
80685,elgqso,sv1,1,0.9822635196266133,216,35,36,287
80685,elgqso,sv1,2,0.9913031671941703,243,37,45,325
80685,elgqso,sv1,3,0.9913031671941703,243,37,45,325
80685,elgqso,sv1,4,0.9895696705195152,227,30,36,293
80685,elgqso,sv1,5,0.9867472465819583,217,36,46,299
80685,elgqso,sv1,6,0.9869357448788644,256,33,35,324
80685,elgqso,sv1,7,0.9839625519576908,208,27,31,266
80685,elgqso,sv1,8,0.9877890111135336,269,18,34,321
80685,elgqso,sv1,9,0.9908349113023495,230,34,51,315
80705,elg,sv1,0,0.9951825343550099,267,38,9,314
80705,elg,sv1,1,0.9947167420341491,245,34,10,289
80705,elg,sv1,2,0.9816835289872117,282,30,10,322
80705,elg,sv1,3,0.9816835289872117,282,30,10,322
80705,elg,sv1,4,0.9892663499589708,250,33,8,291
80705,elg,sv1,5,0.9890314906570556,262,21,16,299
80705,elg,sv1,6,0.9846520931512315,276,27,10,313
80705,elg,sv1,7,0.9886083424870055,239,17,9,265
80705,elg,sv1,8,0.9901106164681942,256,32,10,298
80705,elg,sv1,9,0.9914471142718481,265,31,3,299
80649,bgsmws,sv1,0,0.990590304073197,301,78,0,379
80649,bgsmws,sv1,1,0.9852853018081967,243,97,3,343
80649,bgsmws,sv1,2,0.9918106320400641,249,120,2,371
80649,bgsmws,sv1,3,0.9886384636569044,226,77,3,306
80649,bgsmws,sv1,4,0.9878194729047138,227,107,3,337
80649,bgsmws,sv1,5,0.9938354083699414,244,104,1,349
80649,bgsmws,sv1,6,0.9930128064950595,259,91,5,355
80649,bgsmws,sv1,7,0.9941922288760253,220,87,1,308
80649,bgsmws,sv1,8,0.9921528695484922,275,83,3,361
80649,bgsmws,sv1,9,0.9909075753048441,289,95,1,385
80658,bgsmws,sv1,0,0.9923356670394359,258,83,6,347
80658,bgsmws,sv1,1,0.9915466926931588,255,75,1,331
80658,bgsmws,sv1,2,0.9888454716979814,266,78,5,349
80658,bgsmws,sv1,3,0.9891178028332337,220,67,1,288
80658,bgsmws,sv1,4,0.984957637437666,261,75,3,339
80658,bgsmws,sv1,5,0.9845735658253876,271,68,4,343
80658,bgsmws,sv1,6,0.989173899942003,288,78,3,369
80658,bgsmws,sv1,7,0.9865130626774306,191,82,3,276
80658,bgsmws,sv1,8,0.9902737484807049,238,83,3,324
80658,bgsmws,sv1,9,0.9920613108756456,234,81,6,321
80708,lrgqso,sv1,0,0.9825330297329,172,46,64,282
80708,lrgqso,sv1,1,0.9848830903024445,234,23,25,282
80708,lrgqso,sv1,2,0.9846740809869395,177,37,73,287
80708,lrgqso,sv1,3,0.9836560958545888,198,22,25,245
80708,lrgqso,sv1,4,0.9905256061060582,174,38,52,264
80708,lrgqso,sv1,5,0.9903333959454782,173,42,73,288
80708,lrgqso,sv1,6,0.9841463199323598,234,24,31,289
80708,lrgqso,sv1,7,0.9919802031516239,219,14,36,269
80708,lrgqso,sv1,8,0.9908035000307872,233,31,39,303
80708,lrgqso,sv1,9,0.9795718620872386,118,8,13,139
80637,bgsmws,sv1,0,0.9820618836467654,259,104,3,366
80637,bgsmws,sv1,1,0.989545716516956,255,70,4,329
80637,bgsmws,sv1,2,0.9894775669858671,228,105,2,335
80637,bgsmws,sv1,3,0.9946814859074803,201,75,1,277
80637,bgsmws,sv1,4,0.9960532001932725,264,70,1,335
80637,bgsmws,sv1,5,0.9887348804009879,270,80,4,354
80637,bgsmws,sv1,6,0.981464569293858,237,116,2,355
80637,bgsmws,sv1,7,0.9892494681748162,198,91,4,293
80637,bgsmws,sv1,8,0.9908006910635043,209,113,6,328
80637,bgsmws,sv1,9,0.9891852610074972,250,94,2,346
80712,lrgqso,sv1,0,0.9879132547608915,196,65,80,341
80712,lrgqso,sv1,1,0.9922472375588732,258,15,49,322
80712,lrgqso,sv1,2,0.9886240208064113,218,44,68,330
80712,lrgqso,sv1,3,0.9926910875578168,222,30,31,283
80712,lrgqso,sv1,4,0.9906761031875093,195,47,74,316
80712,lrgqso,sv1,5,0.9894319998828165,192,54,69,315
80712,lrgqso,sv1,6,0.9871234960198426,285,20,37,342
80712,lrgqso,sv1,7,0.9900714756953687,235,19,35,289
80712,lrgqso,sv1,8,0.9914350072179294,279,24,40,343
80712,lrgqso,sv1,9,0.9896745937131235,274,18,41,333
80632,bgsmws,sv1,0,0.9944342367382356,276,82,4,362
80632,bgsmws,sv1,1,0.9824387683781153,274,61,0,335
80632,bgsmws,sv1,2,0.9886002984578621,277,77,7,361
80632,bgsmws,sv1,3,0.9780160540424602,171,63,8,242
80632,bgsmws,sv1,4,0.9926435394889154,264,82,1,347
80632,bgsmws,sv1,5,0.990643324137141,236,94,6,336
80632,bgsmws,sv1,6,0.9882704953868545,288,83,4,375
80632,bgsmws,sv1,7,0.9898847553410868,228,72,0,300
80632,bgsmws,sv1,8,0.9939340776944393,267,88,1,356
80632,bgsmws,sv1,9,0.9932533925261989,300,66,2,368
80789,backup1,sv1,0,0.9920397442311677,0,301,4,305
80789,backup1,sv1,1,0.9723624591147281,0,152,0,152
80789,backup1,sv1,2,0.9878125462739491,4,276,6,286
80789,backup1,sv1,3,0.9869246655244983,0,161,0,161
80789,backup1,sv1,4,0.9841000376593586,1,234,3,238
80789,backup1,sv1,5,0.9959437431500682,4,243,4,251
80789,backup1,sv1,6,0.9752287492327251,3,173,2,178
80789,backup1,sv1,7,0.9805574339486094,6,236,2,244
80789,backup1,sv1,8,0.9824138511811155,9,292,5,306
80789,backup1,sv1,9,0.9568226198085268,3,85,0,88
80788,backup1,sv1,0,0.9940034646581491,3,306,3,312
80788,backup1,sv1,1,0.9777896134380489,1,161,1,163
80788,backup1,sv1,2,0.9882521117598699,1,288,3,292
80788,backup1,sv1,3,0.9596524969260539,2,145,1,148
80788,backup1,sv1,4,0.9926960178240914,1,248,2,251
80788,backup1,sv1,5,0.9794952531204181,1,263,5,269
80788,backup1,sv1,6,0.9810541648619215,1,183,1,185
80788,backup1,sv1,7,0.9809584421433822,2,249,3,254
80788,backup1,sv1,8,0.986624979074464,13,291,1,305
80788,backup1,sv1,9,0.9741001672473415,0,84,0,84
80784,backup1,sv1,0,0.9810284672091365,3,311,2,316
80784,backup1,sv1,1,0.9886921832433093,1,162,1,164
80784,backup1,sv1,2,0.9918246138593662,3,295,3,301
80784,backup1,sv1,3,0.9727710687507384,1,159,0,160
80784,backup1,sv1,4,0.9890066726248172,0,244,6,250
80784,backup1,sv1,5,0.9942587351178375,2,260,4,266
80784,backup1,sv1,6,0.989023394039819,2,181,2,185
80784,backup1,sv1,7,0.9893645452845219,3,248,2,253
80784,backup1,sv1,8,0.9899467186562114,11,284,2,297
80784,backup1,sv1,9,0.9570207113803778,0,87,0,87
80787,backup1,sv1,0,0.987069500332666,9,295,6,310
80787,backup1,sv1,1,0.9766859963531049,2,154,0,156
80787,backup1,sv1,2,0.9907579392949929,5,285,2,292
80787,backup1,sv1,3,0.9910115369487451,3,141,1,145
80787,backup1,sv1,4,0.988503309384124,3,232,5,240
80787,backup1,sv1,5,0.9810666319668372,10,239,5,254
80787,backup1,sv1,6,0.9852464667250902,3,216,3,222
80787,backup1,sv1,7,0.9862669397130298,9,237,3,249
80787,backup1,sv1,8,0.9839479417043842,11,302,4,317
80787,backup1,sv1,9,0.944729266626106,2,85,1,88
80786,backup1,sv1,0,0.995807961718238,10,300,6,316
80786,backup1,sv1,1,0.983273758530448,1,178,2,181
80786,backup1,sv1,2,0.9922059718917189,6,291,8,305
80786,backup1,sv1,3,0.989675764478358,7,174,0,181
80786,backup1,sv1,4,0.9928964089572607,1,233,3,237
80786,backup1,sv1,5,0.9911416892269138,2,262,2,266
80786,backup1,sv1,6,0.9793202087117379,5,204,1,210
80786,backup1,sv1,7,0.9852406043061795,8,250,4,262
80786,backup1,sv1,8,0.9886297620614352,11,306,0,317
80786,backup1,sv1,9,0.9886297620614352,11,306,0,317
80783,backup1,sv1,0,0.9839213212547694,5,310,6,321
80783,backup1,sv1,1,0.9687064604650379,0,164,1,165
80783,backup1,sv1,2,0.9931344959597297,4,281,5,290
80783,backup1,sv1,3,0.9726324365525831,3,151,2,156
80783,backup1,sv1,4,0.9918643988568517,1,233,7,241
80783,backup1,sv1,5,0.9925503244973,3,254,5,262
80783,backup1,sv1,6,0.9726505924068605,0,185,1,186
80783,backup1,sv1,7,0.985412970164822,1,234,3,238
80783,backup1,sv1,8,0.9886850201387206,11,286,4,301
80783,backup1,sv1,9,0.9590870500915338,1,89,0,90
80782,backup1,sv1,0,0.9915764034146717,2,310,2,314
80782,backup1,sv1,1,0.9814736490804159,0,166,0,166
80782,backup1,sv1,2,0.9933444648813006,3,302,6,311
80782,backup1,sv1,3,0.9800440948796626,0,157,4,161
80782,backup1,sv1,4,0.9780681414071689,0,247,5,252
80782,backup1,sv1,5,0.9877573545741934,2,271,2,275
80782,backup1,sv1,6,0.9876981899475498,3,154,0,157
80782,backup1,sv1,7,0.993262774472386,3,246,3,252
80782,backup1,sv1,8,0.9906305425356822,3,297,6,306
80782,backup1,sv1,9,0.9682095925493382,0,86,1,87
80790,backup1,sv1,0,0.9877277083059649,1,295,3,299
80790,backup1,sv1,1,0.9825151484097857,0,159,1,160
80790,backup1,sv1,2,0.987267529205684,1,288,1,290
80790,backup1,sv1,3,0.9777413851398229,1,138,2,141
80790,backup1,sv1,4,0.9832228046398548,1,242,2,245
80790,backup1,sv1,5,0.9862449131212072,3,251,4,258
80790,backup1,sv1,6,0.9839276946693296,0,159,1,160
80790,backup1,sv1,7,0.9865245587396408,1,236,6,243
80790,backup1,sv1,8,0.9875253257290453,3,281,4,288
80790,backup1,sv1,9,0.960415760447392,0,72,0,72
80785,backup1,sv1,0,0.9814365306564611,1,323,4,328
80785,backup1,sv1,1,0.988968054142629,0,173,2,175
80785,backup1,sv1,2,0.9933271988074729,3,297,4,304
80785,backup1,sv1,3,0.9898331010946855,4,148,0,152
80785,backup1,sv1,4,0.9860056150903778,0,234,3,237
80785,backup1,sv1,5,0.9904790561337321,2,265,6,273
80785,backup1,sv1,6,0.9821829025301312,3,180,1,184
80785,backup1,sv1,7,0.9888320235149187,2,254,3,259
80785,backup1,sv1,8,0.9925581807330414,10,292,6,308
80785,backup1,sv1,9,0.9501940297216147,1,89,1,91
80639,bgsmws,sv1,0,0.9925175084008856,276,94,4,374
80639,bgsmws,sv1,1,0.9959164810706302,236,106,2,344
80639,bgsmws,sv1,2,0.9857563103478955,259,105,4,368
80639,bgsmws,sv1,3,0.9846048177590759,191,102,2,295
80639,bgsmws,sv1,4,0.9928853191434577,259,84,3,346
80639,bgsmws,sv1,5,0.9947490788427884,259,91,3,353
80639,bgsmws,sv1,6,0.9909458935608909,288,78,4,370
80639,bgsmws,sv1,7,0.9938045029630725,238,72,3,313
80639,bgsmws,sv1,8,0.9889699463731075,281,79,3,363
80639,bgsmws,sv1,9,0.9908392470984152,306,67,4,377
80659,bgsmws,sv1,0,0.9934886876266419,231,118,3,352
80659,bgsmws,sv1,1,0.9919812805333644,224,78,2,304
80659,bgsmws,sv1,2,0.9905184497315743,287,61,4,352
80659,bgsmws,sv1,3,0.9832142763146362,250,67,1,318
80659,bgsmws,sv1,4,0.9832225382675257,264,55,4,323
80659,bgsmws,sv1,5,0.9892958718505045,243,85,7,335
80659,bgsmws,sv1,6,0.9907096412649625,278,72,3,353
80659,bgsmws,sv1,7,0.9880830570112743,272,42,3,317
80659,bgsmws,sv1,8,0.9932312353868831,297,56,3,356
80659,bgsmws,sv1,9,0.9904445918147496,291,73,2,366
80699,elgqso,sv1,0,0.9948014586746436,257,30,37,324
80699,elgqso,sv1,1,0.9928620720582125,238,25,27,290
80699,elgqso,sv1,2,0.9919310747804028,262,23,46,331
80699,elgqso,sv1,3,0.9898860271430039,214,16,40,270
80699,elgqso,sv1,4,0.9863374689665055,249,13,37,299
80699,elgqso,sv1,5,0.9882155764655275,236,26,39,301
80699,elgqso,sv1,6,0.9918310683806326,242,20,53,315
80699,elgqso,sv1,7,0.9805181488042608,194,22,39,255
80699,elgqso,sv1,8,0.993213757669308,263,18,51,332
80699,elgqso,sv1,9,0.9950988444563008,273,18,38,329
80684,lrgqso,sv1,0,0.9914061262470949,242,84,44,370
80684,lrgqso,sv1,1,0.9875379875377929,213,80,34,327
80684,lrgqso,sv1,2,0.9931388995901733,231,84,38,353
80684,lrgqso,sv1,3,0.9923645483009744,215,72,35,322
80684,lrgqso,sv1,4,0.9846876268151785,246,59,33,338
80684,lrgqso,sv1,5,0.9919713607096239,226,71,36,333
80684,lrgqso,sv1,6,0.9895232452632531,260,73,33,366
80684,lrgqso,sv1,7,0.9831337610574359,216,60,28,304
80684,lrgqso,sv1,8,0.9876522083669228,243,66,36,345
80684,lrgqso,sv1,9,0.9903212427032291,225,101,49,375
80687,elg,sv1,0,0.9903838502489997,250,38,14,302
80687,elg,sv1,1,0.989474303925909,247,20,11,278
80687,elg,sv1,2,0.983169879743391,257,41,8,306
80687,elg,sv1,3,0.993756130081854,226,29,6,261
80687,elg,sv1,4,0.981799792927168,232,36,12,280
80687,elg,sv1,5,0.9903170288837224,244,37,13,294
80687,elg,sv1,6,0.9934188878423496,239,17,9,265
80687,elg,sv1,7,0.98552337182752,228,25,9,262
80687,elg,sv1,8,0.989200478278761,274,14,11,299
80687,elg,sv1,9,0.9914376946500811,290,23,8,321
80694,lrgqso,sv1,0,0.9926264254505652,289,36,39,364
80694,lrgqso,sv1,1,0.9900158475561623,275,22,36,333
80694,lrgqso,sv1,2,0.9889084527013805,281,32,39,352
80694,lrgqso,sv1,3,0.985971255328032,248,25,37,310
80694,lrgqso,sv1,4,0.9848255911590625,278,27,27,332
80694,lrgqso,sv1,5,0.9910373495014841,292,20,30,342
80694,lrgqso,sv1,6,0.9957241370691751,288,24,41,353
80694,lrgqso,sv1,7,0.9859985213390605,224,27,35,286
80694,lrgqso,sv1,8,0.9914353146085366,283,27,42,352
80694,lrgqso,sv1,9,0.9904609487207131,290,35,44,369
80709,elg,sv1,0,0.9921193203261788,261,43,4,308
80709,elg,sv1,1,0.9928196046103102,259,19,5,283
80709,elg,sv1,2,0.983624600227313,286,26,10,322
80709,elg,sv1,3,0.9890680443005295,262,18,8,288
80709,elg,sv1,4,0.9919897423450537,261,33,6,300
80709,elg,sv1,5,0.9819633770745819,262,31,7,300
80709,elg,sv1,6,0.9861612879492935,248,36,7,291
80709,elg,sv1,7,0.9826483282536514,230,20,4,254
80709,elg,sv1,8,0.9881118589039543,266,28,9,303
80709,elg,sv1,9,0.992592062344132,297,27,10,334
80741,bgsmws,sv1,0,0.9919232227332965,279,81,1,361
80741,bgsmws,sv1,1,0.990858142433985,250,87,2,339
80741,bgsmws,sv1,2,0.9914347031377155,267,85,4,356
80741,bgsmws,sv1,3,0.9947705473540176,241,84,4,329
80741,bgsmws,sv1,4,0.9933469644384477,242,82,4,328
80741,bgsmws,sv1,5,0.9876121924410715,253,82,4,339
80741,bgsmws,sv1,6,0.9876121924410715,253,82,4,339
80741,bgsmws,sv1,7,0.9944938982225531,229,59,5,293
80741,bgsmws,sv1,8,0.9894247040857868,297,47,1,345
80741,bgsmws,sv1,9,0.9913374298431971,274,84,0,358
80703,elg,sv1,0,0.990393220620519,269,22,14,305
80703,elg,sv1,1,0.9899782665509559,258,13,8,279
80703,elg,sv1,2,0.9883851187553924,270,29,8,307
80703,elg,sv1,3,0.9916039103174366,264,9,1,274
80703,elg,sv1,4,0.9882925767836934,256,28,6,290
80703,elg,sv1,5,0.9952218374234874,241,30,17,288
80703,elg,sv1,6,0.9818776709038974,271,10,5,286
80703,elg,sv1,7,0.9896493554358243,254,6,3,263
80703,elg,sv1,8,0.9937966119539594,282,13,14,309
80703,elg,sv1,9,0.9949532937406781,329,12,5,346
80643,bgsmws,sv1,0,0.9870015359648763,287,93,0,380
80643,bgsmws,sv1,1,0.992244534693931,265,62,2,329
80643,bgsmws,sv1,2,0.9870438141380796,306,59,2,367
80643,bgsmws,sv1,3,0.9714296252628143,46,28,1,75
80643,bgsmws,sv1,4,0.9925437716383615,229,108,3,340
80643,bgsmws,sv1,5,0.9932059383153587,212,127,5,344
80643,bgsmws,sv1,6,0.9909303045594859,255,104,9,368
80643,bgsmws,sv1,7,0.9894372668526329,217,95,3,315
80643,bgsmws,sv1,8,0.9943234519887735,267,96,2,365
80643,bgsmws,sv1,9,0.9922281481412323,288,83,2,373
80691,elg,sv1,0,0.9853532258561102,257,39,7,303
80691,elg,sv1,1,0.9916627644835613,261,12,9,282
80691,elg,sv1,2,0.9926613131956388,254,35,8,297
80691,elg,sv1,3,0.994169826201514,259,14,9,282
80691,elg,sv1,4,0.9833190743635978,258,26,5,289
80691,elg,sv1,5,0.9925217186806153,241,31,9,281
80691,elg,sv1,6,0.9925217186806153,241,31,9,281
80691,elg,sv1,7,0.9868773385522112,240,11,6,257
80691,elg,sv1,8,0.9929620232750666,277,8,6,291
80691,elg,sv1,9,0.9942912064761977,298,17,16,331
80686,lrgqso,sv1,0,0.9909404896787475,280,38,43,361
80686,lrgqso,sv1,1,0.9879028802547125,255,31,43,329
80686,lrgqso,sv1,2,0.99077067647136,272,33,38,343
80686,lrgqso,sv1,3,0.9914650469914265,254,33,38,325
80686,lrgqso,sv1,4,0.9844325167979208,272,19,41,332
80686,lrgqso,sv1,5,0.9887409840417548,268,25,48,341
80686,lrgqso,sv1,6,0.9942546334337923,253,42,50,345
80686,lrgqso,sv1,7,0.9925265424683908,232,25,41,298
80686,lrgqso,sv1,8,0.9945908940062221,287,30,33,350
80686,lrgqso,sv1,9,0.992408806406237,298,33,50,381
80696,lrgqso,sv1,0,0.9913969228085837,243,39,60,342
80696,lrgqso,sv1,1,0.9893562678951038,224,21,72,317
80696,lrgqso,sv1,2,0.9908717974435861,241,34,57,332
80696,lrgqso,sv1,3,0.9930458261062239,216,23,58,297
80696,lrgqso,sv1,4,0.9888543024106707,240,27,59,326
80696,lrgqso,sv1,5,0.993136314038601,224,32,65,321
80696,lrgqso,sv1,6,0.993136314038601,224,32,65,321
80696,lrgqso,sv1,7,0.985835205950091,202,28,54,284
80696,lrgqso,sv1,8,0.9903647509255359,205,42,77,324
80696,lrgqso,sv1,9,0.9831715788389846,234,37,58,329
80721,ssv,sv1,0,0.9921472548204638,1,363,0,364
80721,ssv,sv1,1,0.9873204094510787,1,334,3,338
80721,ssv,sv1,2,0.9927054800386056,1,360,0,361
80721,ssv,sv1,3,0.9912234347184543,0,337,0,337
80721,ssv,sv1,4,0.9934715017351954,2,342,0,344
80721,ssv,sv1,5,0.9934599451690385,0,350,4,354
80721,ssv,sv1,6,0.9951168587450776,1,360,0,361
80721,ssv,sv1,7,0.9898695181683721,1,303,3,307
80721,ssv,sv1,8,0.9932351328181698,1,364,2,367
80721,ssv,sv1,9,0.9924730287457011,3,384,1,388
80866,unwisebluebright,sv1,0,0.9908450095225936,308,29,0,337
80866,unwisebluebright,sv1,1,0.9895841992675986,307,21,0,328
80866,unwisebluebright,sv1,2,0.9911562584677416,341,21,1,363
80866,unwisebluebright,sv1,3,0.9916168640060207,306,18,1,325
80866,unwisebluebright,sv1,4,0.9889754161397892,311,22,0,333
80866,unwisebluebright,sv1,5,0.9889754161397892,311,22,0,333
80866,unwisebluebright,sv1,6,0.9889754161397892,311,22,0,333
80866,unwisebluebright,sv1,7,0.9888192706323159,282,19,1,302
80866,unwisebluebright,sv1,8,0.9935586604802134,328,32,0,360
80866,unwisebluebright,sv1,9,0.9926032811702614,341,24,0,365
80867,unwisebluefaint,sv1,0,0.9876751676609176,315,17,1,333
80867,unwisebluefaint,sv1,1,0.9925338818908487,304,17,0,321
80867,unwisebluefaint,sv1,2,0.99366426481311,335,18,0,353
80867,unwisebluefaint,sv1,3,0.9872214907055333,313,15,0,328
80867,unwisebluefaint,sv1,4,0.9937943478867398,314,17,2,333
80867,unwisebluefaint,sv1,5,0.9937943478867398,314,17,2,333
80867,unwisebluefaint,sv1,6,0.9937943478867398,314,17,2,333
80867,unwisebluefaint,sv1,7,0.9764016854058798,280,14,0,294
80867,unwisebluefaint,sv1,8,0.9929115747528854,329,19,1,349
80867,unwisebluefaint,sv1,9,0.993720049614593,332,18,1,351
80679,elgqso,sv1,0,0.989385428218214,238,58,36,332
80679,elgqso,sv1,1,0.9854266416059163,220,34,40,294
80679,elgqso,sv1,2,0.9918572738351981,217,47,47,311
80679,elgqso,sv1,3,0.9454356736844354,63,8,7,78
80679,elgqso,sv1,4,0.9892415524178035,230,57,30,317
80679,elgqso,sv1,5,0.9923136163177313,234,30,31,295
80679,elgqso,sv1,6,0.9829632070684852,237,35,31,303
80679,elgqso,sv1,7,0.9863904209895762,213,34,30,277
80679,elgqso,sv1,8,0.9861167681302879,227,40,37,304
80679,elgqso,sv1,9,0.9922891227072618,252,47,37,336
80863,mwclusgaldeep,sv1,0,0.9965947085320058,5,309,31,345
80863,mwclusgaldeep,sv1,1,0.9897729164167003,5,301,27,333
80863,mwclusgaldeep,sv1,2,0.9950069804534803,9,334,22,365
80863,mwclusgaldeep,sv1,3,0.9869003214004324,10,289,21,320
80863,mwclusgaldeep,sv1,4,0.994976130675258,5,312,22,339
80863,mwclusgaldeep,sv1,5,0.9886979488868592,19,283,30,332
80863,mwclusgaldeep,sv1,6,0.9886979488868592,19,283,30,332
80863,mwclusgaldeep,sv1,7,0.9968649907151141,7,269,29,305
80863,mwclusgaldeep,sv1,8,0.9924769639694013,3,310,24,337
80863,mwclusgaldeep,sv1,9,0.992878685059311,7,332,24,363
80695,elg,sv1,0,0.9942289567152871,294,14,8,316
80695,elg,sv1,1,0.987635770419929,282,9,3,294
80695,elg,sv1,2,0.9924039473944442,276,12,9,297
80695,elg,sv1,3,0.9927415623242063,269,6,7,282
80695,elg,sv1,4,0.9903936598149702,258,11,4,273
80695,elg,sv1,5,0.9843294424882164,252,10,11,273
80695,elg,sv1,6,0.9848811338776652,263,4,9,276
80695,elg,sv1,7,0.9926553996540184,242,5,7,254
80695,elg,sv1,8,0.9921568300396802,305,2,12,319
80695,elg,sv1,9,0.989582299577402,304,8,8,320
80888,elg,sv1,0,0.9870579601562233,223,32,9,264
80888,elg,sv1,1,0.9923856522121011,202,31,8,241
80888,elg,sv1,2,0.9867535426263186,216,36,5,257
80888,elg,sv1,3,0.9843408456759902,201,26,6,233
80888,elg,sv1,4,0.9891040652626834,233,24,6,263
80888,elg,sv1,5,0.9942784383843951,217,31,6,254
80888,elg,sv1,6,0.9942784383843951,217,31,6,254
80888,elg,sv1,7,0.9893649847827721,185,29,6,220
80888,elg,sv1,8,0.973740080979885,170,23,5,198
80888,elg,sv1,9,0.9929852787169289,233,35,11,279
80856,lrgqso,sv1,0,0.9922928205617509,191,58,74,323
80856,lrgqso,sv1,1,0.9842650990975134,193,48,75,316
80856,lrgqso,sv1,2,0.9879782796524705,221,39,74,334
80856,lrgqso,sv1,3,0.9794785388671639,192,50,63,305
80856,lrgqso,sv1,4,0.9954579029979106,204,37,75,316
80856,lrgqso,sv1,5,0.9925199681600144,197,44,69,310
80856,lrgqso,sv1,6,0.9925199681600144,197,44,69,310
80856,lrgqso,sv1,7,0.9889203910515107,167,53,62,282
80856,lrgqso,sv1,8,0.9864906437647217,217,38,71,326
80856,lrgqso,sv1,9,0.9881117912634106,206,54,81,341
80698,lrgqso,sv1,0,0.993554356855802,200,63,75,338
80698,lrgqso,sv1,1,0.9910512603228554,188,58,68,314
80698,lrgqso,sv1,2,0.9882733377762953,223,55,67,345
80698,lrgqso,sv1,3,0.9944745283112271,193,40,68,301
80698,lrgqso,sv1,4,0.9948047282265927,180,62,85,327
80698,lrgqso,sv1,5,0.9835851948260043,225,40,72,337
80698,lrgqso,sv1,6,0.9835851948260043,225,40,72,337
80698,lrgqso,sv1,7,0.9904702573151724,177,40,60,277
80698,lrgqso,sv1,8,0.9922185932971946,210,54,65,329
80698,lrgqso,sv1,9,0.9769446186276172,210,49,83,342
80882,elg,sv1,0,0.9873252585908383,251,39,15,305
80882,elg,sv1,1,0.996047823266796,225,34,9,268
80882,elg,sv1,2,0.9889775138052319,241,38,9,288
80882,elg,sv1,3,0.9865044783727125,233,37,5,275
80882,elg,sv1,4,0.9928832496411273,215,35,6,256
80882,elg,sv1,5,0.9816945936130838,227,30,9,266
80882,elg,sv1,6,0.9816945936130838,227,30,9,266
80882,elg,sv1,7,0.983024446429818,180,33,8,221
80882,elg,sv1,8,0.9906712449576376,217,34,6,257
80882,elg,sv1,9,0.9899311385918609,239,41,9,289
80689,elg,sv1,0,0.9900829004119887,261,31,9,301
80689,elg,sv1,1,0.9829434778876579,261,16,7,284
80689,elg,sv1,2,0.9881751228236597,245,33,9,287
80689,elg,sv1,3,0.9876917157744886,228,14,2,244
80689,elg,sv1,4,0.9786124003512108,247,30,8,285
80689,elg,sv1,5,0.9950104776740774,251,35,6,292
80689,elg,sv1,6,0.9918508080707331,274,7,9,290
80689,elg,sv1,7,0.9878207440667194,252,13,8,273
80689,elg,sv1,8,0.9958283480860074,263,21,5,289
80689,elg,sv1,9,0.9922081065398091,293,19,6,318
80876,elg,sv1,0,0.9947788324521795,233,31,8,272
80876,elg,sv1,1,0.9869807068482717,223,30,7,260
80876,elg,sv1,2,0.9908846139106138,228,30,7,265
80876,elg,sv1,3,0.9931663759108081,219,22,5,246
80876,elg,sv1,4,0.9943976922674411,217,26,11,254
80876,elg,sv1,5,0.9839075347203792,246,14,7,267
80876,elg,sv1,6,0.9839075347203792,246,14,7,267
80876,elg,sv1,7,0.9758555581798501,197,15,8,220
80876,elg,sv1,8,0.9779759367587048,224,27,5,256
80876,elg,sv1,9,0.9873728502957831,258,20,9,287
80875,lrgqso2,sv1,0,0.9922056286097041,148,29,56,233
80875,lrgqso2,sv1,1,0.9876435679458493,130,28,53,211
80875,lrgqso2,sv1,2,0.9823318546933304,136,25,56,217
80875,lrgqso2,sv1,3,0.9701474800282694,117,36,45,198
80875,lrgqso2,sv1,4,0.9863824157155086,142,29,40,211
80875,lrgqso2,sv1,5,0.9908921737566813,139,15,51,205
80875,lrgqso2,sv1,6,0.9908921737566813,139,15,51,205
80875,lrgqso2,sv1,7,0.9907472562102638,137,16,37,190
80875,lrgqso2,sv1,8,0.9892184423287899,152,33,41,226
80875,lrgqso2,sv1,9,0.9850850805106491,161,20,54,235
80647,bgsmws,sv1,0,0.9900722062513422,272,99,7,378
80647,bgsmws,sv1,1,0.989578228658764,257,88,4,349
80647,bgsmws,sv1,2,0.9959392978085692,272,91,3,366
80647,bgsmws,sv1,3,0.9881493397738339,219,117,4,340
80647,bgsmws,sv1,4,0.9841765025224029,224,123,5,352
80647,bgsmws,sv1,5,0.9837387199360837,229,121,4,354
80647,bgsmws,sv1,6,0.9946539581671459,246,120,4,370
80647,bgsmws,sv1,7,0.9929736780872925,223,95,1,319
80647,bgsmws,sv1,8,0.9922106499651419,240,120,4,364
80647,bgsmws,sv1,9,0.989105685244539,262,125,0,387
80702,lrgqso,sv1,0,0.9876476966670743,188,74,74,336
80702,lrgqso,sv1,1,0.9911206350576985,160,100,44,304
80702,lrgqso,sv1,2,0.9841476809726096,155,115,50,320
80702,lrgqso,sv1,3,0.9931270340447633,159,88,53,300
80702,lrgqso,sv1,4,0.9825354844133856,222,68,39,329
80702,lrgqso,sv1,5,0.992314705129312,141,103,67,311
80702,lrgqso,sv1,6,0.992314705129312,141,103,67,311
80702,lrgqso,sv1,7,0.9834724940818842,130,83,57,270
80702,lrgqso,sv1,8,0.992511915733311,186,78,43,307
80702,lrgqso,sv1,9,0.9871857263953181,195,85,71,351
80859,lrgqso,sv1,0,0.9928825339589026,196,72,65,333
80859,lrgqso,sv1,1,0.9917331364800841,178,55,57,290
80859,lrgqso,sv1,2,0.9912450799019672,170,76,75,321
80859,lrgqso,sv1,3,0.9951720331586086,170,65,67,302
80859,lrgqso,sv1,4,0.9931334558923982,154,67,83,304
80859,lrgqso,sv1,5,0.9919750469458416,183,65,59,307
80859,lrgqso,sv1,6,0.9919750469458416,183,65,59,307
80859,lrgqso,sv1,7,0.982979966203015,149,56,57,262
80859,lrgqso,sv1,8,0.9899572425360861,162,78,68,308
80859,lrgqso,sv1,9,0.9915391430144538,207,71,45,323
80879,lrgqso2,sv1,0,0.9872411798093746,223,31,80,334
80879,lrgqso2,sv1,1,0.9932377054687295,194,32,86,312
80879,lrgqso2,sv1,2,0.9939351754107331,231,35,73,339
80879,lrgqso2,sv1,3,0.9760570551225861,216,14,82,312
80879,lrgqso2,sv1,4,0.9918946378927358,204,34,71,309
80879,lrgqso2,sv1,5,0.991103231023605,222,30,62,314
80879,lrgqso2,sv1,6,0.991103231023605,222,30,62,314
80879,lrgqso2,sv1,7,0.9873028100987608,187,27,67,281
80879,lrgqso2,sv1,8,0.9917318626987672,215,35,84,334
80879,lrgqso2,sv1,9,0.9948694631671637,240,24,82,346
80737,ssv,sv1,0,0.986099430193401,16,314,3,333
80737,ssv,sv1,1,0.9847197279092574,6,312,1,319
80737,ssv,sv1,2,0.9866489945166905,3,348,4,355
80737,ssv,sv1,3,0.9925039398999267,4,312,3,319
80737,ssv,sv1,4,0.9805382531628126,6,321,4,331
80737,ssv,sv1,5,0.9854479538326193,5,336,2,343
80737,ssv,sv1,6,0.9854479538326193,5,336,2,343
80737,ssv,sv1,7,0.9916646043687595,2,294,0,296
80737,ssv,sv1,8,0.9917209201391526,13,319,2,334
80737,ssv,sv1,9,0.9894312509175288,27,326,3,356
80619,bgsmws,sv1,0,0.9883970436980034,230,134,1,365
80619,bgsmws,sv1,1,0.992749776681921,231,98,3,332
80619,bgsmws,sv1,2,0.9851558225436948,228,116,2,346
80619,bgsmws,sv1,3,0.9905915848636666,224,97,2,323
80619,bgsmws,sv1,4,0.9908867021014793,235,78,1,314
80619,bgsmws,sv1,5,0.9905457047563877,257,72,5,334
80619,bgsmws,sv1,6,0.9913430107676446,292,73,1,366
80619,bgsmws,sv1,7,0.9884016155078325,227,75,2,304
80619,bgsmws,sv1,8,0.9930378111627917,270,89,3,362
80619,bgsmws,sv1,9,0.9971454866759875,269,94,8,371
80650,bgsmws,sv1,0,0.9898578043115446,287,84,5,376
80650,bgsmws,sv1,1,0.9943029904377361,270,72,2,344
80650,bgsmws,sv1,2,0.9869437214411456,276,88,1,365
80650,bgsmws,sv1,3,0.9951868008621225,237,89,2,328
80650,bgsmws,sv1,4,0.9922845552914671,230,112,2,344
80650,bgsmws,sv1,5,0.9909210269010005,211,137,3,351
80650,bgsmws,sv1,6,0.9878692660115787,272,89,6,367
80650,bgsmws,sv1,7,0.9897575758678974,221,92,5,318
80650,bgsmws,sv1,8,0.9948303674065475,259,97,5,361
80650,bgsmws,sv1,9,0.9943400641351965,313,64,8,385
80661,bgsmws,sv1,0,0.9929627377180212,320,61,4,385
80661,bgsmws,sv1,1,0.9895219979960888,228,115,1,344
80661,bgsmws,sv1,2,0.9865897409031031,218,132,3,353
80661,bgsmws,sv1,3,0.9758407698661183,205,115,5,325
80661,bgsmws,sv1,4,0.9929683374346694,256,92,3,351
80661,bgsmws,sv1,5,0.9934294311368758,261,92,4,357
80661,bgsmws,sv1,6,0.9922023465486252,255,108,5,368
80661,bgsmws,sv1,7,0.9910044281054493,214,96,3,313
80661,bgsmws,sv1,8,0.9946694450863302,256,109,1,366
80661,bgsmws,sv1,9,0.9921220843855493,293,87,5,385
80655,bgsmws,sv1,0,0.9926481591986221,267,105,4,376
80655,bgsmws,sv1,1,0.9940691226294317,262,84,2,348
80655,bgsmws,sv1,2,0.9858666464335811,262,99,2,363
80655,bgsmws,sv1,3,0.9892740532471362,231,92,4,327
80655,bgsmws,sv1,4,0.9819268627926826,246,95,4,345
80655,bgsmws,sv1,5,0.9946889352463347,239,103,4,346
80655,bgsmws,sv1,6,0.9969655230039842,272,71,7,350
80655,bgsmws,sv1,7,0.988688510006429,237,67,2,306
80655,bgsmws,sv1,8,0.9917585662533898,225,138,2,365
80655,bgsmws,sv1,9,0.994681144613612,278,97,5,380
80665,bgsmws,sv1,0,0.9884934534894608,297,81,5,383
80665,bgsmws,sv1,1,0.9896301861053777,265,71,2,338
80665,bgsmws,sv1,2,0.9967994224340009,261,95,4,360
80665,bgsmws,sv1,3,0.9906462411346066,270,62,1,333
80665,bgsmws,sv1,4,0.9879152861060513,292,66,1,359
80665,bgsmws,sv1,5,0.995290999271991,264,88,5,357
80665,bgsmws,sv1,6,0.9908180881326052,267,107,2,376
80665,bgsmws,sv1,7,0.9950727667062108,233,84,2,319
80665,bgsmws,sv1,8,0.9845065031205116,294,66,5,365
80665,bgsmws,sv1,9,0.9859739712019706,288,90,3,381
80730,ssv,sv1,0,0.9859054677578883,6,312,3,321
80730,ssv,sv1,1,0.9791080034989349,2,155,5,162
80730,ssv,sv1,2,0.990534635514198,2,306,1,309
80730,ssv,sv1,3,0.9715139682325116,2,186,2,190
80730,ssv,sv1,4,0.9827320771394984,6,312,12,330
80730,ssv,sv1,5,0.9864322550222202,8,327,4,339
80730,ssv,sv1,6,0.9775091201571117,1,183,4,188
80730,ssv,sv1,7,0.993842496326034,2,147,6,155
80730,ssv,sv1,8,0.9813820105695514,2,162,4,168
80730,ssv,sv1,9,0.9716993747488286,1,193,7,201
80663,bgsmws,sv1,0,0.9915353410889252,295,82,1,378
80663,bgsmws,sv1,1,0.9891399542681574,246,92,4,342
80663,bgsmws,sv1,2,0.9861481870128359,275,94,5,374
80663,bgsmws,sv1,3,0.9926788394455061,269,73,3,345
80663,bgsmws,sv1,4,0.9897497479478696,263,88,1,352
80663,bgsmws,sv1,5,0.9927733830486267,276,76,2,354
80663,bgsmws,sv1,6,0.9903469572841181,302,72,3,377
80663,bgsmws,sv1,7,0.9876689053252884,246,66,3,315
80663,bgsmws,sv1,8,0.9889157995835257,283,82,0,365
80663,bgsmws,sv1,9,0.9914924145723504,272,114,2,388
80662,bgsmws,sv1,0,0.9882296561711893,294,81,3,378
80662,bgsmws,sv1,1,0.986348991339754,257,79,2,338
80662,bgsmws,sv1,2,0.9926931866631991,277,91,5,373
80662,bgsmws,sv1,3,0.9946695848226246,254,80,3,337
80662,bgsmws,sv1,4,0.988012170967735,261,88,4,353
80662,bgsmws,sv1,5,0.9883111820225603,304,57,1,362
80662,bgsmws,sv1,6,0.9909022528943742,305,68,5,378
80662,bgsmws,sv1,7,0.990137716130781,236,72,4,312
80662,bgsmws,sv1,8,0.9894462771715891,262,94,7,363
80662,bgsmws,sv1,9,0.989348915068849,285,101,1,387
80732,ssv,sv1,0,0.9894640926344179,1,369,1,371
80732,ssv,sv1,1,0.9867388898762138,2,226,1,229
80732,ssv,sv1,2,0.9892918297222233,0,348,4,352
80732,ssv,sv1,3,0.9887957222137731,1,203,2,206
80732,ssv,sv1,4,0.9922355590617589,1,338,5,344
80732,ssv,sv1,5,0.9866680049118616,0,347,6,353
80732,ssv,sv1,6,0.9891675041928238,0,241,5,246
80732,ssv,sv1,7,0.9790980490926436,2,202,2,206
80732,ssv,sv1,8,0.9889862765751212,0,239,3,242
80732,ssv,sv1,9,0.9917036795212504,1,264,3,268
81058,bright,sv2,0,0.9856177689607926,298,33,5,336
81058,bright,sv2,1,0.9848724714945697,284,21,4,309
81058,bright,sv2,2,0.9910188002699278,325,23,3,351
81058,bright,sv2,3,0.9890680144039573,263,25,3,291
81058,bright,sv2,4,0.9880927472442664,290,20,4,314
81058,bright,sv2,5,0.9890523087862937,303,25,1,329
81058,bright,sv2,6,0.9890523087862937,303,25,1,329
81058,bright,sv2,7,0.9873798433217688,228,22,2,252
81058,bright,sv2,8,0.9929982060124416,310,23,1,334
81058,bright,sv2,9,0.9882739664069969,317,29,0,346
81060,bright,sv2,0,0.9947751748797751,313,28,1,342
81060,bright,sv2,1,0.9922822795594124,260,43,6,309
81060,bright,sv2,2,0.9915160568553368,285,61,1,347
81060,bright,sv2,3,0.9870212693257452,257,34,6,297
81060,bright,sv2,4,0.9864806494313924,277,31,3,311
81060,bright,sv2,5,0.990082356669944,261,28,1,290
81060,bright,sv2,6,0.990082356669944,261,28,1,290
81060,bright,sv2,7,0.9851171749095113,232,20,1,253
81060,bright,sv2,8,0.9968299937154207,299,33,5,337
81060,bright,sv2,9,0.9929766499143213,288,49,6,343
80613,bgsmws,sv1,0,0.9930502458277979,268,109,0,377
80613,bgsmws,sv1,1,0.9891103427219886,252,95,2,349
80613,bgsmws,sv1,2,0.9910432190717786,247,115,2,364
80613,bgsmws,sv1,3,0.9904540784484156,262,65,1,328
80613,bgsmws,sv1,4,0.9867444332591652,232,113,2,347
80613,bgsmws,sv1,5,0.9911342879747812,252,99,7,358
80613,bgsmws,sv1,6,0.9918771077618345,263,98,3,364
80613,bgsmws,sv1,7,0.9909774481872774,236,74,2,312
80613,bgsmws,sv1,8,0.9931780131454767,248,107,2,357
80613,bgsmws,sv1,9,0.9903526912916857,270,106,5,381
81056,bright,sv2,0,0.991444088648065,305,37,3,345
81056,bright,sv2,1,0.9910030228663469,279,27,5,311
81056,bright,sv2,2,0.9942635456983422,325,28,4,357
81056,bright,sv2,3,0.9889813475630592,265,21,4,290
81056,bright,sv2,4,0.9846321974095466,282,26,4,312
81056,bright,sv2,5,0.9905657149076099,292,30,5,327
81056,bright,sv2,6,0.9905657149076099,292,30,5,327
81056,bright,sv2,7,0.9780459392534239,218,29,3,250
81056,bright,sv2,8,0.98266672312801,315,16,2,333
81056,bright,sv2,9,0.9934980468988738,322,28,2,352
81061,bright,sv2,0,0.9907628892647151,305,29,9,343
81061,bright,sv2,1,0.9846290729936352,289,22,2,313
81061,bright,sv2,2,0.9872148380325256,326,24,2,352
81061,bright,sv2,3,0.9822749860049049,270,25,3,298
81061,bright,sv2,4,0.9857749443596829,287,25,1,313
81061,bright,sv2,5,0.9927533590217815,268,26,2,296
81061,bright,sv2,6,0.9927533590217815,268,26,2,296
81061,bright,sv2,7,0.9938791659791099,234,14,2,250
81061,bright,sv2,8,0.984485163971142,308,19,1,328
81061,bright,sv2,9,0.9951996483465272,323,31,5,359
81059,bright,sv2,0,0.9911383921236462,327,15,2,344
81059,bright,sv2,1,0.9938883417929693,286,25,2,313
81059,bright,sv2,2,0.9869784237861248,324,24,5,353
81059,bright,sv2,3,0.9927758378321336,255,35,2,292
81059,bright,sv2,4,0.9974560215640748,280,35,1,316
81059,bright,sv2,5,0.9941640501927451,290,34,2,326
81059,bright,sv2,6,0.9941640501927451,290,34,2,326
81059,bright,sv2,7,0.9947710416391818,220,30,4,254
81059,bright,sv2,8,0.9863118765244073,286,44,3,333
81059,bright,sv2,9,0.9913200926263104,329,18,2,349
80726,ssv,sv1,0,0.9855090973222863,3,357,3,363
80726,ssv,sv1,1,0.9885014800386562,5,332,3,340
80726,ssv,sv1,2,0.9870576631040454,7,347,4,358
80726,ssv,sv1,3,0.9898379295173767,7,314,0,321
80726,ssv,sv1,4,0.9942640897085063,4,333,3,340
80726,ssv,sv1,5,0.9908490725684694,7,336,1,344
80726,ssv,sv1,6,0.9908490725684694,7,336,1,344
80726,ssv,sv1,7,0.983483919417682,1,303,1,305
80726,ssv,sv1,8,0.9902655344811001,3,348,1,352
80726,ssv,sv1,9,0.9885196371694301,3,347,1,351
81057,bright,sv2,0,0.9878548430347454,283,58,3,344
81057,bright,sv2,1,0.9910263618030277,280,25,3,308
81057,bright,sv2,2,0.9874321068582345,312,36,3,351
81057,bright,sv2,3,0.9852374801662978,267,22,4,293
81057,bright,sv2,4,0.9864649354189791,291,23,2,316
81057,bright,sv2,5,0.9924075013054716,301,13,8,322
81057,bright,sv2,6,0.9924075013054716,301,13,8,322
81057,bright,sv2,7,0.9880046571485821,236,18,0,254
81057,bright,sv2,8,0.9801570588822044,314,19,0,333
81057,bright,sv2,9,0.9883491564165775,312,31,3,346
81066,bright,sv2,0,0.9947652637783008,284,70,4,358
81066,bright,sv2,1,0.9882463532761999,272,37,0,309
81066,bright,sv2,2,0.9875302378482794,323,23,0,346
81066,bright,sv2,3,0.9882971102122576,241,15,6,262
81066,bright,sv2,4,0.9906759636428525,297,22,1,320
81066,bright,sv2,5,0.99201156685471,320,19,1,340
81066,bright,sv2,6,0.99201156685471,320,19,1,340
81066,bright,sv2,7,0.981384084453601,226,30,2,258
81066,bright,sv2,8,0.9909305351232613,273,58,7,338
81066,bright,sv2,9,0.988063745545973,286,64,2,352
81064,bright,sv2,0,0.987505242888766,337,17,4,358
81064,bright,sv2,1,0.986243258219958,259,49,4,312
81064,bright,sv2,2,0.9842486133143946,247,101,2,350
81064,bright,sv2,3,0.9888212762361317,273,14,4,291
81064,bright,sv2,4,0.9872613179360273,283,26,9,318
81064,bright,sv2,5,0.9939969455185845,250,78,6,334
81064,bright,sv2,6,0.9939969455185845,250,78,6,334
81064,bright,sv2,7,0.9894313562412214,236,20,3,259
81064,bright,sv2,8,0.9935781911161787,295,42,9,346
81064,bright,sv2,9,0.99287007181518,321,25,6,352
81065,bright,sv2,0,0.9921455724626558,265,83,3,351
81065,bright,sv2,1,0.9837429912480553,222,82,1,305
81065,bright,sv2,2,0.9921090582257146,235,111,4,350
81065,bright,sv2,3,0.981310175741726,241,35,3,279
81065,bright,sv2,4,0.9914818732611508,284,30,2,316
81065,bright,sv2,5,0.9889518408675081,291,38,2,331
81065,bright,sv2,6,0.9889518408675081,291,38,2,331
81065,bright,sv2,7,0.9825546997105384,215,45,2,262
81065,bright,sv2,8,0.9923223506647912,259,84,2,345
81065,bright,sv2,9,0.9930808560908183,269,84,6,359
81063,bright,sv2,0,0.9903279286171545,321,36,3,360
81063,bright,sv2,1,0.9851391715577859,292,26,5,323
81063,bright,sv2,2,0.9927664977989821,271,84,1,356
81063,bright,sv2,3,0.9932457577552622,279,17,4,300
81063,bright,sv2,4,0.9849866988099963,299,19,2,320
81063,bright,sv2,5,0.9918174678237369,311,26,2,339
81063,bright,sv2,6,0.9918174678237369,311,26,2,339
81063,bright,sv2,7,0.9898074743844527,228,34,2,264
81063,bright,sv2,8,0.989875326505628,307,38,4,349
81063,bright,sv2,9,0.9899783349893307,334,18,3,355
81062,bright,sv2,0,0.9912854525769188,330,27,1,358
81062,bright,sv2,1,0.9949594671550022,291,24,4,319
81062,bright,sv2,2,0.9933007754442428,334,19,2,355
81062,bright,sv2,3,0.9904720659828332,276,24,4,304
81062,bright,sv2,4,0.9884852169538895,302,18,2,322
81062,bright,sv2,5,0.9859023159986068,303,29,5,337
81062,bright,sv2,6,0.9859023159986068,303,29,5,337
81062,bright,sv2,7,0.9748612605637818,226,32,2,260
81062,bright,sv2,8,0.994276533691796,317,30,4,351
81062,bright,sv2,9,0.9879779228642369,312,35,3,350
81067,bright,sv2,0,0.9898138446060885,292,57,3,352
81067,bright,sv2,1,0.9938423113263432,270,44,2,316
81067,bright,sv2,2,0.9910114934555144,274,81,3,358
81067,bright,sv2,3,0.9864856641557611,233,55,2,290
81067,bright,sv2,4,0.9945512223148639,242,72,4,318
81067,bright,sv2,5,0.9873926613909532,229,90,3,322
81067,bright,sv2,6,0.9873926613909532,229,90,3,322
81067,bright,sv2,7,0.992428155816663,207,52,3,262
81067,bright,sv2,8,0.9887765318684053,315,26,2,343
81067,bright,sv2,9,0.9921853572260927,321,31,6,358
80722,ssv,sv1,0,0.9915738929612486,1,363,0,364
80722,ssv,sv1,1,0.9938015029599898,2,341,0,343
80722,ssv,sv1,2,0.9927686259631388,1,363,0,364
80722,ssv,sv1,3,0.9955754198003258,1,344,0,345
80722,ssv,sv1,4,0.9931084700731251,2,345,0,347
80722,ssv,sv1,5,0.996366177235768,2,353,0,355
80722,ssv,sv1,6,0.993464716890229,0,367,3,370
80722,ssv,sv1,7,0.9803517304696517,0,315,0,315
80722,ssv,sv1,8,0.9933346715854652,0,371,0,371
80722,ssv,sv1,9,0.9951986930279283,2,387,0,389
80651,bgsmws,sv1,0,0.9923946563688077,286,86,7,379
80651,bgsmws,sv1,1,0.994380192626013,256,80,2,338
80651,bgsmws,sv1,2,0.9879164898587844,289,80,5,374
80651,bgsmws,sv1,3,0.9920663154406602,238,89,6,333
80651,bgsmws,sv1,4,0.9934278558494798,241,93,6,340
80651,bgsmws,sv1,5,0.9923336051739479,263,79,5,347
80651,bgsmws,sv1,6,0.989508541038459,274,88,5,367
80651,bgsmws,sv1,7,0.9920197923455284,213,75,4,292
80651,bgsmws,sv1,8,0.9920587289395112,286,75,2,363
80651,bgsmws,sv1,9,0.9948782014992456,293,86,6,385
80724,ssv,sv1,0,0.985417757155305,3,358,0,361
80724,ssv,sv1,1,0.9935328193437111,4,323,1,328
80724,ssv,sv1,2,0.9932515775863442,2,353,1,356
80724,ssv,sv1,3,0.9911368767804996,1,318,1,320
80724,ssv,sv1,4,0.9892300877522359,6,323,1,330
80724,ssv,sv1,5,0.9883347859054219,7,328,1,336
80724,ssv,sv1,6,0.9883347859054219,7,328,1,336
80724,ssv,sv1,7,0.9883347859054219,7,328,1,336
80724,ssv,sv1,8,0.9927228837361788,6,337,2,345
80724,ssv,sv1,9,0.9911040853385585,8,346,3,357
80618,bgsmws,sv1,0,0.9881056787423808,271,106,2,379
80618,bgsmws,sv1,1,0.9933956565944329,260,76,1,337
80618,bgsmws,sv1,2,0.9909176481710528,235,135,3,373
80618,bgsmws,sv1,3,0.9930240770384072,239,90,2,331
80618,bgsmws,sv1,4,0.9914649943359686,272,69,3,344
80618,bgsmws,sv1,5,0.9886786696152329,268,79,5,352
80618,bgsmws,sv1,6,0.9914493549810186,258,108,2,368
80618,bgsmws,sv1,7,0.9925313721572743,200,105,2,307
80618,bgsmws,sv1,8,0.9890629209506212,239,117,3,359
80618,bgsmws,sv1,9,0.9938971439784374,263,120,3,386
80644,bgsmws,sv1,0,0.9870762188642634,246,135,1,382
80644,bgsmws,sv1,1,0.9915299218320984,213,123,0,336
80644,bgsmws,sv1,2,0.9930367899912637,222,140,5,367
80644,bgsmws,sv1,3,0.9922405477792949,196,136,0,332
80644,bgsmws,sv1,4,0.9916583678702808,242,110,3,355
80644,bgsmws,sv1,5,0.9937472290458428,244,114,3,361
80644,bgsmws,sv1,6,0.9909612511213111,222,145,5,372
80644,bgsmws,sv1,7,0.9898486310081918,209,105,0,314
80644,bgsmws,sv1,8,0.9942214598749493,244,119,1,364
80644,bgsmws,sv1,9,0.9934473572001428,256,131,3,390
80742,bgsmws,sv1,0,0.9926219759578271,292,68,3,363
80742,bgsmws,sv1,1,0.9873005202333646,245,94,3,342
80742,bgsmws,sv1,2,0.9913700592060639,275,93,5,373
80742,bgsmws,sv1,3,0.99010180424888,265,72,2,339
80742,bgsmws,sv1,4,0.9887432286705448,267,83,1,351
80742,bgsmws,sv1,5,0.9940869023204839,323,24,3,350
80742,bgsmws,sv1,6,0.9857693259044706,254,106,4,364
80742,bgsmws,sv1,7,0.989021524069672,196,119,0,315
80742,bgsmws,sv1,8,0.9963318490193251,268,95,6,369
80742,bgsmws,sv1,9,0.9914497685145824,268,116,5,389
80740,bgsmws,sv1,0,0.9933130043752311,269,86,1,356
80740,bgsmws,sv1,1,0.9915011509016346,277,53,3,333
80740,bgsmws,sv1,2,0.9931737088320374,305,52,3,360
80740,bgsmws,sv1,3,0.991951486733622,278,46,4,328
80740,bgsmws,sv1,4,0.9821911848333564,296,42,0,338
80740,bgsmws,sv1,5,0.9861220502667641,288,53,5,346
80740,bgsmws,sv1,6,0.9861220502667641,288,53,5,346
80740,bgsmws,sv1,7,0.9902546330186419,218,76,1,295
80740,bgsmws,sv1,8,0.9934612346321703,253,89,1,343
80740,bgsmws,sv1,9,0.9831804006290301,262,96,3,361
80614,bgsmws,sv1,0,0.9903213447013356,268,111,4,383
80614,bgsmws,sv1,1,0.9915001719313747,247,83,2,332
80614,bgsmws,sv1,2,0.9907006780696244,285,74,1,360
80614,bgsmws,sv1,3,0.992617691693547,255,87,4,346
80614,bgsmws,sv1,4,0.9930619258841729,304,42,3,349
80614,bgsmws,sv1,5,0.9927638414943638,287,56,5,348
80614,bgsmws,sv1,6,0.992920578329803,220,84,3,307
80614,bgsmws,sv1,7,0.980707128772294,219,88,6,313
80614,bgsmws,sv1,8,0.9951412595489649,258,100,3,361
80614,bgsmws,sv1,9,0.9924193594287477,277,101,4,382
80657,bgsmws,sv1,0,0.992384059300826,272,95,4,371
80657,bgsmws,sv1,1,0.9863859093440859,228,93,1,322
80657,bgsmws,sv1,2,0.9952929332218731,269,98,3,370
80657,bgsmws,sv1,3,0.9926765226906116,291,51,1,343
80657,bgsmws,sv1,4,0.9925235027717983,248,85,5,338
80657,bgsmws,sv1,5,0.9892889571549282,265,88,2,355
80657,bgsmws,sv1,6,0.9935203858934482,290,73,6,369
80657,bgsmws,sv1,7,0.9933710333390369,214,85,4,303
80657,bgsmws,sv1,8,0.9926321599273341,257,96,5,358
80657,bgsmws,sv1,9,0.9872937081216255,253,117,5,375
80652,bgsmws,sv1,0,0.9925270212965033,295,70,4,369
80652,bgsmws,sv1,1,0.9835000025327727,253,74,2,329
80652,bgsmws,sv1,2,0.9846664979214771,239,97,5,341
80652,bgsmws,sv1,3,0.9831780585399779,240,77,8,325
80652,bgsmws,sv1,4,0.994323218608109,257,79,3,339
80652,bgsmws,sv1,5,0.989721822984316,260,71,2,333
80652,bgsmws,sv1,6,0.9958203796747997,278,77,3,358
80652,bgsmws,sv1,7,0.9946669170750371,228,51,5,284
80652,bgsmws,sv1,8,0.9917177060155508,229,92,8,329
80652,bgsmws,sv1,9,0.9931300517161253,237,106,1,344
80728,ssv,sv1,0,0.990350813035123,1,366,5,372
80728,ssv,sv1,1,0.9793696801811619,4,190,3,197
80728,ssv,sv1,2,0.99346564671559,1,355,3,359
80728,ssv,sv1,3,0.9831032844761657,3,210,1,214
80728,ssv,sv1,4,0.9897050759481035,0,337,5,342
80728,ssv,sv1,5,0.9900927597945505,3,340,6,349
80728,ssv,sv1,6,0.9715436023232221,3,208,4,215
80728,ssv,sv1,7,0.9876539643137661,1,160,3,164
80728,ssv,sv1,8,0.9748312799651966,2,211,6,219
80728,ssv,sv1,9,0.9829714514741389,1,229,3,233
81068,bright,sv2,0,0.9862641111021949,116,31,0,147
81068,bright,sv2,1,0.9916798501424068,220,86,4,310
81068,bright,sv2,2,0.9968348461192618,257,88,2,347
81068,bright,sv2,3,0.9904023377663435,268,32,2,302
81068,bright,sv2,4,0.9849459467638068,270,41,2,313
81068,bright,sv2,5,0.9916559340142189,277,52,2,331
81068,bright,sv2,6,0.9900550571853168,203,92,0,295
81068,bright,sv2,7,0.9823885978438517,181,72,4,257
81068,bright,sv2,8,0.9909000039628544,298,42,2,342
81068,bright,sv2,9,0.9800760182489858,307,49,2,358
81072,bright,sv2,0,0.9945420044089416,214,138,8,360
81072,bright,sv2,1,0.9895738495159918,246,68,2,316
81072,bright,sv2,2,0.991176688099244,299,50,2,351
81072,bright,sv2,3,0.9866198201871673,229,70,0,299
81072,bright,sv2,4,0.9896627827701061,213,108,2,323
81072,bright,sv2,5,0.9865877336430929,205,124,4,333
81072,bright,sv2,6,0.9945718909376238,198,119,1,318
81072,bright,sv2,7,0.9903488638606583,169,84,3,256
81072,bright,sv2,8,0.991132977016643,251,90,3,344
81072,bright,sv2,9,0.990640104507955,256,95,2,353
81069,bright,sv2,0,0.9904490203084774,262,74,5,341
81069,bright,sv2,1,0.9921874609112841,252,47,3,302
81069,bright,sv2,2,0.9924787051808157,275,50,3,328
81069,bright,sv2,3,0.9911612620223559,216,61,2,279
81069,bright,sv2,4,0.9937510254500729,245,63,3,311
81069,bright,sv2,5,0.9938493487305812,255,46,4,305
81069,bright,sv2,6,0.9876355134871511,223,56,4,283
81069,bright,sv2,7,0.994768718128469,205,41,5,251
81069,bright,sv2,8,0.9926167775502932,285,46,2,333
81069,bright,sv2,9,0.9881290493355329,293,44,3,340
81074,bright,sv2,0,0.9924664444107042,287,67,1,355
81074,bright,sv2,1,0.9900664103077327,257,46,2,305
81074,bright,sv2,2,0.9934425946781182,306,51,0,357
81074,bright,sv2,3,0.9882701080230537,275,22,1,298
81074,bright,sv2,4,0.9898044919111656,290,27,3,320
81074,bright,sv2,5,0.9868072648011504,308,22,5,335
81074,bright,sv2,6,0.9879585009834865,252,52,2,306
81074,bright,sv2,7,0.9851178578794159,228,29,3,260
81074,bright,sv2,8,0.9882865987887142,284,53,2,339
81074,bright,sv2,9,0.9910161754523662,284,59,2,345
81003,dark,sv2,1,0.993534164886097,185,24,75,284
81003,dark,sv2,2,0.9890062243871982,208,23,83,314
81003,dark,sv2,3,0.9875809404250528,184,34,64,282
81003,dark,sv2,4,0.9900293948929595,189,27,74,290
81003,dark,sv2,5,0.9916690411104797,199,24,75,298
81003,dark,sv2,6,0.9809705273480566,168,27,67,262
81003,dark,sv2,7,0.9829900842208191,159,24,53,236
81003,dark,sv2,8,0.9953805084344002,201,27,85,313
81003,dark,sv2,9,0.9941113505804403,212,19,84,315
81002,dark,sv2,0,0.979206701795415,89,7,34,130
81002,dark,sv2,1,0.9863287181660788,191,19,79,289
81002,dark,sv2,2,0.9847837029004366,211,28,75,314
81002,dark,sv2,3,0.989617144949332,187,26,66,279
81002,dark,sv2,4,0.9918465622963231,173,25,85,283
81002,dark,sv2,5,0.9867109174490238,200,25,79,304
81002,dark,sv2,6,0.9850305833016354,176,17,83,276
81002,dark,sv2,7,0.9884975614699116,166,24,58,248
81002,dark,sv2,8,0.9917472737700055,213,21,81,315
81002,dark,sv2,9,0.9819361774003927,208,30,81,319
80873,lrgqso2,sv1,0,0.990762015752775,210,41,82,333
80873,lrgqso2,sv1,1,0.9864293964302682,201,43,68,312
80873,lrgqso2,sv1,2,0.9847048665739119,213,49,59,321
80873,lrgqso2,sv1,3,0.9913242245978008,201,35,78,314
80873,lrgqso2,sv1,4,0.9842681533592358,217,33,70,320
80873,lrgqso2,sv1,5,0.9923612233902381,205,38,83,326
80873,lrgqso2,sv1,6,0.9944552741711817,163,39,52,254
80873,lrgqso2,sv1,7,0.9855552137269151,187,27,74,288
80873,lrgqso2,sv1,8,0.976688332979477,197,41,88,326
80873,lrgqso2,sv1,9,0.9843904909012551,214,39,78,331
80706,lrgqso,sv1,0,0.9934898119386,175,72,77,324
80706,lrgqso,sv1,1,0.9899612522243739,239,32,35,306
80706,lrgqso,sv1,2,0.9877836356251112,194,50,69,313
80706,lrgqso,sv1,3,0.9905361970520061,223,28,37,288
80706,lrgqso,sv1,4,0.9869809692335076,181,58,57,296
80706,lrgqso,sv1,5,0.9900479814138224,179,63,58,300
80706,lrgqso,sv1,6,0.9880958005058489,259,21,34,314
80706,lrgqso,sv1,7,0.9892449046135308,222,33,31,286
80706,lrgqso,sv1,8,0.9835455076819123,253,39,43,335
80706,lrgqso,sv1,9,0.9867931153722448,260,28,39,327
81000,dark,sv2,1,0.9890524223620344,191,32,60,283
81000,dark,sv2,2,0.9882974480002402,218,24,76,318
81000,dark,sv2,3,0.9790146529315313,204,30,46,280
81000,dark,sv2,4,0.9905527162588927,191,27,81,299
81000,dark,sv2,5,0.9933863447887801,205,32,80,317
81000,dark,sv2,6,0.9874934039504202,163,23,85,271
81000,dark,sv2,7,0.9845693083711531,145,27,65,237
81000,dark,sv2,8,0.9908408396555963,208,21,81,310
81000,dark,sv2,9,0.994861038517386,207,27,87,321
80734,ssv,sv1,0,0.984533877961185,5,364,1,370
80734,ssv,sv1,1,0.9922322628003992,2,327,1,330
80734,ssv,sv1,2,0.9860292579760199,4,355,1,360
80734,ssv,sv1,3,0.9824764134733422,4,314,6,324
80734,ssv,sv1,4,0.9878550974814743,1,344,0,345
80734,ssv,sv1,5,0.9891148762207841,0,347,2,349
80734,ssv,sv1,6,0.9915799619193195,0,356,1,357
80734,ssv,sv1,7,0.9903272328385202,0,303,3,306
80734,ssv,sv1,8,0.9850353131536707,2,330,2,334
80734,ssv,sv1,9,0.9929231613252519,4,384,1,389
80885,lrgqso2,sv1,0,0.9854130440779834,196,46,92,334
80885,lrgqso2,sv1,1,0.9899851420264845,204,35,68,307
80885,lrgqso2,sv1,2,0.9864158260489957,218,29,86,333
80885,lrgqso2,sv1,3,0.9887731833508392,182,27,99,308
80885,lrgqso2,sv1,4,0.990508244306093,190,36,86,312
80885,lrgqso2,sv1,5,0.9840355807314578,198,40,78,316
80885,lrgqso2,sv1,6,0.9854278237944615,159,25,55,239
80885,lrgqso2,sv1,7,0.9869784887434622,175,19,85,279
80885,lrgqso2,sv1,8,0.9841201937695635,208,34,90,332
80885,lrgqso2,sv1,9,0.9951769264978421,214,45,84,343
81006,dark,sv2,0,0.9922559378437438,220,30,85,335
81006,dark,sv2,1,0.9856711125681497,175,28,93,296
81006,dark,sv2,2,0.9818188476880718,238,17,79,334
81006,dark,sv2,3,0.9910204599574899,172,26,87,285
81006,dark,sv2,4,0.9900290960656399,216,22,63,301
81006,dark,sv2,5,0.9922730805405328,189,26,88,303
81006,dark,sv2,6,0.9898516902609678,182,27,66,275
81006,dark,sv2,7,0.9828301385169103,134,32,69,235
81006,dark,sv2,8,0.9887892541877411,208,25,68,301
81006,dark,sv2,9,0.9873448705555982,213,33,80,326
80729,ssv,sv1,0,0.9895347318855029,6,314,1,321
80729,ssv,sv1,1,0.9847706743113054,3,185,3,191
80729,ssv,sv1,2,0.9907829203676035,4,323,8,335
80729,ssv,sv1,3,0.9775119472917907,3,163,4,170
80729,ssv,sv1,4,0.9933459207416698,1,320,13,334
80729,ssv,sv1,5,0.9877481092572817,6,327,5,338
80729,ssv,sv1,6,0.9890768950697565,6,175,6,187
80729,ssv,sv1,7,0.9854464773970666,2,149,3,154
80729,ssv,sv1,8,0.9906744313773709,2,172,6,180
80729,ssv,sv1,9,0.9875597436455813,5,178,2,185
80735,ssv,sv1,0,0.9923107031159941,6,363,0,369
80735,ssv,sv1,1,0.986882602001638,1,330,0,331
80735,ssv,sv1,2,0.9924162499495067,3,337,0,340
80735,ssv,sv1,3,0.9927139690037778,1,318,1,320
80735,ssv,sv1,4,0.9907442043411455,0,347,0,347
80735,ssv,sv1,5,0.9885700119574903,0,348,1,349
80735,ssv,sv1,6,0.9947749483160818,3,361,6,370
80735,ssv,sv1,7,0.9877560692945692,1,305,0,306
80735,ssv,sv1,8,0.9895724427106865,2,353,3,358
80735,ssv,sv1,9,0.9937571455138366,3,375,3,381
81001,dark,sv2,1,0.9848966551795314,189,27,76,292
81001,dark,sv2,2,0.9867598885260741,213,37,59,309
81001,dark,sv2,3,0.9899119844772759,199,20,63,282
81001,dark,sv2,4,0.9901236905811797,173,29,89,291
81001,dark,sv2,5,0.992866773482409,216,17,78,311
81001,dark,sv2,6,0.9930140010018351,179,19,65,263
81001,dark,sv2,7,0.987577164964738,162,17,58,237
81001,dark,sv2,8,0.9905717974207181,218,24,75,317
81001,dark,sv2,9,0.9896866692416156,194,29,92,315
80666,bgsmws,sv1,0,0.9934048087862793,253,130,3,386
80666,bgsmws,sv1,1,0.9896899653218798,253,92,2,347
80666,bgsmws,sv1,2,0.9911885760664108,270,100,1,371
80666,bgsmws,sv1,3,0.995155934797751,237,94,3,334
80666,bgsmws,sv1,4,0.9897891710513322,234,111,2,347
80666,bgsmws,sv1,5,0.9936615129276312,253,100,7,360
80666,bgsmws,sv1,6,0.9915446176738869,267,105,3,375
80666,bgsmws,sv1,7,0.9919694673002909,225,90,1,316
80666,bgsmws,sv1,8,0.9833096436584714,254,107,5,366
80666,bgsmws,sv1,9,0.9929713722718368,285,101,2,388
80733,ssv,sv1,0,0.9933914585145772,2,356,5,363
80733,ssv,sv1,1,0.9888144139026005,1,182,5,188
80733,ssv,sv1,2,0.98057912810597,1,241,5,247
80733,ssv,sv1,3,0.9808046254228008,1,201,6,208
80733,ssv,sv1,4,0.9845407942967265,0,177,4,181
80733,ssv,sv1,5,0.9869564281377332,1,188,5,194
80733,ssv,sv1,6,0.9873178422103643,0,203,1,204
80733,ssv,sv1,7,0.9748471139984022,1,138,5,144
80733,ssv,sv1,8,0.9904696410008478,2,194,3,199
80733,ssv,sv1,9,0.9860518116680339,1,213,3,217
81004,dark,sv2,0,0.9956502875808654,210,26,90,326
81004,dark,sv2,1,0.991076920711387,182,37,77,296
81004,dark,sv2,2,0.9923985778352475,213,26,80,319
81004,dark,sv2,3,0.9722998716488377,168,20,86,274
81004,dark,sv2,4,0.9892722167475424,174,33,84,291
81004,dark,sv2,5,0.9868775876268894,201,29,80,310
81004,dark,sv2,6,0.9910022303854519,169,25,67,261
81004,dark,sv2,7,0.9890643113260463,150,25,63,238
81004,dark,sv2,8,0.9886594106679633,215,28,65,308
81004,dark,sv2,9,0.9906695399095298,220,24,87,331
80664,bgsmws,sv1,0,0.988584750993013,246,90,7,343
80664,bgsmws,sv1,1,0.9932025678799956,253,80,3,336
80664,bgsmws,sv1,2,0.9905131192677079,275,72,3,350
80664,bgsmws,sv1,3,0.9899243897522424,231,67,3,301
80664,bgsmws,sv1,4,0.9924724772635812,262,67,4,333
80664,bgsmws,sv1,5,0.9896219302433843,289,54,2,345
80664,bgsmws,sv1,6,0.9909382059961006,293,68,4,365
80664,bgsmws,sv1,7,0.9906726925109727,251,50,5,306
80664,bgsmws,sv1,8,0.9955957464690635,280,67,3,350
80664,bgsmws,sv1,9,0.9909993165815429,308,78,1,387
80731,ssv,sv1,0,0.9872510518160627,0,323,2,325
80731,ssv,sv1,1,0.982481566964738,0,157,2,159
80731,ssv,sv1,2,0.9898349690669553,0,315,7,322
80731,ssv,sv1,3,0.951722783178397,1,160,4,165
80731,ssv,sv1,4,0.9941117120020129,3,309,5,317
80731,ssv,sv1,5,0.9874393118551376,2,306,7,315
80731,ssv,sv1,6,0.9746309642705814,2,171,0,173
80731,ssv,sv1,7,0.9866619183744489,6,155,3,164
80731,ssv,sv1,8,0.9685181681637839,0,165,5,170
80731,ssv,sv1,9,0.9841575006978645,3,183,1,187
80886,elg,sv1,0,0.9823766859714078,258,37,12,307
80886,elg,sv1,1,0.9885995399878603,251,27,8,286
80886,elg,sv1,2,0.9855562134822541,280,25,5,310
80886,elg,sv1,3,0.9880475313977788,233,27,7,267
80886,elg,sv1,4,0.992644197597447,249,32,9,290
80886,elg,sv1,5,0.9916667702698231,241,35,13,289
80886,elg,sv1,6,0.9886424634055865,206,26,6,238
80886,elg,sv1,7,0.9843230935998194,227,14,4,245
80886,elg,sv1,8,0.9873613573996314,259,25,8,292
80886,elg,sv1,9,0.9960690740833481,254,38,8,300
80895,lrgqso2,sv1,0,0.9843404359803896,212,46,95,353
80895,lrgqso2,sv1,1,0.9950915687708395,198,64,77,339
80895,lrgqso2,sv1,2,0.9963607807737584,229,50,76,355
80895,lrgqso2,sv1,3,0.9772352547245527,197,40,90,327
80895,lrgqso2,sv1,4,0.9898141756796399,205,42,71,318
80895,lrgqso2,sv1,5,0.988501866634172,213,44,74,331
80895,lrgqso2,sv1,6,0.9944520495568582,182,36,68,286
80895,lrgqso2,sv1,7,0.9923941918962056,191,41,62,294
80895,lrgqso2,sv1,8,0.9917897817142245,224,50,65,339
80895,lrgqso2,sv1,9,0.9936727660829345,196,55,87,338
80857,lrgqso,sv1,0,0.9812322274022246,174,66,96,336
80857,lrgqso,sv1,1,0.9935650968163343,187,55,79,321
80857,lrgqso,sv1,2,0.988159505219625,206,66,65,337
80857,lrgqso,sv1,3,0.9937512508381626,200,58,56,314
80857,lrgqso,sv1,4,0.9845849583899071,211,55,74,340
80857,lrgqso,sv1,5,0.9931918180341585,180,57,87,324
80857,lrgqso,sv1,6,0.9909357850621957,149,39,56,244
80857,lrgqso,sv1,7,0.9903594486183439,174,52,62,288
80857,lrgqso,sv1,8,0.995399391613265,191,59,70,320
80857,lrgqso,sv1,9,0.9901158485617401,181,67,93,341
80858,lrgqso,sv1,0,0.9940108046141684,206,59,72,337
80858,lrgqso,sv1,1,0.989354274242334,175,72,72,319
80858,lrgqso,sv1,2,0.9915264502785905,199,68,72,339
80858,lrgqso,sv1,3,0.9897471033337786,181,59,72,312
80858,lrgqso,sv1,4,0.9857676593019529,174,61,90,325
80858,lrgqso,sv1,5,0.9872240159247586,188,58,86,332
80858,lrgqso,sv1,6,0.9894871059641129,168,41,45,254
80858,lrgqso,sv1,7,0.9876776010385359,167,50,72,289
80858,lrgqso,sv1,8,0.9954584752607437,195,60,83,338
80858,lrgqso,sv1,9,0.99111890636358,213,56,75,344
81005,dark,sv2,0,0.9919650252784558,213,29,92,334
81005,dark,sv2,1,0.9938902782676959,200,19,77,296
81005,dark,sv2,2,0.9925707377065389,216,23,102,341
81005,dark,sv2,3,0.9909169798778468,175,29,81,285
81005,dark,sv2,4,0.9932315067841592,187,25,82,294
81005,dark,sv2,5,0.9868621419260071,208,24,76,308
81005,dark,sv2,6,0.9844582741924469,182,20,79,281
81005,dark,sv2,7,0.9904914320897219,150,25,67,242
81005,dark,sv2,8,0.9927711113690967,218,25,75,318
81005,dark,sv2,9,0.9896209429824278,209,33,88,330
81007,dark,sv2,0,0.9850367399693644,245,34,59,338
81007,dark,sv2,1,0.9882901531010778,185,18,88,291
81007,dark,sv2,2,0.9877231396736259,223,32,81,336
81007,dark,sv2,3,0.9897464369750668,192,18,73,283
81007,dark,sv2,4,0.9929031620302464,191,19,90,300
81007,dark,sv2,5,0.9871304919570658,198,27,91,316
81007,dark,sv2,6,0.9817214392394037,172,27,75,274
81007,dark,sv2,7,0.9827520017008922,162,29,60,251
81007,dark,sv2,8,0.9932392276678179,218,24,79,321
81007,dark,sv2,9,0.9963227164460462,228,21,79,328
81014,dark,sv2,0,0.9926176545912823,222,30,78,330
81014,dark,sv2,1,0.9933285141405662,194,26,48,268
81014,dark,sv2,2,0.9874606442635938,235,17,61,313
81014,dark,sv2,3,0.9874738860851896,181,24,63,268
81014,dark,sv2,4,0.9871559789755434,197,28,58,283
81014,dark,sv2,5,0.9919190347916753,192,34,66,292
81014,dark,sv2,6,0.9793163602558423,193,23,74,290
81014,dark,sv2,7,0.9826558645468897,129,19,80,228
81014,dark,sv2,8,0.9869078631460887,204,28,76,308
81014,dark,sv2,9,0.9906648832687002,216,28,87,331
81011,dark,sv2,0,0.9918468113776465,247,18,71,336
81011,dark,sv2,1,0.9869582710913106,199,16,54,269
81011,dark,sv2,2,0.9895285522242268,224,24,74,322
81011,dark,sv2,3,0.9705415106152416,185,24,57,266
81011,dark,sv2,4,0.989720993386529,205,25,55,285
81011,dark,sv2,5,0.9858504169810112,210,26,56,292
81011,dark,sv2,6,0.9844144923676266,183,24,55,262
81011,dark,sv2,7,0.9865392340167227,163,28,44,235
81011,dark,sv2,8,0.9894485419995178,203,26,82,311
81011,dark,sv2,9,0.9905917155963052,230,20,83,333
81012,dark,sv2,0,0.9878488357627445,207,31,78,316
81012,dark,sv2,1,0.9925438056627179,202,25,55,282
81012,dark,sv2,2,0.9907501501037709,229,31,62,322
81012,dark,sv2,3,0.9873764491780638,200,26,64,290
81012,dark,sv2,4,0.9871561953310379,196,31,49,276
81012,dark,sv2,5,0.9886315380388478,185,29,81,295
81012,dark,sv2,6,0.9900817733950061,185,21,45,251
81012,dark,sv2,7,0.9794010395155156,168,18,33,219
81012,dark,sv2,8,0.9918394601285802,213,21,75,309
81012,dark,sv2,9,0.9858847484160883,204,28,68,300
81088,backup,sv2,0,0.9851543219269276,8,319,2,329
81088,backup,sv2,1,0.99020347147153,3,281,0,284
81088,backup,sv2,2,0.9900996465944472,11,301,2,314
81088,backup,sv2,3,0.9897500625165055,6,279,1,286
81088,backup,sv2,4,0.9870846964023249,4,277,2,283
81088,backup,sv2,5,0.9948180026247966,12,309,1,322
81088,backup,sv2,6,0.9752954949558139,8,257,0,265
81088,backup,sv2,7,0.9691625603966856,9,216,1,226
81088,backup,sv2,8,0.9926052135088835,3,308,4,315
81088,backup,sv2,9,0.9911744672712082,10,293,1,304
80890,elg,sv1,0,0.9874350025045022,239,41,5,285
80890,elg,sv1,1,0.9814239741848346,223,35,7,265
80890,elg,sv1,2,0.991796489590565,260,30,8,298
80890,elg,sv1,3,0.9875076343953915,244,23,7,274
80890,elg,sv1,4,0.9925070908897436,238,35,6,279
80890,elg,sv1,5,0.9855626107753558,234,32,8,274
80890,elg,sv1,6,0.9910377961797028,170,33,12,215
80890,elg,sv1,7,0.9879508475873076,207,31,8,246
80890,elg,sv1,8,0.9958971497344689,236,35,6,277
80890,elg,sv1,9,0.991180487089049,253,37,12,302
80697,elg,sv1,0,0.9901065208301456,279,22,10,311
80697,elg,sv1,1,0.9856002847438888,261,25,8,294
80697,elg,sv1,2,0.9850675728535473,267,26,9,302
80697,elg,sv1,3,0.9918876362897009,266,10,8,284
80697,elg,sv1,4,0.9881738904448245,256,29,5,290
80697,elg,sv1,5,0.9881016636786719,258,30,11,299
80697,elg,sv1,6,0.9758820181545794,169,9,8,186
80697,elg,sv1,7,0.9777230748117486,252,12,11,275
80697,elg,sv1,8,0.9850694171256352,277,13,14,304
80697,elg,sv1,9,0.9836946383961896,292,17,9,318
81075,bright,sv2,0,0.9914440147152762,190,144,3,337
81075,bright,sv2,1,0.980889311491424,176,105,7,288
81075,bright,sv2,2,0.9936100523757174,222,111,3,336
81075,bright,sv2,3,0.9830324345865952,187,107,1,295
81075,bright,sv2,4,0.9911968291993397,204,86,3,293
81075,bright,sv2,5,0.9913140233070314,231,80,2,313
81075,bright,sv2,6,0.9945265249346809,205,81,4,290
81075,bright,sv2,7,0.9845850969323616,149,95,0,244
81075,bright,sv2,8,0.9935176717898253,206,117,4,327
81075,bright,sv2,9,0.9854109184848023,221,105,3,329
80861,lrgqso,sv1,0,0.9925090835008701,151,127,68,346
80861,lrgqso,sv1,1,0.9859489601107564,136,133,50,319
80861,lrgqso,sv1,2,0.994753601146202,159,112,62,333
80861,lrgqso,sv1,3,0.9926903191743432,167,93,60,320
80861,lrgqso,sv1,4,0.9818069155211349,160,98,58,316
80861,lrgqso,sv1,5,0.9924967399569142,155,104,59,318
80861,lrgqso,sv1,6,0.984229643721369,128,67,45,240
80861,lrgqso,sv1,7,0.9929968631714441,121,100,70,291
80861,lrgqso,sv1,8,0.9921079674629774,153,98,67,318
80861,lrgqso,sv1,9,0.9964135358238911,159,124,58,341
80899,lrgqso2,sv1,0,0.9910498423520318,177,52,98,327
80899,lrgqso2,sv1,1,0.9910572290917765,196,54,72,322
80899,lrgqso2,sv1,2,0.9885632850551904,185,57,88,330
80899,lrgqso2,sv1,3,0.9875504200416751,174,53,80,307
80899,lrgqso2,sv1,4,0.9929484473823346,171,54,103,328
80899,lrgqso2,sv1,5,0.99286395067536,187,45,84,316
80899,lrgqso2,sv1,6,0.9793256516823878,169,45,63,277
80899,lrgqso2,sv1,7,0.9885399213930242,164,58,61,283
80899,lrgqso2,sv1,8,0.9923149863486203,184,65,75,324
80899,lrgqso2,sv1,9,0.9906575147428879,202,54,77,333
80893,lrgqso2,sv1,0,0.9850908066826827,193,47,109,349
80893,lrgqso2,sv1,1,0.9873517447214266,195,40,89,324
80893,lrgqso2,sv1,2,0.9881990447473333,186,46,108,340
80893,lrgqso2,sv1,3,0.985474897893234,190,39,81,310
80893,lrgqso2,sv1,4,0.9924198362530794,221,43,72,336
80893,lrgqso2,sv1,5,0.9889578450184418,208,44,78,330
80893,lrgqso2,sv1,6,0.9903334862600623,173,43,72,288
80893,lrgqso2,sv1,7,0.9889639991100944,156,40,94,290
80893,lrgqso2,sv1,8,0.9909580397968998,210,45,87,342
80893,lrgqso2,sv1,9,0.9912155435754547,190,48,109,347
81073,bright,sv2,0,0.9918403847294337,210,146,3,359
81073,bright,sv2,1,0.9920970990449639,213,97,6,316
81073,bright,sv2,2,0.9943224433650727,273,86,1,360
81073,bright,sv2,3,0.9925320901795212,256,44,2,302
81073,bright,sv2,4,0.9869998146570795,296,25,3,324
81073,bright,sv2,5,0.9890239314269615,308,24,2,334
81073,bright,sv2,6,0.9855796187387363,265,42,2,309
81073,bright,sv2,7,0.985355297672795,223,28,5,256
81073,bright,sv2,8,0.992004222770974,278,61,4,343
81073,bright,sv2,9,0.994100369676201,257,97,1,355
80891,lrgqso2,sv1,0,0.9898269619345439,203,49,91,343
80891,lrgqso2,sv1,1,0.9882472431669791,197,45,85,327
80891,lrgqso2,sv1,2,0.9884419768432345,185,49,100,334
80891,lrgqso2,sv1,3,0.9921827439959913,201,40,83,324
80891,lrgqso2,sv1,4,0.9921642692991961,216,40,69,325
80891,lrgqso2,sv1,5,0.9903788009499603,207,42,70,319
80891,lrgqso2,sv1,6,0.9917430230654215,168,43,72,283
80891,lrgqso2,sv1,7,0.9935892242880741,199,38,57,294
80891,lrgqso2,sv1,8,0.9918195340364908,199,49,83,331
80891,lrgqso2,sv1,9,0.9934783182456571,205,41,89,335
80887,lrgqso2,sv1,0,0.9890762750550466,218,36,86,340
80887,lrgqso2,sv1,1,0.9932707782264882,189,46,91,326
80887,lrgqso2,sv1,2,0.99429853698548,219,48,73,340
80887,lrgqso2,sv1,3,0.994763061381715,209,26,61,296
80887,lrgqso2,sv1,4,0.9861119182035127,209,41,66,316
80887,lrgqso2,sv1,5,0.9862192646455128,217,42,69,328
80887,lrgqso2,sv1,6,0.9905711283580388,187,36,50,273
80887,lrgqso2,sv1,7,0.9868842699403197,166,37,85,288
80887,lrgqso2,sv1,8,0.9895908298992304,231,38,68,337
80887,lrgqso2,sv1,9,0.9835330206933954,204,38,93,335
81015,dark,sv2,0,0.9945654784513311,213,24,78,315
81015,dark,sv2,1,0.9899823153383223,220,22,52,294
81015,dark,sv2,2,0.9887804249709619,238,26,51,315
81015,dark,sv2,3,0.9835545716570895,199,19,68,286
81015,dark,sv2,4,0.9849927525391334,208,31,47,286
81015,dark,sv2,5,0.9904415343166166,209,28,67,304
81015,dark,sv2,6,0.991609301882251,157,26,71,254
81015,dark,sv2,7,0.9875611181843533,168,18,62,248
81015,dark,sv2,8,0.9906491906746617,205,29,90,324
81015,dark,sv2,9,0.992715544406478,208,25,81,314
81009,dark,sv2,0,0.9949221985282849,232,34,63,329
81009,dark,sv2,1,0.9901073890461185,184,33,48,265
81009,dark,sv2,2,0.9889707210612637,215,32,69,316
81009,dark,sv2,3,0.9883329970528477,188,22,56,266
81009,dark,sv2,4,0.9790121372454911,206,18,53,277
81009,dark,sv2,5,0.9906092471347262,211,23,58,292
81009,dark,sv2,6,0.9931464267513596,195,26,52,273
81009,dark,sv2,7,0.986225720299465,153,21,60,234
81009,dark,sv2,8,0.9894510985531032,200,29,76,305
81009,dark,sv2,9,0.9965448463443118,233,21,53,307
80736,ssv,sv1,0,0.9884485492847389,5,355,0,360
80736,ssv,sv1,1,0.994408495254285,5,366,0,371
80736,ssv,sv1,2,0.9882429944048796,1,368,0,369
80736,ssv,sv1,3,0.9905085985235399,6,351,2,359
80736,ssv,sv1,4,0.9824660326895017,4,352,0,356
80736,ssv,sv1,5,0.9894972286156256,1,357,1,359
80736,ssv,sv1,6,0.9885975871716941,1,387,0,388
80736,ssv,sv1,7,0.9871858422417915,6,341,1,348
80736,ssv,sv1,8,0.990258799080544,4,379,1,384
80736,ssv,sv1,9,0.9871535233293637,0,389,2,391
81008,dark,sv2,0,0.9902302285358445,234,18,93,345
81008,dark,sv2,1,0.9912864540010575,190,23,52,265
81008,dark,sv2,2,0.9885235837277766,229,31,65,325
81008,dark,sv2,3,0.9879248197616954,211,19,53,283
81008,dark,sv2,4,0.9889700173453271,198,21,61,280
81008,dark,sv2,5,0.9926441199390672,208,29,71,308
81008,dark,sv2,6,0.9837713830046193,200,18,62,280
81008,dark,sv2,7,0.9884430040134083,150,22,57,229
81008,dark,sv2,8,0.9922380620417044,215,27,74,316
81008,dark,sv2,9,0.9821247945728449,215,28,90,333
80710,lrgqso,sv1,0,0.9935318435130491,139,85,70,294
80710,lrgqso,sv1,1,0.9922941133170735,248,49,42,339
80710,lrgqso,sv1,2,0.988784797656463,152,79,67,298
80710,lrgqso,sv1,3,0.9925502619799454,238,47,43,328
80710,lrgqso,sv1,4,0.9851866126815102,150,64,73,287
80710,lrgqso,sv1,5,0.9866619861252685,143,74,67,284
80710,lrgqso,sv1,6,0.9928357744473993,237,43,43,323
80710,lrgqso,sv1,7,0.9882519593707986,252,41,36,329
80710,lrgqso,sv1,8,0.9922254681307188,257,45,38,340
80710,lrgqso,sv1,9,0.9893487591421626,245,53,38,336
81022,dark,sv2,0,0.9799583387003789,224,28,38,290
81022,dark,sv2,1,0.992360123360143,218,27,36,281
81022,dark,sv2,2,0.9864136094066762,209,39,49,297
81022,dark,sv2,3,0.9922302515116678,202,15,60,277
81022,dark,sv2,4,0.996481469204912,203,20,63,286
81022,dark,sv2,5,0.9871770588638715,200,28,80,308
81022,dark,sv2,6,0.9845492002717214,164,25,67,256
81022,dark,sv2,7,0.9918803624855982,161,17,57,235
81022,dark,sv2,8,0.9909696678702599,230,22,56,308
81022,dark,sv2,9,0.9880427798361494,223,21,53,297
80889,lrgqso2,sv1,0,0.9841210420158524,218,48,78,344
80889,lrgqso2,sv1,1,0.9945753466435305,193,44,83,320
80889,lrgqso2,sv1,2,0.9917241598494243,222,38,93,353
80889,lrgqso2,sv1,3,0.9936362950696697,210,28,64,302
80889,lrgqso2,sv1,4,0.9819461606524221,201,38,72,311
80889,lrgqso2,sv1,5,0.9933971165709305,212,41,69,322
80889,lrgqso2,sv1,6,0.9933994228131894,177,34,51,262
80889,lrgqso2,sv1,7,0.9826572920047014,169,38,76,283
80889,lrgqso2,sv1,8,0.9947731244551169,169,43,94,306
80889,lrgqso2,sv1,9,0.9858656282928275,203,42,90,335
80860,lrgqso,sv1,0,0.9916900373199266,184,99,58,341
80860,lrgqso,sv1,1,0.9918908193728778,129,110,71,310
80860,lrgqso,sv1,2,0.9877932980264422,152,95,80,327
80860,lrgqso,sv1,3,0.9808729266683566,167,85,46,298
80860,lrgqso,sv1,4,0.9904011200177665,153,84,80,317
80860,lrgqso,sv1,5,0.9887779334646221,142,101,81,324
80860,lrgqso,sv1,6,0.9831452002864217,132,72,54,258
80860,lrgqso,sv1,7,0.9885915824816808,147,76,62,285
80860,lrgqso,sv1,8,0.995487860603978,145,94,83,322
80860,lrgqso,sv1,9,0.9920101729961147,188,99,52,339
81010,dark,sv2,0,0.9872811880933318,228,22,68,318
81010,dark,sv2,1,0.9911160653940642,186,32,54,272
81010,dark,sv2,2,0.9924911296000548,215,26,71,312
81010,dark,sv2,3,0.9843975205574851,203,29,40,272
81010,dark,sv2,4,0.9862613835376083,222,24,55,301
81010,dark,sv2,5,0.9914985926583935,221,25,60,306
81010,dark,sv2,6,0.9936531443259246,186,19,49,254
81010,dark,sv2,7,0.9885493850035172,181,21,45,247
81010,dark,sv2,8,0.9947189439633404,220,30,66,316
81010,dark,sv2,9,0.9885945392390394,209,38,50,297
81013,dark,sv2,0,0.9888794283667217,225,22,57,304
81013,dark,sv2,1,0.9926998927398965,189,23,62,274
81013,dark,sv2,2,0.9900757217367695,234,22,47,303
81013,dark,sv2,3,0.9927978242345734,200,27,51,278
81013,dark,sv2,4,0.9818278193154354,216,21,61,298
81013,dark,sv2,5,0.9868929917712946,216,23,69,308
81013,dark,sv2,6,0.9886219200300491,187,12,50,249
81013,dark,sv2,7,0.9802638341865176,164,27,54,245
81013,dark,sv2,8,0.9876307130716387,220,27,66,313
81013,dark,sv2,9,0.9790873137157272,212,32,66,310
80894,elg,sv1,0,0.9917513112079553,262,39,10,311
80894,elg,sv1,1,0.9899595215998462,249,38,12,299
80894,elg,sv1,2,0.9876630066038656,238,35,8,281
80894,elg,sv1,3,0.9844790190158876,225,40,9,274
80894,elg,sv1,4,0.9887657772921544,234,34,6,274
80894,elg,sv1,5,0.9903451409952266,244,30,8,282
80894,elg,sv1,6,0.9875822080798101,204,30,5,239
80894,elg,sv1,7,0.9897727460486139,224,31,10,265
80894,elg,sv1,8,0.994210115613393,242,42,7,291
80894,elg,sv1,9,0.9932169326079882,267,40,8,315
80902,elg,sv1,0,0.9931352880819261,241,39,13,293
80902,elg,sv1,1,0.9923724479656078,250,33,10,293
80902,elg,sv1,2,0.9919863201811158,229,44,7,280
80902,elg,sv1,3,0.992293954642784,251,34,7,292
80902,elg,sv1,4,0.9901255879136531,235,36,5,276
80902,elg,sv1,5,0.9934751963292134,252,34,9,295
80902,elg,sv1,6,0.9893761160502248,214,20,5,239
80902,elg,sv1,7,0.9913023051923032,234,27,5,266
80902,elg,sv1,8,0.9828308524715498,248,34,6,288
80902,elg,sv1,9,0.9786772375201969,240,36,9,285
201,bright,sv3,0,0.9924021814462556,341,53,5,399
201,bright,sv3,1,0.9888473016330623,314,43,3,360
201,bright,sv3,2,0.9900284405045695,323,61,4,388
201,bright,sv3,3,0.989818376197925,308,27,5,340
201,bright,sv3,4,0.9859328147331191,278,65,5,348
201,bright,sv3,5,0.993833604957381,295,60,5,360
201,bright,sv3,6,0.9892912589514145,284,48,3,335
201,bright,sv3,7,0.9916218721770323,251,44,3,298
201,bright,sv3,8,0.9921726131322554,326,55,6,387
201,bright,sv3,9,0.9940830396689601,330,34,1,365
39,bright,sv3,0,0.9940667382994959,380,8,2,390
39,bright,sv3,1,0.992862186415059,311,40,4,355
39,bright,sv3,2,0.9924729009751114,365,29,5,399
39,bright,sv3,3,0.9892466534530974,283,47,3,333
39,bright,sv3,4,0.9946270484101537,301,48,4,353
39,bright,sv3,5,0.9918267208635729,342,24,5,371
39,bright,sv3,6,0.9926128414778663,316,20,3,339
39,bright,sv3,7,0.9749710676089528,269,39,1,309
39,bright,sv3,8,0.9898871762382936,362,17,2,381
39,bright,sv3,9,0.9913623207827859,334,40,6,380
23,backup,sv3,0,0.9918557478310589,5,343,1,349
23,backup,sv3,1,0.9872416123193388,5,311,0,316
23,backup,sv3,2,0.9899243092017079,2,335,0,337
23,backup,sv3,3,0.9811281269254746,1,289,1,291
23,backup,sv3,4,0.9914852167184992,7,289,1,297
23,backup,sv3,5,0.9867231760456258,3,330,0,333
23,backup,sv3,6,0.9839268941344681,7,289,0,296
23,backup,sv3,7,0.9890446239949789,3,244,1,248
23,backup,sv3,8,0.9898765083864234,3,343,0,346
23,backup,sv3,9,0.9926326656681722,2,326,0,328
147,bright,sv3,0,0.9926246697698032,349,37,4,390
147,bright,sv3,1,0.985902907128731,330,29,5,364
147,bright,sv3,2,0.9939983210519255,326,62,0,388
147,bright,sv3,3,0.9926063087988166,285,64,1,350
147,bright,sv3,4,0.9962424461219007,289,60,3,352
147,bright,sv3,5,0.9948184310887909,332,45,1,378
147,bright,sv3,6,0.9832607670405533,303,25,1,329
147,bright,sv3,7,0.9915996102811312,256,43,3,302
147,bright,sv3,8,0.9874525699487048,328,44,3,375
147,bright,sv3,9,0.9914526675358247,331,45,3,379
158,backup,sv3,0,0.9913641034913988,1,353,0,354
158,backup,sv3,1,0.9918086743730451,0,303,2,305
158,backup,sv3,2,0.9933135667155767,3,338,0,341
158,backup,sv3,3,0.9889865966195694,4,298,0,302
158,backup,sv3,4,0.9869272864171744,2,304,0,306
158,backup,sv3,5,0.9898621366367719,4,319,0,323
158,backup,sv3,6,0.990867297206597,9,298,2,309
158,backup,sv3,7,0.9801078868384904,1,245,0,246
158,backup,sv3,8,0.9868148333814594,2,346,1,349
158,backup,sv3,9,0.9899515610013163,4,329,0,333
174,bright,sv3,0,0.98487859340065,289,100,2,391
174,bright,sv3,1,0.9890397851330931,277,82,6,365
174,bright,sv3,2,0.9935006907906062,327,53,4,384
174,bright,sv3,3,0.9905033327853987,287,51,6,344
174,bright,sv3,4,0.9872372898574188,293,59,4,356
174,bright,sv3,5,0.9945850152277296,301,69,5,375
174,bright,sv3,6,0.9900038941754578,269,60,4,333
174,bright,sv3,7,0.9948344035628265,230,62,1,293
174,bright,sv3,8,0.9887770885380641,311,65,6,382
174,bright,sv3,9,0.994420182701863,276,81,4,361
50,backup,sv3,0,0.9835760932638011,6,308,2,316
50,backup,sv3,1,0.9898334724917011,2,292,0,294
50,backup,sv3,2,0.988021923175938,2,314,0,316
50,backup,sv3,3,0.9873044236748231,3,284,0,287
50,backup,sv3,4,0.9928429383580363,5,267,2,274
50,backup,sv3,5,0.989517888438507,2,304,0,306
50,backup,sv3,6,0.9844918230811801,6,262,2,270
50,backup,sv3,7,0.9889250685209201,3,248,1,252
50,backup,sv3,8,0.9877111367330187,1,293,1,295
50,backup,sv3,9,0.9916541093259235,1,302,0,303
93,bright,sv3,0,0.9919335002043304,338,61,1,400
93,bright,sv3,1,0.9876630188164569,300,67,2,369
93,bright,sv3,2,0.992889228332328,339,50,7,396
93,bright,sv3,3,0.993579783375508,322,36,4,362
93,bright,sv3,4,0.9876511909170713,316,44,4,364
93,bright,sv3,5,0.9913128957232749,324,45,2,371
93,bright,sv3,6,0.9919547000013915,285,39,2,326
93,bright,sv3,7,0.9863127723356125,235,56,2,293
93,bright,sv3,8,0.9914692060041211,339,43,1,383
93,bright,sv3,9,0.9859673820107573,329,53,4,386
244,dark,sv3,0,0.994779027731776,220,20,90,330
244,dark,sv3,1,0.9886599215925068,222,14,78,314
244,dark,sv3,2,0.9890043847922455,264,14,70,348
244,dark,sv3,3,0.9895044532928998,210,14,83,307
244,dark,sv3,4,0.9938036082900699,219,13,92,324
244,dark,sv3,5,0.9942930917608024,235,12,92,339
244,dark,sv3,6,0.9915747521813904,198,14,73,285
244,dark,sv3,7,0.989988245324496,183,14,65,262
244,dark,sv3,8,0.9837678905977847,240,18,78,336
244,dark,sv3,9,0.9933115729984014,215,19,93,327
12,bright,sv3,0,0.9905046167499694,363,41,1,405
12,bright,sv3,1,0.9921949501575473,306,48,3,357
12,bright,sv3,2,0.9911121236054699,329,52,5,386
12,bright,sv3,3,0.9900303658981487,302,46,4,352
12,bright,sv3,4,0.989791540902815,321,44,4,369
12,bright,sv3,5,0.9860789246201503,359,19,6,384
12,bright,sv3,6,0.9910962858452881,285,40,5,330
12,bright,sv3,7,0.9878790568667286,282,26,2,310
12,bright,sv3,8,0.9913217306367791,315,64,5,384
12,bright,sv3,9,0.9965518586930253,302,87,5,394
80896,elg,sv1,0,0.9889737584313866,250,42,6,298
80896,elg,sv1,1,0.9888903478240519,240,33,7,280
80896,elg,sv1,2,0.9831675314073217,234,33,13,280
80896,elg,sv1,3,0.9887712707009271,239,34,2,275
80896,elg,sv1,4,0.9859769432980927,248,34,2,284
80896,elg,sv1,5,0.9914713948843409,234,35,14,283
80896,elg,sv1,6,0.980002748924265,206,31,4,241
80896,elg,sv1,7,0.9852381262540574,208,29,12,249
80896,elg,sv1,8,0.9933192497251949,235,38,6,279
80896,elg,sv1,9,0.9929743578418023,256,36,12,304
190,dark,sv3,0,0.9938344439806309,263,10,91,364
190,dark,sv3,1,0.9911540471564705,232,7,78,317
190,dark,sv3,2,0.992402201574075,241,13,96,350
190,dark,sv3,3,0.9925697825954356,217,12,82,311
190,dark,sv3,4,0.986609279824108,213,16,107,336
190,dark,sv3,5,0.9903727112197066,265,9,68,342
190,dark,sv3,6,0.9807739844947979,203,9,87,299
190,dark,sv3,7,0.99069064836354,195,9,76,280
190,dark,sv3,8,0.9905387191574994,239,16,105,360
190,dark,sv3,9,0.9923011906809072,263,10,74,347
217,dark,sv3,0,0.9900139877652344,214,12,84,310
217,dark,sv3,1,0.9848516687514755,197,15,64,276
217,dark,sv3,2,0.9933116059096175,219,17,80,316
217,dark,sv3,3,0.9902852855292836,200,12,82,294
217,dark,sv3,4,0.9808077032718305,189,9,101,299
217,dark,sv3,5,0.9937978657011718,230,16,71,317
217,dark,sv3,6,0.9862799228820723,180,13,88,281
217,dark,sv3,7,0.9859792575769051,173,14,63,250
217,dark,sv3,8,0.9853379007942581,212,12,89,313
217,dark,sv3,9,0.9856383757017149,222,16,74,312
80897,lrgqso2,sv1,0,0.9904613649234698,205,42,67,314
80897,lrgqso2,sv1,1,0.9920118836288206,172,47,69,288
80897,lrgqso2,sv1,2,0.9787443217153566,196,43,71,310
80897,lrgqso2,sv1,3,0.9875556228596536,174,46,72,292
80897,lrgqso2,sv1,4,0.9933509315218733,190,45,65,300
80897,lrgqso2,sv1,5,0.9864832776378342,192,39,70,301
80897,lrgqso2,sv1,6,0.9914061592279042,175,36,64,275
80897,lrgqso2,sv1,7,0.9911463381765581,176,42,50,268
80897,lrgqso2,sv1,8,0.9794513710887601,172,55,65,292
80897,lrgqso2,sv1,9,0.9865674160264218,179,47,87,313
55,dark,sv3,0,0.9918499180165109,264,13,91,368
55,dark,sv3,1,0.9888443660922497,219,16,93,328
55,dark,sv3,2,0.9913765093689124,247,20,77,344
55,dark,sv3,3,0.9905254764989659,237,12,88,337
55,dark,sv3,4,0.9944006316492008,245,16,82,343
55,dark,sv3,5,0.9922660703882161,239,9,90,338
55,dark,sv3,6,0.989969411727975,207,18,80,305
55,dark,sv3,7,0.9899421277894859,206,13,81,300
55,dark,sv3,8,0.987876606895981,243,12,96,351
55,dark,sv3,9,0.9910716595504847,242,17,105,364
298,dark,sv3,0,0.9860526690783802,258,12,85,355
298,dark,sv3,1,0.9891108093524494,230,15,74,319
298,dark,sv3,2,0.9887293668415943,249,14,86,349
298,dark,sv3,3,0.9906988956684529,235,12,77,324
298,dark,sv3,4,0.9901365049057544,245,19,72,336
298,dark,sv3,5,0.9916567832195358,225,13,98,336
298,dark,sv3,6,0.9839904743005943,201,11,74,286
298,dark,sv3,7,0.9910707694339376,208,10,56,274
298,dark,sv3,8,0.9944885937204101,247,18,85,350
298,dark,sv3,9,0.9936207440994916,254,12,78,344
66,bright,sv3,0,0.9943850058558085,363,44,1,408
66,bright,sv3,1,0.9935629429854212,325,37,4,366
66,bright,sv3,2,0.993548261660331,342,48,2,392
66,bright,sv3,3,0.9827344418562524,301,53,5,359
66,bright,sv3,4,0.9952504879659507,330,32,5,367
66,bright,sv3,5,0.993997041350386,341,34,5,380
66,bright,sv3,6,0.9939613083533084,324,9,4,337
66,bright,sv3,7,0.9931574722213244,259,47,2,308
66,bright,sv3,8,0.9918576777573118,347,32,2,381
66,bright,sv3,9,0.9885859145226907,366,23,3,392
80900,elg,sv1,0,0.9887356171687398,247,36,5,288
80900,elg,sv1,1,0.9851716933369764,234,35,9,278
80900,elg,sv1,2,0.9913924834528977,244,35,8,287
80900,elg,sv1,3,0.9908396834463177,219,35,5,259
80900,elg,sv1,4,0.9948286731715824,238,33,3,274
80900,elg,sv1,5,0.9896073654167755,202,36,9,247
80900,elg,sv1,6,0.9897822253868992,204,31,5,240
80900,elg,sv1,7,0.9923650703712438,192,30,5,227
80900,elg,sv1,8,0.9899560437825796,247,34,4,285
80900,elg,sv1,9,0.9871737827463969,243,31,10,284
271,dark,sv3,0,0.9879161344914832,243,11,89,343
271,dark,sv3,1,0.994063486735115,235,12,73,320
271,dark,sv3,2,0.9920616132745166,234,15,83,332
271,dark,sv3,3,0.9806777892457726,212,14,72,298
271,dark,sv3,4,0.9923107791107204,220,17,82,319
271,dark,sv3,5,0.9858933884029532,217,16,97,330
271,dark,sv3,6,0.9898426415802205,197,12,80,289
271,dark,sv3,7,0.9865066956003279,157,12,90,259
271,dark,sv3,8,0.9896661607481764,228,17,85,330
271,dark,sv3,9,0.9896836061969272,234,22,80,336
109,dark,sv3,0,0.9888502391604146,278,12,91,381
109,dark,sv3,1,0.9960293197355787,245,12,89,346
109,dark,sv3,2,0.9895982357525869,275,10,89,374
109,dark,sv3,3,0.994072010118804,223,8,92,323
109,dark,sv3,4,0.9888690663075228,230,11,110,351
109,dark,sv3,5,0.9939005831241163,245,13,94,352
109,dark,sv3,6,0.9958619680482272,224,14,87,325
109,dark,sv3,7,0.9797962483333925,209,13,69,291
109,dark,sv3,8,0.9935081939015262,239,11,107,357
109,dark,sv3,9,0.9945632200272553,270,10,84,364
163,dark,sv3,0,0.9842118176878585,263,12,75,350
163,dark,sv3,1,0.9943511765415246,205,14,80,299
163,dark,sv3,2,0.9893083709703585,258,13,80,351
163,dark,sv3,3,0.9864996490214083,219,11,81,311
163,dark,sv3,4,0.9921269182625571,232,9,79,320
163,dark,sv3,5,0.9918446654381815,221,12,94,327
163,dark,sv3,6,0.9899652920785083,196,11,90,297
163,dark,sv3,7,0.9915777493913954,181,10,71,262
163,dark,sv3,8,0.9933673641260177,244,9,82,335
163,dark,sv3,9,0.990710841038246,233,23,72,328
1,dark,sv3,0,0.9914035344461706,275,15,84,374
1,dark,sv3,1,0.9895426766419623,241,12,71,324
1,dark,sv3,2,0.994416278540533,256,14,87,357
1,dark,sv3,3,0.9921043766300471,222,14,85,321
1,dark,sv3,4,0.9886114008810138,228,17,84,329
1,dark,sv3,5,0.9954551871121906,238,14,95,347
1,dark,sv3,6,0.991631295521862,215,14,85,314
1,dark,sv3,7,0.990769211470139,208,14,70,292
1,dark,sv3,8,0.9950052567855205,248,10,93,351
1,dark,sv3,9,0.9852113163641228,261,10,84,355
80901,lrgqso2,sv1,0,0.9896378414644622,197,46,97,340
80901,lrgqso2,sv1,1,0.9881565675812529,174,52,75,301
80901,lrgqso2,sv1,2,0.9910711632007599,175,58,96,329
80901,lrgqso2,sv1,3,0.9899994761829735,178,48,81,307
80901,lrgqso2,sv1,4,0.9908294214221648,185,48,59,292
80901,lrgqso2,sv1,5,0.9903772779563482,170,48,80,298
80901,lrgqso2,sv1,6,0.9876344532267868,162,46,69,277
80901,lrgqso2,sv1,7,0.9928229613637528,157,42,80,279
80901,lrgqso2,sv1,8,0.9911699201228341,181,54,76,311
80901,lrgqso2,sv1,9,0.9833695264399644,182,58,77,317
325,dark,sv3,0,0.9928852077840061,251,22,73,346
325,dark,sv3,1,0.9924144342813919,203,11,102,316
325,dark,sv3,2,0.9924144342813919,203,11,102,316
325,dark,sv3,3,0.9924744006472052,215,11,81,307
325,dark,sv3,4,0.9904909206665874,239,16,70,325
325,dark,sv3,5,0.9860131549174774,226,17,82,325
325,dark,sv3,6,0.9933462527428122,212,11,64,287
325,dark,sv3,7,0.9891041801973565,202,10,63,275
325,dark,sv3,8,0.994291591216135,232,15,77,324
325,dark,sv3,9,0.9833540890650078,223,10,86,319
379,dark,sv3,0,0.9891056707841045,244,20,92,356
379,dark,sv3,1,0.9919740207680731,213,18,91,322
379,dark,sv3,2,0.988386242852906,234,25,87,346
379,dark,sv3,3,0.9919796339638881,235,13,70,318
379,dark,sv3,4,0.9913377305131934,224,17,78,319
379,dark,sv3,5,0.9953388753907436,234,17,92,343
379,dark,sv3,6,0.9895896498428841,207,15,71,293
379,dark,sv3,7,0.9901039029144169,185,18,67,270
379,dark,sv3,8,0.9900127901374786,244,16,83,343
379,dark,sv3,9,0.9855969886059986,224,16,88,328
80892,elg,sv1,0,0.9943037244614097,267,36,9,312
80892,elg,sv1,1,0.9912111897134711,233,31,9,273
80892,elg,sv1,2,0.9835149747103767,236,38,9,283
80892,elg,sv1,3,0.9892618911088848,232,36,12,280
80892,elg,sv1,4,0.9861878925864683,248,36,6,290
80892,elg,sv1,5,0.9825971211233725,245,32,12,289
80892,elg,sv1,6,0.9904483523455603,204,34,6,244
80892,elg,sv1,7,0.9891300482345046,208,29,4,241
80892,elg,sv1,8,0.9861818516603614,248,39,2,289
80892,elg,sv1,9,0.9940058175958904,260,33,5,298
80898,elg,sv1,0,0.9932525514566375,226,36,10,272
80898,elg,sv1,1,0.982757996345611,213,34,10,257
80898,elg,sv1,2,0.9845054515111573,242,32,5,279
80898,elg,sv1,3,0.9762880173376222,203,30,6,239
80898,elg,sv1,4,0.9876074193673473,213,37,6,256
80898,elg,sv1,5,0.9930733227295965,224,36,9,269
80898,elg,sv1,6,0.9740514806976492,191,31,5,227
80898,elg,sv1,7,0.9808382453390535,194,31,7,232
80898,elg,sv1,8,0.9911501606591349,228,35,11,274
80898,elg,sv1,9,0.9875021533148246,214,34,14,262
136,dark,sv3,0,0.9914593268875624,247,19,94,360
136,dark,sv3,1,0.9925708424308674,225,17,103,345
136,dark,sv3,2,0.989333773409989,233,18,115,366
136,dark,sv3,3,0.9851075291432618,220,18,91,329
136,dark,sv3,4,0.9751016790463136,209,12,91,312
136,dark,sv3,5,0.9931658159879528,252,16,84,352
136,dark,sv3,6,0.9862775521294903,196,15,91,302
136,dark,sv3,7,0.9878410423012126,204,13,74,291
136,dark,sv3,8,0.991726672115329,242,19,88,349
136,dark,sv3,9,0.9945860425876345,232,16,89,337
131,backup,sv3,0,0.9861053417410497,24,251,1,276
131,backup,sv3,1,0.9781214749717484,20,209,3,232
131,backup,sv3,2,0.9752685420249548,11,270,1,282
131,backup,sv3,3,0.9822148821236064,6,240,2,248
131,backup,sv3,4,0.9810671357137616,9,232,2,243
131,backup,sv3,5,0.9824177731467538,8,239,0,247
131,backup,sv3,6,0.986101599382341,10,214,1,225
131,backup,sv3,7,0.9852460152477324,10,177,1,188
131,backup,sv3,8,0.9892383643527337,15,237,3,255
131,backup,sv3,9,0.9913427019292521,18,236,3,257
406,dark,sv3,0,0.9938176091691812,241,21,94,356
406,dark,sv3,1,0.9896040430341552,228,13,89,330
406,dark,sv3,2,0.9904710698443655,237,20,88,345
406,dark,sv3,3,0.9822087156006997,228,18,71,317
406,dark,sv3,4,0.993792776267975,219,11,88,318
406,dark,sv3,5,0.9796272131329978,224,13,81,318
406,dark,sv3,6,0.9887879352569217,211,17,55,283
406,dark,sv3,7,0.9854516150869563,187,13,73,273
406,dark,sv3,8,0.993246640081948,247,18,82,347
406,dark,sv3,9,0.9899485479641454,234,14,84,332
80738,ssv,sv1,0,0.9911256302446344,7,362,1,370
80738,ssv,sv1,1,0.9939653702303617,10,343,1,354
80738,ssv,sv1,2,0.988858590039856,12,354,1,367
80738,ssv,sv1,3,0.994913050705946,5,328,1,334
80738,ssv,sv1,4,0.9898661105962226,10,347,0,357
80738,ssv,sv1,5,0.987915768739257,1,361,2,364
80738,ssv,sv1,6,0.9971201471505736,6,353,3,362
80738,ssv,sv1,7,0.9909957846195404,12,321,2,335
80738,ssv,sv1,8,0.9936440657331621,3,383,2,388
80738,ssv,sv1,9,0.992330679521019,3,370,3,376
352,dark,sv3,0,0.9921799292558069,249,17,98,364
352,dark,sv3,1,0.9913714301553759,218,14,83,315
352,dark,sv3,2,0.9942389648587442,256,14,91,361
352,dark,sv3,3,0.9871697541035294,226,8,78,312
352,dark,sv3,4,0.9940009892944424,239,13,83,335
352,dark,sv3,5,0.994926515304454,241,13,81,335
352,dark,sv3,6,0.9841469534188885,176,11,89,276
352,dark,sv3,7,0.9896266583320977,211,9,63,283
352,dark,sv3,8,0.9874474802667045,244,15,88,347
352,dark,sv3,9,0.9852903640010134,229,15,102,346
13,bright,sv3,0,0.9915707097433146,294,100,2,396
13,bright,sv3,1,0.9916433431861424,274,85,1,360
13,bright,sv3,2,0.992701730667975,292,100,4,396
13,bright,sv3,3,0.9750519401486764,228,103,2,333
13,bright,sv3,4,0.995833875168263,287,73,4,364
13,bright,sv3,5,0.9932214050610082,306,65,8,379
13,bright,sv3,6,0.9887027585420076,252,74,2,328
13,bright,sv3,7,0.9889339148545673,216,80,1,297
13,bright,sv3,8,0.9886661926498351,237,133,5,375
13,bright,sv3,9,0.9930359522475148,279,104,4,387
380,dark,sv3,0,0.9942154617225887,259,11,91,361
380,dark,sv3,1,0.9882885318063954,229,19,60,308
380,dark,sv3,2,0.9887652127403056,252,15,76,343
380,dark,sv3,3,0.9901453505024609,252,10,59,321
380,dark,sv3,4,0.9843240881818653,234,12,70,316
380,dark,sv3,5,0.9896306754625911,263,14,49,326
380,dark,sv3,6,0.9803728445426745,224,15,62,301
380,dark,sv3,7,0.9908911313937512,195,13,67,275
380,dark,sv3,8,0.9885517970246386,254,9,60,323
380,dark,sv3,9,0.9888831324766013,260,12,73,345
218,dark,sv3,0,0.9946515466903055,263,15,64,342
218,dark,sv3,1,0.991272020632679,184,15,84,283
218,dark,sv3,2,0.9902634493168776,257,9,74,340
218,dark,sv3,3,0.990240179388148,229,13,63,305
218,dark,sv3,4,0.988165113890119,222,15,80,317
218,dark,sv3,5,0.9949355979622042,234,17,58,309
218,dark,sv3,6,0.9850748226454694,230,9,54,293
218,dark,sv3,7,0.9913346188605232,207,12,55,274
218,dark,sv3,8,0.9815926827514079,224,11,57,292
218,dark,sv3,9,0.9852213420561495,234,18,71,323
255,bright,sv3,0,0.992480472264725,338,51,1,390
255,bright,sv3,1,0.9911000572668426,293,31,3,327
255,bright,sv3,2,0.9932579383522065,344,19,2,365
255,bright,sv3,3,0.9944155938793793,305,24,1,330
255,bright,sv3,4,0.9962396316156829,295,45,4,344
255,bright,sv3,5,0.9931108072939867,316,44,4,364
255,bright,sv3,6,0.9917559111604018,278,36,6,320
255,bright,sv3,7,0.9962841433801901,249,27,1,277
255,bright,sv3,8,0.9936970856674627,286,38,2,326
255,bright,sv3,9,0.9894789946764803,302,68,5,375
336,bright,sv3,0,0.9915572430291423,331,64,2,397
336,bright,sv3,1,0.99263577121452,270,77,3,350
336,bright,sv3,2,0.9958985724766879,299,74,6,379
336,bright,sv3,3,0.9906975882874598,279,66,2,347
336,bright,sv3,4,0.9822954989084828,289,64,7,360
336,bright,sv3,5,0.9932902595809364,192,33,0,225
336,bright,sv3,6,0.9929550526429274,258,60,2,320
336,bright,sv3,7,0.9938116656606836,240,43,2,285
336,bright,sv3,8,0.9862613749170018,326,26,2,354
336,bright,sv3,9,0.9912189302054755,349,32,3,384
326,dark,sv3,0,0.9954845891168081,274,21,54,349
326,dark,sv3,1,0.9921744786068583,237,10,58,305
326,dark,sv3,2,0.991146262887257,256,20,70,346
326,dark,sv3,3,0.9862365219969299,231,11,47,289
326,dark,sv3,4,0.9865562134493471,240,14,56,310
326,dark,sv3,5,0.9866568568764087,239,11,67,317
326,dark,sv3,6,0.9853805437952533,234,17,53,304
326,dark,sv3,7,0.9890861150240612,209,12,46,267
326,dark,sv3,8,0.994213280354528,228,11,63,302
326,dark,sv3,9,0.9912718627998859,252,10,69,331
299,dark,sv3,0,0.9868278756839641,260,12,71,343
299,dark,sv3,1,0.9912841916872078,235,10,53,298
299,dark,sv3,2,0.9890290999782387,261,11,70,342
299,dark,sv3,3,0.991196713345858,247,9,47,303
299,dark,sv3,4,0.9920276055631635,236,10,59,305
299,dark,sv3,5,0.9782022829240994,231,11,76,318
299,dark,sv3,6,0.9881663014906809,231,10,58,299
299,dark,sv3,7,0.9800407368109344,213,11,43,267
299,dark,sv3,8,0.9927318127145065,244,8,54,306
299,dark,sv3,9,0.9902109970221133,275,11,52,338
120,bright,sv3,0,0.9893279024806206,371,19,2,392
120,bright,sv3,1,0.9882176211558968,332,24,3,359
120,bright,sv3,2,0.993173327060844,347,36,3,386
120,bright,sv3,3,0.9945995248892578,330,23,8,361
120,bright,sv3,4,0.9913277689520371,324,30,3,357
120,bright,sv3,5,0.9941868671400552,339,35,3,377
120,bright,sv3,6,0.9856580624130465,315,19,2,336
120,bright,sv3,7,0.9917218574426684,250,43,4,297
120,bright,sv3,8,0.9950994050052064,306,56,7,369
120,bright,sv3,9,0.9884690885512283,355,20,6,381
272,dark,sv3,0,0.9949689638003382,259,12,80,351
272,dark,sv3,1,0.9877525382814386,233,16,59,308
272,dark,sv3,2,0.9901787455415847,257,13,72,342
272,dark,sv3,3,0.9925917736620514,214,14,67,295
272,dark,sv3,4,0.9845753613437224,239,13,80,332
272,dark,sv3,5,0.9863515272950696,245,14,76,335
272,dark,sv3,6,0.9791374503801858,203,14,58,275
272,dark,sv3,7,0.9922877201847994,198,10,63,271
272,dark,sv3,8,0.9935263783414422,213,11,63,287
272,dark,sv3,9,0.9907111075576116,247,16,66,329
353,dark,sv3,0,0.9841470632911811,260,15,88,363
353,dark,sv3,1,0.9906077818789982,241,8,59,308
353,dark,sv3,2,0.9940971581457121,260,11,71,342
353,dark,sv3,3,0.9905990261459032,248,12,59,319
353,dark,sv3,4,0.9907883837294398,256,12,69,337
353,dark,sv3,5,0.9915537201748309,263,14,58,335
353,dark,sv3,6,0.9917260543882379,225,17,57,299
353,dark,sv3,7,0.9877121797697686,205,13,48,266
353,dark,sv3,8,0.9892588614364611,254,10,57,321
353,dark,sv3,9,0.9935595578192171,251,16,85,352
164,dark,sv3,0,0.9860104339829077,261,14,72,347
164,dark,sv3,1,0.984726734009378,224,7,63,294
164,dark,sv3,2,0.993768422757199,264,9,68,341
164,dark,sv3,3,0.9886531165663366,220,9,61,290
164,dark,sv3,4,0.9933945487307515,218,11,70,299
164,dark,sv3,5,0.9827148074892953,245,16,71,332
164,dark,sv3,6,0.9875781218628726,199,13,77,289
164,dark,sv3,7,0.9943733442323407,191,8,62,261
164,dark,sv3,8,0.9841412882255611,237,8,64,309
164,dark,sv3,9,0.993036561522329,269,8,54,331
2,dark,sv3,0,0.9864485477031311,296,13,63,372
2,dark,sv3,1,0.9928907581954265,250,12,50,312
2,dark,sv3,2,0.9938931957167125,265,12,64,341
2,dark,sv3,3,0.9915943938424758,236,15,64,315
2,dark,sv3,4,0.9860494458988248,263,12,63,338
2,dark,sv3,5,0.9906062813837526,273,7,68,348
2,dark,sv3,6,0.9838773899855568,215,11,75,301
2,dark,sv3,7,0.9908887557196426,218,12,61,291
2,dark,sv3,8,0.9878901071326563,274,11,63,348
2,dark,sv3,9,0.9897032736289157,275,11,64,350
67,bright,sv3,0,0.989247401394806,300,96,6,402
67,bright,sv3,1,0.9840399301660855,286,56,2,344
67,bright,sv3,2,0.9945610938748014,266,98,0,364
67,bright,sv3,3,0.9889969247457379,244,77,4,325
67,bright,sv3,4,0.993631982246017,276,65,2,343
67,bright,sv3,5,0.9873704564037998,279,91,1,371
67,bright,sv3,6,0.9849444157793104,272,49,1,322
67,bright,sv3,7,0.9900607603794164,202,76,3,281
67,bright,sv3,8,0.9952896139048178,292,51,2,345
67,bright,sv3,9,0.9924916650180661,296,88,8,392
175,bright,sv3,0,0.9892535269835828,242,118,2,362
175,bright,sv3,1,0.9936557350655357,227,71,2,300
175,bright,sv3,2,0.9936360234460808,285,79,8,372
175,bright,sv3,3,0.9902377122385614,242,71,4,317
175,bright,sv3,4,0.9873408583931257,225,93,7,325
175,bright,sv3,5,0.9744139794999153,238,88,5,331
175,bright,sv3,6,0.9926541633419717,195,107,1,303
175,bright,sv3,7,0.9823661371744034,182,83,4,269
175,bright,sv3,8,0.9936062739975965,228,102,3,333
175,bright,sv3,9,0.9947142547991396,199,120,3,322
82,dark,sv3,0,0.9918923683356808,276,12,99,387
82,dark,sv3,1,0.9941358744218625,227,12,93,332
82,dark,sv3,2,0.9927902912518787,260,12,107,379
82,dark,sv3,3,0.9902407602846602,222,11,100,333
82,dark,sv3,4,0.9931821095125514,269,9,77,355
82,dark,sv3,5,0.9907899839890267,261,10,72,343
82,dark,sv3,6,0.981820402629852,224,10,73,307
82,dark,sv3,7,0.9894830743279063,209,10,66,285
82,dark,sv3,8,0.9894097578186369,258,12,87,357
82,dark,sv3,9,0.9880778100652993,268,16,81,365
148,bright,sv3,0,0.9924230980334457,301,89,0,390
148,bright,sv3,1,0.986532770223779,282,58,2,342
148,bright,sv3,2,0.9963680746888983,260,109,1,370
148,bright,sv3,3,0.9861903277052495,237,105,1,343
148,bright,sv3,4,0.9949628342313588,240,111,3,354
148,bright,sv3,5,0.9893524594969457,258,101,2,361
148,bright,sv3,6,0.9923634333862598,242,70,3,315
148,bright,sv3,7,0.9839963654033069,212,81,2,295
148,bright,sv3,8,0.9910552073809209,250,97,5,352
148,bright,sv3,9,0.985361031825727,290,92,3,385
94,bright,sv3,0,0.9923787191398851,285,79,4,368
94,bright,sv3,1,0.9914717811395929,226,74,6,306
94,bright,sv3,2,0.9948211401330689,280,83,2,365
94,bright,sv3,3,0.9885771720783243,263,58,2,323
94,bright,sv3,4,0.9854140392321166,260,64,0,324
94,bright,sv3,5,0.990241050121032,251,88,6,345
94,bright,sv3,6,0.9947050787759414,236,75,5,316
94,bright,sv3,7,0.9926208195214079,209,63,3,275
94,bright,sv3,8,0.9898474146732992,231,78,6,315
94,bright,sv3,9,0.9955391477783527,268,77,2,347
56,dark,sv3,0,0.9944419797672919,288,11,67,366
56,dark,sv3,1,0.9966644365030859,242,11,70,323
56,dark,sv3,2,0.9927897533244316,260,12,71,343
56,dark,sv3,3,0.9891251830142851,217,8,68,293
56,dark,sv3,4,0.9898175916921319,258,8,61,327
56,dark,sv3,5,0.9947151547484552,259,13,67,339
56,dark,sv3,6,0.983664775325517,223,9,60,292
56,dark,sv3,7,0.979116839369137,188,10,63,261
56,dark,sv3,8,0.9812798531316946,175,5,42,222
56,dark,sv3,9,0.9926150135779342,262,12,73,347
407,dark,sv3,0,0.9930434237084701,277,16,70,363
407,dark,sv3,1,0.9908647302269141,217,12,72,301
407,dark,sv3,2,0.9913667575552424,264,10,76,350
407,dark,sv3,3,0.9939509794783322,248,12,61,321
407,dark,sv3,4,0.9844185885508365,244,11,76,331
407,dark,sv3,5,0.9851253058105902,253,9,56,318
407,dark,sv3,6,0.9788958455533557,218,14,64,296
407,dark,sv3,7,0.9837102249769617,184,15,69,268
407,dark,sv3,8,0.9955496622377612,248,14,58,320
407,dark,sv3,9,0.9947222801637148,256,17,72,345
309,bright,sv3,0,0.9925087008702649,385,19,1,405
309,bright,sv3,1,0.9949487603971351,288,49,3,340
309,bright,sv3,2,0.990161055482275,356,30,3,389
309,bright,sv3,3,0.993971065870648,293,37,3,333
309,bright,sv3,4,0.9900631600734675,329,34,2,365
309,bright,sv3,5,0.992022215174237,324,27,4,355
309,bright,sv3,6,0.9895341581264357,293,21,3,317
309,bright,sv3,7,0.9905763512718535,271,24,3,298
309,bright,sv3,8,0.9951107469675539,325,20,5,350
309,bright,sv3,9,0.9934364230195246,356,21,7,384
28,dark,sv3,0,0.9869333614638276,260,13,96,369
28,dark,sv3,1,0.9911465145960184,218,9,70,297
28,dark,sv3,2,0.9898920949386746,260,16,81,357
28,dark,sv3,3,0.9869968117595758,252,9,63,324
28,dark,sv3,4,0.9947374728396796,222,13,85,320
28,dark,sv3,5,0.9869908926061828,236,14,90,340
28,dark,sv3,6,0.9907849034167381,199,14,85,298
28,dark,sv3,7,0.9873682737511024,203,13,67,283
28,dark,sv3,8,0.9925111612110917,239,15,80,334
28,dark,sv3,9,0.9917947894960711,249,12,83,344
40,bright,sv3,0,0.9928577604949311,345,52,4,401
40,bright,sv3,1,0.9938169331082739,291,64,1,356
40,bright,sv3,2,0.9879029967268397,321,59,3,383
40,bright,sv3,3,0.9919136569393626,237,84,5,326
40,bright,sv3,4,0.9883206293293342,247,94,1,342
40,bright,sv3,5,0.9943677199562236,289,72,7,368
40,bright,sv3,6,0.9842917571207671,261,50,0,311
40,bright,sv3,7,0.984169905902088,225,58,4,287
40,bright,sv3,8,0.9927294977504775,275,54,3,332
40,bright,sv3,9,0.9888874433580005,308,82,3,393
110,dark,sv3,0,0.9862715609330095,258,9,85,352
110,dark,sv3,1,0.9828946394761372,220,13,82,315
110,dark,sv3,2,0.9906576557837006,261,12,81,354
110,dark,sv3,3,0.9907134287278774,229,8,72,309
110,dark,sv3,4,0.9861600066555111,228,12,83,323
110,dark,sv3,5,0.9867535970077186,263,11,64,338
110,dark,sv3,6,0.989090446858479,233,9,63,305
110,dark,sv3,7,0.9844947269537851,186,11,65,262
110,dark,sv3,8,0.989771015094684,241,8,62,311
110,dark,sv3,9,0.9933114981129031,260,9,73,342
137,dark,sv3,0,0.9936210627818512,237,19,73,329
137,dark,sv3,1,0.9882904174624739,236,8,58,302
137,dark,sv3,2,0.9913758958695015,252,10,78,340
137,dark,sv3,3,0.9907825344088452,208,17,70,295
137,dark,sv3,4,0.9952141796324734,230,13,74,317
137,dark,sv3,5,0.9906961304567288,237,13,68,318
137,dark,sv3,6,0.9885553126973158,202,11,62,275
137,dark,sv3,7,0.9850226132064215,215,12,46,273
137,dark,sv3,8,0.9855104121962377,236,12,66,314
137,dark,sv3,9,0.9904663368427907,250,13,71,334
245,dark,sv3,0,0.9931727758586901,258,18,58,334
245,dark,sv3,1,0.9881132306193661,230,8,55,293
245,dark,sv3,2,0.9946196242717464,251,17,65,333
245,dark,sv3,3,0.9861617237340305,215,12,66,293
245,dark,sv3,4,0.992485818143853,212,11,64,287
245,dark,sv3,5,0.9886503762669403,242,12,70,324
245,dark,sv3,6,0.9870343020641437,222,12,45,279
245,dark,sv3,7,0.9793573448461057,184,12,51,247
245,dark,sv3,8,0.9807187308472257,223,10,59,292
245,dark,sv3,9,0.9933392275676691,243,14,72,329
327,dark,sv3,0,0.98340796871712,267,13,64,344
327,dark,sv3,1,0.9847171303429523,212,8,54,274
327,dark,sv3,2,0.9929322396104073,264,11,76,351
327,dark,sv3,3,0.9890491178847997,223,11,60,294
327,dark,sv3,4,0.9826635202534367,245,10,55,310
327,dark,sv3,5,0.9920595838139892,248,16,59,323
327,dark,sv3,6,0.9884960195864301,239,7,37,283
327,dark,sv3,7,0.9894506772849391,186,9,52,247
327,dark,sv3,8,0.9902737358632209,247,11,58,316
327,dark,sv3,9,0.9868629089442047,242,10,69,321
300,dark,sv3,0,0.9962054681561978,270,11,71,352
300,dark,sv3,1,0.9913096459746615,227,12,61,300
300,dark,sv3,2,0.9855996010538866,271,13,55,339
300,dark,sv3,3,0.9925895946217982,266,10,50,326
300,dark,sv3,4,0.9911765808045091,270,7,50,327
300,dark,sv3,5,0.9850506176405593,252,13,65,330
300,dark,sv3,6,0.9849722647328734,228,8,50,286
300,dark,sv3,7,0.9947370359445286,225,9,34,268
300,dark,sv3,8,0.9910673942789394,263,10,71,344
300,dark,sv3,9,0.9943978111119736,292,10,51,353
14,bright,sv3,0,0.9908271603474808,206,158,2,366
14,bright,sv3,1,0.9902189246778408,223,112,6,341
14,bright,sv3,2,0.9930260356953983,224,154,3,381
14,bright,sv3,3,0.9913164033969285,210,111,4,325
14,bright,sv3,4,0.9922134489011227,226,127,3,356
14,bright,sv3,5,0.9853529220851064,259,111,2,372
14,bright,sv3,6,0.9898900608380381,203,121,3,327
14,bright,sv3,7,0.9944921505580554,191,84,5,280
14,bright,sv3,8,0.989827624462551,205,138,2,345
14,bright,sv3,9,0.9901686221832746,166,168,1,335
354,dark,sv3,0,0.9925139054987869,267,13,69,349
354,dark,sv3,1,0.9847415626353274,218,8,65,291
354,dark,sv3,2,0.9892998132145984,270,12,59,341
354,dark,sv3,3,0.9955361866304036,234,9,57,300
354,dark,sv3,4,0.9851460393277418,229,11,57,297
354,dark,sv3,5,0.9815042736805542,263,10,44,317
354,dark,sv3,6,0.9862001642747503,226,10,46,282
354,dark,sv3,7,0.9860623099213404,203,11,40,254
354,dark,sv3,8,0.9810710869390487,255,12,59,326
354,dark,sv3,9,0.9850833367249505,245,12,76,333
381,dark,sv3,0,0.9909771311134805,259,9,90,358
381,dark,sv3,1,0.9867100032917243,260,12,55,327
381,dark,sv3,2,0.9927847696076584,263,14,77,354
381,dark,sv3,3,0.9884772095008099,232,10,71,313
381,dark,sv3,4,0.98907918746086,267,8,44,319
381,dark,sv3,5,0.980870119122666,262,12,52,326
381,dark,sv3,6,0.9830776884307669,207,15,71,293
381,dark,sv3,7,0.9853578449105987,196,10,55,261
381,dark,sv3,8,0.9820714186895836,264,12,54,330
381,dark,sv3,9,0.9891769103321002,252,8,74,334
246,dark,sv3,0,0.9869978559277928,241,15,61,317
246,dark,sv3,1,0.9919113147062584,212,13,51,276
246,dark,sv3,2,0.9828022609185041,275,11,33,319
246,dark,sv3,3,0.9961946674662872,233,9,55,297
246,dark,sv3,4,0.9887332288498485,236,10,60,306
246,dark,sv3,5,0.9927486643054863,232,10,54,296
246,dark,sv3,6,0.9867871071966386,198,12,61,271
246,dark,sv3,7,0.9877146288894,189,9,53,251
246,dark,sv3,8,0.9856500363204806,228,13,64,305
246,dark,sv3,9,0.9879021317425267,239,10,70,319
408,dark,sv3,0,0.9946217186466321,277,11,67,355
408,dark,sv3,1,0.9917527221752634,239,12,57,308
408,dark,sv3,2,0.9935145707504246,278,12,62,352
408,dark,sv3,3,0.983589169225347,251,8,55,314
408,dark,sv3,4,0.9882082846449608,256,12,62,330
408,dark,sv3,5,0.9903542994603902,254,9,56,319
408,dark,sv3,6,0.9937824194373387,227,12,52,291
408,dark,sv3,7,0.9753334920739896,204,15,60,279
408,dark,sv3,8,0.9898839470242967,252,11,61,324
408,dark,sv3,9,0.9897682430816653,257,14,71,342
191,dark,sv3,0,0.993549860974623,293,9,69,371
191,dark,sv3,1,0.9900555425988812,241,13,77,331
191,dark,sv3,2,0.9919957469130778,263,12,84,359
191,dark,sv3,3,0.9946776300526161,246,11,64,321
191,dark,sv3,4,0.9937025559824619,246,9,82,337
191,dark,sv3,5,0.9942818477954571,261,13,71,345
191,dark,sv3,6,0.9936791779237657,236,12,53,301
191,dark,sv3,7,0.9924810833828999,221,11,71,303
191,dark,sv3,8,0.996035189725955,236,16,76,328
191,dark,sv3,9,0.9946566461747702,287,10,64,361
273,dark,sv3,0,0.9920451133432887,282,11,64,357
273,dark,sv3,1,0.9958506680936076,237,9,52,298
273,dark,sv3,2,0.9882609930352857,255,13,61,329
273,dark,sv3,3,0.9950390083838362,249,11,58,318
273,dark,sv3,4,0.9848365861894285,251,10,52,313
273,dark,sv3,5,0.9899578597349273,243,10,59,312
273,dark,sv3,6,0.989853872064686,207,10,66,283
273,dark,sv3,7,0.992238410656366,203,11,48,262
273,dark,sv3,8,0.9913815299707313,252,15,60,327
273,dark,sv3,9,0.9927920914594878,258,14,63,335
409,dark,sv3,0,0.9923524353754815,278,9,59,346
409,dark,sv3,1,0.9931302203491299,236,11,64,311
409,dark,sv3,2,0.9868460727803742,259,12,58,329
409,dark,sv3,3,0.9914216940342356,233,11,47,291
409,dark,sv3,4,0.9920867657978057,245,9,57,311
409,dark,sv3,5,0.9858756632628082,186,5,48,239
409,dark,sv3,6,0.990968067421388,221,11,46,278
409,dark,sv3,7,0.9903197221496756,191,11,63,265
409,dark,sv3,8,0.983757911512808,228,12,53,293
409,dark,sv3,9,0.9910107511467491,273,13,55,341
219,dark,sv3,0,0.9941125883404909,263,11,66,340
219,dark,sv3,1,0.9861495880905917,203,11,59,273
219,dark,sv3,2,0.9881591148768873,248,8,68,324
219,dark,sv3,3,0.9843118966396525,246,12,47,305
219,dark,sv3,4,0.9920524720793126,246,9,64,319
219,dark,sv3,5,0.9886611635129559,259,9,44,312
219,dark,sv3,6,0.9904261804277777,218,9,51,278
219,dark,sv3,7,0.9874555508449885,198,12,42,252
219,dark,sv3,8,0.9928164951089661,258,11,47,316
219,dark,sv3,9,0.9951547131189388,242,12,69,323
165,dark,sv3,0,0.9901141980749505,270,10,68,348
165,dark,sv3,1,0.9898079921625583,234,10,56,300
165,dark,sv3,2,0.9947981882829874,264,12,55,331
165,dark,sv3,3,0.9847192564104933,224,14,55,293
165,dark,sv3,4,0.9876993415802171,238,12,71,321
165,dark,sv3,5,0.9902842048668704,251,11,67,329
165,dark,sv3,6,0.991185618410449,205,12,62,279
165,dark,sv3,7,0.9738642801345542,208,12,50,270
165,dark,sv3,8,0.98765774051408,238,9,62,309
165,dark,sv3,9,0.9900480451677943,257,10,50,317
247,dark,sv3,0,0.9918154180178647,265,8,56,329
247,dark,sv3,1,0.9591292233724722,242,8,36,286
247,dark,sv3,2,0.9954500404431899,244,13,47,304
247,dark,sv3,3,0.9926013597674211,225,10,52,287
247,dark,sv3,4,0.9914879825376299,242,11,66,319
247,dark,sv3,5,0.99298434724076,259,11,48,318
247,dark,sv3,6,0.9878266447060012,219,10,49,278
247,dark,sv3,7,0.9833898337587622,196,11,49,256
247,dark,sv3,8,0.9911439114271591,244,7,55,306
247,dark,sv3,9,0.9899169902267455,249,16,56,321
390,bright,sv3,0,0.9871532144290861,359,28,8,395
390,bright,sv3,1,0.9915332099757346,284,67,0,351
390,bright,sv3,2,0.9907294647335444,323,47,1,371
390,bright,sv3,3,0.9898489268921212,271,55,3,329
390,bright,sv3,4,0.9892334261206484,292,58,3,353
390,bright,sv3,5,0.9867487359695643,297,80,2,379
390,bright,sv3,6,0.9874110729864741,246,60,2,308
390,bright,sv3,7,0.9900533544742206,234,58,2,294
390,bright,sv3,8,0.9944724373821984,324,57,0,381
390,bright,sv3,9,0.9889382518002863,318,54,0,372
363,bright,sv3,0,0.9938729800913028,365,40,1,406
363,bright,sv3,1,0.9906321218081016,320,18,0,338
363,bright,sv3,2,0.9897834797620901,340,29,4,373
363,bright,sv3,3,0.9906959637368115,293,45,4,342
363,bright,sv3,4,0.984465333100913,317,29,3,349
363,bright,sv3,5,0.9928379692219541,332,38,1,371
363,bright,sv3,6,0.9894860217122975,295,20,2,317
363,bright,sv3,7,0.9896383596379998,272,30,1,303
363,bright,sv3,8,0.9915498080808182,331,37,5,373
363,bright,sv3,9,0.9920874276661223,338,44,2,384
192,dark,sv3,0,0.9911513117745563,286,11,68,365
192,dark,sv3,1,0.9832862148399949,228,12,54,294
192,dark,sv3,2,0.9898549492247305,254,10,82,346
192,dark,sv3,3,0.986627825525341,238,7,51,296
192,dark,sv3,4,0.9903169593945552,232,11,65,308
192,dark,sv3,5,0.9924369601220994,265,7,65,337
192,dark,sv3,6,0.991297864193738,225,11,49,285
192,dark,sv3,7,0.9788387889353091,205,10,59,274
192,dark,sv3,8,0.9919403320945093,245,8,72,325
192,dark,sv3,9,0.9943252726388883,273,8,54,335
382,dark,sv3,0,0.9941703470914606,271,12,71,354
382,dark,sv3,1,0.9947217498174071,233,9,66,308
382,dark,sv3,2,0.9849511025339996,258,8,57,323
382,dark,sv3,3,0.9855110099324658,232,9,58,299
382,dark,sv3,4,0.9843189280323716,258,11,42,311
382,dark,sv3,5,0.9845648113220713,263,12,52,327
382,dark,sv3,6,0.9830636704608954,223,11,51,285
382,dark,sv3,7,0.9896307307166265,200,13,62,275
382,dark,sv3,8,0.9859727697853038,262,8,58,328
382,dark,sv3,9,0.991804849665375,240,14,65,319
417,bright,sv3,0,0.9967373060950155,317,79,3,399
417,bright,sv3,1,0.9889530780127048,277,60,6,343
417,bright,sv3,2,0.9899546108647581,320,45,3,368
417,bright,sv3,3,0.9926140374820568,265,55,2,322
417,bright,sv3,4,0.9937608626299241,270,58,5,333
417,bright,sv3,5,0.9843897000942451,293,70,3,366
417,bright,sv3,6,0.9847129071647499,244,65,2,311
417,bright,sv3,7,0.9869696018895585,244,48,1,293
417,bright,sv3,8,0.9876157253039706,331,38,1,370
417,bright,sv3,9,0.9949840130468798,310,73,1,384
138,dark,sv3,0,0.9910637529495614,264,12,65,341
138,dark,sv3,1,0.9897579819171747,232,12,52,296
138,dark,sv3,2,0.9864992222872406,237,12,69,318
138,dark,sv3,3,0.9905530129430583,225,13,64,302
138,dark,sv3,4,0.9895805580510401,247,11,68,326
138,dark,sv3,5,0.9839348546760579,250,6,65,321
138,dark,sv3,6,0.9881575218792406,209,12,62,283
138,dark,sv3,7,0.9945596788458549,220,10,39,269
138,dark,sv3,8,0.9864769104560931,249,14,60,323
138,dark,sv3,9,0.9903473355429648,247,11,73,331
274,dark,sv3,0,0.9924001760217621,274,10,63,347
274,dark,sv3,1,0.9952859721217875,224,6,49,279
274,dark,sv3,2,0.9853476012106049,238,10,54,302
274,dark,sv3,3,0.982061317280704,211,7,57,275
274,dark,sv3,4,0.9909177395681639,231,13,52,296
274,dark,sv3,5,0.9895368858816255,224,7,57,288
274,dark,sv3,6,0.9831376273288196,213,9,54,276
274,dark,sv3,7,0.9951167917102653,186,13,46,245
274,dark,sv3,8,0.989507135464662,242,12,59,313
274,dark,sv3,9,0.9951023217203843,239,10,58,307
3,dark,sv3,0,0.9928291774155784,276,12,60,348
3,dark,sv3,1,0.9857718546671479,268,10,44,322
3,dark,sv3,2,0.9888207563121889,290,10,58,358
3,dark,sv3,3,0.992729270692234,249,9,47,305
3,dark,sv3,4,0.9911570082547142,238,10,57,305
3,dark,sv3,5,0.9903617248648833,259,11,69,339
3,dark,sv3,6,0.991985197181657,238,9,51,298
3,dark,sv3,7,0.9864520749040949,202,7,60,269
3,dark,sv3,8,0.9924328504280933,255,11,53,319
3,dark,sv3,9,0.9914353814248029,260,12,53,325
328,dark,sv3,0,0.9919887393607766,277,14,65,356
328,dark,sv3,1,0.9818401111603894,247,10,56,313
328,dark,sv3,2,0.9897619428253116,254,10,59,323
328,dark,sv3,3,0.9922797894916554,233,12,52,297
328,dark,sv3,4,0.9884852353062653,244,10,56,310
328,dark,sv3,5,0.9879699837178664,262,9,57,328
328,dark,sv3,6,0.9891607394452397,220,12,42,274
328,dark,sv3,7,0.9922205938572218,220,9,40,269
328,dark,sv3,8,0.9926058432979281,268,10,47,325
328,dark,sv3,9,0.9932909349249778,251,9,77,337
355,dark,sv3,0,0.9889828155250351,275,11,77,363
355,dark,sv3,1,0.9915796201455244,241,11,51,303
355,dark,sv3,2,0.9861439960779083,254,11,58,323
355,dark,sv3,3,0.9843965281244704,247,10,42,299
355,dark,sv3,4,0.9926511015200292,237,12,55,304
355,dark,sv3,5,0.9890952162956462,268,11,48,327
355,dark,sv3,6,0.9858629393292853,197,13,64,274
355,dark,sv3,7,0.9939975507405593,222,10,34,266
355,dark,sv3,8,0.992322452471603,245,11,59,315
355,dark,sv3,9,0.9873699819532389,255,10,67,332
29,dark,sv3,0,0.9943682289141401,289,14,75,378
29,dark,sv3,1,0.9924000960856443,260,14,64,338
29,dark,sv3,2,0.9867463623071595,277,12,66,355
29,dark,sv3,3,0.9860276949187199,259,11,47,317
29,dark,sv3,4,0.9937197536136191,248,14,65,327
29,dark,sv3,5,0.9851503228747982,261,12,56,329
29,dark,sv3,6,0.9863563951873534,213,13,71,297
29,dark,sv3,7,0.9880915908133827,211,9,50,270
29,dark,sv3,8,0.9910859146660125,267,10,66,343
29,dark,sv3,9,0.9958652020476652,273,12,69,354
301,dark,sv3,0,0.9898026668708636,269,7,70,346
301,dark,sv3,1,0.9919853567981924,257,10,49,316
301,dark,sv3,2,0.9932489769657437,254,7,65,326
301,dark,sv3,3,0.988410186828356,248,10,43,301
301,dark,sv3,4,0.9814653393863076,253,12,53,318
301,dark,sv3,5,0.9960445868249714,227,11,62,300
301,dark,sv3,6,0.9897178473239259,209,10,63,282
301,dark,sv3,7,0.9775839389991035,215,10,38,263
301,dark,sv3,8,0.9912058306335418,252,10,63,325
301,dark,sv3,9,0.9883238376325572,282,10,53,345
83,dark,sv3,0,0.9919885320469537,269,11,81,361
83,dark,sv3,1,0.9900650819939321,243,12,78,333
83,dark,sv3,2,0.9931258402052167,263,10,84,357
83,dark,sv3,3,0.9902258401663613,229,9,76,314
83,dark,sv3,4,0.9927926105758526,251,11,74,336
83,dark,sv3,5,0.9893999770229244,279,10,63,352
83,dark,sv3,6,0.989140227465442,227,9,53,289
83,dark,sv3,7,0.9858023626366869,203,11,49,263
83,dark,sv3,8,0.9930492036266563,262,10,59,331
83,dark,sv3,9,0.9846349906883427,264,16,62,342
111,dark,sv3,0,0.9900634766055817,254,11,86,351
111,dark,sv3,1,0.9861501335526689,235,9,59,303
111,dark,sv3,2,0.9930709562693562,262,9,64,335
111,dark,sv3,3,0.9933411030670772,226,10,58,294
111,dark,sv3,4,0.9857232007194485,213,8,79,300
111,dark,sv3,5,0.9899702971626294,263,9,58,330
111,dark,sv3,6,0.985467162037255,208,12,69,289
111,dark,sv3,7,0.9781233672995658,179,12,61,252
111,dark,sv3,8,0.9949351347658087,251,8,74,333
111,dark,sv3,9,0.993605321307856,266,10,63,339
57,dark,sv3,0,0.9811459099555301,271,12,63,346
57,dark,sv3,1,0.988889468433665,254,9,59,322
57,dark,sv3,2,0.995945796953056,275,11,50,336
57,dark,sv3,3,0.9879547462537456,235,11,65,311
57,dark,sv3,4,0.9826002817999366,265,10,46,321
57,dark,sv3,5,0.9919039772447107,250,10,70,330
57,dark,sv3,6,0.9906523964077659,231,11,46,288
57,dark,sv3,7,0.9880701467368292,209,11,59,279
57,dark,sv3,8,0.9893897435202431,239,12,70,321
57,dark,sv3,9,0.982872582417486,262,10,67,339
275,dark,sv3,0,0.9938621879463644,271,11,51,333
275,dark,sv3,1,0.9944322988334234,255,9,47,311
275,dark,sv3,2,0.9922479772715035,263,10,46,319
275,dark,sv3,3,0.9954621587783732,222,9,43,274
275,dark,sv3,4,0.9918220440447187,253,11,47,311
275,dark,sv3,5,0.9898673862436383,282,9,37,328
275,dark,sv3,6,0.9904220015150595,214,8,41,263
275,dark,sv3,7,0.9896483567061938,214,9,40,263
275,dark,sv3,8,0.9820340886071139,250,12,48,310
275,dark,sv3,9,0.9884419214409097,264,10,51,325
383,dark,sv3,0,0.9936385055717929,267,11,71,349
383,dark,sv3,1,0.9790978614238837,240,11,48,299
383,dark,sv3,2,0.9869818694872815,263,15,66,344
383,dark,sv3,3,0.9928881053768198,220,8,45,273
383,dark,sv3,4,0.9896160691867992,256,9,41,306
383,dark,sv3,5,0.9910594638818969,272,12,43,327
383,dark,sv3,6,0.982665832749969,223,11,44,278
383,dark,sv3,7,0.994681304054224,219,8,53,280
383,dark,sv3,8,0.9875883880476344,263,15,41,319
383,dark,sv3,9,0.9952815883798498,248,12,65,325
112,dark,sv3,0,0.993372509793876,274,12,74,360
112,dark,sv3,1,0.9931878364441442,194,8,137,339
112,dark,sv3,2,0.9880290229622863,272,10,68,350
112,dark,sv3,3,0.9869970942419868,242,10,61,313
112,dark,sv3,4,0.9928784963098516,246,12,66,324
112,dark,sv3,5,0.9928933879302909,255,9,60,324
112,dark,sv3,6,0.9888149932969924,213,10,57,280
112,dark,sv3,7,0.9867028945194147,207,10,67,284
112,dark,sv3,8,0.9931112990934957,255,10,54,319
112,dark,sv3,9,0.9960733336059303,257,11,72,340
329,dark,sv3,0,0.9930095593492758,290,19,47,356
329,dark,sv3,1,0.9928109897020556,257,9,52,318
329,dark,sv3,2,0.9806224106963157,272,10,50,332
329,dark,sv3,3,0.9916836934145017,229,10,46,285
329,dark,sv3,4,0.9939988103319547,262,9,50,321
329,dark,sv3,5,0.9918607239827104,271,10,52,333
329,dark,sv3,6,0.9858244379376484,240,12,23,275
329,dark,sv3,7,0.9912193462166184,219,10,45,274
329,dark,sv3,8,0.9860437126730348,263,12,48,323
329,dark,sv3,9,0.9890818424402014,267,11,60,338
193,dark,sv3,0,0.9910861546014257,307,10,57,374
193,dark,sv3,1,0.9872557509684021,238,11,67,316
193,dark,sv3,2,0.9930557433906877,271,8,70,349
193,dark,sv3,3,0.9910195652696784,224,7,54,285
193,dark,sv3,4,0.979304865650814,234,10,72,316
193,dark,sv3,5,0.9877411908274055,287,7,55,349
193,dark,sv3,6,0.9905221634064889,219,10,52,281
193,dark,sv3,7,0.9821656590583203,221,10,49,280
193,dark,sv3,8,0.9899815094615968,261,10,66,337
193,dark,sv3,9,0.9936564791380261,271,12,55,338
30,dark,sv3,0,0.9859431092898562,274,10,75,359
30,dark,sv3,1,0.9901134058997336,237,11,59,307
30,dark,sv3,2,0.9893480288005874,279,13,60,352
30,dark,sv3,3,0.9822968387040346,256,10,38,304
30,dark,sv3,4,0.9870510079407226,267,10,59,336
30,dark,sv3,5,0.9928260359889656,275,13,54,342
30,dark,sv3,6,0.9932988654781916,224,11,57,292
30,dark,sv3,7,0.9902676669752921,211,12,53,276
30,dark,sv3,8,0.9879129760518315,261,11,65,337
30,dark,sv3,9,0.9913198431599262,277,11,62,350
248,dark,sv3,0,0.9899255217184253,261,11,36,308
248,dark,sv3,1,0.9941602187707327,237,9,48,294
248,dark,sv3,2,0.9864033318340845,272,10,39,321
248,dark,sv3,3,0.9841085003427325,193,8,48,249
248,dark,sv3,4,0.9828875242533148,234,10,51,295
248,dark,sv3,5,0.9781993945449359,252,8,51,311
248,dark,sv3,6,0.978380550386586,211,12,34,257
248,dark,sv3,7,0.9767465936145401,187,11,49,247
248,dark,sv3,8,0.9905172051137112,235,10,53,298
248,dark,sv3,9,0.9893018872440115,239,9,55,303
391,bright,sv3,0,0.9908009639582276,326,73,4,403
391,bright,sv3,1,0.9880430089344315,245,107,4,356
391,bright,sv3,2,0.990949566268224,284,95,8,387
391,bright,sv3,3,0.9918832652514635,226,84,5,315
391,bright,sv3,4,0.9927783403192904,261,97,2,360
391,bright,sv3,5,0.9873099855864205,248,116,5,369
391,bright,sv3,6,0.9940382337607534,187,126,3,316
391,bright,sv3,7,0.9923259296805291,191,106,3,300
391,bright,sv3,8,0.9954518998474475,286,89,4,379
391,bright,sv3,9,0.9868565904933171,270,113,2,385
220,dark,sv3,0,0.9891258631578582,251,11,56,318
220,dark,sv3,1,0.9922862820906467,238,9,59,306
220,dark,sv3,2,0.9945322630899986,282,9,47,338
220,dark,sv3,3,0.9886091626768853,201,13,54,268
220,dark,sv3,4,0.9920330500455447,237,12,65,314
220,dark,sv3,5,0.9877716000054776,242,11,53,306
220,dark,sv3,6,0.9829743617343222,221,10,48,279
220,dark,sv3,7,0.9891798982672041,205,13,46,264
220,dark,sv3,8,0.9943859574342007,242,10,54,306
220,dark,sv3,9,0.9952384765962593,256,10,52,318
202,bright,sv3,0,0.9928898178776008,275,96,4,375
202,bright,sv3,1,0.993656633981602,284,65,1,350
202,bright,sv3,2,0.9891441565762217,280,84,4,368
202,bright,sv3,3,0.9918427576302292,253,59,2,314
202,bright,sv3,4,0.9928965726693513,257,85,6,348
202,bright,sv3,5,0.9922792667343991,251,104,7,362
202,bright,sv3,6,0.9898110973091357,213,81,4,298
202,bright,sv3,7,0.9899446345066333,210,74,5,289
202,bright,sv3,8,0.9906079865007453,257,100,3,360
202,bright,sv3,9,0.990351713236783,298,72,4,374
256,bright,sv3,0,0.9909340515921867,298,99,2,399
256,bright,sv3,1,0.9912041869171837,311,47,2,360
256,bright,sv3,2,0.9947459938849719,344,45,4,393
256,bright,sv3,3,0.9888343626089032,262,52,4,318
256,bright,sv3,4,0.9816800605270637,276,84,3,363
256,bright,sv3,5,0.9887180966594087,283,91,4,378
256,bright,sv3,6,0.9862787182513353,236,75,2,313
256,bright,sv3,7,0.9933832538556292,233,76,3,312
256,bright,sv3,8,0.9942254117631892,287,90,3,380
256,bright,sv3,9,0.9950551216979654,277,106,5,388
166,dark,sv3,0,0.9965378982314063,295,10,60,365
166,dark,sv3,1,0.9890419741479629,267,9,59,335
166,dark,sv3,2,0.9941850709872654,272,11,57,340
166,dark,sv3,3,0.9933496012540716,219,10,48,277
166,dark,sv3,4,0.9887326616246372,241,10,62,313
166,dark,sv3,5,0.9832691878214173,247,12,63,322
166,dark,sv3,6,0.9891917193798031,218,10,59,287
166,dark,sv3,7,0.9921843474042712,198,13,53,264
166,dark,sv3,8,0.9917692282408648,261,12,62,335
166,dark,sv3,9,0.9900259666587793,272,8,55,335
337,bright,sv3,0,0.9869440958438888,258,130,6,394
337,bright,sv3,1,0.9885983492058585,234,124,3,361
337,bright,sv3,2,0.9948232622548776,262,129,3,394
337,bright,sv3,3,0.9848355355160872,205,114,0,319
337,bright,sv3,4,0.9960929686337434,271,93,2,366
337,bright,sv3,5,0.9874153356239553,261,112,11,384
337,bright,sv3,6,0.9954465524003542,198,118,2,318
337,bright,sv3,7,0.9921053544198418,198,90,6,294
337,bright,sv3,8,0.9913005161787569,307,81,0,388
337,bright,sv3,9,0.9922277605527222,266,113,2,381
84,dark,sv3,0,0.9900942448757363,270,10,89,369
84,dark,sv3,1,0.9925085521308943,245,12,63,320
84,dark,sv3,2,0.9941324889967917,289,11,66,366
84,dark,sv3,3,0.9875879498771388,244,9,65,318
84,dark,sv3,4,0.9839563032794488,254,11,66,331
84,dark,sv3,5,0.9884099989946626,275,9,55,339
84,dark,sv3,6,0.9865664973477256,230,9,55,294
84,dark,sv3,7,0.9840804304076589,212,12,56,280
84,dark,sv3,8,0.9927867973336502,264,13,70,347
84,dark,sv3,9,0.9917674632965724,268,13,57,338
139,dark,sv3,0,0.9844122220941608,263,13,59,335
139,dark,sv3,1,0.9828532806680409,235,10,61,306
139,dark,sv3,2,0.9873050741186524,245,12,71,328
139,dark,sv3,3,0.9930614155286225,235,9,54,298
139,dark,sv3,4,0.9946179347192274,257,7,61,325
139,dark,sv3,5,0.99075105717078,269,6,60,335
139,dark,sv3,6,0.992578228329222,214,10,52,276
139,dark,sv3,7,0.9881843002094287,211,10,39,260
139,dark,sv3,8,0.9872287432928152,252,8,56,316
139,dark,sv3,9,0.9859999779488791,251,9,66,326
410,dark,sv3,0,0.9909908650175642,280,9,54,343
410,dark,sv3,1,0.9846169646417342,247,11,53,311
410,dark,sv3,2,0.9955408359947306,265,10,55,330
410,dark,sv3,3,0.9865718132312017,209,13,47,269
410,dark,sv3,4,0.9911053634501167,243,12,56,311
410,dark,sv3,5,0.9966130212114418,253,13,60,326
410,dark,sv3,6,0.9887203782276281,212,11,43,266
410,dark,sv3,7,0.9898427245316455,221,11,39,271
410,dark,sv3,8,0.9890453982299755,250,12,48,310
410,dark,sv3,9,0.9904887550802774,254,16,46,316
310,bright,sv3,0,0.9951997291963243,312,82,4,398
310,bright,sv3,1,0.9867069934645748,262,105,3,370
310,bright,sv3,2,0.990641582105106,332,61,5,398
310,bright,sv3,3,0.9932164722517407,275,68,4,347
310,bright,sv3,4,0.9926955621040762,294,61,5,360
310,bright,sv3,5,0.9909736381126899,290,96,1,387
310,bright,sv3,6,0.9957353628705857,259,60,4,323
310,bright,sv3,7,0.9898824157276735,256,60,0,316
310,bright,sv3,8,0.9941712245728787,311,71,2,384
310,bright,sv3,9,0.9904062631578666,346,58,4,408
4,dark,sv3,0,0.9921233738541958,303,7,58,368
4,dark,sv3,1,0.9873612363147853,253,11,57,321
4,dark,sv3,2,0.9947301273482573,291,9,61,361
4,dark,sv3,3,0.9902135737037071,242,10,52,304
4,dark,sv3,4,0.9894011998892976,253,10,60,323
4,dark,sv3,5,0.993854122235876,282,8,58,348
4,dark,sv3,6,0.9902140512658966,225,10,51,286
4,dark,sv3,7,0.9832461793215942,228,10,48,286
4,dark,sv3,8,0.9920762261829618,271,10,58,339
4,dark,sv3,9,0.9924681900695037,289,11,53,353
356,dark,sv3,0,0.9940344769297971,269,11,51,331
356,dark,sv3,1,0.9920323700153019,276,12,40,328
356,dark,sv3,2,0.9943814887867196,278,12,42,332
356,dark,sv3,3,0.9841158438957666,226,15,35,276
356,dark,sv3,4,0.9899765546081769,264,10,40,314
356,dark,sv3,5,0.986154752747386,287,10,31,328
356,dark,sv3,6,0.9876584068167624,224,11,48,283
356,dark,sv3,7,0.9915408872162828,241,9,36,286
356,dark,sv3,8,0.9941829785318076,256,9,45,310
356,dark,sv3,9,0.9868320128408914,248,14,60,322
282,bright,sv3,0,0.9937086178049972,364,35,4,403
282,bright,sv3,1,0.989432157367749,311,25,7,343
282,bright,sv3,2,0.9828351579621035,350,41,3,394
282,bright,sv3,3,0.9879667729128907,260,49,1,310
282,bright,sv3,4,0.9927991789988594,321,23,5,349
282,bright,sv3,5,0.9936559867404449,351,26,2,379
282,bright,sv3,6,0.9853272352418727,283,24,2,309
282,bright,sv3,7,0.99034615407762,264,37,5,306
282,bright,sv3,8,0.9901771261641963,324,46,6,376
282,bright,sv3,9,0.9928014373336755,353,36,1,390
41,bright,sv3,0,0.9855326512288514,268,110,1,379
41,bright,sv3,1,0.9922737840823745,227,97,4,328
41,bright,sv3,2,0.9948576648027795,269,81,4,354
41,bright,sv3,3,0.9903151097574854,165,114,0,279
41,bright,sv3,4,0.9895464190220841,186,120,5,311
41,bright,sv3,5,0.9938898009651793,251,97,5,353
41,bright,sv3,6,0.9910116639287919,225,94,0,319
41,bright,sv3,7,0.9871655345989192,188,80,2,270
41,bright,sv3,8,0.9955652932027238,295,78,6,379
41,bright,sv3,9,0.9846214779039789,250,103,5,358
302,dark,sv3,0,0.983151760679896,278,11,58,347
302,dark,sv3,1,0.9917072019028903,249,12,50,311
302,dark,sv3,2,0.9929841339844427,292,10,51,353
302,dark,sv3,3,0.9823323358755869,227,11,43,281
302,dark,sv3,4,0.9926496746027262,261,7,52,320
302,dark,sv3,5,0.9851510720740918,231,13,52,296
302,dark,sv3,6,0.9860848949476275,209,10,52,271
302,dark,sv3,7,0.9844447110208475,215,8,28,251
302,dark,sv3,8,0.9866690912250663,260,10,52,322
302,dark,sv3,9,0.992286251719802,273,10,49,332
418,bright,sv3,0,0.9850010839875525,275,117,5,397
418,bright,sv3,1,0.9919043648366378,229,110,5,344
418,bright,sv3,2,0.992353291888577,310,77,3,390
418,bright,sv3,3,0.992002683211016,230,78,0,308
418,bright,sv3,4,0.9839300688099077,236,124,3,363
418,bright,sv3,5,0.991240454589615,225,140,7,372
418,bright,sv3,6,0.992493931185302,210,101,4,315
418,bright,sv3,7,0.9895352366759935,218,94,1,313
418,bright,sv3,8,0.9955608244761036,284,95,4,383
418,bright,sv3,9,0.9904213395068909,228,149,6,383
364,bright,sv3,0,0.9942002504651366,301,107,6,414
364,bright,sv3,1,0.9932508332710112,306,45,2,353
364,bright,sv3,2,0.9951406071522115,304,92,0,396
364,bright,sv3,3,0.9905503933587713,252,71,3,326
364,bright,sv3,4,0.9941633368897151,291,60,4,355
364,bright,sv3,5,0.9958136793620254,294,69,4,367
364,bright,sv3,6,0.9886884338033118,253,59,5,317
364,bright,sv3,7,0.9852471765546397,252,52,3,307
364,bright,sv3,8,0.9912254428113733,282,85,5,372
364,bright,sv3,9,0.9957512799792543,294,85,3,382
51,backup,sv3,0,0.9866388230068189,4,273,1,278
51,backup,sv3,1,0.9824953160733615,2,251,2,255
51,backup,sv3,2,0.9886308472175759,4,253,0,257
51,backup,sv3,3,0.9915989527420696,5,196,2,203
51,backup,sv3,4,0.9856820440388195,1,191,0,192
51,backup,sv3,5,0.9845513383444551,3,223,1,227
51,backup,sv3,6,0.9781121519359077,4,198,0,202
51,backup,sv3,7,0.9822167821659329,5,189,2,196
51,backup,sv3,8,0.9802564608007185,19,221,1,241
51,backup,sv3,9,0.9911964398314622,7,248,0,255
320,backup,sv3,0,0.9942424030471136,5,374,0,379
320,backup,sv3,1,0.9861386812531577,1,336,0,337
320,backup,sv3,2,0.9939610578872362,10,346,1,357
320,backup,sv3,3,0.9880090075459323,5,257,0,262
320,backup,sv3,4,0.9866577331619398,27,234,0,261
320,backup,sv3,5,0.9910487102483211,41,297,0,338
320,backup,sv3,6,0.9909965430780053,6,305,1,312
320,backup,sv3,7,0.9927750652478604,4,275,1,280
320,backup,sv3,8,0.9925529520282342,2,361,1,364
320,backup,sv3,9,0.9912784774549471,1,283,1,285
365,bright,sv3,0,0.9915213631843764,247,144,4,395
365,bright,sv3,1,0.9925798146849462,252,99,6,357
365,bright,sv3,2,0.9881035081501083,283,106,1,390
365,bright,sv3,3,0.9850807515985612,170,102,1,273
365,bright,sv3,4,0.9938938968859824,243,114,4,361
365,bright,sv3,5,0.9907555316302316,222,146,5,373
365,bright,sv3,6,0.9969695980370129,205,118,2,325
365,bright,sv3,7,0.9888526158473809,220,86,7,313
365,bright,sv3,8,0.990269273771079,244,127,2,373
365,bright,sv3,9,0.9921798337837233,174,113,5,292
384,dark,sv3,0,0.9931479103482311,265,14,48,327
384,dark,sv3,1,0.9847379411332372,253,8,35,296
384,dark,sv3,2,0.9931781950246975,267,11,38,316
384,dark,sv3,3,0.9766800938484355,178,14,27,219
384,dark,sv3,4,0.9862852610009024,237,23,30,290
384,dark,sv3,5,0.9910373818727974,244,12,42,298
384,dark,sv3,6,0.9887744385595331,236,8,34,278
384,dark,sv3,7,0.9919946076451324,206,6,41,253
384,dark,sv3,8,0.9934443022886535,244,12,44,300
384,dark,sv3,9,0.9765761263145106,193,15,24,232
185,backup,sv3,0,0.9954159399910804,1,319,0,320
185,backup,sv3,1,0.9727167559779034,6,269,2,277
185,backup,sv3,2,0.988880101215846,5,309,0,314
185,backup,sv3,3,0.9865860153329107,3,221,0,224
185,backup,sv3,4,0.9926665434784738,2,254,1,257
185,backup,sv3,5,0.991643178585726,3,288,0,291
185,backup,sv3,6,0.9878748590430727,5,260,0,265
185,backup,sv3,7,0.9865233784054399,5,220,1,226
185,backup,sv3,8,0.9900700471987823,3,297,0,300
185,backup,sv3,9,0.9902694250684756,2,255,1,258
411,dark,sv3,0,0.9838388108666857,275,15,35,325
411,dark,sv3,1,0.9832344839864849,228,13,40,281
411,dark,sv3,2,0.994263836299337,273,14,40,327
411,dark,sv3,3,0.9822835840414442,180,11,29,220
411,dark,sv3,4,0.987537577659192,234,9,40,283
411,dark,sv3,5,0.9906917365534956,232,10,34,276
411,dark,sv3,6,0.989925343425478,238,10,38,286
411,dark,sv3,7,0.9947554313338753,219,12,45,276
411,dark,sv3,8,0.9850452544751599,276,11,38,325
411,dark,sv3,9,0.9877363502487981,185,14,35,234
77,backup,sv3,0,0.9912430540327408,2,338,0,340
77,backup,sv3,1,0.9889856236504102,3,272,0,275
77,backup,sv3,2,0.9954019332862494,2,314,0,316
77,backup,sv3,3,0.9891600878761742,3,265,3,271
77,backup,sv3,4,0.9887384188200976,4,267,0,271
77,backup,sv3,5,0.9889839525677466,0,319,0,319
77,backup,sv3,6,0.985964656895732,3,271,0,274
77,backup,sv3,7,0.9780295338506526,1,247,0,248
77,backup,sv3,8,0.9912531743387105,2,312,5,319
77,backup,sv3,9,0.9859789704238302,0,254,0,254
428,backup,sv3,0,0.994444523930129,1,378,0,379
428,backup,sv3,1,0.9912716179733637,2,330,1,333
428,backup,sv3,2,0.9894744695040776,2,374,0,376
428,backup,sv3,3,0.9857653391344708,3,259,1,263
428,backup,sv3,4,0.9940965405003239,5,313,1,319
428,backup,sv3,5,0.9888728943722283,2,365,0,367
428,backup,sv3,6,0.9797080928132562,1,319,0,320
428,backup,sv3,7,0.9849924653001102,2,287,1,290
428,backup,sv3,8,0.9888379042707154,4,359,0,363
428,backup,sv3,9,0.9891528440466584,0,305,0,305
104,backup,sv3,0,0.9884460097042135,4,302,2,308
104,backup,sv3,1,0.9889177762532334,2,251,0,253
104,backup,sv3,2,0.9862970282256603,1,298,0,299
104,backup,sv3,3,0.9927789237431783,2,212,2,216
104,backup,sv3,4,0.9905559297807738,1,271,3,275
104,backup,sv3,5,0.9804858127903013,6,281,1,288
104,backup,sv3,6,0.9820252091616364,2,241,2,245
104,backup,sv3,7,0.9913879400448407,0,226,2,228
104,backup,sv3,8,0.9866719929676517,0,271,1,272
104,backup,sv3,9,0.9842050576623388,3,222,0,225
357,dark,sv3,0,0.9902358182987456,263,11,47,321
357,dark,sv3,1,0.9851875483894454,241,10,38,289
357,dark,sv3,2,0.9906325470092918,269,13,30,312
357,dark,sv3,3,0.9864214159930473,197,8,33,238
357,dark,sv3,4,0.9934831309049518,248,12,33,293
357,dark,sv3,5,0.9938101390229382,257,12,34,303
357,dark,sv3,6,0.9913826853604729,218,12,34,264
357,dark,sv3,7,0.9892051727104554,219,9,35,263
357,dark,sv3,8,0.9878412794919531,266,12,48,326
357,dark,sv3,9,0.9684651626769617,208,13,39,260
167,dark,sv3,0,0.9924113116045249,293,10,48,351
167,dark,sv3,1,0.9905165566363495,258,9,52,319
167,dark,sv3,2,0.9922244883756784,250,9,57,316
167,dark,sv3,3,0.9886700710750604,233,9,40,282
167,dark,sv3,4,0.9957007231819626,250,10,60,320
167,dark,sv3,5,0.9930846199322271,253,11,63,327
167,dark,sv3,6,0.9855758852200528,226,9,49,284
167,dark,sv3,7,0.9898692117836142,209,10,48,267
167,dark,sv3,8,0.9888925032046636,269,9,42,320
167,dark,sv3,9,0.9786753199001583,277,8,41,326
194,dark,sv3,0,0.991936890003268,298,10,42,350
194,dark,sv3,1,0.9893548299947567,254,11,40,305
194,dark,sv3,2,0.9920652612262214,279,8,61,348
194,dark,sv3,3,0.9878127156296703,225,11,52,288
194,dark,sv3,4,0.9899990887317576,248,10,58,316
194,dark,sv3,5,0.9900649960516573,276,10,41,327
194,dark,sv3,6,0.9912521298236624,231,10,43,284
194,dark,sv3,7,0.9873931321769358,202,10,50,262
194,dark,sv3,8,0.9921671560211682,265,11,53,329
194,dark,sv3,9,0.9885013745933866,263,10,50,323
303,dark,sv3,0,0.9849307360070796,274,11,37,322
303,dark,sv3,1,0.9836968883736962,246,10,42,298
303,dark,sv3,2,0.9924078012610138,265,14,39,318
303,dark,sv3,3,0.9884364368119858,221,13,32,266
303,dark,sv3,4,0.9824582924627255,253,12,38,303
303,dark,sv3,5,0.9962443176009877,256,12,46,314
303,dark,sv3,6,0.9889195348517134,223,9,39,271
303,dark,sv3,7,0.9897121257505604,221,10,31,262
303,dark,sv3,8,0.9881284711658791,278,12,42,332
303,dark,sv3,9,0.9950897473801628,271,10,43,324
113,dark,sv3,0,0.9910337949618824,263,14,52,329
113,dark,sv3,1,0.9902822313619276,241,11,44,296
113,dark,sv3,2,0.9858320118535826,268,9,50,327
113,dark,sv3,3,0.9900671669831845,222,9,51,282
113,dark,sv3,4,0.9897775242693416,244,9,55,308
113,dark,sv3,5,0.9934387969210047,264,9,47,320
113,dark,sv3,6,0.9940043883299156,235,11,53,299
113,dark,sv3,7,0.9889954463403708,195,9,53,257
113,dark,sv3,8,0.9942768246264772,254,11,52,317
113,dark,sv3,9,0.9912301668932131,247,12,57,316
85,dark,sv3,0,0.9838137207730601,276,11,57,344
85,dark,sv3,1,0.9932125964922356,256,8,68,332
85,dark,sv3,2,0.9936626335032284,277,11,60,348
85,dark,sv3,3,0.9907430571674459,230,11,65,306
85,dark,sv3,4,0.9848273015426484,252,10,69,331
85,dark,sv3,5,0.9947848443920437,280,9,51,340
85,dark,sv3,6,0.9898366907091017,231,10,51,292
85,dark,sv3,7,0.9891058161136401,220,11,46,277
85,dark,sv3,8,0.9919694533873131,254,11,60,325
85,dark,sv3,9,0.9914548570065168,271,9,48,328
203,bright,sv3,0,0.9885823037144438,210,122,5,337
203,bright,sv3,1,0.9920239104469062,220,101,0,321
203,bright,sv3,2,0.9886984802854447,242,106,3,351
203,bright,sv3,3,0.9919516844931826,190,97,3,290
203,bright,sv3,4,0.986449100596244,211,113,2,326
203,bright,sv3,5,0.9923303267642214,207,123,3,333
203,bright,sv3,6,0.9965630394028189,179,100,2,281
203,bright,sv3,7,0.9871708283260594,181,94,2,277
203,bright,sv3,8,0.9851584063872625,203,117,2,322
203,bright,sv3,9,0.9937479849526747,252,93,3,348
58,dark,sv3,0,0.9919407155104667,284,9,56,349
58,dark,sv3,1,0.9944420566171968,263,5,56,324
58,dark,sv3,2,0.9859764552527455,293,8,47,348
58,dark,sv3,3,0.981600724618249,238,8,57,303
58,dark,sv3,4,0.9950233666114705,251,12,58,321
58,dark,sv3,5,0.99523328561612,265,11,68,344
58,dark,sv3,6,0.9893807211681525,220,10,56,286
58,dark,sv3,7,0.9915984475366277,203,11,61,275
58,dark,sv3,8,0.9918357452976994,260,9,71,340
58,dark,sv3,9,0.9906828828059839,244,11,68,323
221,dark,sv3,0,0.9831488669323365,240,15,59,314
221,dark,sv3,1,0.9933391797529866,230,12,54,296
221,dark,sv3,2,0.9898306609281583,245,10,53,308
221,dark,sv3,3,0.9904390983343626,216,9,42,267
221,dark,sv3,4,0.9881255872862378,235,9,56,300
221,dark,sv3,5,0.9879506098381937,255,7,36,298
221,dark,sv3,6,0.9918272885041155,216,10,44,270
221,dark,sv3,7,0.981440061141494,191,10,36,237
221,dark,sv3,8,0.9929363816629312,260,9,47,316
221,dark,sv3,9,0.9877106359805654,229,11,57,297
42,bright,sv3,0,0.9926661691664254,233,128,1,362
42,bright,sv3,1,0.9956918404715609,197,110,5,312
42,bright,sv3,2,0.9893360578598812,197,126,7,330
42,bright,sv3,3,0.9788071240623799,139,112,1,252
42,bright,sv3,4,0.9885180281583452,160,128,1,289
42,bright,sv3,5,0.9940866127117151,192,117,4,313
42,bright,sv3,6,0.9925281240752789,165,92,3,260
42,bright,sv3,7,0.9916996873355138,155,104,1,260
42,bright,sv3,8,0.9933134138607502,252,88,4,344
42,bright,sv3,9,0.9913359531744101,171,147,2,320
330,dark,sv3,0,0.9894000209789658,281,14,30,325
330,dark,sv3,1,0.9930643227961177,261,8,40,309
330,dark,sv3,2,0.9914961495432261,272,10,45,327
330,dark,sv3,3,0.9939333019000802,232,11,39,282
330,dark,sv3,4,0.9961002632777552,250,11,37,298
330,dark,sv3,5,0.9907514330064701,265,13,40,318
330,dark,sv3,6,0.9729608603478476,244,11,24,279
330,dark,sv3,7,0.9902971088529756,219,10,45,274
330,dark,sv3,8,0.987899289274572,279,13,35,327
330,dark,sv3,9,0.9892158272607733,230,13,55,298
276,dark,sv3,0,0.9916610668240933,282,10,31,323
276,dark,sv3,1,0.9929091482553529,258,11,39,308
276,dark,sv3,2,0.9964973841564544,285,10,32,327
276,dark,sv3,3,0.9848034789938668,223,11,31,265
276,dark,sv3,4,0.9887125106967102,246,10,42,298
276,dark,sv3,5,0.9802439795658745,269,9,41,319
276,dark,sv3,6,0.9915436966026993,219,11,29,259
276,dark,sv3,7,0.9927264328154684,210,11,45,266
276,dark,sv3,8,0.9904238776705113,254,11,48,313
276,dark,sv3,9,0.9912068379111453,257,10,41,308
5,dark,sv3,0,0.9898894543695661,278,12,47,337
5,dark,sv3,1,0.9821575461992859,243,13,37,293
5,dark,sv3,2,0.9875605244205411,271,11,42,324
5,dark,sv3,3,0.9907928252035066,265,9,33,307
5,dark,sv3,4,0.9931174642343662,261,11,43,315
5,dark,sv3,5,0.9882181794160366,285,8,49,342
5,dark,sv3,6,0.9892239053334021,232,11,43,286
5,dark,sv3,7,0.9925294836950407,220,8,42,270
5,dark,sv3,8,0.9852184752738953,287,12,50,349
5,dark,sv3,9,0.9879620081346111,271,9,44,324
412,dark,sv3,0,0.9918133683072284,239,18,28,285
412,dark,sv3,1,0.9938390724650952,206,12,33,251
412,dark,sv3,2,0.9907281849905047,243,18,26,287
412,dark,sv3,3,0.9878477347435941,204,10,27,241
412,dark,sv3,4,0.9889420816363003,250,10,28,288
412,dark,sv3,5,0.9796074414930804,210,13,33,256
412,dark,sv3,6,0.9851949642365674,230,10,22,262
412,dark,sv3,7,0.977991735780743,208,13,42,263
412,dark,sv3,8,0.9877472125690858,276,13,37,326
412,dark,sv3,9,0.978598101048776,235,10,29,274
140,dark,sv3,0,0.9931744581945948,269,13,51,333
140,dark,sv3,1,0.9855324022958425,232,10,41,283
140,dark,sv3,2,0.9919357428768907,259,8,59,326
140,dark,sv3,3,0.986020597027801,219,9,44,272
140,dark,sv3,4,0.9886250356270329,243,8,59,310
140,dark,sv3,5,0.9862380036770757,272,8,49,329
140,dark,sv3,6,0.9910776940771882,220,11,46,277
140,dark,sv3,7,0.9865299850772364,203,7,34,244
140,dark,sv3,8,0.9881726785998977,268,9,51,328
140,dark,sv3,9,0.9838137343077881,238,10,59,307
385,dark,sv3,0,0.9910715394327259,252,13,24,289
385,dark,sv3,1,0.9881996564733218,239,16,19,274
385,dark,sv3,2,0.9867552499866177,258,18,21,297
385,dark,sv3,3,0.9884947696214751,229,13,27,269
385,dark,sv3,4,0.9914323985433058,246,19,28,293
385,dark,sv3,5,0.9936994267074047,257,19,31,307
385,dark,sv3,6,0.9846598894261998,244,12,21,277
385,dark,sv3,7,0.98643114652098,205,10,41,256
385,dark,sv3,8,0.9908863422616164,249,18,27,294
385,dark,sv3,9,0.9844735904348537,256,15,26,297
358,dark,sv3,0,0.9927097924373124,231,18,33,282
358,dark,sv3,1,0.9890437246757959,242,13,28,283
358,dark,sv3,2,0.9856479952132416,241,10,24,275
358,dark,sv3,3,0.9862880456879509,214,18,18,250
358,dark,sv3,4,0.9914073913123783,252,13,26,291
358,dark,sv3,5,0.9892428830967576,251,15,33,299
358,dark,sv3,6,0.9934736691990118,214,17,24,255
358,dark,sv3,7,0.9803313223991055,224,10,29,263
358,dark,sv3,8,0.991850453614852,245,16,31,292
358,dark,sv3,9,0.9887985054171462,240,15,43,298
15,bright,sv3,0,0.980825316418213,174,165,1,340
15,bright,sv3,1,0.9890101015783294,170,145,1,316
15,bright,sv3,2,0.9914528947118229,175,160,2,337
15,bright,sv3,3,0.9939489800527948,145,141,3,289
15,bright,sv3,4,0.9926701962555278,174,147,1,322
15,bright,sv3,5,0.9956110608094423,203,144,2,349
15,bright,sv3,6,0.9922963415765896,130,141,1,272
15,bright,sv3,7,0.9809497850309993,169,102,2,273
15,bright,sv3,8,0.9913317596487407,123,170,1,294
15,bright,sv3,9,0.9909657166389682,129,159,1,289
31,dark,sv3,0,0.9931949135557891,284,9,58,351
31,dark,sv3,1,0.9926935176396304,264,10,42,316
31,dark,sv3,2,0.9958156579832738,296,10,45,351
31,dark,sv3,3,0.9889455486893957,268,10,34,312
31,dark,sv3,4,0.9917302326894634,268,11,48,327
31,dark,sv3,5,0.9881842777236367,272,9,46,327
31,dark,sv3,6,0.9957724300909099,215,11,57,283
31,dark,sv3,7,0.9857320119971186,208,11,43,262
31,dark,sv3,8,0.993305476458018,268,12,56,336
31,dark,sv3,9,0.9915064710041828,277,10,53,340
386,dark,sv3,0,0.9904538391694497,239,16,25,280
386,dark,sv3,1,0.9892323861674129,241,12,23,276
386,dark,sv3,2,0.9806338249697061,225,12,23,260
386,dark,sv3,3,0.9877816355870745,221,19,21,261
386,dark,sv3,4,0.9902137727785532,224,18,19,261
386,dark,sv3,5,0.9775589783515368,217,29,12,258
386,dark,sv3,6,0.9880153905768805,220,14,18,252
386,dark,sv3,7,0.9908859177835871,222,10,23,255
386,dark,sv3,8,0.9745276742459968,209,22,21,252
386,dark,sv3,9,0.9863483787261869,221,18,20,259
283,bright,sv3,0,0.9923767341303257,314,81,4,399
283,bright,sv3,1,0.9820256235889013,300,54,6,360
283,bright,sv3,2,0.9903379043161814,285,98,3,386
283,bright,sv3,3,0.9896980284658043,233,97,3,333
283,bright,sv3,4,0.9954549233856764,297,63,2,362
283,bright,sv3,5,0.989662621290506,314,63,6,383
283,bright,sv3,6,0.986050901317586,256,59,5,320
283,bright,sv3,7,0.9858936405831763,225,62,5,292
283,bright,sv3,8,0.9952513676648045,272,108,4,384
283,bright,sv3,9,0.9787483126693585,308,73,8,389
413,dark,sv3,0,0.995037252610982,215,15,30,260
413,dark,sv3,1,0.9910421612953806,212,13,23,248
413,dark,sv3,2,0.9823182778407692,216,15,34,265
413,dark,sv3,3,0.990619102947238,195,15,33,243
413,dark,sv3,4,0.9855868356689668,237,18,23,278
413,dark,sv3,5,0.9813908775460238,182,14,30,226
413,dark,sv3,6,0.9901107939272904,213,15,18,246
413,dark,sv3,7,0.9900466603464083,200,13,20,233
413,dark,sv3,8,0.9851258600108996,230,20,21,271
413,dark,sv3,9,0.9864495307787486,189,16,26,231
331,dark,sv3,0,0.9855124356089807,240,14,23,277
331,dark,sv3,1,0.9908277920500376,259,11,34,304
331,dark,sv3,2,0.9914223160812794,220,11,33,264
331,dark,sv3,3,0.9840011014877112,211,13,30,254
331,dark,sv3,4,0.9851519600547585,233,12,35,280
331,dark,sv3,5,0.9917485872812758,251,13,25,289
331,dark,sv3,6,0.9939462571473245,217,12,25,254
331,dark,sv3,7,0.9871221775175619,235,9,26,270
331,dark,sv3,8,0.9904521065731275,253,14,33,300
331,dark,sv3,9,0.9882528748753199,231,12,40,283
212,backup,sv3,0,0.9877875034787514,4,333,0,337
212,backup,sv3,1,0.9881801005084454,1,302,2,305
212,backup,sv3,2,0.990272697900055,4,312,4,320
212,backup,sv3,3,0.9864467312172897,3,280,1,284
212,backup,sv3,4,0.9857019264313905,3,281,0,284
212,backup,sv3,5,0.9839134332545351,7,274,0,281
212,backup,sv3,6,0.9931170694836019,7,264,0,271
212,backup,sv3,7,0.97959900252449,3,231,0,234
212,backup,sv3,8,0.9926267282915833,2,308,0,310
212,backup,sv3,9,0.9877384498223268,1,316,0,317
204,bright,sv3,0,0.9886768305919482,122,164,3,289
204,bright,sv3,1,0.9837164519193886,166,112,1,279
204,bright,sv3,2,0.9816599123543727,59,34,2,95
204,bright,sv3,3,0.9918050683966917,167,114,2,283
204,bright,sv3,4,0.9959991096452424,153,121,2,276
204,bright,sv3,5,0.9878104780604382,158,125,1,284
204,bright,sv3,6,0.9863777445708307,131,114,2,247
204,bright,sv3,7,0.9869531309948713,133,97,3,233
204,bright,sv3,8,0.9856463114672166,148,114,1,263
204,bright,sv3,9,0.9827678572870094,173,135,3,311
359,dark,sv3,0,0.9918552064720518,234,10,22,266
359,dark,sv3,1,0.9851998833556375,228,12,25,265
359,dark,sv3,2,0.988047106940932,207,17,28,252
359,dark,sv3,3,0.993661425951643,204,12,16,232
359,dark,sv3,4,0.9929568302346332,238,8,31,277
359,dark,sv3,5,0.9881011131801426,222,12,23,257
359,dark,sv3,6,0.9912726540269483,217,13,16,246
359,dark,sv3,7,0.9928364213329343,202,12,25,239
359,dark,sv3,8,0.9863924490198199,199,13,17,229
359,dark,sv3,9,0.9898353998000275,177,14,27,218
249,dark,sv3,0,0.996149384302,277,11,32,320
249,dark,sv3,1,0.9908298908050763,267,8,40,315
249,dark,sv3,2,0.9925701322757847,276,10,28,314
249,dark,sv3,3,0.9937588851010992,246,11,31,288
249,dark,sv3,4,0.994111410275807,260,10,44,314
249,dark,sv3,5,0.9843088452876161,277,9,37,323
249,dark,sv3,6,0.9877436951388558,231,9,30,270
249,dark,sv3,7,0.9877267948557092,202,8,52,262
249,dark,sv3,8,0.9887196489736229,274,13,53,340
249,dark,sv3,9,0.98820548953509,274,13,50,337
257,bright,sv3,0,0.9918508247800906,235,171,3,409
257,bright,sv3,1,0.995690811190485,231,129,3,363
257,bright,sv3,2,0.9915160764730263,262,89,3,354
257,bright,sv3,3,0.9910411859604896,265,82,3,350
257,bright,sv3,4,0.9932988204542458,226,133,5,364
257,bright,sv3,5,0.9881843071389695,231,139,4,374
257,bright,sv3,6,0.9936373853742893,193,130,1,324
257,bright,sv3,7,0.9876799206602002,200,108,2,310
257,bright,sv3,8,0.9875361142085981,234,148,2,384
257,bright,sv3,9,0.9952003280223705,217,164,8,389
304,dark,sv3,0,0.9948511312659075,264,13,29,306
304,dark,sv3,1,0.9843790864959862,233,9,28,270
304,dark,sv3,2,0.9962019085235616,240,10,21,271
304,dark,sv3,3,0.9906212477060384,204,8,28,240
304,dark,sv3,4,0.9916901075145235,230,15,28,273
304,dark,sv3,5,0.985685670146536,245,11,40,296
304,dark,sv3,6,0.9889442178693324,200,11,31,242
304,dark,sv3,7,0.9770552014710756,224,10,25,259
304,dark,sv3,8,0.9911271113701314,258,12,31,301
304,dark,sv3,9,0.9820646467899996,266,14,29,309
277,dark,sv3,0,0.9932217227971213,281,9,19,309
277,dark,sv3,1,0.9881514464701406,240,8,27,275
277,dark,sv3,2,0.9846392697214598,240,12,21,273
277,dark,sv3,3,0.9767447975166246,209,10,26,245
277,dark,sv3,4,0.9874983196063364,244,11,32,287
277,dark,sv3,5,0.9854195690686959,259,10,34,303
277,dark,sv3,6,0.9819075700248991,206,10,27,243
277,dark,sv3,7,0.9859354535903461,183,10,35,228
277,dark,sv3,8,0.9931586505809162,234,15,33,282
277,dark,sv3,9,0.9888803301364664,268,9,32,309
78,backup,sv3,0,0.9874116691619684,2,272,1,275
78,backup,sv3,1,0.995346033060829,3,244,1,248
78,backup,sv3,2,0.9929192150531332,2,253,0,255
78,backup,sv3,3,0.9908964348349596,4,182,2,188
78,backup,sv3,4,0.9734650184228605,6,216,1,223
78,backup,sv3,5,0.9676974661373005,2,216,1,219
78,backup,sv3,6,0.9820567261927613,4,184,1,189
78,backup,sv3,7,0.9755509355231999,0,199,1,200
78,backup,sv3,8,0.9785790341067617,4,221,1,226
78,backup,sv3,9,0.976753627769834,1,247,1,249
284,bright,sv3,0,0.9907899098490128,255,140,4,399
284,bright,sv3,1,0.9920819038457778,241,112,2,355
284,bright,sv3,2,0.9888856538999342,243,145,5,393
284,bright,sv3,3,0.9908707207237125,199,146,1,346
284,bright,sv3,4,0.9871655373062993,241,122,2,365
284,bright,sv3,5,0.9849321371392225,266,103,4,373
284,bright,sv3,6,0.99164673386523,214,111,5,330
284,bright,sv3,7,0.991242291261545,208,85,2,295
284,bright,sv3,8,0.9950989215813807,239,150,4,393
284,bright,sv3,9,0.9922765062119779,240,133,3,376
205,bright,sv3,0,0.9890662698892293,172,189,6,367
205,bright,sv3,1,0.9899359638311044,190,148,2,340
205,bright,sv3,2,0.9943008752537564,207,169,5,381
205,bright,sv3,3,0.9949233140115078,168,135,4,307
205,bright,sv3,4,0.9902026652734528,172,155,1,328
205,bright,sv3,5,0.9904274875452259,186,133,3,322
205,bright,sv3,6,0.9812940577073191,167,147,2,316
205,bright,sv3,7,0.990103617147842,138,134,6,278
205,bright,sv3,8,0.9890107308715219,180,170,4,354
205,bright,sv3,9,0.9944153218933997,198,161,5,364
338,bright,sv3,0,0.9920633206589196,220,174,2,396
338,bright,sv3,1,0.9960248965473012,184,155,1,340
338,bright,sv3,2,0.9850767459012519,199,156,2,357
338,bright,sv3,3,0.9903351929786965,150,170,0,320
338,bright,sv3,4,0.9971378877322149,188,157,1,346
338,bright,sv3,5,0.9903453390062267,157,177,6,340
338,bright,sv3,6,0.9819383614690297,176,152,4,332
338,bright,sv3,7,0.9875212994422907,196,103,3,302
338,bright,sv3,8,0.98971018867115,255,114,1,370
338,bright,sv3,9,0.9937811416522958,215,155,5,375
258,bright,sv3,0,0.9939624590537394,162,234,3,399
258,bright,sv3,1,0.9934122861865478,195,164,1,360
258,bright,sv3,2,0.9927480641423928,229,156,7,392
258,bright,sv3,3,0.9906561585868296,205,130,6,341
258,bright,sv3,4,0.9933269775826777,187,169,4,360
258,bright,sv3,5,0.9881485625409852,198,165,1,364
258,bright,sv3,6,0.9881120413908395,145,188,1,334
258,bright,sv3,7,0.9852665006718805,165,123,3,291
258,bright,sv3,8,0.9782645841538968,159,220,4,383
258,bright,sv3,9,0.9927331589712619,137,217,4,358
105,backup,sv3,0,0.9894915853460483,3,229,3,235
105,backup,sv3,1,0.979715199075664,1,191,2,194
105,backup,sv3,2,0.9914381610830765,1,212,3,216
105,backup,sv3,3,0.9790517766238814,6,195,2,203
105,backup,sv3,4,0.9881652048073091,2,201,0,203
105,backup,sv3,5,0.9868179672467834,7,201,2,210
105,backup,sv3,6,0.9820369341508656,6,171,2,179
105,backup,sv3,7,0.9716536852846804,2,159,0,161
105,backup,sv3,8,0.9802640177491633,6,205,0,211
105,backup,sv3,9,0.9840392838413611,3,224,0,227
311,bright,sv3,0,0.9935421294619736,293,109,2,404
311,bright,sv3,1,0.9937707958853178,229,119,0,348
311,bright,sv3,2,0.9910640269129626,279,116,1,396
311,bright,sv3,3,0.9922047573166218,211,137,5,353
311,bright,sv3,4,0.9960146007343604,259,101,4,364
311,bright,sv3,5,0.9873875268571543,265,113,3,381
311,bright,sv3,6,0.9939207231142867,226,107,3,336
311,bright,sv3,7,0.9956171706402377,240,69,3,312
311,bright,sv3,8,0.9928464067504786,265,119,1,385
311,bright,sv3,9,0.9918650311271416,299,91,5,395
132,backup,sv3,0,0.9907339776189573,10,198,1,209
132,backup,sv3,1,0.9854078442022053,10,185,1,196
132,backup,sv3,2,0.9785601483888094,10,201,0,211
132,backup,sv3,3,0.986723106116501,6,154,2,162
132,backup,sv3,4,0.9910981824659888,7,124,0,131
132,backup,sv3,5,0.990591993026115,2,166,1,169
132,backup,sv3,6,0.9782135770701064,3,157,1,161
132,backup,sv3,7,0.9853672665769663,5,155,2,162
132,backup,sv3,8,0.9740199650428824,17,165,1,183
132,backup,sv3,9,0.9789552415949017,12,184,0,196
176,bright,sv3,0,0.9826794914568826,171,125,3,299
176,bright,sv3,1,0.9864369475837663,159,114,3,276
176,bright,sv3,2,0.9913317771932489,230,107,5,342
176,bright,sv3,3,0.9878556868554037,180,105,0,285
176,bright,sv3,4,0.981919068614689,158,120,3,281
176,bright,sv3,5,0.9895485247601018,170,132,5,307
176,bright,sv3,6,0.9914365180415184,154,115,2,271
176,bright,sv3,7,0.9913808568284161,155,106,4,265
176,bright,sv3,8,0.9897010277903615,181,110,3,294
176,bright,sv3,9,0.9910081575448174,185,118,4,307
186,backup,sv3,0,0.9892932968297229,3,209,1,213
186,backup,sv3,1,0.9750898204172802,1,198,1,200
186,backup,sv3,2,0.9880975951016303,3,225,2,230
186,backup,sv3,3,0.9835841638138298,4,202,0,206
186,backup,sv3,4,0.9870272109461966,5,210,1,216
186,backup,sv3,5,0.9879521146172234,4,191,3,198
186,backup,sv3,6,0.9835293451281497,1,191,1,193
186,backup,sv3,7,0.9803995983845981,1,190,2,193
186,backup,sv3,8,0.9828729751783883,4,201,4,209
186,backup,sv3,9,0.9837561832392484,1,217,3,221
213,backup,sv3,0,0.9829851338269641,4,289,1,294
213,backup,sv3,1,0.9933384507500164,2,263,0,265
213,backup,sv3,2,0.9890781569708549,2,299,2,303
213,backup,sv3,3,0.9838976165021173,8,261,0,269
213,backup,sv3,4,0.9866889667065737,6,255,3,264
213,backup,sv3,5,0.9897230480156499,5,277,0,282
213,backup,sv3,6,0.9909129150389908,5,249,0,254
213,backup,sv3,7,0.98016062439764,3,208,1,212
213,backup,sv3,8,0.9895081632846575,4,284,3,291
213,backup,sv3,9,0.9951197868365673,2,301,1,304
419,bright,sv3,0,0.988077607893376,219,185,5,409
419,bright,sv3,1,0.9926089965365151,223,133,2,358
419,bright,sv3,2,0.9919349065856679,244,139,5,388
419,bright,sv3,3,0.9858917800872001,179,166,8,353
419,bright,sv3,4,0.9957419744766248,186,174,2,362
419,bright,sv3,5,0.9896948965867735,158,221,2,381
419,bright,sv3,6,0.9880392098872292,158,175,2,335
419,bright,sv3,7,0.9881517368311445,180,134,3,317
419,bright,sv3,8,0.9884756230054282,214,175,5,394
419,bright,sv3,9,0.9942504180103551,185,208,5,398
106,backup,sv3,0,0.9883581014131648,3,302,3,308
106,backup,sv3,1,0.9935850667146797,3,254,1,258
106,backup,sv3,2,0.987630497762062,1,274,2,277
106,backup,sv3,3,0.9773178564281914,9,237,3,249
106,backup,sv3,4,0.9932136992210586,3,254,2,259
106,backup,sv3,5,0.9875190277455267,9,274,0,283
106,backup,sv3,6,0.9823443978099756,6,221,2,229
106,backup,sv3,7,0.9854405331746124,0,223,0,223
106,backup,sv3,8,0.9877766522640162,2,274,1,277
106,backup,sv3,9,0.9941228454961851,3,261,0,264
43,bright,sv3,0,0.9910308324323154,191,129,4,324
43,bright,sv3,1,0.9854590038505605,142,137,6,285
43,bright,sv3,2,0.9807532361750129,166,123,4,293
43,bright,sv3,3,0.9868145094208517,89,123,2,214
43,bright,sv3,4,0.9874972839137484,96,124,5,225
43,bright,sv3,5,0.9898139601895322,150,122,2,274
43,bright,sv3,6,0.9917405442804568,123,102,1,226
43,bright,sv3,7,0.9903463008378357,147,98,1,246
43,bright,sv3,8,0.9886905594915235,185,133,4,322
43,bright,sv3,9,0.9830603253515611,148,138,2,288
187,backup,sv3,0,0.9855986086800357,1,290,0,291
187,backup,sv3,1,0.9860484669925249,10,254,2,266
187,backup,sv3,2,0.9793963779613717,11,269,3,283
187,backup,sv3,3,0.9877162867267675,11,242,1,254
187,backup,sv3,4,0.9795386737886652,4,244,1,249
187,backup,sv3,5,0.9797522552964321,14,256,0,270
187,backup,sv3,6,0.9908985064898427,3,248,4,255
187,backup,sv3,7,0.9906401676711217,5,224,1,230
187,backup,sv3,8,0.98495780173228,3,269,1,273
187,backup,sv3,9,0.9828300094327082,5,266,2,273
347,backup,sv3,0,0.9959425938832179,2,387,0,389
347,backup,sv3,1,0.9931008280622448,3,326,2,331
347,backup,sv3,2,0.9880806394348142,3,333,1,337
347,backup,sv3,3,0.9838376089478824,0,179,0,179
347,backup,sv3,4,0.992618774748683,2,326,0,328
347,backup,sv3,5,0.9881779458497038,4,353,1,358
347,backup,sv3,6,0.9934294992948665,3,317,0,320
347,backup,sv3,7,0.9851034335674567,2,281,1,284
347,backup,sv3,8,0.985929542038378,1,366,0,367
347,backup,sv3,9,0.994316756630429,3,379,1,383
133,backup,sv3,0,0.989222645206626,22,262,1,285
133,backup,sv3,1,0.9855439196772046,23,225,2,250
133,backup,sv3,2,0.993589600414287,11,276,0,287
133,backup,sv3,3,0.9870248013349715,6,204,1,211
133,backup,sv3,4,0.9860503379547593,6,223,3,232
133,backup,sv3,5,0.9924558185373125,9,231,1,241
133,backup,sv3,6,0.9746956089953153,7,214,2,223
133,backup,sv3,7,0.9831401466135519,7,181,3,191
133,backup,sv3,8,0.9939529098767,16,237,2,255
133,backup,sv3,9,0.9893037886743254,16,234,1,251
52,backup,sv3,0,0.9735430639886287,3,156,0,159
52,backup,sv3,1,0.9708373093227645,2,148,1,151
52,backup,sv3,2,0.9831175045772199,4,119,1,124
52,backup,sv3,3,0.9794121817784376,2,121,0,123
52,backup,sv3,4,0.9879144924031078,3,146,2,151
52,backup,sv3,5,0.9874242231704106,6,155,0,161
52,backup,sv3,6,0.9508139620921533,7,128,1,136
52,backup,sv3,7,0.9693303750675849,0,147,0,147
52,backup,sv3,8,0.989369029859469,5,181,0,186
52,backup,sv3,9,0.9862017208382118,2,177,1,180
24,backup,sv3,0,0.9918397651329509,7,281,2,290
24,backup,sv3,1,0.993595056509054,5,259,0,264
24,backup,sv3,2,0.9837728204643572,4,255,1,260
24,backup,sv3,3,0.9762874399655198,3,192,0,195
24,backup,sv3,4,0.9892828723305016,4,220,0,224
24,backup,sv3,5,0.9879271076643168,7,205,0,212
24,backup,sv3,6,0.9863986797061537,4,229,1,234
24,backup,sv3,7,0.9785749747635976,5,224,0,229
24,backup,sv3,8,0.9919471080219214,2,267,1,270
24,backup,sv3,9,0.980340174321808,5,285,0,290
214,backup,sv3,0,0.9878878544898074,4,299,3,306
214,backup,sv3,1,0.9945487143422845,2,263,0,265
214,backup,sv3,2,0.9887854032700839,4,275,1,280
214,backup,sv3,3,0.991436452738752,3,253,1,257
214,backup,sv3,4,0.9859220284514619,4,263,0,267
214,backup,sv3,5,0.9862229983762967,9,258,1,268
214,backup,sv3,6,0.9937821639724412,3,248,0,251
214,backup,sv3,7,0.9922837633522061,0,202,1,203
214,backup,sv3,8,0.9847326333880275,5,272,1,278
214,backup,sv3,9,0.9864377726258674,4,291,1,296
168,dark,sv3,0,0.9928433359622546,264,12,32,308
168,dark,sv3,1,0.9893604631517724,244,14,42,300
168,dark,sv3,2,0.9945715708653662,266,14,40,320
168,dark,sv3,3,0.9881519303384941,243,10,29,282
168,dark,sv3,4,0.9847958400790134,192,7,41,240
168,dark,sv3,5,0.9890033320210169,247,11,38,296
168,dark,sv3,6,0.9927144031127418,216,11,45,272
168,dark,sv3,7,0.9874300401904357,204,9,47,260
168,dark,sv3,8,0.9853185739580487,280,11,37,328
168,dark,sv3,9,0.9922128975316276,256,10,42,308
366,bright,sv3,0,0.9907466293392073,152,218,5,375
366,bright,sv3,1,0.994180973436633,209,149,1,359
366,bright,sv3,2,0.9950461106198235,172,202,1,375
366,bright,sv3,3,0.992630429835687,176,144,4,324
366,bright,sv3,4,0.9845826590915412,216,154,4,374
366,bright,sv3,5,0.9899103404854279,213,161,2,376
366,bright,sv3,6,0.9917971540320599,173,160,4,337
366,bright,sv3,7,0.9800646897600507,168,135,2,305
366,bright,sv3,8,0.9878233858303279,188,185,3,376
366,bright,sv3,9,0.9940411743239822,183,212,2,397
95,bright,sv3,0,0.9946009260246461,229,110,3,342
95,bright,sv3,1,0.9774908472109579,196,112,6,314
95,bright,sv3,2,0.9857634425550259,209,96,3,308
95,bright,sv3,3,0.9877160089103032,193,89,8,290
95,bright,sv3,4,0.9892169957497488,203,96,6,305
95,bright,sv3,5,0.9837567311045718,220,93,6,319
95,bright,sv3,6,0.987665806310355,200,90,4,294
95,bright,sv3,7,0.9861362243385099,189,87,3,279
95,bright,sv3,8,0.9937363958000541,229,119,3,351
95,bright,sv3,9,0.9955299420999189,192,128,1,321
86,dark,sv3,0,0.9857071146779919,267,11,55,333
86,dark,sv3,1,0.9867482691910978,240,11,53,304
86,dark,sv3,2,0.992623461284767,271,11,54,336
86,dark,sv3,3,0.9911373308305713,242,10,61,313
86,dark,sv3,4,0.9936918247442001,232,11,70,313
86,dark,sv3,5,0.9889702687264108,256,11,30,297
86,dark,sv3,6,0.98520791138221,217,14,42,273
86,dark,sv3,7,0.9925910021230192,195,9,45,249
86,dark,sv3,8,0.9915369406271209,245,11,46,302
86,dark,sv3,9,0.983387791402997,259,13,41,313
195,dark,sv3,0,0.9941034978636071,297,12,26,335
195,dark,sv3,1,0.9905071692292162,265,11,29,305
195,dark,sv3,2,0.9873140687566748,259,10,45,314
195,dark,sv3,3,0.9949716823613,234,10,36,280
195,dark,sv3,4,0.9897189971131122,231,11,48,290
195,dark,sv3,5,0.9909796470113346,265,13,34,312
195,dark,sv3,6,0.9922171992763399,239,10,42,291
195,dark,sv3,7,0.9941230205439664,212,10,47,269
195,dark,sv3,8,0.9907008751196192,273,11,40,324
195,dark,sv3,9,0.9909009980879877,276,11,27,314
141,dark,sv3,0,0.9905195383478295,261,13,44,318
141,dark,sv3,1,0.9855551018785714,241,9,41,291
141,dark,sv3,2,0.994001001198486,256,12,34,302
141,dark,sv3,3,0.989140652317113,223,11,38,272
141,dark,sv3,4,0.9839121805800537,246,10,39,295
141,dark,sv3,5,0.9924398434828121,269,7,28,304
141,dark,sv3,6,0.9866756642110576,232,11,39,282
141,dark,sv3,7,0.9846733700363188,212,10,28,250
141,dark,sv3,8,0.9854372837122954,272,10,39,321
141,dark,sv3,9,0.9878697350731779,260,12,48,320
392,bright,sv3,0,0.9880850702649989,290,117,4,411
392,bright,sv3,1,0.9932186074431868,209,161,1,371
392,bright,sv3,2,0.997027994880022,234,161,1,396
392,bright,sv3,3,0.9929201396971966,210,134,2,346
392,bright,sv3,4,0.995172135625593,161,202,2,365
392,bright,sv3,5,0.9921694190348145,167,217,3,387
392,bright,sv3,6,0.991980644283899,145,189,6,340
392,bright,sv3,7,0.9868162015608298,168,150,3,321
392,bright,sv3,8,0.9906427453937905,207,181,3,391
392,bright,sv3,9,0.9849822916785635,228,163,2,393
32,dark,sv3,0,0.9888831948525507,290,9,54,353
32,dark,sv3,1,0.9938472943814685,264,11,46,321
32,dark,sv3,2,0.9924268578556344,289,10,51,350
32,dark,sv3,3,0.9925903175419338,280,8,23,311
32,dark,sv3,4,0.9937252735752261,267,10,42,319
32,dark,sv3,5,0.9885299826485391,268,9,37,314
32,dark,sv3,6,0.9913248983087568,232,9,42,283
32,dark,sv3,7,0.9881520927399149,206,11,44,261
32,dark,sv3,8,0.9913534342942374,255,10,50,315
32,dark,sv3,9,0.9886325186991407,268,10,42,320
332,dark,sv3,0,0.9854791073838007,274,18,24,316
332,dark,sv3,1,0.9801179284020847,259,13,31,303
332,dark,sv3,2,0.9895360925550883,278,11,30,319
332,dark,sv3,3,0.9860355659320602,238,11,24,273
332,dark,sv3,4,0.9917358172698331,250,14,31,295
332,dark,sv3,5,0.9967709540510908,260,13,27,300
332,dark,sv3,6,0.983342566854385,230,19,11,260
332,dark,sv3,7,0.9861023899265967,215,10,21,246
332,dark,sv3,8,0.9916108263429594,239,13,25,277
332,dark,sv3,9,0.9853525095153858,227,15,28,270
68,bright,sv3,0,0.9952166296216384,212,158,7,377
68,bright,sv3,1,0.9862497295896538,231,103,4,338
68,bright,sv3,2,0.9927863421894793,241,112,2,355
68,bright,sv3,3,0.9928243774239296,183,112,3,298
68,bright,sv3,4,0.9949465061255278,229,112,5,346
68,bright,sv3,5,0.9906135346725721,244,109,2,355
68,bright,sv3,6,0.9929586660377334,247,88,2,337
68,bright,sv3,7,0.9891283352635821,200,78,3,281
68,bright,sv3,8,0.9918242689334287,279,95,3,377
68,bright,sv3,9,0.9952653707781023,263,107,2,372
177,bright,sv3,0,0.988865368607563,178,195,6,379
177,bright,sv3,1,0.9890942624027499,174,150,3,327
177,bright,sv3,2,0.9936341654585811,215,151,5,371
177,bright,sv3,3,0.9892659694385552,194,127,1,322
177,bright,sv3,4,0.9900791693218823,177,136,3,316
177,bright,sv3,5,0.9927494588940804,186,163,4,353
177,bright,sv3,6,0.9891380708466743,171,143,3,317
177,bright,sv3,7,0.992153476993176,129,128,2,259
177,bright,sv3,8,0.991217230069861,187,169,3,359
177,bright,sv3,9,0.9897669490020496,146,186,2,334
149,bright,sv3,0,0.9938102219707182,247,144,4,395
149,bright,sv3,1,0.9876258871437782,254,102,4,360
149,bright,sv3,2,0.986928715187501,223,156,1,380
149,bright,sv3,3,0.9911910857260321,176,139,4,319
149,bright,sv3,4,0.996194502013767,185,134,2,321
149,bright,sv3,5,0.9866466561928267,215,117,0,332
149,bright,sv3,6,0.9927476699701169,204,122,2,328
149,bright,sv3,7,0.9895415370587436,196,92,3,291
149,bright,sv3,8,0.9914532011884177,226,135,2,363
149,bright,sv3,9,0.9921669111554356,246,100,5,351
44,bright,sv3,0,0.994040966857985,211,176,3,390
44,bright,sv3,1,0.9858079746396645,177,155,3,335
44,bright,sv3,2,0.9898746587992279,192,184,5,381
44,bright,sv3,3,0.9789372317969021,153,165,1,319
44,bright,sv3,4,0.9912086933621362,166,170,0,336
44,bright,sv3,5,0.9938341664051511,205,156,5,366
44,bright,sv3,6,0.9905051424760783,184,125,2,311
44,bright,sv3,7,0.9915647139701681,155,122,2,279
44,bright,sv3,8,0.9836108594757276,220,141,5,366
44,bright,sv3,9,0.9916856734527266,168,188,2,358
206,bright,sv3,0,0.9897118872006652,182,185,8,375
206,bright,sv3,1,0.9882435382645587,165,157,4,326
206,bright,sv3,2,0.9923302013036155,183,179,2,364
206,bright,sv3,3,0.9933208936177161,177,148,3,328
206,bright,sv3,4,0.9866360008178315,155,168,3,326
206,bright,sv3,5,0.9904828241696897,195,153,1,349
206,bright,sv3,6,0.9826125587393654,160,141,2,303
206,bright,sv3,7,0.9891490697637216,135,128,2,265
206,bright,sv3,8,0.9927823073417514,190,172,2,364
206,bright,sv3,9,0.9839907360162552,193,153,4,350
228,bright,sv3,0,0.9875722664605295,349,56,4,409
228,bright,sv3,1,0.9914384009299203,315,60,4,379
228,bright,sv3,2,0.9939276861180983,345,53,5,403
228,bright,sv3,3,0.9887584719677199,334,32,1,367
228,bright,sv3,4,0.993393784628198,339,31,5,375
228,bright,sv3,5,0.9902484479333752,358,19,8,385
228,bright,sv3,6,0.9961889392161396,325,14,5,344
228,bright,sv3,7,0.9880159396184034,300,32,3,335
228,bright,sv3,8,0.9943680550644509,359,41,2,402
228,bright,sv3,9,0.9957697282318727,345,45,7,397
420,bright,sv3,0,0.9920504899932351,126,279,5,410
420,bright,sv3,1,0.9917805495821304,137,210,5,352
420,bright,sv3,2,0.9902286269525703,148,234,8,390
420,bright,sv3,3,0.9918191739687895,140,196,2,338
420,bright,sv3,4,0.992519669578415,135,231,3,369
420,bright,sv3,5,0.9941254738338605,134,229,5,368
420,bright,sv3,6,0.9871866917703854,108,214,5,327
420,bright,sv3,7,0.9843726592301175,124,169,1,294
420,bright,sv3,8,0.9930972668695562,171,207,0,378
420,bright,sv3,9,0.9927528244630515,104,274,3,381
59,dark,sv3,0,0.9942440362792815,293,12,53,358
59,dark,sv3,1,0.9941849859272223,259,11,52,322
59,dark,sv3,2,0.986905928012299,268,10,63,341
59,dark,sv3,3,0.9880716656847653,254,8,39,301
59,dark,sv3,4,0.9896209812245161,271,11,53,335
59,dark,sv3,5,0.9931410200133608,244,11,54,309
59,dark,sv3,6,0.9837956117186637,220,10,50,280
59,dark,sv3,7,0.9901491380155661,206,9,46,261
59,dark,sv3,8,0.9942044413510939,252,12,57,321
59,dark,sv3,9,0.981730695259273,255,11,54,320
285,bright,sv3,0,0.9878964618199272,182,208,5,395
285,bright,sv3,1,0.9841108474065638,182,161,4,347
285,bright,sv3,2,0.9861296314599339,175,202,7,384
285,bright,sv3,3,0.9917404777041114,179,155,2,336
285,bright,sv3,4,0.9926105324171078,205,154,2,361
285,bright,sv3,5,0.9834118783394648,227,132,1,360
285,bright,sv3,6,0.9881387508575215,182,148,0,330
285,bright,sv3,7,0.9937031777835391,152,143,2,297
285,bright,sv3,8,0.9879866783832059,139,233,2,374
285,bright,sv3,9,0.9898959131871696,173,198,2,373
414,dark,sv3,0,0.9872097200932857,262,16,20,298
414,dark,sv3,1,0.9908997007358263,208,13,25,246
414,dark,sv3,2,0.9899848048830973,249,13,18,280
414,dark,sv3,3,0.9865580900350607,212,20,20,252
414,dark,sv3,4,0.9863443736522075,216,18,26,260
414,dark,sv3,5,0.9889450708795855,224,16,22,262
414,dark,sv3,6,0.9854804395767489,207,16,12,235
414,dark,sv3,7,0.9761073956432315,196,18,24,238
414,dark,sv3,8,0.9884073778166164,230,22,19,271
414,dark,sv3,9,0.9829119989546156,236,20,32,288
360,dark,sv3,0,0.9864046320133234,241,18,32,291
360,dark,sv3,1,0.9894449976207972,233,16,23,272
360,dark,sv3,2,0.9874302976989627,248,17,15,280
360,dark,sv3,3,0.9867755539247725,234,14,23,271
360,dark,sv3,4,0.9907792275051549,230,16,20,266
360,dark,sv3,5,0.9856859090588314,227,12,24,263
360,dark,sv3,6,0.9932132178291017,220,15,24,259
360,dark,sv3,7,0.9838444164621462,208,13,15,236
360,dark,sv3,8,0.9874786306681724,259,14,25,298
360,dark,sv3,9,0.9918180996815444,238,15,31,284
259,bright,sv3,0,0.9908741966902533,130,261,1,392
259,bright,sv3,1,0.9895510371877191,167,175,3,345
259,bright,sv3,2,0.9923182076067978,182,207,2,391
259,bright,sv3,3,0.9922301644773267,167,171,3,341
259,bright,sv3,4,0.9918192064071563,151,193,3,347
259,bright,sv3,5,0.9878267269475854,124,236,4,364
259,bright,sv3,6,0.9903417452799395,103,226,0,329
259,bright,sv3,7,0.9926780950675421,119,183,1,303
259,bright,sv3,8,0.993599160987978,137,233,4,374
259,bright,sv3,9,0.9975069194778394,141,220,4,365
387,dark,sv3,0,0.9880619263947268,267,21,23,311
387,dark,sv3,1,0.9832358116927907,242,16,21,279
387,dark,sv3,2,0.9859496045267274,221,21,26,268
387,dark,sv3,3,0.9915195228133977,244,10,17,271
387,dark,sv3,4,0.9842216941707409,226,22,15,263
387,dark,sv3,5,0.9845535078614833,249,20,15,284
387,dark,sv3,6,0.9885044241052785,236,18,13,267
387,dark,sv3,7,0.9881480391943047,198,12,21,231
387,dark,sv3,8,0.9896972655869921,249,14,20,283
387,dark,sv3,9,0.9848098841366569,228,14,28,270
80862,mwclusgaldeep,sv1,0,0.9913494527236891,15,331,22,368
80862,mwclusgaldeep,sv1,1,0.9944551989199739,16,300,20,336
80862,mwclusgaldeep,sv1,2,0.9928714537829351,18,316,24,358
80862,mwclusgaldeep,sv1,3,0.9898982090855462,10,304,26,340
80862,mwclusgaldeep,sv1,4,0.9936155193148695,12,305,22,339
80862,mwclusgaldeep,sv1,5,0.992716842696175,33,284,23,340
80862,mwclusgaldeep,sv1,6,0.9837620159625197,26,254,29,309
80862,mwclusgaldeep,sv1,7,0.9873842072269033,12,266,16,294
80862,mwclusgaldeep,sv1,8,0.9885808072989921,11,306,27,344
80862,mwclusgaldeep,sv1,9,0.9877506182514746,9,322,31,362
250,dark,sv3,0,0.9900307402481557,270,10,29,309
250,dark,sv3,1,0.9902697762315201,244,10,25,279
250,dark,sv3,2,0.9929067129981678,264,10,31,305
250,dark,sv3,3,0.9822853851401525,246,11,20,277
250,dark,sv3,4,0.9806190758792006,242,11,33,286
250,dark,sv3,5,0.9915285225152766,261,9,26,296
250,dark,sv3,6,0.9849090817936963,239,10,30,279
250,dark,sv3,7,0.969506857588046,203,8,34,245
250,dark,sv3,8,0.9932199943716955,292,11,24,327
250,dark,sv3,9,0.9942250118211785,260,11,28,299
339,bright,sv3,0,0.9914092016422904,162,222,4,388
339,bright,sv3,1,0.9895062003752438,151,194,6,351
339,bright,sv3,2,0.9926317257194228,151,210,5,366
339,bright,sv3,3,0.9940131582656961,133,197,1,331
339,bright,sv3,4,0.9918538563714124,185,163,2,350
339,bright,sv3,5,0.986808094548137,157,197,4,358
339,bright,sv3,6,0.9898667180494043,123,202,3,328
339,bright,sv3,7,0.9838974413478407,145,157,1,303
339,bright,sv3,8,0.9904331051777056,209,166,6,381
339,bright,sv3,9,0.9915529408646334,196,170,2,368
222,dark,sv3,0,0.9871576932275651,274,10,41,325
222,dark,sv3,1,0.9937376693256118,237,14,40,291
222,dark,sv3,2,0.9874602121135546,259,10,33,302
222,dark,sv3,3,0.9874630165238089,244,8,34,286
222,dark,sv3,4,0.9873654335105303,231,10,50,291
222,dark,sv3,5,0.9825181233040513,272,13,30,315
222,dark,sv3,6,0.9890736980782581,219,9,32,260
222,dark,sv3,7,0.9824140090408106,190,10,42,242
222,dark,sv3,8,0.9910409780023764,252,10,43,305
222,dark,sv3,9,0.9838913122320743,247,11,30,288
305,dark,sv3,0,0.9834694495819041,247,15,39,301
305,dark,sv3,1,0.9898206869750708,241,13,27,281
305,dark,sv3,2,0.9892832322607711,273,14,24,311
305,dark,sv3,3,0.9862998178696313,236,17,23,276
305,dark,sv3,4,0.989026617063925,243,15,32,290
305,dark,sv3,5,0.9856132892167249,242,10,19,271
305,dark,sv3,6,0.9808576206247844,217,10,24,251
305,dark,sv3,7,0.9787629991212803,215,11,23,249
305,dark,sv3,8,0.9902053685991484,261,14,23,298
305,dark,sv3,9,0.9935223621609061,279,12,6,297
121,bright,sv3,0,0.9962990675234091,343,39,6,388
121,bright,sv3,1,0.9930846124872094,286,46,5,337
121,bright,sv3,2,0.9875631850347634,297,69,4,370
121,bright,sv3,3,0.9933384461734637,276,51,4,331
121,bright,sv3,4,0.9915831480427378,292,64,3,359
121,bright,sv3,5,0.990610343982488,281,61,3,345
121,bright,sv3,6,0.9909196279252351,262,53,6,321
121,bright,sv3,7,0.9900871711192347,195,72,4,271
121,bright,sv3,8,0.9933602794997934,275,71,3,349
121,bright,sv3,9,0.9946036904150315,325,49,0,374
278,dark,sv3,0,0.9901960210990655,277,9,18,304
278,dark,sv3,1,0.9795461855738126,242,12,30,284
278,dark,sv3,2,0.9904198726044102,259,13,29,301
278,dark,sv3,3,0.9957226172000232,226,13,20,259
278,dark,sv3,4,0.9904740823007526,247,18,24,289
278,dark,sv3,5,0.9920560897929602,231,16,19,266
278,dark,sv3,6,0.9806158202096288,191,16,20,227
278,dark,sv3,7,0.9915843335732211,189,10,26,225
278,dark,sv3,8,0.9893137685665752,248,15,22,285
278,dark,sv3,9,0.9908676375558689,255,11,23,289
312,bright,sv3,0,0.9924475845456798,233,161,2,396
312,bright,sv3,1,0.9916535550320569,171,183,0,354
312,bright,sv3,2,0.9941157328373235,208,177,3,388
312,bright,sv3,3,0.9876938683566662,178,146,3,327
312,bright,sv3,4,0.9821044195231712,207,146,2,355
312,bright,sv3,5,0.9824151767197058,211,152,4,367
312,bright,sv3,6,0.9918255748684939,193,138,1,332
312,bright,sv3,7,0.9811485800772869,188,103,4,295
312,bright,sv3,8,0.9915388334411127,208,165,6,379
312,bright,sv3,9,0.9941521287783136,228,142,3,373
114,dark,sv3,0,0.9907217173800145,248,12,36,296
114,dark,sv3,1,0.9894123077521619,245,9,43,297
114,dark,sv3,2,0.9832742038852634,267,10,36,313
114,dark,sv3,3,0.9891226123494298,240,11,35,286
114,dark,sv3,4,0.9857715297341415,257,14,48,319
114,dark,sv3,5,0.9876704635586807,204,13,46,263
114,dark,sv3,6,0.9915241217790314,221,10,50,281
114,dark,sv3,7,0.9956161378251575,203,10,51,264
114,dark,sv3,8,0.9959960096217038,238,10,45,293
114,dark,sv3,9,0.9834270445392643,237,10,39,286
361,dark,sv3,0,0.9934806861832903,237,17,22,276
361,dark,sv3,1,0.9728149712373227,229,12,14,255
361,dark,sv3,2,0.9800387192138733,258,17,19,294
361,dark,sv3,3,0.9915119740304957,224,14,21,259
361,dark,sv3,4,0.9828580584466928,236,15,22,273
361,dark,sv3,5,0.9899612171969921,234,13,19,266
361,dark,sv3,6,0.9917737058412616,222,18,12,252
361,dark,sv3,7,0.9863001601031453,201,10,19,230
361,dark,sv3,8,0.9894014361609051,226,13,23,262
361,dark,sv3,9,0.9836432192096626,204,12,8,224
115,dark,sv3,0,0.9899208675216956,251,12,33,296
115,dark,sv3,1,0.9849655667516829,249,13,30,292
115,dark,sv3,2,0.9932071884903809,271,10,27,308
115,dark,sv3,3,0.9880932281883917,243,14,32,289
115,dark,sv3,4,0.9947723362690164,265,11,43,319
115,dark,sv3,5,0.9946121447479959,244,12,36,292
115,dark,sv3,6,0.9847358497254175,227,11,26,264
115,dark,sv3,7,0.9946757106727229,211,10,40,261
115,dark,sv3,8,0.9896859777863901,138,5,16,159
115,dark,sv3,9,0.987645757618017,260,11,22,293
45,bright,sv3,0,0.9974107530069484,203,191,2,396
45,bright,sv3,1,0.987447763361156,186,155,2,343
45,bright,sv3,2,0.9863079186498764,204,169,5,378
45,bright,sv3,3,0.9956485679624699,163,161,0,324
45,bright,sv3,4,0.9931501961501938,179,151,4,334
45,bright,sv3,5,0.9882894580616417,187,165,0,352
45,bright,sv3,6,0.9950809246305649,166,145,4,315
45,bright,sv3,7,0.9792672034637252,139,133,1,273
45,bright,sv3,8,0.9829883043593994,186,166,4,356
45,bright,sv3,9,0.9863793801693717,173,180,4,357
6,dark,sv3,0,0.9911576680801635,270,13,35,318
6,dark,sv3,1,0.995738744905247,261,16,32,309
6,dark,sv3,2,0.9896186377533955,284,15,26,325
6,dark,sv3,3,0.9955091317846935,249,14,29,292
6,dark,sv3,4,0.9901292879582176,259,13,42,314
6,dark,sv3,5,0.9907863583051949,271,12,39,322
6,dark,sv3,6,0.9871098756243684,245,10,40,295
6,dark,sv3,7,0.9828118077955249,240,11,40,291
6,dark,sv3,8,0.9891502845797925,280,10,32,322
6,dark,sv3,9,0.9895543426422977,267,12,35,314
279,dark,sv3,0,0.9895310216256555,261,17,17,295
279,dark,sv3,1,0.9901001947147277,220,14,13,247
279,dark,sv3,2,0.9937030778685613,228,13,10,251
279,dark,sv3,3,0.9854448782693409,222,14,7,243
279,dark,sv3,4,0.9902857861180705,210,13,17,240
279,dark,sv3,5,0.9812212800865825,166,5,17,188
279,dark,sv3,6,0.9875233951295432,182,12,22,216
279,dark,sv3,7,0.9901035095390713,186,17,24,227
279,dark,sv3,8,0.995575667907518,221,14,25,260
279,dark,sv3,9,0.9875575025326063,251,11,20,282
223,dark,sv3,0,0.9867814708606382,277,10,19,306
223,dark,sv3,1,0.9912281781564575,232,9,35,276
223,dark,sv3,2,0.9903488670070875,260,10,28,298
223,dark,sv3,3,0.9936512022797471,255,12,34,301
223,dark,sv3,4,0.9929327025672439,241,9,33,283
223,dark,sv3,5,0.9923065185867544,270,12,21,303
223,dark,sv3,6,0.9856374547668594,234,9,20,263
223,dark,sv3,7,0.9890584455355711,198,10,26,234
223,dark,sv3,8,0.994248832963432,239,10,26,275
223,dark,sv3,9,0.9938409068215532,239,12,32,283
388,dark,sv3,0,0.990520790593236,268,14,11,293
388,dark,sv3,1,0.9886703909711166,227,17,15,259
388,dark,sv3,2,0.9854232937937357,244,13,15,272
388,dark,sv3,3,0.9903731397022901,216,24,14,254
388,dark,sv3,4,0.9772841417663021,215,20,18,253
388,dark,sv3,5,0.9900521134798863,242,16,21,279
388,dark,sv3,6,0.990053061751562,215,15,12,242
388,dark,sv3,7,0.9863363813990145,193,12,22,227
388,dark,sv3,8,0.9873641332185732,236,18,14,268
388,dark,sv3,9,0.9886465720220284,185,18,17,220
33,dark,sv3,0,0.9878904303200348,309,11,34,354
33,dark,sv3,1,0.9895818091000875,263,10,36,309
33,dark,sv3,2,0.9938693989921481,285,14,34,333
33,dark,sv3,3,0.9829424071814641,263,10,25,298
33,dark,sv3,4,0.9944507936847631,259,10,43,312
33,dark,sv3,5,0.9890257453647915,275,9,25,309
33,dark,sv3,6,0.9890049939919427,228,11,44,283
33,dark,sv3,7,0.9867283035199632,220,10,34,264
33,dark,sv3,8,0.9916689596733453,263,10,28,301
33,dark,sv3,9,0.9915952501523748,277,9,27,313
122,bright,sv3,0,0.992604760695695,298,85,3,386
122,bright,sv3,1,0.9897970666875924,256,85,5,346
122,bright,sv3,2,0.990434246181021,256,98,8,362
122,bright,sv3,3,0.9940310379157293,243,78,3,324
122,bright,sv3,4,0.9915793276214189,255,83,6,344
122,bright,sv3,5,0.9902389593951728,275,88,2,365
122,bright,sv3,6,0.9868874050862413,234,82,5,321
122,bright,sv3,7,0.9906492779655374,188,80,4,272
122,bright,sv3,8,0.9891214242864346,228,90,4,322
122,bright,sv3,9,0.9915256167253543,297,63,6,366
415,dark,sv3,0,0.9845187332402121,259,20,16,295
415,dark,sv3,1,0.9826040276197019,224,19,15,258
415,dark,sv3,2,0.9944201434354595,222,19,28,269
415,dark,sv3,3,0.9858956325194369,223,18,20,261
415,dark,sv3,4,0.9910120804060875,223,16,26,265
415,dark,sv3,5,0.9925230674118846,230,22,25,277
415,dark,sv3,6,0.9794135638949187,214,16,15,245
415,dark,sv3,7,0.9872199984000467,188,18,28,234
415,dark,sv3,8,0.9929755127560612,221,24,13,258
415,dark,sv3,9,0.9877349493309419,210,24,11,245
60,dark,sv3,0,0.9924597833290882,280,12,42,334
60,dark,sv3,1,0.9932004934543096,254,9,36,299
60,dark,sv3,2,0.9869516943708524,280,14,34,328
60,dark,sv3,3,0.9912403898862849,242,10,44,296
60,dark,sv3,4,0.9907133673971844,256,9,45,310
60,dark,sv3,5,0.9925379076983182,267,11,37,315
60,dark,sv3,6,0.991573626306096,238,9,36,283
60,dark,sv3,7,0.9779678711738827,205,7,50,262
60,dark,sv3,8,0.9953428386321179,260,12,50,322
60,dark,sv3,9,0.9864612277609455,277,11,35,323
306,dark,sv3,0,0.9915826451468919,245,13,22,280
306,dark,sv3,1,0.9921609950631212,233,10,27,270
306,dark,sv3,2,0.9833156112332819,255,13,17,285
306,dark,sv3,3,0.985403684591511,252,12,18,282
306,dark,sv3,4,0.9890778768369518,227,10,14,251
306,dark,sv3,5,0.9906368329591116,232,12,26,270
306,dark,sv3,6,0.9840176375046841,227,10,19,256
306,dark,sv3,7,0.9858776050184608,208,9,16,233
306,dark,sv3,8,0.990896425358009,235,12,17,264
306,dark,sv3,9,0.9830924113887024,234,12,16,262
96,bright,sv3,0,0.9868834258660011,212,157,4,373
96,bright,sv3,1,0.9933143759155763,196,127,4,327
96,bright,sv3,2,0.985501488332669,221,140,4,365
96,bright,sv3,3,0.9863645922179008,94,59,5,158
96,bright,sv3,4,0.9907891941118665,166,88,1,255
96,bright,sv3,5,0.9890415168251694,206,139,4,349
96,bright,sv3,6,0.977400842815787,176,130,3,309
96,bright,sv3,7,0.9909040673755536,182,103,1,286
96,bright,sv3,8,0.9788783956449214,199,137,1,337
96,bright,sv3,9,0.9902767186631967,190,162,5,357
142,dark,sv3,0,0.9849403372934531,268,11,24,303
142,dark,sv3,1,0.9916275445404502,241,14,22,277
142,dark,sv3,2,0.9862396201798534,239,10,37,286
142,dark,sv3,3,0.9869264167139647,192,15,21,228
142,dark,sv3,4,0.9871427517953251,180,8,20,208
142,dark,sv3,5,0.9870839698204937,273,10,24,307
142,dark,sv3,6,0.9946891985024585,221,10,19,250
142,dark,sv3,7,0.9915035448583933,204,10,68,282
142,dark,sv3,8,0.9929839117156578,250,10,25,285
142,dark,sv3,9,0.9891016060176945,254,14,29,297
313,bright,sv3,0,0.992385713522464,211,184,3,398
313,bright,sv3,1,0.9891177908657567,169,177,0,346
313,bright,sv3,2,0.9906213792519439,189,192,1,382
313,bright,sv3,3,0.9885154912390194,161,178,3,342
313,bright,sv3,4,0.9914557217163349,178,161,2,341
313,bright,sv3,5,0.9909872701801387,171,185,5,361
313,bright,sv3,6,0.9901971066792246,205,90,18,313
313,bright,sv3,7,0.9920983071239369,150,149,4,303
313,bright,sv3,8,0.9920983071239369,150,149,4,303
313,bright,sv3,9,0.9920983071239369,150,149,4,303
87,dark,sv3,0,0.9912606691774978,279,12,37,328
87,dark,sv3,1,0.9890172662472057,247,10,36,293
87,dark,sv3,2,0.9949565696834051,281,11,42,334
87,dark,sv3,3,0.9863956030342416,237,8,54,299
87,dark,sv3,4,0.9934429855530745,263,11,27,301
87,dark,sv3,5,0.9906585174784512,262,12,38,312
87,dark,sv3,6,0.9919298318779906,245,12,25,282
87,dark,sv3,7,0.9923832851083365,206,10,41,257
87,dark,sv3,8,0.9915708394353029,267,13,47,327
87,dark,sv3,9,0.9892956030512262,266,13,36,315
333,dark,sv3,0,0.9818134353057867,259,17,21,297
333,dark,sv3,1,0.9881540268647974,239,11,21,271
333,dark,sv3,2,0.991115217770708,248,11,18,277
333,dark,sv3,3,0.9860584332589039,224,12,12,248
333,dark,sv3,4,0.9846184269773106,233,12,21,266
333,dark,sv3,5,0.9902010346854809,239,17,14,270
333,dark,sv3,6,0.988570467593226,203,14,13,230
333,dark,sv3,7,0.9562093545220186,191,10,22,223
333,dark,sv3,8,0.9805863303036177,217,16,23,256
333,dark,sv3,9,0.9914306995443394,199,11,36,246
16,bright,sv3,0,0.9915502582421372,137,154,3,294
16,bright,sv3,1,0.9902286895494128,139,135,1,275
16,bright,sv3,2,0.9823430130247739,93,171,2,266
16,bright,sv3,3,0.9868879267081782,99,144,1,244
16,bright,sv3,4,0.982738307168992,107,169,3,279
16,bright,sv3,5,0.9800717254546988,110,150,3,263
16,bright,sv3,6,0.9854260124582542,115,135,3,253
16,bright,sv3,7,0.990697671367419,110,137,1,248
16,bright,sv3,8,0.9893993109164962,104,160,3,267
16,bright,sv3,9,0.9912349303561078,84,153,1,238
69,bright,sv3,0,0.9892921131070241,226,167,3,396
69,bright,sv3,1,0.992834340837462,222,115,2,339
69,bright,sv3,2,0.9885495060734442,188,172,3,363
69,bright,sv3,3,0.9897242494348818,193,129,4,326
69,bright,sv3,4,0.9918545237241198,196,141,4,341
69,bright,sv3,5,0.9870020278122619,223,135,4,362
69,bright,sv3,6,0.9920883171683463,166,149,2,317
69,bright,sv3,7,0.9915928388177737,180,102,2,284
69,bright,sv3,8,0.9908279902327023,204,138,1,343
69,bright,sv3,9,0.9900998234413444,210,157,3,370
416,dark,sv3,0,0.9861599568586308,259,16,19,294
416,dark,sv3,1,0.9848628503412183,223,18,16,257
416,dark,sv3,2,0.9910061850337754,253,21,18,292
416,dark,sv3,3,0.9896905583855028,226,16,15,257
416,dark,sv3,4,0.9920355375281865,232,16,17,265
416,dark,sv3,5,0.9874027017679518,242,16,18,276
416,dark,sv3,6,0.9784729060008345,203,22,11,236
416,dark,sv3,7,0.9785636301617405,185,13,14,212
416,dark,sv3,8,0.9827670223076219,241,19,16,276
416,dark,sv3,9,0.990282618752074,227,21,19,267
123,bright,sv3,0,0.9891773249805726,286,92,4,382
123,bright,sv3,1,0.9880927247312313,221,90,4,315
123,bright,sv3,2,0.9865756914546641,248,112,5,365
123,bright,sv3,3,0.9926445207372555,245,78,2,325
123,bright,sv3,4,0.9885019948192031,236,109,3,348
123,bright,sv3,5,0.9955143602395362,224,112,7,343
123,bright,sv3,6,0.9871167006400723,209,109,3,321
123,bright,sv3,7,0.9908940076381362,181,85,4,270
123,bright,sv3,8,0.990569984991006,227,94,4,325
123,bright,sv3,9,0.9958456041580704,236,103,2,341
340,bright,sv3,0,0.9902237956777918,136,253,0,389
340,bright,sv3,1,0.9903726951240436,134,201,4,339
340,bright,sv3,2,0.9909367700772339,156,215,1,372
340,bright,sv3,3,0.9879826624655854,111,211,3,325
340,bright,sv3,4,0.9904974712500209,140,208,2,350
340,bright,sv3,5,0.9887877220139746,132,229,1,362
340,bright,sv3,6,0.9908737394926154,96,224,1,321
340,bright,sv3,7,0.983422649752583,127,159,5,291
340,bright,sv3,8,0.9969988778688486,179,192,3,374
340,bright,sv3,9,0.9891435261576104,137,233,3,373
116,dark,sv3,0,0.9880750927277945,249,12,32,293
116,dark,sv3,1,0.9948550491031853,251,11,29,291
116,dark,sv3,2,0.985769203390216,271,12,21,304
116,dark,sv3,3,0.9880975622743693,235,14,27,276
116,dark,sv3,4,0.9868563447759842,257,15,24,296
116,dark,sv3,5,0.9860976875979164,266,12,26,304
116,dark,sv3,6,0.9939202290940491,228,10,19,257
116,dark,sv3,7,0.9867397620637801,198,12,28,238
116,dark,sv3,8,0.992741762011203,258,12,20,290
116,dark,sv3,9,0.9916095393667544,238,12,31,281
367,bright,sv3,0,0.990661775466405,164,220,3,387
367,bright,sv3,1,0.9856719994291987,191,154,5,350
367,bright,sv3,2,0.9929530691253773,172,209,5,386
367,bright,sv3,3,0.9940715403601283,150,188,1,339
367,bright,sv3,4,0.9909100671278523,153,187,1,341
367,bright,sv3,5,0.9935642861959288,141,223,1,365
367,bright,sv3,6,0.9939817479318648,115,211,3,329
367,bright,sv3,7,0.9924690412188135,151,136,2,289
367,bright,sv3,8,0.9920157327985489,156,219,2,377
367,bright,sv3,9,0.986795871932554,131,234,1,366
150,bright,sv3,0,0.992798338536459,207,190,3,400
150,bright,sv3,1,0.9930678248502253,210,146,1,357
150,bright,sv3,2,0.9813798350711291,179,215,3,397
150,bright,sv3,3,0.9864752123721967,179,145,2,326
150,bright,sv3,4,0.996686881121229,185,159,3,347
150,bright,sv3,5,0.9892536258199467,197,168,2,367
150,bright,sv3,6,0.9903475931529621,150,177,2,329
150,bright,sv3,7,0.9914775666046973,155,127,2,284
150,bright,sv3,8,0.9930061384463802,186,174,4,364
150,bright,sv3,9,0.985119523952654,198,180,3,381
251,dark,sv3,0,0.9863899918343039,224,12,22,258
251,dark,sv3,1,0.983139184293142,251,10,21,282
251,dark,sv3,2,0.9903033003272762,260,14,22,296
251,dark,sv3,3,0.9895844596693791,223,12,21,256
251,dark,sv3,4,0.9900512206257629,241,12,16,269
251,dark,sv3,5,0.9833138264508368,258,9,13,280
251,dark,sv3,6,0.9891133734723726,242,12,9,263
251,dark,sv3,7,0.9895474119998804,213,9,20,242
251,dark,sv3,8,0.9861689228483036,242,10,9,261
251,dark,sv3,9,0.9848958853651102,249,15,26,290
229,bright,sv3,0,0.9843797404605067,284,125,1,410
229,bright,sv3,1,0.9948551855579514,247,109,4,360
229,bright,sv3,2,0.991756972296399,263,133,3,399
229,bright,sv3,3,0.9915947655173022,296,54,1,351
229,bright,sv3,4,0.990962115751416,311,61,1,373
229,bright,sv3,5,0.991012603641665,320,61,4,385
229,bright,sv3,6,0.9949532713216559,285,48,3,336
229,bright,sv3,7,0.9865506453971924,249,50,1,300
229,bright,sv3,8,0.9937726513902855,270,101,9,380
229,bright,sv3,9,0.9912319229136439,298,84,2,384
207,bright,sv3,0,0.9928380411308693,149,141,5,295
207,bright,sv3,1,0.9926671179575658,161,177,1,339
207,bright,sv3,2,0.9897709729218972,193,173,1,367
207,bright,sv3,3,0.9888477294556269,164,153,4,321
207,bright,sv3,4,0.9896941304304022,172,161,5,338
207,bright,sv3,5,0.9913363217837573,188,143,8,339
207,bright,sv3,6,0.9892089581191658,173,142,1,316
207,bright,sv3,7,0.994767572153217,144,130,5,279
207,bright,sv3,8,0.9905882235649095,175,167,4,346
207,bright,sv3,9,0.9899156714722828,193,137,3,333
362,dark,sv3,0,0.9890247915502063,264,18,19,301
362,dark,sv3,1,0.988808075592026,248,10,16,274
362,dark,sv3,2,0.9895048660759309,242,10,28,280
362,dark,sv3,3,0.9880540849483892,236,12,13,261
362,dark,sv3,4,0.991326210085143,232,19,20,271
362,dark,sv3,5,0.995923746073635,227,13,13,253
362,dark,sv3,6,0.9882983836671398,203,18,24,245
362,dark,sv3,7,0.9866934026447947,209,12,7,228
362,dark,sv3,8,0.9841245698648327,241,13,21,275
362,dark,sv3,9,0.9900178054694103,254,16,21,291
389,dark,sv3,0,0.9801719263061051,252,16,21,289
389,dark,sv3,1,0.9910079432217173,240,19,13,272
389,dark,sv3,2,0.9908203188296508,254,21,20,295
389,dark,sv3,3,0.9926547294828213,214,20,16,250
389,dark,sv3,4,0.9880892257433662,231,31,10,272
389,dark,sv3,5,0.9912396333010617,224,29,12,265
389,dark,sv3,6,0.9905237803978203,207,19,13,239
389,dark,sv3,7,0.9856751631808908,203,15,12,230
389,dark,sv3,8,0.9802513039480312,236,15,24,275
389,dark,sv3,9,0.9905317430086698,222,18,16,256
368,bright,sv3,0,0.992181321842081,133,256,3,392
368,bright,sv3,1,0.993152266692527,152,194,2,348
368,bright,sv3,2,0.9925838036193408,141,245,1,387
368,bright,sv3,3,0.9833912977606585,117,214,3,334
368,bright,sv3,4,0.9889797792814611,141,201,2,344
368,bright,sv3,5,0.9867717796553401,137,214,5,356
368,bright,sv3,6,0.9943984780334121,110,202,3,315
368,bright,sv3,7,0.9895755048563805,125,168,3,296
368,bright,sv3,8,0.9915272529488995,139,235,2,376
368,bright,sv3,9,0.9908268478404033,138,210,3,351
439,dark,sv3,0,0.9946129952748485,254,17,29,300
439,dark,sv3,1,0.9876006519007638,226,16,20,262
439,dark,sv3,2,0.9865500798612804,247,22,25,294
439,dark,sv3,3,0.9899877434508922,235,15,15,265
439,dark,sv3,4,0.9910916704707794,238,13,23,274
439,dark,sv3,5,0.992043862725874,235,19,38,292
439,dark,sv3,6,0.9873024929544366,208,18,20,246
439,dark,sv3,7,0.9830768318178621,184,20,19,223
439,dark,sv3,8,0.983895254021365,247,21,13,281
439,dark,sv3,9,0.985980540524002,225,22,13,260
421,bright,sv3,0,0.98857214132935,106,296,2,404
421,bright,sv3,1,0.9937115062003911,121,231,3,355
421,bright,sv3,2,0.98967278293445,141,249,6,396
421,bright,sv3,3,0.9914030676974547,123,217,1,341
421,bright,sv3,4,0.9842782447009569,97,250,3,350
421,bright,sv3,5,0.99599506244696,69,294,5,368
421,bright,sv3,6,0.9887117512832768,61,267,2,330
421,bright,sv3,7,0.9852629847120732,79,213,2,294
421,bright,sv3,8,0.9901571329981826,83,304,1,388
421,bright,sv3,9,0.9941616071167215,68,304,3,375
307,dark,sv3,0,0.9945122816182435,266,13,22,301
307,dark,sv3,1,0.9896196430109809,235,14,23,272
307,dark,sv3,2,0.9913663170073223,258,17,16,291
307,dark,sv3,3,0.9925942508800185,242,15,16,273
307,dark,sv3,4,0.9773120750507078,225,14,26,265
307,dark,sv3,5,0.9855172814319706,239,9,25,273
307,dark,sv3,6,0.9866050429963955,223,11,19,253
307,dark,sv3,7,0.9871323811228508,206,13,12,231
307,dark,sv3,8,0.9906943225165511,255,17,22,294
307,dark,sv3,9,0.9912390472308649,265,11,11,287
143,dark,sv3,0,0.9922861932103935,260,14,29,303
143,dark,sv3,1,0.990574257079211,240,10,29,279
143,dark,sv3,2,0.9949722617815746,247,16,35,298
143,dark,sv3,3,0.9905744553481608,209,13,26,248
143,dark,sv3,4,0.9905412157943461,256,11,19,286
143,dark,sv3,5,0.9859388710626511,241,13,20,274
143,dark,sv3,6,0.9889034640090912,218,14,8,240
143,dark,sv3,7,0.9907125740522226,207,13,22,242
143,dark,sv3,8,0.9898889289094768,230,14,19,263
143,dark,sv3,9,0.9798850587987783,241,12,25,278
393,bright,sv3,0,0.9933101825496016,201,202,2,405
393,bright,sv3,1,0.9866384590820554,132,211,5,348
393,bright,sv3,2,0.9875675816828702,151,238,5,394
393,bright,sv3,3,0.992199062768446,133,206,2,341
393,bright,sv3,4,0.9910911008738079,153,214,2,369
393,bright,sv3,5,0.983880315872561,140,234,2,376
393,bright,sv3,6,0.994055361703762,113,212,5,330
393,bright,sv3,7,0.9832664982993772,129,177,2,308
393,bright,sv3,8,0.993056971858817,152,232,1,385
393,bright,sv3,9,0.9921325973862599,134,243,5,382
196,dark,sv3,0,0.9941679484426149,307,8,20,335
196,dark,sv3,1,0.9955723579211254,258,12,27,297
196,dark,sv3,2,0.9845061758273606,268,10,34,312
196,dark,sv3,3,0.9895212067156733,227,10,31,268
196,dark,sv3,4,0.987486282041413,248,13,28,289
196,dark,sv3,5,0.9902223420691304,283,9,22,314
196,dark,sv3,6,0.9882437083102877,240,10,29,279
196,dark,sv3,7,0.9846270872183963,223,10,29,262
196,dark,sv3,8,0.983770923017577,261,11,31,303
196,dark,sv3,9,0.9879404339862061,263,8,36,307
436,dark,sv3,0,0.9861880882873751,255,21,20,296
436,dark,sv3,1,0.9870972205672985,228,21,12,261
436,dark,sv3,2,0.9876109730982433,258,20,14,292
436,dark,sv3,3,0.9877583012402255,195,31,12,238
436,dark,sv3,4,0.9933380111762673,213,34,26,273
436,dark,sv3,5,0.9923961342182974,240,24,32,296
436,dark,sv3,6,0.9893585501180754,221,16,24,261
436,dark,sv3,7,0.976966897565164,192,14,16,222
436,dark,sv3,8,0.9862514511580059,251,12,24,287
436,dark,sv3,9,0.9930086163497173,215,25,18,258
334,dark,sv3,0,0.984664984006681,262,18,13,293
334,dark,sv3,1,0.9880993320326583,225,9,21,255
334,dark,sv3,2,0.9816051557009945,259,13,26,298
334,dark,sv3,3,0.9900495215533561,207,15,25,247
334,dark,sv3,4,0.9887636856889388,212,17,31,260
334,dark,sv3,5,0.9903386674192457,231,13,27,271
334,dark,sv3,6,0.9914347615035201,206,18,13,237
334,dark,sv3,7,0.9930205744871833,203,15,9,227
334,dark,sv3,8,0.9883527729538992,224,11,20,255
334,dark,sv3,9,0.9804773562948623,224,13,22,259
433,dark,sv3,0,0.9874042790944476,265,16,33,314
433,dark,sv3,1,0.9805065534428898,224,15,22,261
433,dark,sv3,2,0.9913127123541143,246,11,20,277
433,dark,sv3,3,0.9935419624685174,223,13,13,249
433,dark,sv3,4,0.9942233251115407,228,14,29,271
433,dark,sv3,5,0.9910081700922455,231,14,20,265
433,dark,sv3,6,0.9871529626473089,215,15,14,244
433,dark,sv3,7,0.9777480605035059,186,13,7,206
433,dark,sv3,8,0.9870065586831911,240,12,29,281
433,dark,sv3,9,0.9887855951991705,227,16,26,269
224,dark,sv3,0,0.992944662541872,239,10,32,281
224,dark,sv3,1,0.9881158610725217,222,11,34,267
224,dark,sv3,2,0.9903231283728883,262,10,19,291
224,dark,sv3,3,0.9936379398716697,238,10,19,267
224,dark,sv3,4,0.9877789870082571,250,16,31,297
224,dark,sv3,5,0.9880223264555537,240,9,25,274
224,dark,sv3,6,0.987590909844872,212,11,10,233
224,dark,sv3,7,0.986774050919552,186,9,20,215
224,dark,sv3,8,0.9968370327323185,205,11,21,237
224,dark,sv3,9,0.9904605131561679,220,11,23,254
252,dark,sv3,0,0.9909076087674007,239,25,16,280
252,dark,sv3,1,0.9896743205405409,218,11,21,250
252,dark,sv3,2,0.9784737420444469,232,20,15,267
252,dark,sv3,3,0.9863641918678027,209,12,18,239
252,dark,sv3,4,0.991582984011822,246,13,14,273
252,dark,sv3,5,0.9893035141669062,246,16,10,272
252,dark,sv3,6,0.9845171263818439,197,15,13,225
252,dark,sv3,7,0.9889332775573273,207,11,25,243
252,dark,sv3,8,0.9941536742574533,221,18,27,266
252,dark,sv3,9,0.978333632571708,228,14,26,268
169,dark,sv3,0,0.9886954171590958,295,11,30,336
169,dark,sv3,1,0.9839914414445086,238,11,46,295
169,dark,sv3,2,0.9878179563497791,274,10,27,311
169,dark,sv3,3,0.9911314434511044,256,10,27,293
169,dark,sv3,4,0.9864756259727369,244,12,42,298
169,dark,sv3,5,0.9911789059919909,257,14,25,296
169,dark,sv3,6,0.9913058992525476,220,12,27,259
169,dark,sv3,7,0.9658988975062109,204,11,35,250
169,dark,sv3,8,0.9818118206327632,262,11,34,307
169,dark,sv3,9,0.9876539135887008,250,11,27,288
178,bright,sv3,0,0.9896199466569431,177,186,3,366
178,bright,sv3,1,0.9853020898860584,154,163,4,321
178,bright,sv3,2,0.994772148349507,198,161,5,364
178,bright,sv3,3,0.9905107551883626,180,123,0,303
178,bright,sv3,4,0.989796420270203,185,159,3,347
178,bright,sv3,5,0.9912836947228328,153,198,4,355
178,bright,sv3,6,0.9857341268376417,171,146,3,320
178,bright,sv3,7,0.9939882627744295,124,150,1,275
178,bright,sv3,8,0.9901102362648553,159,186,3,348
178,bright,sv3,9,0.9873836679730278,166,177,2,345
208,bright,sv3,0,0.9954041005072954,184,183,5,372
208,bright,sv3,1,0.9815487693958882,162,157,3,322
208,bright,sv3,2,0.9943979023953973,199,160,3,362
208,bright,sv3,3,0.99131481431748,184,133,2,319
208,bright,sv3,4,0.9868058117887778,174,153,4,331
208,bright,sv3,5,0.9938168307670828,165,168,2,335
208,bright,sv3,6,0.9842036843382277,176,124,3,303
208,bright,sv3,7,0.9910729780548586,129,139,2,270
208,bright,sv3,8,0.9875777313939107,180,173,1,354
208,bright,sv3,9,0.9887966577887998,197,147,7,351
314,bright,sv3,0,0.993352231399224,175,219,3,397
314,bright,sv3,1,0.987661475837809,127,204,5,336
314,bright,sv3,2,0.987661475837809,127,204,5,336
314,bright,sv3,3,0.99139724685723,135,194,1,330
314,bright,sv3,4,0.9895588949517722,143,193,1,337
314,bright,sv3,5,0.9881318310669316,176,182,5,363
314,bright,sv3,6,0.9881318310669316,176,182,5,363
314,bright,sv3,7,0.988285340403605,154,134,0,288
314,bright,sv3,8,0.9847700766719312,180,192,1,373
314,bright,sv3,9,0.9893511576605892,194,167,2,363
230,bright,sv3,0,0.9961546891633005,206,193,2,401
230,bright,sv3,1,0.9884475056796267,179,164,5,348
230,bright,sv3,2,0.9916808865909953,193,193,1,387
230,bright,sv3,3,0.9910531997778029,212,126,1,339
230,bright,sv3,4,0.9877167933415385,270,89,3,362
230,bright,sv3,5,0.9930132240906208,258,112,1,371
230,bright,sv3,6,0.9843133190939204,241,93,1,335
230,bright,sv3,7,0.9875453750455033,199,99,1,299
230,bright,sv3,8,0.9837637100510488,236,148,4,388
230,bright,sv3,9,0.9885886060786281,257,109,5,371
374,backup,sv3,0,0.9932891143576065,4,400,1,405
374,backup,sv3,1,0.9845989410094927,3,334,2,339
374,backup,sv3,2,0.9922189293615904,4,383,0,387
374,backup,sv3,3,0.9840185945630541,4,313,1,318
374,backup,sv3,4,0.9887043261692898,0,342,1,343
374,backup,sv3,5,0.9944373493792577,1,390,0,391
374,backup,sv3,6,0.9895315602742929,3,336,2,341
374,backup,sv3,7,0.9913221641553553,1,305,1,307
374,backup,sv3,8,0.9880928633473396,3,381,0,384
374,backup,sv3,9,0.993804769515009,12,395,0,407
197,dark,sv3,0,0.9877680827493204,300,16,24,340
197,dark,sv3,1,0.9856806166553961,260,12,26,298
197,dark,sv3,2,0.9904849920500729,258,13,34,305
197,dark,sv3,3,0.9923101939784214,238,10,27,275
197,dark,sv3,4,0.9913962048004322,238,12,39,289
197,dark,sv3,5,0.9899558192892851,265,10,25,300
197,dark,sv3,6,0.9878020000697284,229,9,22,260
197,dark,sv3,7,0.9872575121024398,208,11,28,247
197,dark,sv3,8,0.98344173837854,268,13,19,300
197,dark,sv3,9,0.9867679920385614,279,11,25,315
422,bright,sv3,0,0.9948380906294532,77,319,3,399
422,bright,sv3,1,0.994982100665291,67,285,1,353
422,bright,sv3,2,0.9920366873393415,91,295,1,387
422,bright,sv3,3,0.9933093488845464,73,262,1,336
422,bright,sv3,4,0.992518297551707,80,268,2,350
422,bright,sv3,5,0.9944906218108374,66,296,1,363
422,bright,sv3,6,0.9923393367266063,49,277,0,326
422,bright,sv3,7,0.9900386400104255,76,206,0,282
422,bright,sv3,8,0.992963783047716,96,287,2,385
422,bright,sv3,9,0.9927679219359973,70,299,2,371
440,dark,sv3,0,0.9906214529416975,282,17,21,320
440,dark,sv3,1,0.9936063064528353,246,19,22,287
440,dark,sv3,2,0.9914921708825993,274,18,21,313
440,dark,sv3,3,0.9918040787594198,220,19,25,264
440,dark,sv3,4,0.9908020884599937,257,19,13,289
440,dark,sv3,5,0.9920531373372833,252,18,19,289
440,dark,sv3,6,0.984212966690921,211,16,13,240
440,dark,sv3,7,0.988626673243383,184,18,14,216
440,dark,sv3,8,0.9912983422381303,252,29,14,295
440,dark,sv3,9,0.9929085660540418,253,20,23,296
437,dark,sv3,0,0.9896813118023727,256,20,32,308
437,dark,sv3,1,0.9861617708256472,236,20,19,275
437,dark,sv3,2,0.9906415459698248,263,14,27,304
437,dark,sv3,3,0.9814583179287736,228,25,14,267
437,dark,sv3,4,0.9851965011610756,213,32,17,262
437,dark,sv3,5,0.9859416981413374,249,39,11,299
437,dark,sv3,6,0.992096156454364,207,21,20,248
437,dark,sv3,7,0.9856264084776934,193,15,16,224
437,dark,sv3,8,0.9905204281117319,242,24,18,284
437,dark,sv3,9,0.9938613659841522,242,14,22,278
286,bright,sv3,0,0.9920166928296534,194,211,0,405
286,bright,sv3,1,0.9872415671241352,162,189,2,353
286,bright,sv3,2,0.9956983170199101,143,247,1,391
286,bright,sv3,3,0.9930447312149283,133,205,2,340
286,bright,sv3,4,0.9892063054341302,155,200,3,358
286,bright,sv3,5,0.9952866566231944,173,189,4,366
286,bright,sv3,6,0.9881000334200211,113,210,2,325
286,bright,sv3,7,0.9964538428197915,99,197,2,298
286,bright,sv3,8,0.9931698186284772,141,240,1,382
286,bright,sv3,9,0.990847951665496,156,216,1,373
97,bright,sv3,0,0.9869500315390163,217,144,5,366
97,bright,sv3,1,0.9897061620668184,216,114,7,337
97,bright,sv3,2,0.9938791675779731,205,160,4,369
97,bright,sv3,3,0.9908335916829324,180,149,7,336
97,bright,sv3,4,0.9898365341722553,200,137,2,339
97,bright,sv3,5,0.9926777979085213,190,160,2,352
97,bright,sv3,6,0.9922213665613244,176,129,4,309
97,bright,sv3,7,0.993684867304921,147,125,4,276
97,bright,sv3,8,0.994872651441228,202,159,1,362
97,bright,sv3,9,0.991991028663085,190,153,5,348
80968,backup1,sv1,0,0.9977646296852968,1,295,5,301
80968,backup1,sv1,1,0.9916761630468947,1,295,2,298
80968,backup1,sv1,2,0.9902410654755747,3,239,2,244
80968,backup1,sv1,3,0.991248899583085,3,283,4,290
80968,backup1,sv1,4,0.9626703160685098,5,144,1,150
80968,backup1,sv1,5,0.9884919786938188,7,195,2,204
80968,backup1,sv1,6,0.9752399375065067,0,176,0,176
80968,backup1,sv1,7,0.9752399375065067,0,176,0,176
80968,backup1,sv1,8,0.9889819393025874,0,319,2,321
80968,backup1,sv1,9,0.9796933934852208,1,274,2,277
80950,backup1,sv1,0,0.9921183923044165,1,280,1,282
80950,backup1,sv1,1,0.9905300249411416,2,274,4,280
80950,backup1,sv1,2,0.988842535500682,5,222,1,228
80950,backup1,sv1,3,0.9833009915372558,2,272,2,276
80950,backup1,sv1,4,0.9874197611805029,1,275,3,279
80950,backup1,sv1,5,0.9728627535446576,2,255,3,260
80950,backup1,sv1,6,0.9795917403909602,2,287,1,290
80950,backup1,sv1,7,0.9795917403909602,2,287,1,290
80950,backup1,sv1,8,0.9949354966283152,2,324,4,330
80950,backup1,sv1,9,0.9825048235544562,2,262,4,268
80962,backup1,sv1,0,0.990843077498925,2,292,6,300
80962,backup1,sv1,1,0.9864801724269507,2,294,2,298
80962,backup1,sv1,2,0.9801030450499197,2,230,4,236
80962,backup1,sv1,3,0.9872808275810946,5,287,3,295
80962,backup1,sv1,4,0.987915715974415,2,305,2,309
80962,backup1,sv1,5,0.9877883239318875,12,245,4,261
80962,backup1,sv1,6,0.992312191727788,2,307,2,311
80962,backup1,sv1,7,0.992312191727788,2,307,2,311
80962,backup1,sv1,8,0.9825698948169996,4,334,2,340
80962,backup1,sv1,9,0.9842976042875199,1,279,1,281
80938,backup1,sv1,0,0.992032775242375,0,300,2,302
80938,backup1,sv1,1,0.9891765867155946,3,287,5,295
80938,backup1,sv1,2,0.9916435244524809,3,347,3,353
80938,backup1,sv1,3,0.9837442336788281,7,289,1,297
80938,backup1,sv1,4,0.9840086274831493,3,305,6,314
80938,backup1,sv1,5,0.993761436393237,1,257,4,262
80938,backup1,sv1,6,0.9898286818538948,0,295,7,302
80938,backup1,sv1,7,0.9898286818538948,0,295,7,302
80938,backup1,sv1,8,0.9910153168967816,4,333,1,338
80938,backup1,sv1,9,0.9766241899382443,6,269,6,281
80966,backup1,sv1,0,0.9916469946813357,0,295,1,296
80966,backup1,sv1,1,0.9909233711919627,0,291,1,292
80966,backup1,sv1,2,0.9840649891479438,1,234,1,236
80966,backup1,sv1,3,0.9859006944227827,7,285,1,293
80966,backup1,sv1,4,0.9887362259054019,1,306,3,310
80966,backup1,sv1,5,0.9898359085177554,0,260,4,264
80966,backup1,sv1,6,0.9902133699491553,0,298,5,303
80966,backup1,sv1,7,0.9902133699491553,0,298,5,303
80966,backup1,sv1,8,0.9932773076597348,3,336,3,342
80966,backup1,sv1,9,0.9932773076597348,3,336,3,342
80944,backup1,sv1,0,0.9913172556637919,9,289,5,303
80944,backup1,sv1,1,0.9862388063629777,9,280,5,294
80944,backup1,sv1,2,0.9875978680965253,3,221,5,229
80944,backup1,sv1,3,0.9905273180560904,14,279,3,296
80944,backup1,sv1,4,0.9923577618310837,2,303,3,308
80944,backup1,sv1,5,0.9802452216840852,3,256,2,261
80944,backup1,sv1,6,0.9871457253612732,0,288,2,290
80944,backup1,sv1,7,0.9526402595914564,4,113,1,118
80944,backup1,sv1,8,0.9856400359503177,2,336,1,339
80944,backup1,sv1,9,0.991565521274009,3,259,3,265
80963,backup1,sv1,0,0.9941579733119821,0,354,2,356
80963,backup1,sv1,1,0.9911427272994983,2,296,3,301
80963,backup1,sv1,2,0.9886697717581947,6,342,8,356
80963,backup1,sv1,3,0.9896080853526169,0,294,2,296
80963,backup1,sv1,4,0.9909072770945815,3,313,3,319
80963,backup1,sv1,5,0.9877751491474307,2,325,2,329
80963,backup1,sv1,6,0.9859415444188049,1,303,1,305
80963,backup1,sv1,7,0.9890842525764091,1,248,5,254
80963,backup1,sv1,8,0.9858359214182203,3,307,3,313
80963,backup1,sv1,9,0.9895261365676133,2,339,5,346
80956,backup1,sv1,0,0.9917259225995059,0,329,4,333
80956,backup1,sv1,1,0.9863516229995241,2,294,4,300
80956,backup1,sv1,2,0.9888039366957964,3,330,5,338
80956,backup1,sv1,3,0.9812671561199704,5,286,4,295
80956,backup1,sv1,4,0.9934658483225763,3,293,7,303
80956,backup1,sv1,5,0.9941774763490931,9,310,0,319
80956,backup1,sv1,6,0.989397898506089,1,300,3,304
80956,backup1,sv1,7,0.9841778112944338,1,243,2,246
80956,backup1,sv1,8,0.9899936988142144,1,314,4,319
80956,backup1,sv1,9,0.9919686160744202,3,322,6,331
80970,backup1,sv1,0,0.9808717623179507,3,349,2,354
80970,backup1,sv1,1,0.9846528285888309,3,296,4,303
80970,backup1,sv1,2,0.993856330953704,3,350,3,356
80970,backup1,sv1,3,0.9969753036701151,5,289,3,297
80970,backup1,sv1,4,0.9930373062662479,13,293,7,313
80970,backup1,sv1,5,0.9891103116375485,24,290,4,318
80970,backup1,sv1,6,0.9831787957210028,2,301,2,305
80970,backup1,sv1,7,0.9870799295114515,3,237,3,243
80970,backup1,sv1,8,0.9900664081700192,2,312,4,318
80970,backup1,sv1,9,0.9908463896586425,7,310,5,322
80960,backup1,sv1,0,0.9935271732326584,2,352,0,354
80960,backup1,sv1,1,0.99458680159789,2,291,4,297
80960,backup1,sv1,2,0.9894280109016447,0,356,2,358
80960,backup1,sv1,3,0.9893856618645949,1,300,2,303
80960,backup1,sv1,4,0.9966142915006608,0,312,3,315
80960,backup1,sv1,5,0.9953107768191468,30,298,5,333
80960,backup1,sv1,6,0.9886990165205422,0,300,2,302
80960,backup1,sv1,7,0.976402940612638,1,253,2,256
80960,backup1,sv1,8,0.9944664314687878,2,338,4,344
80960,backup1,sv1,9,0.9939629606607403,4,340,4,348
80959,backup1,sv1,0,0.9860553082239767,0,337,7,344
80959,backup1,sv1,1,0.988994371205627,0,293,4,297
80959,backup1,sv1,2,0.9907867378732162,3,336,3,342
80959,backup1,sv1,3,0.9813574066743578,1,297,3,301
80959,backup1,sv1,4,0.9904570162310535,2,314,2,318
80959,backup1,sv1,5,0.9909568600512164,15,315,2,332
80959,backup1,sv1,6,0.9852397585806612,2,297,4,303
80959,backup1,sv1,7,0.9840401377933327,0,242,6,248
80959,backup1,sv1,8,0.993436561731546,0,312,3,315
80959,backup1,sv1,9,0.9906373991510231,6,335,4,345
80958,backup1,sv1,0,0.9905761609600559,116,228,0,344
80958,backup1,sv1,1,0.9862358339417044,91,187,3,281
80958,backup1,sv1,2,0.9943438771471839,132,206,2,340
80958,backup1,sv1,3,0.98104905750458,115,172,4,291
80958,backup1,sv1,4,0.9888904234776427,117,194,2,313
80958,backup1,sv1,5,0.9869835312164614,138,182,3,323
80958,backup1,sv1,6,0.9886797431001496,121,175,0,296
80958,backup1,sv1,7,0.982782939090521,106,132,3,241
80958,backup1,sv1,8,0.9887869443049704,82,225,3,310
80958,backup1,sv1,9,0.9955699862774936,116,219,2,337
80955,backup1,sv1,0,0.9916770852983533,11,340,4,355
80955,backup1,sv1,1,0.9875385260218462,7,292,2,301
80955,backup1,sv1,2,0.9870554329768743,17,332,3,352
80955,backup1,sv1,3,0.9900325102269723,18,283,4,305
80955,backup1,sv1,4,0.9883559632734767,5,307,2,314
80955,backup1,sv1,5,0.9878728832170733,13,322,2,337
80955,backup1,sv1,6,0.9905663358582564,14,293,3,310
80955,backup1,sv1,7,0.985296281955642,7,240,6,253
80955,backup1,sv1,8,0.9917447185956588,9,318,3,330
80955,backup1,sv1,9,0.9932016286976,6,337,1,344
80949,backup1,sv1,0,0.9929343049599364,131,220,5,356
80949,backup1,sv1,1,0.9862256650247808,124,165,2,291
80949,backup1,sv1,2,0.9911417429547894,108,224,4,336
80949,backup1,sv1,3,0.9856141766634655,143,133,2,278
80949,backup1,sv1,4,0.9901319506889306,133,171,0,304
80949,backup1,sv1,5,0.9886271226386153,163,150,3,316
80949,backup1,sv1,6,0.9923940003536399,107,182,2,291
80949,backup1,sv1,7,0.9897232036776694,92,150,3,245
80949,backup1,sv1,8,0.9877137041444297,119,199,0,318
80949,backup1,sv1,9,0.9917992158920085,109,225,2,336
80952,backup1,sv1,0,0.9960656079427893,27,320,4,351
80952,backup1,sv1,1,0.9869465495743783,15,276,3,294
80952,backup1,sv1,2,0.9881766227479986,28,324,4,356
80952,backup1,sv1,3,0.9836474957542659,48,245,3,296
80952,backup1,sv1,4,0.9895797173296886,20,288,5,313
80952,backup1,sv1,5,0.9916428866792633,37,290,3,330
80952,backup1,sv1,6,0.9916486760333131,32,276,1,309
80952,backup1,sv1,7,0.9811020123616455,19,224,7,250
80952,backup1,sv1,8,0.9805367866174431,23,300,5,328
80952,backup1,sv1,9,0.9864904810617412,21,319,4,344
80951,backup1,sv1,0,0.988372911047258,1,340,3,344
80951,backup1,sv1,1,0.9885896240672476,0,291,5,296
80951,backup1,sv1,2,0.9934910914039914,4,354,1,359
80951,backup1,sv1,3,0.991557018906978,6,288,4,298
80951,backup1,sv1,4,0.9915156173744226,1,308,6,315
80951,backup1,sv1,5,0.9924665374115567,2,340,3,345
80951,backup1,sv1,6,0.9899138488177966,2,298,3,303
80951,backup1,sv1,7,0.9844055583723855,1,255,2,258
80951,backup1,sv1,8,0.9923040679249158,5,306,4,315
80951,backup1,sv1,9,0.9899666823453694,8,333,4,345
80954,backup1,sv1,0,0.9962652432215557,3,332,3,338
80954,backup1,sv1,1,0.9906597865845437,1,301,2,304
80954,backup1,sv1,2,0.9898825994917926,14,324,3,341
80954,backup1,sv1,3,0.9853098633530217,9,287,1,297
80954,backup1,sv1,4,0.9879104276214684,2,310,3,315
80954,backup1,sv1,5,0.9840541891423189,12,314,4,330
80954,backup1,sv1,6,0.9891735856843216,0,305,1,306
80954,backup1,sv1,7,0.9846178112225533,18,231,0,249
80954,backup1,sv1,8,0.9792950537579549,1,328,2,331
80954,backup1,sv1,9,0.9927532297708517,79,250,0,329
79,backup,sv3,0,0.9895165089974818,0,324,0,324
79,backup,sv3,1,0.9771251881133822,2,282,0,284
79,backup,sv3,2,0.9935220750848062,5,312,0,317
79,backup,sv3,3,0.9971265470165954,5,249,2,256
79,backup,sv3,4,0.99506701698216,5,259,1,265
79,backup,sv3,5,0.9815854297641965,1,172,0,173
79,backup,sv3,6,0.9923028836619185,2,243,2,247
79,backup,sv3,7,0.9793916554004816,2,230,1,233
79,backup,sv3,8,0.9933806614315308,9,281,0,290
79,backup,sv3,9,0.9862227707042145,4,277,2,283
341,bright,sv3,0,0.9934134458874357,131,252,1,384
341,bright,sv3,1,0.9909818924500744,114,229,2,345
341,bright,sv3,2,0.9817358102892401,129,246,0,375
341,bright,sv3,3,0.9871388008059658,121,205,2,328
341,bright,sv3,4,0.9933657856756799,115,225,0,340
341,bright,sv3,5,0.9907939748615824,132,228,4,364
341,bright,sv3,6,0.9900780020027129,97,220,1,318
341,bright,sv3,7,0.9906335361218068,132,165,2,299
341,bright,sv3,8,0.9944840062868288,174,206,0,380
341,bright,sv3,9,0.9938765541118384,139,231,3,373
107,backup,sv3,0,0.9736224612269139,1,101,2,104
107,backup,sv3,1,0.9781772282781529,1,235,1,237
107,backup,sv3,2,0.9781772282781529,1,235,1,237
107,backup,sv3,3,0.9811039220348594,2,239,2,243
107,backup,sv3,4,0.9888889063806164,4,263,3,270
107,backup,sv3,5,0.9856944005758488,10,153,0,163
107,backup,sv3,6,0.9918608236804269,2,243,2,247
107,backup,sv3,7,0.9881185457752726,4,203,2,209
107,backup,sv3,8,0.9846855249467142,4,260,1,265
107,backup,sv3,9,0.9865821813335431,8,249,0,257
423,bright,sv3,0,0.995271798603371,60,336,1,397
423,bright,sv3,1,0.9958671175485105,54,301,0,355
423,bright,sv3,2,0.9917690666859297,65,313,0,378
423,bright,sv3,3,0.9927804123478169,90,239,4,333
423,bright,sv3,4,0.9910458038579175,71,275,5,351
423,bright,sv3,5,0.9822302292589232,42,162,1,205
423,bright,sv3,6,0.9899731838180491,52,272,0,324
423,bright,sv3,7,0.9865679095431711,76,210,1,287
423,bright,sv3,8,0.9863962345495657,60,305,3,368
423,bright,sv3,9,0.9940418057267794,49,312,5,366
209,bright,sv3,0,0.9902980883633818,201,161,3,365
209,bright,sv3,1,0.9900046651133317,174,139,4,317
209,bright,sv3,2,0.9815793129946022,209,158,4,371
209,bright,sv3,3,0.9927977755034408,183,137,5,325
209,bright,sv3,4,0.9952032268045675,183,147,4,334
209,bright,sv3,5,0.9970952528949262,187,142,6,335
209,bright,sv3,6,0.9924602574291208,169,137,1,307
209,bright,sv3,7,0.9903708813340022,143,117,2,262
209,bright,sv3,8,0.9887742452193286,129,113,3,245
209,bright,sv3,9,0.9907184976639848,198,166,2,366
179,bright,sv3,0,0.9898705779814113,167,184,4,355
179,bright,sv3,1,0.9919474979866483,148,151,3,302
179,bright,sv3,2,0.9957414578131523,188,171,5,364
179,bright,sv3,3,0.992783292834195,164,151,2,317
179,bright,sv3,4,0.9891889351390114,154,181,6,341
179,bright,sv3,5,0.9768037287589089,89,88,1,178
179,bright,sv3,6,0.9879163975965625,153,153,1,307
179,bright,sv3,7,0.9857716028278293,130,122,7,259
179,bright,sv3,8,0.9898102358009486,178,161,5,344
179,bright,sv3,9,0.9894351874175443,163,153,3,319
369,bright,sv3,0,0.9938294321422837,119,281,0,400
369,bright,sv3,1,0.9913977495450309,135,223,1,359
369,bright,sv3,2,0.9910638894100358,124,264,3,391
369,bright,sv3,3,0.9923784539998762,140,194,8,342
369,bright,sv3,4,0.9929693566319535,138,217,2,357
369,bright,sv3,5,0.9937702283723753,135,230,0,365
369,bright,sv3,6,0.9862917988563197,127,202,1,330
369,bright,sv3,7,0.9865557317356362,120,171,1,292
369,bright,sv3,8,0.9932974587395415,129,246,3,378
369,bright,sv3,9,0.9927897184076826,122,256,2,380
315,bright,sv3,0,0.9897758842964849,106,164,1,271
315,bright,sv3,1,0.9795969997557396,100,134,2,236
315,bright,sv3,2,0.9795969997557396,100,134,2,236
315,bright,sv3,3,0.994261768289942,152,181,2,335
315,bright,sv3,4,0.9931910583977257,137,198,3,338
315,bright,sv3,5,0.9931910583977257,137,198,3,338
315,bright,sv3,6,0.990079232157441,117,205,1,323
315,bright,sv3,7,0.9904394700088953,160,136,2,298
315,bright,sv3,8,0.9854070929685548,124,128,2,254
315,bright,sv3,9,0.9907270896270362,196,172,4,372
375,backup,sv3,0,0.9930217253299859,1,361,0,362
375,backup,sv3,1,0.9917699791690937,1,315,1,317
375,backup,sv3,2,0.9886171429998823,6,363,0,369
375,backup,sv3,3,0.9920447400170734,3,315,0,318
375,backup,sv3,4,0.9872159770766443,1,330,2,333
375,backup,sv3,5,0.9846944469101983,2,352,1,355
375,backup,sv3,6,0.9935256066086097,1,321,1,323
375,backup,sv3,7,0.989593618021312,2,280,1,283
375,backup,sv3,8,0.9924307856804764,1,242,0,243
375,backup,sv3,9,0.9909679505264832,0,357,1,358
321,backup,sv3,0,0.9925471695927879,9,305,1,315
321,backup,sv3,1,0.9895983955877897,6,283,1,290
321,backup,sv3,2,0.9853186215597339,5,324,0,329
321,backup,sv3,3,0.990147909637787,4,274,0,278
321,backup,sv3,4,0.9835050123738734,3,275,0,278
321,backup,sv3,5,0.9562292516624584,6,121,0,127
321,backup,sv3,6,0.9891290420570884,3,280,0,283
321,backup,sv3,7,0.9799060532708765,8,232,0,240
321,backup,sv3,8,0.9819044724930114,2,211,0,213
321,backup,sv3,9,0.9798446178535257,1,313,1,315
215,backup,sv3,0,0.9901865079165433,6,295,1,302
215,backup,sv3,1,0.9811528973564736,1,254,0,255
215,backup,sv3,2,0.9888723623503697,9,293,2,304
215,backup,sv3,3,0.9926897029198536,6,249,1,256
215,backup,sv3,4,0.9885057270056079,6,272,1,279
215,backup,sv3,5,0.9930814920744191,10,256,1,267
215,backup,sv3,6,0.9918598217630431,5,240,0,245
215,backup,sv3,7,0.9759409905595449,3,198,1,202
215,backup,sv3,8,0.9792766872788925,1,191,1,193
215,backup,sv3,9,0.9887936034071311,3,284,0,287
401,backup,sv3,0,0.9965466773428534,3,403,0,406
401,backup,sv3,1,0.9924546542858006,0,367,0,367
401,backup,sv3,2,0.9870387389177563,1,390,0,391
401,backup,sv3,3,0.9918000406274092,4,352,0,356
401,backup,sv3,4,0.9921697276963634,3,365,0,368
401,backup,sv3,5,0.9953558623839112,3,384,0,387
401,backup,sv3,6,0.9891802366576312,1,338,0,339
401,backup,sv3,7,0.9818685584094956,2,307,0,309
401,backup,sv3,8,0.989983845057389,0,263,0,263
401,backup,sv3,9,0.9911903198378484,0,390,0,390
80711,elgqso,sv1,0,0.9921762032587219,295,28,44,367
80711,elgqso,sv1,1,0.9962959769802587,296,31,28,355
80711,elgqso,sv1,2,0.9945206719870672,281,23,51,355
80711,elgqso,sv1,3,0.9882751087985988,270,23,45,338
80711,elgqso,sv1,4,0.9921705009951074,274,22,45,341
80711,elgqso,sv1,5,0.9955056099498999,260,27,50,337
80711,elgqso,sv1,6,0.9820136008587127,278,25,38,341
80711,elgqso,sv1,7,0.9928218048577904,245,29,52,326
80711,elgqso,sv1,8,0.9884374080651219,275,34,45,354
80711,elgqso,sv1,9,0.9934767110821789,289,33,37,359
7,dark,sv3,0,0.9892138030952933,296,10,22,328
7,dark,sv3,1,0.9843899504590129,194,8,19,221
7,dark,sv3,2,0.9961812774365044,289,12,22,323
7,dark,sv3,3,0.9889957786667641,241,12,30,283
7,dark,sv3,4,0.995963810306867,251,12,28,291
7,dark,sv3,5,0.9870297174279892,278,9,23,310
7,dark,sv3,6,0.9812472127684485,241,11,25,277
7,dark,sv3,7,0.9775731624038214,152,7,21,180
7,dark,sv3,8,0.9821379947041037,247,13,19,279
7,dark,sv3,9,0.9846921024611509,184,10,19,213
370,bright,sv3,0,0.9973948527296509,146,232,2,380
370,bright,sv3,1,0.9940138514069692,156,186,2,344
370,bright,sv3,2,0.9922740928229571,148,235,1,384
370,bright,sv3,3,0.991985417363032,136,189,0,325
370,bright,sv3,4,0.9923012943555288,134,214,1,349
370,bright,sv3,5,0.9920943358077504,144,212,3,359
370,bright,sv3,6,0.9909075523345283,106,212,1,319
370,bright,sv3,7,0.9944872049847935,103,178,0,281
370,bright,sv3,8,0.9899365502904911,137,217,7,361
370,bright,sv3,9,0.9976284632009405,124,236,1,361
394,bright,sv3,0,0.9895876105240857,170,235,4,409
394,bright,sv3,1,0.9924598010533482,153,227,2,382
394,bright,sv3,2,0.9961239657475697,125,275,1,401
394,bright,sv3,3,0.9888105473603126,98,258,2,358
394,bright,sv3,4,0.990574799841919,115,256,3,374
394,bright,sv3,5,0.9865199406700086,74,307,2,383
394,bright,sv3,6,0.985757036730787,43,285,2,330
394,bright,sv3,7,0.988914604694275,79,239,3,321
394,bright,sv3,8,0.9948153865759795,81,305,2,388
394,bright,sv3,9,0.9937611290022742,137,247,2,386
260,bright,sv3,0,0.9910502583244415,126,275,3,404
260,bright,sv3,1,0.9879030428385297,123,248,2,373
260,bright,sv3,2,0.9944670235994737,168,233,0,401
260,bright,sv3,3,0.9903843708899758,140,208,5,353
260,bright,sv3,4,0.9899698381171557,107,257,1,365
260,bright,sv3,5,0.9920062037489,120,254,2,376
260,bright,sv3,6,0.981935669970999,107,214,3,324
260,bright,sv3,7,0.9911180950076365,127,182,2,311
260,bright,sv3,8,0.9927704841424871,144,237,3,384
260,bright,sv3,9,0.9908371954456947,95,280,1,376
17,bright,sv3,0,0.9926291294117292,193,188,5,386
17,bright,sv3,1,0.9884173065789167,149,199,6,354
17,bright,sv3,2,0.9919186687026881,165,212,2,379
17,bright,sv3,3,0.9929705665641934,155,171,4,330
17,bright,sv3,4,0.9956219172135377,195,162,1,358
17,bright,sv3,5,0.9918433000324416,180,183,6,369
17,bright,sv3,6,0.9954857510597235,134,180,3,317
17,bright,sv3,7,0.9876436632298252,147,141,4,292
17,bright,sv3,8,0.9953933769040568,154,204,2,360
17,bright,sv3,9,0.9907203122469679,133,240,1,374
316,bright,sv3,0,0.994046455403197,170,216,2,388
316,bright,sv3,1,0.990234198549865,130,206,2,338
316,bright,sv3,2,0.992003129834935,178,207,3,388
316,bright,sv3,3,0.9776109567667124,124,195,3,322
316,bright,sv3,4,0.990262820863645,148,199,3,350
316,bright,sv3,5,0.9907502114536221,136,219,1,356
316,bright,sv3,6,0.9943585425232012,122,199,1,322
316,bright,sv3,7,0.9938734966325343,113,173,5,291
316,bright,sv3,8,0.9883415960479943,130,228,1,359
316,bright,sv3,9,0.9905084016660959,166,193,2,361
342,bright,sv3,0,0.985810579716522,137,236,2,375
342,bright,sv3,1,0.9932856852659858,108,233,2,343
342,bright,sv3,2,0.9757810874202819,132,237,4,373
342,bright,sv3,3,0.9823131134946125,111,211,1,323
342,bright,sv3,4,0.9909878044794882,136,216,0,352
342,bright,sv3,5,0.987780233381357,124,228,2,354
342,bright,sv3,6,0.9931394535441193,106,217,1,324
342,bright,sv3,7,0.9896917343589066,107,182,2,291
342,bright,sv3,8,0.9940954864832773,149,207,0,356
342,bright,sv3,9,0.9913979406312996,153,205,4,362
88,dark,sv3,0,0.9883104887306958,264,14,41,319
88,dark,sv3,1,0.9831241160444173,255,13,35,303
88,dark,sv3,2,0.9907910490061541,286,14,32,332
88,dark,sv3,3,0.9892873479347613,242,10,38,290
88,dark,sv3,4,0.9890328005744037,266,9,33,308
88,dark,sv3,5,0.9868872451416686,269,10,30,309
88,dark,sv3,6,0.9877260041361935,238,10,20,268
88,dark,sv3,7,0.9919793011521251,207,16,29,252
88,dark,sv3,8,0.9933585945309565,248,13,31,292
88,dark,sv3,9,0.9819938878433702,248,14,27,289
170,dark,sv3,0,0.9936348282713401,290,14,28,332
170,dark,sv3,1,0.9828092836945684,248,10,38,296
170,dark,sv3,2,0.9962941369732602,279,11,36,326
170,dark,sv3,3,0.9886054826163723,222,14,30,266
170,dark,sv3,4,0.9925462771802807,255,11,23,289
170,dark,sv3,5,0.9852201349130292,248,12,27,287
170,dark,sv3,6,0.990758982270588,245,12,20,277
170,dark,sv3,7,0.9787228887160525,208,12,23,243
170,dark,sv3,8,0.9920746096043964,273,13,20,306
170,dark,sv3,9,0.9931205413801175,258,15,19,292
8,dark,sv3,0,0.9875233335291091,284,15,26,325
8,dark,sv3,1,0.9866952629521629,251,15,26,292
8,dark,sv3,2,0.9867066418808007,271,16,24,311
8,dark,sv3,3,0.9928510179947583,258,16,11,285
8,dark,sv3,4,0.9888758436576672,266,10,21,297
8,dark,sv3,5,0.9897759630996215,269,15,20,304
8,dark,sv3,6,0.9887280320536165,249,12,21,282
8,dark,sv3,7,0.980747238823326,225,10,25,260
8,dark,sv3,8,0.9935260164970534,269,16,20,305
8,dark,sv3,9,0.960567551416175,268,13,20,301
117,dark,sv3,0,0.9930123688629788,241,13,24,278
117,dark,sv3,1,0.9926209418403071,215,11,27,253
117,dark,sv3,2,0.9916195157851556,252,14,11,277
117,dark,sv3,3,0.9904640408166514,227,12,21,260
117,dark,sv3,4,0.9890687879658053,231,14,27,272
117,dark,sv3,5,0.9920524050014999,246,11,25,282
117,dark,sv3,6,0.9876671926197095,199,14,29,242
117,dark,sv3,7,0.9856979424473187,178,11,35,224
117,dark,sv3,8,0.9843618632311117,229,14,30,273
117,dark,sv3,9,0.9880552827178001,252,13,26,291
424,bright,sv3,0,0.9921555736222502,73,315,0,388
424,bright,sv3,1,0.9955924269537866,78,270,1,349
424,bright,sv3,2,0.9872299155831524,115,269,0,384
424,bright,sv3,3,0.9919445039989095,122,210,1,333
424,bright,sv3,4,0.9878202369664001,90,264,1,355
424,bright,sv3,5,0.9848928424853982,56,295,1,352
424,bright,sv3,6,0.9824004549941615,71,255,1,327
424,bright,sv3,7,0.9903592467211768,66,222,2,290
424,bright,sv3,8,0.9934787880851683,63,303,0,366
424,bright,sv3,9,0.9960053189380536,72,294,1,367
210,bright,sv3,0,0.9899801215121161,193,164,7,364
210,bright,sv3,1,0.9905111071217584,190,140,2,332
210,bright,sv3,2,0.9873192930142399,210,148,5,363
210,bright,sv3,3,0.9898700772948225,198,128,4,330
210,bright,sv3,4,0.992265063454912,206,132,3,341
210,bright,sv3,5,0.9884319945780569,187,148,2,337
210,bright,sv3,6,0.991558040013836,174,127,6,307
210,bright,sv3,7,0.9831996180747181,144,113,2,259
210,bright,sv3,8,0.9886683967019618,196,148,4,348
210,bright,sv3,9,0.9856654401027737,198,147,2,347
61,dark,sv3,0,0.9846234084982882,276,16,23,315
61,dark,sv3,1,0.9935919039504538,238,10,41,289
61,dark,sv3,2,0.9877280952804247,288,12,24,324
61,dark,sv3,3,0.9880590706934022,244,12,25,281
61,dark,sv3,4,0.9903780203273761,248,13,33,294
61,dark,sv3,5,0.9920528387934086,254,9,29,292
61,dark,sv3,6,0.9882318930953681,222,9,21,252
61,dark,sv3,7,0.9815164487937448,223,9,34,266
61,dark,sv3,8,0.9834976860837854,265,12,23,300
61,dark,sv3,9,0.9938598651853129,264,10,20,294
18,bright,sv3,0,0.9926199398377036,163,207,3,373
18,bright,sv3,1,0.9879476767161678,152,186,3,341
18,bright,sv3,2,0.9940194770916188,171,209,2,382
18,bright,sv3,3,0.9893581398016708,164,169,4,337
18,bright,sv3,4,0.9922585507433221,169,173,3,345
18,bright,sv3,5,0.9919546978697593,189,169,3,361
18,bright,sv3,6,0.991918672281994,157,162,5,324
18,bright,sv3,7,0.9899142147931992,113,157,1,271
18,bright,sv3,8,0.9937596994511211,134,209,3,346
18,bright,sv3,9,0.9930428184701157,145,205,5,355
124,bright,sv3,0,0.9923813149250602,229,114,7,350
124,bright,sv3,1,0.9873931520332467,205,95,5,305
124,bright,sv3,2,0.9935521530142946,228,127,4,359
124,bright,sv3,3,0.9945751791228916,198,108,1,307
124,bright,sv3,4,0.9891999997868579,203,121,8,332
124,bright,sv3,5,0.9875438497431748,206,130,3,339
124,bright,sv3,6,0.9932682129820655,182,116,5,303
124,bright,sv3,7,0.9813438924516118,155,91,6,252
124,bright,sv3,8,0.9873197030327403,194,130,3,327
124,bright,sv3,9,0.9939007381669697,239,95,5,339
198,dark,sv3,0,0.995925826997495,287,14,21,322
198,dark,sv3,1,0.9862065197489849,248,15,18,281
198,dark,sv3,2,0.9886526350655606,269,13,24,306
198,dark,sv3,3,0.9920875943901437,215,14,27,256
198,dark,sv3,4,0.989739831002627,256,11,12,279
198,dark,sv3,5,0.9898911941537023,257,10,23,290
198,dark,sv3,6,0.9830151852442618,214,11,15,240
198,dark,sv3,7,0.9907683330996577,216,9,30,255
198,dark,sv3,8,0.9919219997597151,240,13,28,281
198,dark,sv3,9,0.9926617623904773,254,10,25,289
70,bright,sv3,0,0.9914316722773266,215,178,3,396
70,bright,sv3,1,0.9929872289150692,196,161,7,364
70,bright,sv3,2,0.9936455493802485,195,184,5,384
70,bright,sv3,3,0.9929628965843743,169,172,4,345
70,bright,sv3,4,0.9936804859457122,193,162,2,357
70,bright,sv3,5,0.991182652314169,181,168,3,352
70,bright,sv3,6,0.9859834288685656,181,140,2,323
70,bright,sv3,7,0.9823219718812393,154,141,1,296
70,bright,sv3,8,0.9876829682812889,210,168,6,384
70,bright,sv3,9,0.9916391814760709,199,163,4,366
231,bright,sv3,0,0.9932421001071364,150,239,2,391
231,bright,sv3,1,0.9945618082866177,148,206,5,359
231,bright,sv3,2,0.99434260905215,171,214,4,389
231,bright,sv3,3,0.9939078432429808,189,140,5,334
231,bright,sv3,4,0.9898829876108121,221,135,4,360
231,bright,sv3,5,0.9911934799141578,211,155,2,368
231,bright,sv3,6,0.9934707557655448,174,157,2,333
231,bright,sv3,7,0.9844231094234519,172,122,2,296
231,bright,sv3,8,0.9943561115937637,167,197,4,368
231,bright,sv3,9,0.9913627271141587,161,207,2,370
395,bright,sv3,0,0.9922410649536768,105,291,1,397
395,bright,sv3,1,0.9911937356185404,97,254,2,353
395,bright,sv3,2,0.9956805711196529,78,304,4,386
395,bright,sv3,3,0.9901968640035838,55,278,2,335
395,bright,sv3,4,0.991753303056366,74,280,0,354
395,bright,sv3,5,0.9885320478030922,68,287,0,355
395,bright,sv3,6,0.9848461278005671,64,261,1,326
395,bright,sv3,7,0.9910590392053746,70,230,1,301
395,bright,sv3,8,0.9923903127603477,72,294,3,369
395,bright,sv3,9,0.9893964474917453,93,274,2,369
317,bright,sv3,0,0.9934688094395085,184,197,1,382
317,bright,sv3,1,0.9880683006345595,139,198,2,339
317,bright,sv3,2,0.9900897770476039,170,205,3,378
317,bright,sv3,3,0.9896757952698906,156,170,2,328
317,bright,sv3,4,0.989018643305399,144,199,2,345
317,bright,sv3,5,0.9843089666216229,172,184,1,357
317,bright,sv3,6,0.9906349236711638,142,178,6,326
317,bright,sv3,7,0.9901944552093255,132,146,2,280
317,bright,sv3,8,0.9878879862298963,171,196,1,368
317,bright,sv3,9,0.9937027327564126,172,194,3,369
371,bright,sv3,0,0.9893364203945912,161,228,0,389
371,bright,sv3,1,0.9926499367998873,153,187,2,342
371,bright,sv3,2,0.9969135388947986,149,231,2,382
371,bright,sv3,3,0.9937730473056073,139,190,0,329
371,bright,sv3,4,0.9861393532387943,135,204,8,347
371,bright,sv3,5,0.9892810152985124,151,209,1,361
371,bright,sv3,6,0.9905060038743377,141,182,1,324
371,bright,sv3,7,0.9841291225516211,111,173,0,284
371,bright,sv3,8,0.9921281158089116,146,210,4,360
371,bright,sv3,9,0.9824887468937139,158,204,2,364
261,bright,sv3,0,0.9918697708048051,106,285,0,391
261,bright,sv3,1,0.992364492271525,111,242,2,355
261,bright,sv3,2,0.9952722947907693,124,266,1,391
261,bright,sv3,3,0.9914015977632963,125,204,6,335
261,bright,sv3,4,0.9847183548081642,111,233,5,349
261,bright,sv3,5,0.9954238115755214,110,249,0,359
261,bright,sv3,6,0.9909656368127625,105,220,4,329
261,bright,sv3,7,0.9933969165616068,94,203,0,297
261,bright,sv3,8,0.990188055994029,100,267,1,368
261,bright,sv3,9,0.9924970452072901,106,262,3,371
287,bright,sv3,0,0.9924181375168732,120,257,4,381
287,bright,sv3,1,0.9943119289283808,128,219,3,350
287,bright,sv3,2,0.9917471785624755,127,257,1,385
287,bright,sv3,3,0.9908746205931169,117,210,2,329
287,bright,sv3,4,0.9884400680508296,143,203,4,350
287,bright,sv3,5,0.9900635989614224,151,207,3,361
287,bright,sv3,6,0.9876066074355302,131,183,2,316
287,bright,sv3,7,0.9867947294261369,116,171,2,289
287,bright,sv3,8,0.9937213933011378,121,242,2,365
287,bright,sv3,9,0.987286851288291,120,247,4,371
80871,scndcosmos,sv1,0,0.9824770354291567,193,26,50,269
80871,scndcosmos,sv1,1,0.9835476244040376,170,18,23,211
80871,scndcosmos,sv1,2,0.9874828671413897,188,17,24,229
80871,scndcosmos,sv1,3,0.9860003448753926,189,22,23,234
80871,scndcosmos,sv1,4,0.9838438338287299,185,17,35,237
80871,scndcosmos,sv1,5,0.9867678731776173,167,27,33,227
80871,scndcosmos,sv1,6,0.9831129027360951,132,17,26,175
80871,scndcosmos,sv1,7,0.9800782683163711,145,17,18,180
80871,scndcosmos,sv1,8,0.9916127292492461,179,21,33,233
80871,scndcosmos,sv1,9,0.9882903822885938,201,23,30,254
46,bright,sv3,0,0.992064684270994,237,148,2,387
46,bright,sv3,1,0.9919854416638422,178,159,3,340
46,bright,sv3,2,0.9934470790914127,221,149,8,378
46,bright,sv3,3,0.988482233658443,149,158,4,311
46,bright,sv3,4,0.987276000936517,168,167,3,338
46,bright,sv3,5,0.9792199698350805,195,156,2,353
46,bright,sv3,6,0.9872106229875899,174,133,1,308
46,bright,sv3,7,0.9860242324092692,153,124,0,277
46,bright,sv3,8,0.9838645417429476,191,164,3,358
46,bright,sv3,9,0.9969057836975656,172,175,2,349
98,bright,sv3,0,0.9898719500151046,196,179,1,376
98,bright,sv3,1,0.9949951919181906,172,152,3,327
98,bright,sv3,2,0.9911670112833807,188,159,10,357
98,bright,sv3,3,0.9965099340780974,168,146,2,316
98,bright,sv3,4,0.985247523720455,199,135,4,338
98,bright,sv3,5,0.9873256776605408,193,138,2,333
98,bright,sv3,6,0.990798343537005,169,131,6,306
98,bright,sv3,7,0.9896928384829716,128,145,3,276
98,bright,sv3,8,0.9945921226264889,203,147,2,352
98,bright,sv3,9,0.9938998856956585,189,155,3,347
81097,dark,sv2,0,0.9941018880677811,214,10,59,283
81097,dark,sv2,1,0.9853693080218618,217,10,51,278
81097,dark,sv2,2,0.9931651587928314,230,10,62,302
81097,dark,sv2,3,0.9885972176927504,229,11,53,293
81097,dark,sv2,4,0.9904167415008338,240,10,52,302
81097,dark,sv2,5,0.9837285320694958,243,11,42,296
81097,dark,sv2,6,0.9864450290551277,203,9,53,265
81097,dark,sv2,7,0.9807376033404498,202,9,60,271
81097,dark,sv2,8,0.9899048508834614,222,10,58,290
81097,dark,sv2,9,0.9934403779070136,224,11,57,292
343,bright,sv3,0,0.9949001019849253,135,240,0,375
343,bright,sv3,1,0.9880300361852241,130,212,2,344
343,bright,sv3,2,0.9885800646292102,157,212,2,371
343,bright,sv3,3,0.9943119410934341,129,186,4,319
343,bright,sv3,4,0.9969321734792889,137,215,0,352
343,bright,sv3,5,0.985220378316475,142,205,5,352
343,bright,sv3,6,0.9853649043266778,118,193,1,312
343,bright,sv3,7,0.9890495682811982,107,170,1,278
343,bright,sv3,8,0.9931927858233446,160,202,0,362
343,bright,sv3,9,0.9942898826214321,131,227,1,359
429,backup,sv3,0,0.9870286727188846,5,407,1,413
429,backup,sv3,1,0.992626932156012,5,379,2,386
429,backup,sv3,2,0.987802928652424,6,396,1,403
429,backup,sv3,3,0.9930723679655222,8,346,0,354
429,backup,sv3,4,0.9912531975221275,2,366,1,369
429,backup,sv3,5,0.9926038410297942,6,381,0,387
429,backup,sv3,6,0.9862742223075939,4,333,0,337
429,backup,sv3,7,0.9795906573537462,1,317,0,318
429,backup,sv3,8,0.9878344516604586,3,393,0,396
429,backup,sv3,9,0.9874980866569696,3,399,0,402
344,bright,sv3,0,0.9935013742679759,146,173,1,320
344,bright,sv3,1,0.9959262818625098,125,195,6,326
344,bright,sv3,2,0.9905332355988836,144,232,1,377
344,bright,sv3,3,0.9936631001437536,134,184,4,322
344,bright,sv3,4,0.991051961665737,139,195,2,336
344,bright,sv3,5,0.995614527587981,136,214,1,351
344,bright,sv3,6,0.9880283803178567,115,202,1,318
344,bright,sv3,7,0.9880099636351616,103,175,2,280
344,bright,sv3,8,0.9942451473470736,166,191,1,358
344,bright,sv3,9,0.9872097991397899,166,196,2,364
335,dark,sv3,0,0.9794986167535611,228,17,22,267
335,dark,sv3,1,0.9875451605352124,250,16,13,279
335,dark,sv3,2,0.9897022177684835,250,18,20,288
335,dark,sv3,3,0.994372640715756,231,15,17,263
335,dark,sv3,4,0.9920679327486189,240,17,17,274
335,dark,sv3,5,0.9790951007854873,231,20,22,273
335,dark,sv3,6,0.9930021035291373,223,14,3,240
335,dark,sv3,7,0.9857950943401226,192,19,14,225
335,dark,sv3,8,0.993734537964804,218,15,16,249
335,dark,sv3,9,0.9863396599132814,246,11,25,282
19,bright,sv3,0,0.9923334333252297,160,161,3,324
19,bright,sv3,1,0.9886735164759909,173,168,3,344
19,bright,sv3,2,0.9886689667095536,172,197,4,373
19,bright,sv3,3,0.9929198861155037,143,180,1,324
19,bright,sv3,4,0.9868115927844033,173,166,2,341
19,bright,sv3,5,0.9961214017588873,171,175,3,349
19,bright,sv3,6,0.9851883426580673,156,156,1,313
19,bright,sv3,7,0.9836297773259767,123,158,0,281
19,bright,sv3,8,0.9947315809460793,160,186,3,349
19,bright,sv3,9,0.9950587173632303,159,200,4,363
71,bright,sv3,0,0.9889742738227242,144,186,3,333
71,bright,sv3,1,0.9873550607012892,178,159,4,341
71,bright,sv3,2,0.9922614182299054,171,202,1,374
71,bright,sv3,3,0.9865280363778258,140,183,3,326
71,bright,sv3,4,0.9941536836744698,178,162,1,341
71,bright,sv3,5,0.987552575732492,199,161,2,362
71,bright,sv3,6,0.9824653191086732,162,155,3,320
71,bright,sv3,7,0.9856763824863606,154,127,4,285
71,bright,sv3,8,0.9934268656055446,184,171,3,358
71,bright,sv3,9,0.9921360607940958,187,177,3,367
47,bright,sv3,0,0.9912741237484317,193,132,1,326
47,bright,sv3,1,0.9892315283024,174,162,7,343
47,bright,sv3,2,0.9919801691833593,227,152,5,384
47,bright,sv3,3,0.9936588088126774,155,163,2,320
47,bright,sv3,4,0.9885190172260252,187,142,7,336
47,bright,sv3,5,0.9908200451605079,194,156,5,355
47,bright,sv3,6,0.9936569155015873,210,112,1,323
47,bright,sv3,7,0.98888079089023,142,138,2,282
47,bright,sv3,8,0.9894532334789296,205,142,6,353
47,bright,sv3,9,0.9969444092342377,186,176,2,364
318,bright,sv3,0,0.9920493877122841,156,171,2,329
318,bright,sv3,1,0.9932740820666468,137,198,1,336
318,bright,sv3,2,0.9815031068607113,177,193,4,374
318,bright,sv3,3,0.9898901635013919,164,163,2,329
318,bright,sv3,4,0.99436581840131,161,193,0,354
318,bright,sv3,5,0.9914890341461937,163,197,1,361
318,bright,sv3,6,0.9889399475648094,145,175,3,323
318,bright,sv3,7,0.9842905483563018,113,164,2,279
318,bright,sv3,8,0.9931713641736157,145,204,0,349
318,bright,sv3,9,0.991055040616877,148,221,2,371
180,bright,sv3,0,0.9871367685719449,134,160,0,294
180,bright,sv3,1,0.9903075524018013,148,166,4,318
180,bright,sv3,2,0.9916168314123172,193,173,3,369
180,bright,sv3,3,0.9807642010212275,170,134,2,306
180,bright,sv3,4,0.993466904376187,179,148,3,330
180,bright,sv3,5,0.9930834740966179,163,177,4,344
180,bright,sv3,6,0.9947896460713946,143,162,0,305
180,bright,sv3,7,0.9920071227628177,118,158,3,279
180,bright,sv3,8,0.991493453504357,164,175,3,342
180,bright,sv3,9,0.9885627503290473,156,165,3,324
89,dark,sv3,0,0.9875158263189153,261,13,31,305
89,dark,sv3,1,0.9844558256848253,265,8,33,306
89,dark,sv3,2,0.9926282307295817,290,14,26,330
89,dark,sv3,3,0.9910352105417626,240,13,19,272
89,dark,sv3,4,0.9903920811619531,269,12,18,299
89,dark,sv3,5,0.9863832838971991,255,14,15,284
89,dark,sv3,6,0.9893666676636832,229,11,23,263
89,dark,sv3,7,0.9870637844759731,205,12,26,243
89,dark,sv3,8,0.9924605267972627,249,13,22,284
89,dark,sv3,9,0.9851675902944785,256,11,20,287
211,bright,sv3,0,0.9938521344202038,169,146,3,318
211,bright,sv3,1,0.9873771076202664,196,137,5,338
211,bright,sv3,2,0.993598302175049,216,152,2,370
211,bright,sv3,3,0.9917068565884947,175,132,4,311
211,bright,sv3,4,0.9894696456817721,185,146,5,336
211,bright,sv3,5,0.9912378128873839,198,137,4,339
211,bright,sv3,6,0.9953575290324645,167,138,2,307
211,bright,sv3,7,0.9890253383785061,151,124,2,277
211,bright,sv3,8,0.9881460321119291,186,152,1,339
211,bright,sv3,9,0.9835006572609823,203,151,2,356
53,backup,sv3,0,0.9835215019336307,7,241,0,248
53,backup,sv3,1,0.9902477584603173,0,269,1,270
53,backup,sv3,2,0.9841681207380482,5,288,1,294
53,backup,sv3,3,0.986537136421577,4,249,1,254
53,backup,sv3,4,0.9924963510077425,3,262,2,267
53,backup,sv3,5,0.988329916975659,5,287,2,294
53,backup,sv3,6,0.9923172489212705,6,232,3,241
53,backup,sv3,7,0.9894524461353089,7,222,2,231
53,backup,sv3,8,0.9849813071588287,6,277,1,284
53,backup,sv3,9,0.9886501194957776,4,289,2,295
511,dark,sv3,0,0.9824247058204226,246,17,79,342
511,dark,sv3,1,0.9946885673057401,207,15,80,302
511,dark,sv3,2,0.988009218873551,227,16,90,333
511,dark,sv3,3,0.9842410162386063,203,17,81,301
511,dark,sv3,4,0.9877046542516459,236,12,77,325
511,dark,sv3,5,0.9914539271782512,224,13,79,316
511,dark,sv3,6,0.9859850746296399,196,18,77,291
511,dark,sv3,7,0.9661778510211666,189,20,52,261
511,dark,sv3,8,0.990268201469147,237,17,63,317
511,dark,sv3,9,0.9903663233841609,236,15,75,326
151,bright,sv3,0,0.9899395835414685,170,207,6,383
151,bright,sv3,1,0.9888918713896633,179,157,7,343
151,bright,sv3,2,0.9860571762669041,154,225,2,381
151,bright,sv3,3,0.9887427067067717,151,174,3,328
151,bright,sv3,4,0.9935310891652027,137,209,1,347
151,bright,sv3,5,0.9856953063476172,172,185,1,358
151,bright,sv3,6,0.995241099993532,142,179,2,323
151,bright,sv3,7,0.9858838330873833,138,139,1,278
151,bright,sv3,8,0.9909853590806051,164,190,2,356
151,bright,sv3,9,0.9891592758489945,186,177,2,365
20,bright,sv3,0,0.9957025644788943,192,180,5,377
20,bright,sv3,1,0.9918888950222728,158,173,2,333
20,bright,sv3,2,0.993573821743564,179,189,3,371
20,bright,sv3,3,0.9923424591276243,152,172,3,327
20,bright,sv3,4,0.9861905030990884,164,180,3,347
20,bright,sv3,5,0.9911811451600464,188,165,3,356
20,bright,sv3,6,0.9957660941005523,134,182,2,318
20,bright,sv3,7,0.984224840074995,143,125,1,269
20,bright,sv3,8,0.989596182314669,157,185,3,345
20,bright,sv3,9,0.9883033828626919,146,209,3,358
48,bright,sv3,0,0.9907571313723197,219,158,5,382
48,bright,sv3,1,0.9941500954837792,180,147,5,332
48,bright,sv3,2,0.992855989589948,235,142,5,382
48,bright,sv3,3,0.9887763709771268,184,131,2,317
48,bright,sv3,4,0.9875330507200497,167,165,2,334
48,bright,sv3,5,0.9894406201336835,188,164,4,356
48,bright,sv3,6,0.9904577433720689,194,116,3,313
48,bright,sv3,7,0.9856223740604348,162,125,3,290
48,bright,sv3,8,0.9902191424421855,214,141,6,361
48,bright,sv3,9,0.9929267958706209,187,168,2,357
280,dark,sv3,1,0.9850994766606201,212,17,13,242
280,dark,sv3,2,0.9899889367427069,241,11,24,276
280,dark,sv3,3,0.9845115219181604,214,10,22,246
280,dark,sv3,4,0.9829588350710022,236,17,14,267
280,dark,sv3,5,0.9900296804867705,222,13,19,254
280,dark,sv3,6,0.9869117020184437,177,17,15,209
280,dark,sv3,7,0.9695033432621766,176,19,15,210
280,dark,sv3,8,0.9904127843811682,229,14,9,252
280,dark,sv3,9,0.9879536767936893,215,13,4,232
481,dark,sv3,0,0.992855300389751,262,14,99,375
481,dark,sv3,1,0.990174471728895,232,17,84,333
481,dark,sv3,2,0.9950362053447032,258,14,92,364
481,dark,sv3,3,0.9924193368488604,224,11,83,318
481,dark,sv3,4,0.9916299119369427,244,11,86,341
481,dark,sv3,5,0.9908332136830508,250,11,86,347
481,dark,sv3,6,0.9902365164032536,220,11,84,315
481,dark,sv3,7,0.9882565840174456,195,13,73,281
481,dark,sv3,8,0.9850567037504367,248,15,90,353
481,dark,sv3,9,0.9882131736486802,245,15,91,351
144,dark,sv3,0,0.9870646005422283,226,17,16,259
144,dark,sv3,1,0.9859288675971052,220,13,18,251
144,dark,sv3,2,0.9907705020482925,228,20,14,262
144,dark,sv3,3,0.975615267248354,210,12,20,242
144,dark,sv3,4,0.9862952063040727,226,10,21,257
144,dark,sv3,5,0.9854432879655591,244,13,14,271
144,dark,sv3,6,0.9878501761848795,196,16,10,222
144,dark,sv3,7,0.9882898692494124,206,11,22,239
144,dark,sv3,8,0.9864348711961636,232,18,23,273
144,dark,sv3,9,0.9915857969306913,230,17,21,268
9,dark,sv3,0,0.990090206182471,292,14,15,321
9,dark,sv3,1,0.9817526618773471,250,14,13,277
9,dark,sv3,2,0.9938470074282484,268,17,16,301
9,dark,sv3,3,0.987979390009286,225,13,14,252
9,dark,sv3,4,0.9906370096056846,272,16,17,305
9,dark,sv3,5,0.9934321283658495,235,17,29,281
9,dark,sv3,6,0.9893670235171581,214,10,33,257
9,dark,sv3,7,0.9894024814030965,214,10,25,249
9,dark,sv3,8,0.9897460660135572,249,11,17,277
9,dark,sv3,9,0.990258550375261,285,15,15,315
585,bright,sv3,0,0.9881066209383758,332,70,2,404
585,bright,sv3,1,0.9923490433196609,314,37,6,357
585,bright,sv3,2,0.9926151366450698,343,38,4,385
585,bright,sv3,3,0.9886721692086607,296,41,4,341
585,bright,sv3,4,0.9917215058875668,301,53,4,358
585,bright,sv3,5,0.9921141198740292,314,54,4,372
585,bright,sv3,6,0.9923902156520411,241,87,3,331
585,bright,sv3,7,0.9939581043136673,251,39,1,291
585,bright,sv3,8,0.9886513704003018,305,65,3,373
585,bright,sv3,9,0.9923629494918201,321,51,3,375
525,bright,sv3,0,0.9918653285322184,348,52,1,401
525,bright,sv3,1,0.9920564039445521,294,44,5,343
525,bright,sv3,2,0.9855770651424091,349,43,6,398
525,bright,sv3,3,0.9918884629279675,298,34,6,338
525,bright,sv3,4,0.9879791130264998,307,49,4,360
525,bright,sv3,5,0.9882860144597654,348,17,3,368
525,bright,sv3,6,0.9908810215235263,309,23,3,335
525,bright,sv3,7,0.9854668061294201,275,16,1,292
525,bright,sv3,8,0.9920084900113143,347,23,2,372
525,bright,sv3,9,0.9936658373530153,346,30,2,378
90,dark,sv3,0,0.9885565028719089,258,12,17,287
90,dark,sv3,1,0.9963679149012032,239,14,24,277
90,dark,sv3,2,0.9916001456751753,293,10,14,317
90,dark,sv3,3,0.99181482028898,247,15,20,282
90,dark,sv3,4,0.9877889112991118,249,12,23,284
90,dark,sv3,5,0.9848615912971238,253,12,17,282
90,dark,sv3,6,0.9927724646773567,226,14,20,260
90,dark,sv3,7,0.9818002623432852,194,11,29,234
90,dark,sv3,8,0.9839131955404047,255,8,29,292
90,dark,sv3,9,0.9892680483006591,252,12,18,282
288,bright,sv3,0,0.9946026926112537,118,272,4,394
288,bright,sv3,1,0.9922216682884448,122,229,0,351
288,bright,sv3,2,0.9896050759131685,133,251,4,388
288,bright,sv3,3,0.9904933563857661,119,210,2,331
288,bright,sv3,4,0.9852953337188113,147,198,4,349
288,bright,sv3,5,0.990159213136906,143,218,3,364
288,bright,sv3,6,0.9943425792507505,142,172,1,315
288,bright,sv3,7,0.9832193839403194,114,174,2,290
288,bright,sv3,8,0.9944512424652348,101,258,1,360
288,bright,sv3,9,0.9907946752557804,109,256,3,368
99,bright,sv3,0,0.9925292002088288,214,156,4,374
99,bright,sv3,1,0.9927692776783422,180,141,3,324
99,bright,sv3,2,0.9912830559414196,201,154,7,362
99,bright,sv3,3,0.9956129997195521,181,143,4,328
99,bright,sv3,4,0.9931620162833689,200,134,4,338
99,bright,sv3,5,0.9924500506648893,205,147,2,354
99,bright,sv3,6,0.9946095251620221,172,131,2,305
99,bright,sv3,7,0.9903928216849569,153,120,4,277
99,bright,sv3,8,0.9925319767769023,190,151,4,345
99,bright,sv3,9,0.9953704642725503,183,160,0,343
281,dark,sv3,0,0.9913368137463963,244,18,19,281
281,dark,sv3,1,0.9872649086263016,216,16,15,247
281,dark,sv3,2,0.9877890134507931,226,19,12,257
281,dark,sv3,3,0.9918149065240657,185,15,11,211
281,dark,sv3,4,0.9790371951181714,210,16,17,243
281,dark,sv3,5,0.9711164546775602,97,10,6,113
281,dark,sv3,6,0.9944125611076094,184,14,12,210
281,dark,sv3,7,0.987466578547592,160,17,19,196
281,dark,sv3,8,0.9805317159777799,209,15,6,230
281,dark,sv3,9,0.9900271199763153,210,12,15,237
225,dark,sv3,0,0.9891887302161282,214,14,12,240
225,dark,sv3,1,0.9892425667109532,200,15,16,231
225,dark,sv3,2,0.9896733620543112,250,11,16,277
225,dark,sv3,3,0.9820299042799426,214,12,19,245
225,dark,sv3,4,0.9860525492369434,216,13,20,249
225,dark,sv3,5,0.9819464242432226,117,5,6,128
225,dark,sv3,6,0.9796969440036082,196,10,17,223
225,dark,sv3,7,0.9887499453034986,195,12,19,226
225,dark,sv3,8,0.986772860608667,223,12,27,262
225,dark,sv3,9,0.9840842267256766,209,17,21,247
586,bright,sv3,0,0.9888082498895799,277,123,4,404
586,bright,sv3,1,0.9952643543108475,254,103,1,358
586,bright,sv3,2,0.9931709309719062,275,116,7,398
586,bright,sv3,3,0.9929945549547348,275,62,2,339
586,bright,sv3,4,0.9936728055873403,235,123,1,359
586,bright,sv3,5,0.983532009081405,134,45,2,181
586,bright,sv3,6,0.9904365717071362,190,139,5,334
586,bright,sv3,7,0.9921701280189158,199,97,3,299
586,bright,sv3,8,0.9926462125008113,249,118,8,375
586,bright,sv3,9,0.9871029852245008,273,106,3,382
10,dark,sv3,0,0.9906565796696543,286,15,21,322
10,dark,sv3,1,0.9886274253732036,231,18,28,277
10,dark,sv3,2,0.9883169931086501,264,15,27,306
10,dark,sv3,3,0.9894458718333728,251,15,19,285
10,dark,sv3,4,0.9841812377222096,233,11,20,264
10,dark,sv3,5,0.9824965396471043,137,4,6,147
10,dark,sv3,6,0.9833892619557668,234,10,13,257
10,dark,sv3,7,0.9832132535555899,213,12,11,236
10,dark,sv3,8,0.986178374445914,228,11,19,258
10,dark,sv3,9,0.9858285061566269,257,12,15,284
512,dark,sv3,0,0.9922906905204738,267,14,57,338
512,dark,sv3,1,0.9876519251519569,218,12,79,309
512,dark,sv3,2,0.9943971816851221,253,15,69,337
512,dark,sv3,3,0.988181612892626,216,17,65,298
512,dark,sv3,4,0.9895166606980184,232,13,60,305
512,dark,sv3,5,0.9765365685767974,111,5,33,149
512,dark,sv3,6,0.988970236173682,216,11,61,288
512,dark,sv3,7,0.9814135912415508,198,16,49,263
512,dark,sv3,8,0.9888280158354456,248,15,58,321
512,dark,sv3,9,0.9887368100986658,244,13,59,316
482,dark,sv3,0,0.9910664874272295,266,13,84,363
482,dark,sv3,1,0.9964284406362526,247,15,76,338
482,dark,sv3,2,0.9855571023407401,265,11,79,355
482,dark,sv3,3,0.9895988544195535,243,10,63,316
482,dark,sv3,4,0.992378258154359,261,12,63,336
482,dark,sv3,5,0.9809588664907545,130,8,22,160
482,dark,sv3,6,0.994853946479107,215,14,71,300
482,dark,sv3,7,0.991143367605917,203,12,57,272
482,dark,sv3,8,0.9926526667415324,263,11,62,336
482,dark,sv3,9,0.9817504946756815,261,13,76,350
526,bright,sv3,0,0.9946431837468476,276,117,5,398
526,bright,sv3,1,0.9939143192596548,266,85,3,354
526,bright,sv3,2,0.9872383067234833,281,106,5,392
526,bright,sv3,3,0.9916079052561423,236,106,2,344
526,bright,sv3,4,0.9903289356400057,262,90,5,357
526,bright,sv3,5,0.9833381393849753,124,47,0,171
526,bright,sv3,6,0.9888877427955762,263,69,5,337
526,bright,sv3,7,0.9927461571545927,268,23,1,292
526,bright,sv3,8,0.995090496899237,297,69,7,373
526,bright,sv3,9,0.995090496899237,297,69,7,373
555,bright,sv3,0,0.9938988774219606,361,32,6,399
555,bright,sv3,1,0.9879891582221376,310,38,3,351
555,bright,sv3,2,0.9859408839850515,315,61,5,381
555,bright,sv3,3,0.990942183387994,289,43,2,334
555,bright,sv3,4,0.995565088579231,283,67,4,354
555,bright,sv3,5,0.9751789460316694,153,25,1,179
555,bright,sv3,6,0.9869711920849747,292,35,1,328
555,bright,sv3,7,0.9866679630056285,256,36,1,293
555,bright,sv3,8,0.9939032807118668,316,46,7,369
555,bright,sv3,9,0.9853302973687807,362,13,4,379
319,bright,sv3,0,0.9903883287898267,195,200,2,397
319,bright,sv3,1,0.9929410363821521,155,179,4,338
319,bright,sv3,2,0.9894552533337153,177,203,2,382
319,bright,sv3,3,0.9961926268519846,153,176,1,330
319,bright,sv3,4,0.9919684128015115,169,175,4,348
319,bright,sv3,5,0.9954252289526379,165,189,2,356
319,bright,sv3,6,0.993833838893442,145,176,2,323
319,bright,sv3,7,0.9868043226622845,126,160,2,288
319,bright,sv3,8,0.9942553729392323,183,185,3,371
319,bright,sv3,9,0.9869952053981967,183,182,5,370
571,dark,sv3,0,0.9882562154404283,286,15,80,381
571,dark,sv3,1,0.9896345030811857,217,19,93,329
571,dark,sv3,2,0.9905505672034504,256,13,108,377
571,dark,sv3,3,0.9849248692506178,225,13,75,313
571,dark,sv3,4,0.9880506425444094,251,14,68,333
571,dark,sv3,5,0.9912973531048599,124,7,37,168
571,dark,sv3,6,0.9890100130816876,218,16,70,304
571,dark,sv3,7,0.992716731152856,201,11,69,281
571,dark,sv3,8,0.989532962360201,240,17,90,347
571,dark,sv3,9,0.9871916218164408,252,14,87,353
118,dark,sv3,0,0.9932750675807455,239,15,23,277
118,dark,sv3,1,0.9953533731007461,229,11,21,261
118,dark,sv3,2,0.9938040366430283,248,10,21,279
118,dark,sv3,3,0.9919885727861938,214,15,23,252
118,dark,sv3,4,0.9866041825406445,228,13,24,265
118,dark,sv3,5,0.9852389279530294,115,4,8,127
118,dark,sv3,6,0.9775428386582337,200,15,19,234
118,dark,sv3,7,0.9854072607524796,177,12,23,212
118,dark,sv3,8,0.9884518278353059,201,14,25,240
118,dark,sv3,9,0.9820774548242227,234,15,23,272
152,bright,sv3,0,0.9943208758397829,161,223,1,385
152,bright,sv3,1,0.9958160674519033,144,193,2,339
152,bright,sv3,2,0.995532546504088,150,228,2,380
152,bright,sv3,3,0.9813534477260335,127,188,2,317
152,bright,sv3,4,0.9923326886883257,148,193,3,344
152,bright,sv3,5,0.9856958910750815,78,85,1,164
152,bright,sv3,6,0.9915547138676648,137,183,4,324
152,bright,sv3,7,0.9925143249504674,147,136,2,285
152,bright,sv3,8,0.9932126369316348,165,195,0,360
152,bright,sv3,9,0.9946753478285324,163,202,3,368
262,bright,sv3,0,0.9964509061737866,124,270,0,394
262,bright,sv3,1,0.983606605468684,117,239,2,358
262,bright,sv3,2,0.9814579484856537,130,256,5,391
262,bright,sv3,3,0.9949486658612104,132,207,3,342
262,bright,sv3,4,0.9855763039917619,117,235,4,356
262,bright,sv3,5,0.990785706445805,111,250,5,366
262,bright,sv3,6,0.990543475028206,114,217,1,332
262,bright,sv3,7,0.9878810223933197,86,202,2,290
262,bright,sv3,8,0.9930365079307152,96,270,2,368
262,bright,sv3,9,0.9843251573671323,99,272,7,378
232,bright,sv3,0,0.993849050163758,144,248,1,393
232,bright,sv3,1,0.9901669657995396,121,219,1,341
232,bright,sv3,2,0.9946753070366371,127,265,0,392
232,bright,sv3,3,0.9911976226041028,157,176,5,338
232,bright,sv3,4,0.9834459330293281,169,186,2,357
232,bright,sv3,5,0.9764598233918694,93,90,0,183
232,bright,sv3,6,0.9913886224941552,128,195,1,324
232,bright,sv3,7,0.9850885126162252,136,160,1,297
232,bright,sv3,8,0.9887813990296536,118,248,5,371
232,bright,sv3,9,0.9919227518093033,146,226,2,374
396,bright,sv3,0,0.9950170928960512,74,325,2,401
396,bright,sv3,1,0.9940840443481649,62,289,1,352
396,bright,sv3,2,0.9917906824200965,65,322,0,387
396,bright,sv3,3,0.98531549871402,58,274,2,334
396,bright,sv3,4,0.9912713752956146,69,274,1,344
396,bright,sv3,5,0.972958935382858,44,126,0,170
396,bright,sv3,6,0.9924895911331822,69,263,2,334
396,bright,sv3,7,0.9832436684792973,60,225,3,288
396,bright,sv3,8,0.9875925429751116,62,304,1,367
396,bright,sv3,9,0.990757911373592,63,307,0,370
308,dark,sv3,0,0.9928263215775351,259,14,18,291
308,dark,sv3,1,0.9889027081291104,246,13,23,282
308,dark,sv3,2,0.9946048314444516,256,13,14,283
308,dark,sv3,3,0.993073903123711,225,18,19,262
308,dark,sv3,4,0.9867170751990229,224,15,14,253
308,dark,sv3,5,0.9904030220185718,207,15,12,234
308,dark,sv3,6,0.9826236567832777,223,15,13,251
308,dark,sv3,7,0.9878124922220893,202,12,15,229
308,dark,sv3,8,0.9882945012044955,244,12,17,273
308,dark,sv3,9,0.9928325145447982,254,12,19,285
145,dark,sv3,0,0.9860073742694634,227,14,20,261
145,dark,sv3,1,0.9831383830397697,211,13,8,232
145,dark,sv3,2,0.9836802679294534,229,12,29,270
145,dark,sv3,3,0.9883430035174877,204,15,28,247
145,dark,sv3,4,0.9859550317749574,219,15,15,249
145,dark,sv3,5,0.9798037626170394,104,9,5,118
145,dark,sv3,6,0.9867009472751352,185,20,4,209
145,dark,sv3,7,0.9822838366309405,197,13,12,222
145,dark,sv3,8,0.9941375390181227,220,17,17,254
145,dark,sv3,9,0.98790780251304,228,14,17,259
21,bright,sv3,0,0.98929100040143,185,181,4,370
21,bright,sv3,1,0.9819593897326356,155,181,2,338
21,bright,sv3,2,0.9903384147364287,196,175,1,372
21,bright,sv3,3,0.9943300074808107,166,149,1,316
21,bright,sv3,4,0.9935217156493116,181,159,4,344
21,bright,sv3,5,0.9826763552381639,85,71,4,160
21,bright,sv3,6,0.9883940183807669,142,157,3,302
21,bright,sv3,7,0.9900453073384914,132,144,1,277
21,bright,sv3,8,0.9936109739344572,151,184,2,337
21,bright,sv3,9,0.9924878191679849,182,164,2,348
541,dark,sv3,0,0.9878560000816439,279,15,89,383
541,dark,sv3,1,0.9865152053972411,240,15,83,338
541,dark,sv3,2,0.997116822102409,238,16,87,341
541,dark,sv3,3,0.9944682473545507,216,13,84,313
541,dark,sv3,4,0.9947100642448514,232,13,79,324
541,dark,sv3,5,0.9734441485892227,107,6,46,159
541,dark,sv3,6,0.9921716443502485,212,22,69,303
541,dark,sv3,7,0.9814554867888012,172,25,71,268
541,dark,sv3,8,0.9919636289899428,242,29,72,343
541,dark,sv3,9,0.9893539192350908,253,13,77,343
34,dark,sv3,0,0.9959692406924624,287,10,19,316
34,dark,sv3,1,0.9923233819965952,261,10,28,299
34,dark,sv3,2,0.9926454829229079,277,11,21,309
34,dark,sv3,3,0.9903729937577617,195,8,17,220
34,dark,sv3,4,0.9840680837938818,259,12,30,301
34,dark,sv3,5,0.9951871235611676,260,8,26,294
34,dark,sv3,6,0.9717530028384099,229,12,26,267
34,dark,sv3,7,0.9913527943377869,228,9,20,257
34,dark,sv3,8,0.9853051675660935,250,16,19,285
34,dark,sv3,9,0.9804091329567376,261,13,19,293
153,bright,sv3,0,0.9940273166117293,190,200,4,394
153,bright,sv3,1,0.9915037130882156,124,216,3,343
153,bright,sv3,2,0.9926985153288257,162,206,2,370
153,bright,sv3,3,0.9926579787371792,133,140,1,274
153,bright,sv3,4,0.9897858456837152,159,182,3,344
153,bright,sv3,5,0.9913100812316717,160,193,1,354
153,bright,sv3,6,0.987847000608639,134,177,1,312
153,bright,sv3,7,0.9805998294522676,127,146,3,276
153,bright,sv3,8,0.9927217167240746,148,229,2,379
153,bright,sv3,9,0.9922897313507474,153,204,1,358
233,bright,sv3,0,0.9945502024822993,110,284,1,395
233,bright,sv3,1,0.9914546473944279,103,244,1,348
233,bright,sv3,2,0.9923227460944328,139,250,1,390
233,bright,sv3,3,0.9864069346232521,100,173,2,275
233,bright,sv3,4,0.9947539912881367,164,190,3,357
233,bright,sv3,5,0.9890358320016502,155,201,6,362
233,bright,sv3,6,0.9801517028057095,123,194,1,318
233,bright,sv3,7,0.9926451988656665,127,155,2,284
233,bright,sv3,8,0.98839228049319,138,242,2,382
233,bright,sv3,9,0.9944188337103422,128,229,5,362
483,dark,sv3,0,0.982595162693147,267,11,70,348
483,dark,sv3,1,0.9935311562648861,252,12,61,325
483,dark,sv3,2,0.9923040951888709,280,11,64,355
483,dark,sv3,3,0.9882590223781493,212,8,49,269
483,dark,sv3,4,0.9936945906498171,248,10,61,319
483,dark,sv3,5,0.9927698378520742,247,10,72,329
483,dark,sv3,6,0.9843201173750129,233,12,65,310
483,dark,sv3,7,0.9906060045792375,192,9,52,253
483,dark,sv3,8,0.9956605077549107,264,11,72,347
483,dark,sv3,9,0.9851737069320908,258,12,69,339
72,bright,sv3,0,0.9971687879696253,187,201,1,389
72,bright,sv3,1,0.9923735242550104,170,166,5,341
72,bright,sv3,2,0.9863669509679226,166,207,1,374
72,bright,sv3,3,0.9799562248196158,127,137,3,267
72,bright,sv3,4,0.9874120735030951,187,146,4,337
72,bright,sv3,5,0.9939067737302131,162,177,2,341
72,bright,sv3,6,0.9877055201349297,163,157,3,323
72,bright,sv3,7,0.9791417548398352,143,142,2,287
72,bright,sv3,8,0.9928996104731351,186,185,2,373
72,bright,sv3,9,0.9928286123009952,173,181,5,359
119,dark,sv3,0,0.9900212143498601,248,14,26,288
119,dark,sv3,1,0.988610466267056,232,12,15,259
119,dark,sv3,2,0.9848738341312419,258,14,16,288
119,dark,sv3,3,0.9836967961469256,177,11,10,198
119,dark,sv3,4,0.9911278820184092,233,10,17,260
119,dark,sv3,5,0.9916656179462635,239,11,14,264
119,dark,sv3,6,0.9831328690841439,205,11,19,235
119,dark,sv3,7,0.976011778442693,171,14,24,209
119,dark,sv3,8,0.9843570263345467,239,12,32,283
119,dark,sv3,9,0.9875606298048542,250,15,23,288
146,dark,sv3,0,0.9852624369922798,223,15,16,254
146,dark,sv3,1,0.9902238900554511,202,14,16,232
146,dark,sv3,2,0.9751454562776131,217,19,21,257
146,dark,sv3,3,0.9719406843747701,172,14,7,193
146,dark,sv3,4,0.9777978163403506,202,14,13,229
146,dark,sv3,5,0.9887846303253811,215,16,14,245
146,dark,sv3,6,0.9711676814473127,193,15,10,218
146,dark,sv3,7,0.9921943882861594,180,12,20,212
146,dark,sv3,8,0.9827120649929334,213,13,18,244
146,dark,sv3,9,0.9907871035384008,205,14,25,244
572,dark,sv3,0,0.9936663301885011,279,16,71,366
572,dark,sv3,1,0.9813613383946372,234,12,75,321
572,dark,sv3,2,0.9930090309120116,258,12,85,355
572,dark,sv3,3,0.9912207363582466,192,7,57,256
572,dark,sv3,4,0.9871977143703119,265,12,59,336
572,dark,sv3,5,0.9935414221578249,238,12,88,338
572,dark,sv3,6,0.9914982996365845,224,16,64,304
572,dark,sv3,7,0.9916939739313397,200,11,57,268
572,dark,sv3,8,0.9910122712579531,256,15,81,352
572,dark,sv3,9,0.9956483417667168,272,12,68,352
62,dark,sv3,0,0.9870151825360842,280,14,21,315
62,dark,sv3,1,0.9818111401322833,225,11,34,270
62,dark,sv3,2,0.9910617692033751,258,15,29,302
62,dark,sv3,3,0.9846388612466656,180,9,28,217
62,dark,sv3,4,0.99272037219391,246,16,17,279
62,dark,sv3,5,0.9783018871526116,243,10,12,265
62,dark,sv3,6,0.985790172090722,205,13,20,238
62,dark,sv3,7,0.9815505150855126,200,10,23,233
62,dark,sv3,8,0.9874502626897206,262,13,23,298
62,dark,sv3,9,0.9835200406219399,253,12,23,288
263,bright,sv3,0,0.99113820806752,138,253,1,392
263,bright,sv3,1,0.993292435039598,113,226,4,343
263,bright,sv3,2,0.9935487035017369,123,254,3,380
263,bright,sv3,3,0.9894579560726393,112,168,1,281
263,bright,sv3,4,0.9846085669162302,129,218,2,349
263,bright,sv3,5,0.9952617586548886,122,236,2,360
263,bright,sv3,6,0.9941745635572803,126,198,3,327
263,bright,sv3,7,0.9934607359335015,110,176,0,286
263,bright,sv3,8,0.9945666005238935,142,231,6,379
263,bright,sv3,9,0.9830283963817898,121,244,0,365
542,dark,sv3,0,0.9935829390281051,262,17,75,354
542,dark,sv3,1,0.9897509578073284,253,11,58,322
542,dark,sv3,2,0.9956122914260914,267,15,58,340
542,dark,sv3,3,0.9931632399473148,192,10,59,261
542,dark,sv3,4,0.9927820937123037,245,12,69,326
542,dark,sv3,5,0.9932929195583597,226,18,78,322
542,dark,sv3,6,0.9877512167379336,211,17,72,300
542,dark,sv3,7,0.9927279246659378,190,23,55,268
542,dark,sv3,8,0.98886367306912,266,14,67,347
542,dark,sv3,9,0.9887045275918237,253,13,74,340
495,bright,sv3,0,0.9957403402017465,368,35,1,404
495,bright,sv3,1,0.9896041967289394,301,49,2,352
495,bright,sv3,2,0.9960329546132504,347,43,5,395
495,bright,sv3,3,0.9824957384636487,258,28,3,289
495,bright,sv3,4,0.9917493357976364,337,16,4,357
495,bright,sv3,5,0.9927990632972318,322,45,4,371
495,bright,sv3,6,0.987435304986168,299,25,4,328
495,bright,sv3,7,0.9882177100427422,274,15,3,292
495,bright,sv3,8,0.9919263200236946,335,40,10,385
495,bright,sv3,9,0.9981842618302912,351,22,4,377
253,dark,sv3,0,0.9805009137274502,215,15,16,246
253,dark,sv3,1,0.9890054019617703,222,12,18,252
253,dark,sv3,2,0.9926884472243361,217,21,16,254
253,dark,sv3,3,0.9896640817331496,191,14,12,217
253,dark,sv3,4,0.9910239535974259,204,14,25,243
253,dark,sv3,5,0.9839730325997085,210,12,13,235
253,dark,sv3,6,0.9948376879456369,193,15,5,213
253,dark,sv3,7,0.9855518058210178,184,9,16,209
253,dark,sv3,8,0.9899271091004498,230,13,8,251
253,dark,sv3,9,0.990899623226198,212,20,10,242
91,dark,sv3,0,0.9876321045982654,256,12,33,301
91,dark,sv3,1,0.9879513233499271,242,13,27,282
91,dark,sv3,2,0.9917312998710903,281,13,20,314
91,dark,sv3,3,0.9832478265307151,206,9,16,231
91,dark,sv3,4,0.9887954139211417,245,13,23,281
91,dark,sv3,5,0.9862824751177957,246,12,23,281
91,dark,sv3,6,0.9903044340722748,219,10,17,246
91,dark,sv3,7,0.983883023843019,201,11,18,230
91,dark,sv3,8,0.99263052867481,268,13,20,301
91,dark,sv3,9,0.9909433508970952,263,16,15,294
397,bright,sv3,0,0.9889479944641443,95,303,1,399
397,bright,sv3,1,0.9932551235202159,82,267,2,351
397,bright,sv3,2,0.993801988926445,98,279,3,380
397,bright,sv3,3,0.9872323538268232,78,195,2,275
397,bright,sv3,4,0.9890432935907039,82,261,2,345
397,bright,sv3,5,0.9892794164240378,63,293,2,358
397,bright,sv3,6,0.9900089522487105,74,252,1,327
397,bright,sv3,7,0.9931980845207251,46,238,0,284
397,bright,sv3,8,0.9905664814607373,57,325,4,386
397,bright,sv3,9,0.9963846289331559,76,286,2,364
587,bright,sv3,0,0.9908144350372071,195,198,0,393
587,bright,sv3,1,0.9948212156189127,219,134,3,356
587,bright,sv3,2,0.9934982498483275,215,161,3,379
587,bright,sv3,3,0.9894978253507088,155,119,6,280
587,bright,sv3,4,0.9906289380208146,177,171,2,350
587,bright,sv3,5,0.9873971362432162,199,155,4,358
587,bright,sv3,6,0.9930569133540903,137,181,3,321
587,bright,sv3,7,0.9946316484989217,146,139,1,286
587,bright,sv3,8,0.9919053868066999,220,155,2,377
587,bright,sv3,9,0.9906219353773317,216,157,3,376
425,bright,sv3,0,0.9915090459658443,105,291,0,396
425,bright,sv3,1,0.9895339137053697,91,260,2,353
425,bright,sv3,2,0.9905725305020076,107,275,2,384
425,bright,sv3,3,0.9965172605791384,98,227,2,327
425,bright,sv3,4,0.9951953197243343,81,270,1,352
425,bright,sv3,5,0.9948992765458085,75,285,2,362
425,bright,sv3,6,0.9931031680121953,80,242,0,322
425,bright,sv3,7,0.9837932505240546,53,238,2,293
425,bright,sv3,8,0.9904671183720317,100,277,1,378
425,bright,sv3,9,0.9923282935785304,84,288,3,375
125,bright,sv3,0,0.9927757133518776,222,129,3,354
125,bright,sv3,1,0.9951657939652198,206,113,2,321
125,bright,sv3,2,0.9913071163546661,194,152,1,347
125,bright,sv3,3,0.9897752351355964,163,96,3,262
125,bright,sv3,4,0.9891438355846907,215,113,9,337
125,bright,sv3,5,0.9869370730548057,196,134,3,333
125,bright,sv3,6,0.9888959712612151,189,121,2,312
125,bright,sv3,7,0.9828541283990466,155,91,1,247
125,bright,sv3,8,0.9862403588848723,182,144,4,330
125,bright,sv3,9,0.989878023706899,223,116,2,341
475,dark,sv3,0,0.9938665555698505,243,11,16,270
475,dark,sv3,1,0.9867521600921506,229,14,15,258
475,dark,sv3,2,0.9783352860427732,259,12,18,289
475,dark,sv3,3,0.9842361333441197,220,13,24,257
475,dark,sv3,4,0.9881546743905975,225,15,32,272
475,dark,sv3,5,0.9891656045146597,216,17,41,274
475,dark,sv3,6,0.9910167504843984,219,12,35,266
475,dark,sv3,7,0.9750469913637247,189,12,25,226
475,dark,sv3,8,0.9920107411407946,214,14,16,244
475,dark,sv3,9,0.9933972447081486,246,16,19,281
588,bright,sv3,0,0.9909839227954106,174,209,5,388
588,bright,sv3,1,0.9943124844385647,158,185,1,344
588,bright,sv3,2,0.9932237211152103,194,184,7,385
588,bright,sv3,3,0.9908282585107113,177,152,2,331
588,bright,sv3,4,0.9911121945278492,149,185,1,335
588,bright,sv3,5,0.9970076703791544,167,180,5,352
588,bright,sv3,6,0.9924534377591172,112,198,3,313
588,bright,sv3,7,0.9922457783951674,116,168,0,284
588,bright,sv3,8,0.9932851262410055,133,178,2,313
588,bright,sv3,9,0.9915954414963921,155,209,4,368
573,dark,sv3,0,0.990719305979932,306,10,50,366
573,dark,sv3,1,0.9923702367818784,240,15,69,324
573,dark,sv3,2,0.9941463277114858,268,16,77,361
573,dark,sv3,3,0.9837260525809238,247,10,52,309
573,dark,sv3,4,0.9878748821896641,265,11,51,327
573,dark,sv3,5,0.9929910547887895,248,8,71,327
573,dark,sv3,6,0.9846953141778825,228,14,54,296
573,dark,sv3,7,0.9924954963545538,197,13,55,265
573,dark,sv3,8,0.9941199712677234,222,11,53,286
573,dark,sv3,9,0.9860903857399271,277,10,50,337
513,dark,sv3,0,0.983512381258468,270,11,44,325
513,dark,sv3,1,0.9936051632401164,234,9,60,303
513,dark,sv3,2,0.9855949963015848,242,15,63,320
513,dark,sv3,3,0.9876588707605517,213,12,53,278
513,dark,sv3,4,0.9930461563555988,233,11,54,298
513,dark,sv3,5,0.9916647164887067,245,12,59,316
513,dark,sv3,6,0.9891373703829973,220,10,48,278
513,dark,sv3,7,0.9879946258898963,196,11,40,247
513,dark,sv3,8,0.9918448222628535,247,19,59,325
513,dark,sv3,9,0.9962999381192638,265,11,56,332
454,dark,sv3,0,0.9873355819795883,254,15,13,282
454,dark,sv3,1,0.9938462141186741,217,14,18,249
454,dark,sv3,2,0.9922334623986607,253,11,10,274
454,dark,sv3,3,0.9831561619620299,217,13,20,250
454,dark,sv3,4,0.9838384702761723,226,12,40,278
454,dark,sv3,5,0.9918158317649359,241,12,37,290
454,dark,sv3,6,0.988588805049814,204,14,33,251
454,dark,sv3,7,0.9916729740211748,173,10,23,206
454,dark,sv3,8,0.9846167888232527,196,10,18,224
454,dark,sv3,9,0.9826927408274898,241,13,12,266
81098,dark,sv2,0,0.9948101902818224,222,9,65,296
81098,dark,sv2,1,0.9898360484527164,232,10,56,298
81098,dark,sv2,2,0.9948705934005351,227,10,71,308
81098,dark,sv2,3,0.9872557854095131,221,12,59,292
81098,dark,sv2,4,0.9879187141433041,225,11,58,294
81098,dark,sv2,5,0.9852427833032507,230,10,40,280
81098,dark,sv2,6,0.9886128169855859,182,10,55,247
81098,dark,sv2,7,0.9774722813556467,189,9,59,257
81098,dark,sv2,8,0.9843050312961288,171,8,55,234
81098,dark,sv2,9,0.9902316130163203,201,9,63,273
11,dark,sv3,0,0.9940477778796224,301,17,16,334
11,dark,sv3,1,0.9902262270906841,245,19,14,278
11,dark,sv3,2,0.9968496329496366,280,23,18,321
11,dark,sv3,3,0.992704249050101,240,15,13,268
11,dark,sv3,4,0.9928668511972538,252,15,18,285
11,dark,sv3,5,0.9831987668598084,256,10,19,285
11,dark,sv3,6,0.9892733922402269,238,11,19,268
11,dark,sv3,7,0.9926826586529411,213,11,22,246
11,dark,sv3,8,0.9925492289028772,236,11,16,263
11,dark,sv3,9,0.9887422492549307,275,14,12,301
527,bright,sv3,0,0.9902048263988028,238,147,7,392
527,bright,sv3,1,0.9899403042418623,203,151,2,356
527,bright,sv3,2,0.991685282358649,206,180,4,390
527,bright,sv3,3,0.9896977604348061,181,153,3,337
527,bright,sv3,4,0.9827332912128554,204,155,1,360
527,bright,sv3,5,0.9871760024313823,266,92,3,361
527,bright,sv3,6,0.9893082231135379,224,103,5,332
527,bright,sv3,7,0.9895857074574143,254,40,1,295
527,bright,sv3,8,0.985929731578459,201,121,1,323
527,bright,sv3,9,0.9853320103429324,288,83,5,376
478,dark,sv3,0,0.991894770970367,268,17,18,303
478,dark,sv3,1,0.974778519889741,229,17,18,264
478,dark,sv3,2,0.9880632209189693,236,13,34,283
478,dark,sv3,3,0.9903576862067556,209,12,29,250
478,dark,sv3,4,0.9841198314562283,236,18,24,278
478,dark,sv3,5,0.9822672832707681,234,12,30,276
478,dark,sv3,6,0.9858844422688028,211,16,18,245
478,dark,sv3,7,0.9886799946096544,185,13,11,209
478,dark,sv3,8,0.98332431783357,185,15,23,223
478,dark,sv3,9,0.9934464649495166,220,15,21,256
556,bright,sv3,0,0.9891121456387197,291,109,4,404
556,bright,sv3,1,0.9826534356588297,268,79,8,355
556,bright,sv3,2,0.9911368427426502,271,115,5,391
556,bright,sv3,3,0.9927953035121784,256,74,5,335
556,bright,sv3,4,0.9889903325681896,236,122,4,362
556,bright,sv3,5,0.9881795685790381,269,98,4,371
556,bright,sv3,6,0.9930844314862473,260,68,4,332
556,bright,sv3,7,0.9767288275391314,236,57,3,296
556,bright,sv3,8,0.9937128197480292,280,95,6,381
556,bright,sv3,9,0.9938178228467286,320,50,4,374
484,dark,sv3,0,0.9899971824789322,284,10,55,349
484,dark,sv3,1,0.9961794375918628,249,11,62,322
484,dark,sv3,2,0.9902712423593786,261,9,68,338
484,dark,sv3,3,0.9889840551089045,228,10,51,289
484,dark,sv3,4,0.9907478851608187,216,11,50,277
484,dark,sv3,5,0.9950342915821228,266,10,63,339
484,dark,sv3,6,0.9837874025217751,213,10,68,291
484,dark,sv3,7,0.9826123849848278,185,10,52,247
484,dark,sv3,8,0.9869338532817931,218,11,51,280
484,dark,sv3,9,0.9935221597346411,274,10,49,333
398,bright,sv3,0,0.9904718074557042,104,291,2,397
398,bright,sv3,1,0.9837341889367326,100,242,2,344
398,bright,sv3,2,0.9932154443517284,90,292,1,383
398,bright,sv3,3,0.9900313333911576,76,258,1,335
398,bright,sv3,4,0.9852323846734512,78,266,2,346
398,bright,sv3,5,0.9962018219751193,74,277,0,351
398,bright,sv3,6,0.9925819190362268,68,254,2,324
398,bright,sv3,7,0.98373818322134,49,238,0,287
398,bright,sv3,8,0.98373818322134,49,238,0,287
398,bright,sv3,9,0.9894552114499187,110,262,0,372
73,bright,sv3,0,0.9878686046156248,196,185,2,383
73,bright,sv3,1,0.990824413699743,176,158,6,340
73,bright,sv3,2,0.9912089524822484,181,191,0,372
73,bright,sv3,3,0.9902496729097585,161,165,5,331
73,bright,sv3,4,0.9871447010787989,169,164,2,335
73,bright,sv3,5,0.9851426216414141,177,163,5,345
73,bright,sv3,6,0.9892630973754357,186,136,2,324
73,bright,sv3,7,0.981777717253029,142,135,4,281
73,bright,sv3,8,0.9861869869500512,163,159,3,325
73,bright,sv3,9,0.9940001206913639,173,182,1,356
234,bright,sv3,0,0.9889301561577616,132,256,0,388
234,bright,sv3,1,0.993950959714694,98,249,1,348
234,bright,sv3,2,0.9847292103151432,122,258,2,382
234,bright,sv3,3,0.9907233408645062,136,191,2,329
234,bright,sv3,4,0.9945510577444672,169,181,2,352
234,bright,sv3,5,0.9878381664321674,154,192,2,348
234,bright,sv3,6,0.9883327235470407,136,186,2,324
234,bright,sv3,7,0.9914578007966522,116,172,3,291
234,bright,sv3,8,0.9901353240629044,97,213,2,312
234,bright,sv3,9,0.9854246387502732,105,265,2,372
154,bright,sv3,0,0.987201153595176,174,217,1,392
154,bright,sv3,1,0.9881201018857064,179,164,4,347
154,bright,sv3,2,0.9910589248138597,184,198,1,383
154,bright,sv3,3,0.9881188915963615,135,174,2,311
154,bright,sv3,4,0.9846608850605675,140,193,2,335
154,bright,sv3,5,0.9901766785363034,157,189,3,349
154,bright,sv3,6,0.9904435476270225,159,162,3,324
154,bright,sv3,7,0.985180802807295,117,153,4,274
154,bright,sv3,8,0.9827205889943248,137,172,1,310
154,bright,sv3,9,0.9929979031587839,178,172,2,352
35,dark,sv3,0,0.9927575175171504,291,11,17,319
35,dark,sv3,1,0.9863665260697589,262,14,16,292
35,dark,sv3,2,0.9915151769774209,272,12,19,303
35,dark,sv3,3,0.9915648139146066,235,12,9,256
35,dark,sv3,4,0.9893265156732927,229,13,11,253
35,dark,sv3,5,0.9798868681260146,253,13,17,283
35,dark,sv3,6,0.9903078244407022,211,12,18,241
35,dark,sv3,7,0.9911719345785343,207,15,15,237
35,dark,sv3,8,0.9872180325070571,202,17,16,235
35,dark,sv3,9,0.9914885140263712,249,14,27,290
457,dark,sv3,0,0.9825664520612306,205,21,15,241
457,dark,sv3,1,0.9832825141089857,190,14,15,219
457,dark,sv3,2,0.9807030841107885,210,14,16,240
457,dark,sv3,3,0.9897692361135403,210,20,13,243
457,dark,sv3,4,0.9877105561090745,208,22,16,246
457,dark,sv3,5,0.9942324383224794,210,15,26,251
457,dark,sv3,6,0.9896743618689362,203,16,19,238
457,dark,sv3,7,0.978162963315806,165,9,14,188
457,dark,sv3,8,0.9899110141710239,187,14,17,218
457,dark,sv3,9,0.9834368975777904,214,17,10,241
254,dark,sv3,0,0.9872098315506068,215,18,17,250
254,dark,sv3,1,0.9854697353292984,186,16,18,220
254,dark,sv3,2,0.9897742537927166,197,21,10,228
254,dark,sv3,3,0.986069462948652,179,15,17,211
254,dark,sv3,4,0.9810674714630325,205,18,10,233
254,dark,sv3,5,0.9847895294557707,196,19,8,223
254,dark,sv3,6,0.9862654068494724,174,15,10,199
254,dark,sv3,7,0.993025224448701,178,13,15,206
254,dark,sv3,8,0.9943562122230252,172,15,18,205
254,dark,sv3,9,0.98449843080082,201,20,11,232
92,dark,sv3,0,0.9944893902882244,266,11,33,310
92,dark,sv3,1,0.9881197501537236,229,11,25,265
92,dark,sv3,2,0.992413025821247,253,17,22,292
92,dark,sv3,3,0.9857140957708542,240,12,18,270
92,dark,sv3,4,0.9856062761149116,222,18,26,266
92,dark,sv3,5,0.9941080008634586,224,11,15,250
92,dark,sv3,6,0.9850145956620084,228,14,10,252
92,dark,sv3,7,0.9854596855525216,202,11,23,236
92,dark,sv3,8,0.9897191191599537,223,7,20,250
92,dark,sv3,9,0.9905669755350944,243,12,22,277
100,bright,sv3,0,0.9916769619534463,225,153,2,380
100,bright,sv3,1,0.9939430952605941,202,133,5,340
100,bright,sv3,2,0.9924705106835262,227,145,3,375
100,bright,sv3,3,0.9887607513899119,175,142,3,320
100,bright,sv3,4,0.9836027977330167,199,132,6,337
100,bright,sv3,5,0.9929339271934299,198,139,8,345
100,bright,sv3,6,0.982719482473364,181,120,1,302
100,bright,sv3,7,0.9832533313895675,140,131,1,272
100,bright,sv3,8,0.9909616264617481,213,147,5,365
100,bright,sv3,9,0.994316612958078,195,147,0,342
472,dark,sv3,0,0.9927222119585704,220,17,15,252
472,dark,sv3,1,0.9737771888425807,200,17,9,226
472,dark,sv3,2,0.9882204771234953,212,14,14,240
472,dark,sv3,3,0.9845164922613893,202,16,13,231
472,dark,sv3,4,0.9877401634574124,205,14,14,233
472,dark,sv3,5,0.9859992591765151,204,18,21,243
472,dark,sv3,6,0.9858734830232863,186,14,28,228
472,dark,sv3,7,0.9878590227568178,155,16,30,201
472,dark,sv3,8,0.9771662484275612,204,10,19,233
472,dark,sv3,9,0.9886839128632466,183,15,20,218
199,dark,sv3,0,0.9886838300553505,260,14,17,291
199,dark,sv3,1,0.9884260872076908,234,14,18,266
199,dark,sv3,2,0.9846949580909786,250,10,22,282
199,dark,sv3,3,0.9894676397997979,208,12,21,241
199,dark,sv3,4,0.9919180201872102,230,13,29,272
199,dark,sv3,5,0.9892595440598598,234,14,16,264
199,dark,sv3,6,0.9878293263503728,196,11,14,221
199,dark,sv3,7,0.981745534233358,205,12,17,234
199,dark,sv3,8,0.993730604110146,195,12,16,223
199,dark,sv3,9,0.9930494679027609,246,15,19,280
289,bright,sv3,0,0.987382471842718,159,231,3,393
289,bright,sv3,1,0.992918741689207,140,203,3,346
289,bright,sv3,2,0.9953344143573716,140,238,4,382
289,bright,sv3,3,0.9921562485371004,119,202,4,325
289,bright,sv3,4,0.9908874343681677,120,226,2,348
289,bright,sv3,5,0.9838302657508743,130,214,2,346
289,bright,sv3,6,0.9936539508237678,129,180,1,310
289,bright,sv3,7,0.9872058345467738,88,189,3,280
289,bright,sv3,8,0.9935976084039396,98,209,5,312
289,bright,sv3,9,0.9938107069165076,130,235,2,367
63,dark,sv3,0,0.9924963089757258,267,11,26,304
63,dark,sv3,1,0.9879005370541891,232,13,17,262
63,dark,sv3,2,0.987164386093751,251,15,19,285
63,dark,sv3,3,0.9885484374114976,228,14,14,256
63,dark,sv3,4,0.9937207502865278,244,12,14,270
63,dark,sv3,5,0.9929079338579399,240,13,18,271
63,dark,sv3,6,0.9841722441855141,208,14,20,242
63,dark,sv3,7,0.9791010015130243,206,11,19,236
63,dark,sv3,8,0.9837860426666879,196,12,27,235
63,dark,sv3,9,0.9886880185993454,250,9,14,273
126,bright,sv3,0,0.9902692892633784,218,118,4,340
126,bright,sv3,1,0.9934333730874598,190,109,1,300
126,bright,sv3,2,0.9937327481638838,195,153,5,353
126,bright,sv3,3,0.9942891770704124,211,102,4,317
126,bright,sv3,4,0.9866524471960613,200,125,4,329
126,bright,sv3,5,0.9905336411685303,198,115,3,316
126,bright,sv3,6,0.983630654262969,199,108,4,311
126,bright,sv3,7,0.9867650163854197,137,122,5,264
126,bright,sv3,8,0.9828872981293432,150,111,6,267
126,bright,sv3,9,0.9906338740422616,221,124,1,346
226,dark,sv3,0,0.9933705616420231,210,19,10,239
226,dark,sv3,1,0.988428437597865,183,16,16,215
226,dark,sv3,2,0.9877928727683755,223,14,17,254
226,dark,sv3,3,0.9901342598587857,189,18,26,233
226,dark,sv3,4,0.9780358614376758,198,10,19,227
226,dark,sv3,5,0.9910361086198969,208,15,15,238
226,dark,sv3,6,0.9888647613899196,172,12,9,193
226,dark,sv3,7,0.9744209830478536,166,10,11,187
226,dark,sv3,8,0.9828810009289618,163,15,5,183
226,dark,sv3,9,0.9795970669772468,200,18,11,229
181,bright,sv3,0,0.9951612683239761,183,168,5,356
181,bright,sv3,1,0.9946538524730115,178,136,6,320
181,bright,sv3,2,0.9872136243090853,215,155,2,372
181,bright,sv3,3,0.9886852878961065,188,130,2,320
181,bright,sv3,4,0.9925917184891324,165,166,3,334
181,bright,sv3,5,0.9864695158512624,171,166,3,340
181,bright,sv3,6,0.9857254176979542,159,144,2,305
181,bright,sv3,7,0.9808393671942133,142,128,1,271
181,bright,sv3,8,0.9904449714049164,121,143,5,269
181,bright,sv3,9,0.9903238753142839,156,173,4,333
127,bright,sv3,0,0.9931203607357034,264,126,7,397
127,bright,sv3,1,0.9902530969336344,220,125,7,352
127,bright,sv3,2,0.9940604392240577,242,145,2,389
127,bright,sv3,3,0.9944322434643362,228,126,3,357
127,bright,sv3,4,0.9940571960419989,232,141,7,380
127,bright,sv3,5,0.9915454582722614,243,132,5,380
127,bright,sv3,6,0.9925487419953702,206,94,3,303
127,bright,sv3,7,0.9931693423646647,197,122,6,325
127,bright,sv3,8,0.9933250972269417,239,129,3,371
127,bright,sv3,9,0.9951321128608255,256,123,3,382
155,bright,sv3,0,0.9969201673694311,218,198,2,418
155,bright,sv3,1,0.9899876710945704,201,185,3,389
155,bright,sv3,2,0.9883851366223939,212,203,0,415
155,bright,sv3,3,0.9943233142675494,166,189,4,359
155,bright,sv3,4,0.9922261984931094,179,211,3,393
155,bright,sv3,5,0.9941654235194097,196,198,2,396
155,bright,sv3,6,0.9909897386116656,152,170,1,323
155,bright,sv3,7,0.9927837033306605,180,175,2,357
155,bright,sv3,8,0.9941855399336336,188,227,3,418
155,bright,sv3,9,0.9958148042460558,197,217,4,418
290,bright,sv3,0,0.9958890934527752,158,270,2,430
290,bright,sv3,1,0.9882048314181354,151,234,5,390
290,bright,sv3,2,0.9947286375552054,175,246,3,424
290,bright,sv3,3,0.9871910215208721,138,246,1,385
290,bright,sv3,4,0.9850183142246669,164,214,7,385
290,bright,sv3,5,0.9952863475499573,148,247,3,398
290,bright,sv3,6,0.989570533488701,147,164,4,315
290,bright,sv3,7,0.9909874452810192,145,210,6,361
290,bright,sv3,8,0.993455317299105,161,249,4,414
290,bright,sv3,9,0.9925927441296487,183,230,4,417
528,bright,sv3,0,0.9941406549248266,184,245,2,431
528,bright,sv3,1,0.9909373077437899,157,234,1,392
528,bright,sv3,2,0.9905123740022869,171,247,1,419
528,bright,sv3,3,0.9927552484121488,177,204,4,385
528,bright,sv3,4,0.9874248731694218,193,197,5,395
528,bright,sv3,5,0.9926705711790955,234,168,2,404
528,bright,sv3,6,0.9894668640765635,173,152,2,327
528,bright,sv3,7,0.9918101132253547,247,113,2,362
528,bright,sv3,8,0.9917131125742308,221,194,4,419
528,bright,sv3,9,0.9850962675862008,229,197,1,427
182,bright,sv3,0,0.9940269914652813,200,186,5,391
182,bright,sv3,1,0.9856873913202429,193,160,2,355
182,bright,sv3,2,0.9929545354927312,241,165,3,409
182,bright,sv3,3,0.9943244716080677,199,170,2,371
182,bright,sv3,4,0.9942356878808842,195,171,5,371
182,bright,sv3,5,0.994699948394518,198,182,2,382
182,bright,sv3,6,0.9893256787573969,151,157,1,309
182,bright,sv3,7,0.9897917328121375,169,169,1,339
182,bright,sv3,8,0.9937810951398505,207,184,2,393
182,bright,sv3,9,0.9947008333706636,205,171,4,380
171,dark,sv3,0,0.9915001565202981,275,15,17,307
171,dark,sv3,1,0.9799892463772321,250,9,22,281
171,dark,sv3,2,0.9868920653867157,257,14,15,286
171,dark,sv3,3,0.9855272445402954,229,12,15,256
171,dark,sv3,4,0.9829255382266451,224,15,25,264
171,dark,sv3,5,0.9926755160068083,248,14,25,287
171,dark,sv3,6,0.9765204394940504,202,10,19,231
171,dark,sv3,7,0.989617440422836,210,10,22,242
171,dark,sv3,8,0.9821369772852095,257,14,27,298
171,dark,sv3,9,0.9823666586975749,235,12,24,271
64,dark,sv3,0,0.9938676451521061,307,11,23,341
64,dark,sv3,1,0.991152480495903,261,16,24,301
64,dark,sv3,2,0.9891385317510243,289,17,21,327
64,dark,sv3,3,0.9901522141381189,266,13,27,306
64,dark,sv3,4,0.9853218455057913,280,17,22,319
64,dark,sv3,5,0.9881765502044056,256,13,19,288
64,dark,sv3,6,0.983832093818502,182,11,17,210
64,dark,sv3,7,0.9921734935721794,255,15,25,295
64,dark,sv3,8,0.9909230409185454,269,20,17,306
64,dark,sv3,9,0.9911219431064565,295,14,21,330
101,bright,sv3,0,0.982690675111799,229,176,3,408
101,bright,sv3,1,0.9889042400427883,215,151,7,373
101,bright,sv3,2,0.9939453441245378,246,160,4,410
101,bright,sv3,3,0.9942048942803049,218,155,3,376
101,bright,sv3,4,0.991379249770517,225,151,9,385
101,bright,sv3,5,0.996137516810005,224,158,4,386
101,bright,sv3,6,0.9895356977597503,190,124,1,315
101,bright,sv3,7,0.9852778464323259,190,153,0,343
101,bright,sv3,8,0.9842759419079439,244,159,1,404
101,bright,sv3,9,0.98999123518453,231,161,2,394
200,dark,sv3,0,0.9914690777341137,291,13,29,333
200,dark,sv3,1,0.9888469459621695,285,14,21,320
200,dark,sv3,2,0.9911925918536661,301,15,23,339
200,dark,sv3,3,0.9869687701375696,267,14,16,297
200,dark,sv3,4,0.9860619967381747,259,11,27,297
200,dark,sv3,5,0.995030919227341,278,14,24,316
200,dark,sv3,6,0.9916345418093037,205,13,18,236
200,dark,sv3,7,0.9899537789195161,259,11,27,297
200,dark,sv3,8,0.9929319754825118,279,15,27,321
200,dark,sv3,9,0.9925839795090954,286,16,33,335
227,dark,sv3,0,0.9924528561494298,245,18,29,292
227,dark,sv3,1,0.9829387378306781,222,18,25,265
227,dark,sv3,2,0.9900739298570836,239,20,22,281
227,dark,sv3,3,0.9943565435576336,241,16,16,273
227,dark,sv3,4,0.9881960844545906,236,16,12,264
227,dark,sv3,5,0.9893766659858318,234,18,9,261
227,dark,sv3,6,0.9899469202563624,178,10,12,200
227,dark,sv3,7,0.9842255890130291,230,23,17,270
227,dark,sv3,8,0.9862582705874756,239,17,22,278
227,dark,sv3,9,0.9853381936935537,208,21,30,259
557,bright,sv3,0,0.9919141579460533,244,182,4,430
557,bright,sv3,1,0.9948129578064542,226,176,2,404
557,bright,sv3,2,0.9938174437195063,204,228,1,433
557,bright,sv3,3,0.9969545879549473,181,205,4,390
557,bright,sv3,4,0.99410592786377,168,235,3,406
557,bright,sv3,5,0.9935004085997479,231,172,5,408
557,bright,sv3,6,0.9892869734463526,185,139,6,330
557,bright,sv3,7,0.9912005693734771,194,168,0,362
557,bright,sv3,8,0.9943507533942554,229,190,3,422
557,bright,sv3,9,0.9851983560291648,262,162,7,431
469,dark,sv3,0,0.9898781607989645,248,23,31,302
469,dark,sv3,1,0.9877089612019336,242,17,31,290
469,dark,sv3,2,0.9893972755574395,229,20,21,270
469,dark,sv3,3,0.9925669007905611,241,13,18,272
469,dark,sv3,4,0.9872979549279586,228,19,11,258
469,dark,sv3,5,0.9951229968973271,233,15,8,256
469,dark,sv3,6,0.9824606571532367,194,17,5,216
469,dark,sv3,7,0.9847880744534557,196,15,11,222
469,dark,sv3,8,0.994704875478503,245,19,11,275
469,dark,sv3,9,0.983834965798661,230,15,30,275
514,dark,sv3,0,0.9885670986644427,284,10,48,342
514,dark,sv3,1,0.9957038712028681,258,11,62,331
514,dark,sv3,2,0.9916171118868017,267,16,63,346
514,dark,sv3,3,0.9892581175738285,266,10,54,330
514,dark,sv3,4,0.9860946642390149,256,9,50,315
514,dark,sv3,5,0.9872126257092186,276,10,59,345
514,dark,sv3,6,0.9854279492767947,217,12,44,273
514,dark,sv3,7,0.9945921430025746,259,12,42,313
514,dark,sv3,8,0.984154650140407,284,13,57,354
514,dark,sv3,9,0.9907286562343318,280,12,53,345
485,dark,sv3,0,0.9954116411039616,302,14,70,386
485,dark,sv3,1,0.9890459396751978,301,11,45,357
485,dark,sv3,2,0.9942994039699959,285,13,69,367
485,dark,sv3,3,0.98880735293137,283,11,51,345
485,dark,sv3,4,0.9874724196671131,298,9,52,359
485,dark,sv3,5,0.9929825788951616,299,10,55,364
485,dark,sv3,6,0.9914994869374368,242,9,48,299
485,dark,sv3,7,0.9933824731506369,266,10,50,326
485,dark,sv3,8,0.9926201611843702,302,10,59,371
485,dark,sv3,9,0.9912942251295765,293,13,61,367
451,dark,sv3,0,0.9919287458312026,289,14,26,329
451,dark,sv3,1,0.9875341623382126,270,17,20,307
451,dark,sv3,2,0.9901170341936507,307,14,31,352
451,dark,sv3,3,0.9852156616215131,278,14,28,320
451,dark,sv3,4,0.989680593427509,295,12,36,343
451,dark,sv3,5,0.9861542286191962,298,12,32,342
451,dark,sv3,6,0.981466802912195,223,12,32,267
451,dark,sv3,7,0.9941243231535729,255,15,20,290
451,dark,sv3,8,0.98865196573136,298,12,24,334
451,dark,sv3,9,0.9881406014744671,303,15,21,339
589,bright,sv3,0,0.9903372323475185,185,227,1,413
589,bright,sv3,1,0.9915578789231294,172,212,2,386
589,bright,sv3,2,0.9944985137695449,164,233,4,401
589,bright,sv3,3,0.9916744023024733,176,197,4,377
589,bright,sv3,4,0.9959887636193109,139,248,2,389
589,bright,sv3,5,0.9841199504079564,153,235,6,394
589,bright,sv3,6,0.9888275610181223,107,208,4,319
589,bright,sv3,7,0.9893799597268543,140,214,0,354
589,bright,sv3,8,0.9847378391865413,188,222,4,414
589,bright,sv3,9,0.993669855195924,174,225,3,402
574,dark,sv3,0,0.9911638174873391,318,10,67,395
574,dark,sv3,1,0.993741994596039,262,15,69,346
574,dark,sv3,2,0.9916773102677777,283,13,77,373
574,dark,sv3,3,0.9875272967915547,278,10,60,348
574,dark,sv3,4,0.9972167912323147,304,11,47,362
574,dark,sv3,5,0.9930147509500002,284,12,68,364
574,dark,sv3,6,0.9938650049719707,229,11,46,286
574,dark,sv3,7,0.9953582208230786,274,11,48,333
574,dark,sv3,8,0.9934783625048927,309,14,63,386
574,dark,sv3,9,0.9938453489237312,322,11,57,390
235,bright,sv3,0,0.9929903729462723,148,272,2,422
235,bright,sv3,1,0.9937829312187407,122,260,2,384
235,bright,sv3,2,0.9907868925837655,143,280,0,423
235,bright,sv3,3,0.9927812005200269,174,207,1,382
235,bright,sv3,4,0.9942693549184912,167,228,3,398
235,bright,sv3,5,0.9921138548066681,156,243,4,403
235,bright,sv3,6,0.9910709430319425,123,204,1,328
235,bright,sv3,7,0.9943055958583221,113,239,3,355
235,bright,sv3,8,0.9897710600528328,132,283,4,419
235,bright,sv3,9,0.9931597377618688,147,277,4,428
36,dark,sv3,0,0.9887596861039382,292,16,13,321
36,dark,sv3,1,0.9866908917477646,264,17,18,299
36,dark,sv3,2,0.9903273223694334,287,17,18,322
36,dark,sv3,3,0.9884918732168635,275,12,23,310
36,dark,sv3,4,0.9886888846792846,267,11,25,303
36,dark,sv3,5,0.9883298866077559,290,13,12,315
36,dark,sv3,6,0.9872683009348376,213,9,14,236
36,dark,sv3,7,0.9886814709622473,249,14,24,287
36,dark,sv3,8,0.9935871415026252,293,15,18,326
36,dark,sv3,9,0.9928772534430949,285,13,23,321
496,bright,sv3,0,0.9953204443500426,301,78,1,380
496,bright,sv3,1,0.9872626990184867,256,87,7,350
496,bright,sv3,2,0.9948661197452082,287,93,3,383
496,bright,sv3,3,0.9912708519847728,268,60,3,331
496,bright,sv3,4,0.987435264623989,300,49,6,355
496,bright,sv3,5,0.9806806759451392,274,79,4,357
496,bright,sv3,6,0.9877040316975882,236,60,1,297
496,bright,sv3,7,0.9811216876586779,232,58,7,297
496,bright,sv3,8,0.9930980141103302,303,73,6,382
496,bright,sv3,9,0.9918685843991003,314,57,5,376
486,dark,sv3,0,0.9948445979309023,309,12,43,364
486,dark,sv3,1,0.9904502451576778,302,12,36,350
486,dark,sv3,2,0.9936704796874354,308,13,41,362
486,dark,sv3,3,0.9830185985680604,260,9,23,292
486,dark,sv3,4,0.9831053862270661,286,14,42,342
486,dark,sv3,5,0.9897417862119093,280,10,46,336
486,dark,sv3,6,0.9881770523770143,267,13,45,325
486,dark,sv3,7,0.9856034718862943,251,11,50,312
486,dark,sv3,8,0.9884702841412922,312,10,47,369
486,dark,sv3,9,0.9884325982027387,308,11,46,365
442,dark,sv3,0,0.9931467589282503,326,17,15,358
442,dark,sv3,1,0.9936986123587817,286,18,20,324
442,dark,sv3,2,0.9938616272709875,304,19,15,338
442,dark,sv3,3,0.9922741994939078,233,11,21,265
442,dark,sv3,4,0.9834159091137373,289,16,29,334
442,dark,sv3,5,0.9917787474076994,285,15,40,340
442,dark,sv3,6,0.9945880892481362,254,11,32,297
442,dark,sv3,7,0.9853364840326871,261,10,24,295
442,dark,sv3,8,0.9934997347890226,298,16,21,335
442,dark,sv3,9,0.9848225981564298,304,14,10,328
236,bright,sv3,0,0.9931447058802242,152,266,2,420
236,bright,sv3,1,0.9887035798122996,127,254,1,382
236,bright,sv3,2,0.9942797354794615,157,251,2,410
236,bright,sv3,3,0.9841944555430693,144,176,4,324
236,bright,sv3,4,0.9934536742343394,163,237,7,407
236,bright,sv3,5,0.9937157175798274,166,223,2,391
236,bright,sv3,6,0.9952773236232062,145,221,1,367
236,bright,sv3,7,0.989008297238402,151,210,2,363
236,bright,sv3,8,0.991210634220073,147,264,2,413
236,bright,sv3,9,0.9926116595850083,151,271,4,426
463,dark,sv3,0,0.9937341066474668,301,17,19,337
463,dark,sv3,1,0.9949006339978476,276,13,21,310
463,dark,sv3,2,0.996729299176487,296,20,19,335
463,dark,sv3,3,0.9840204864312071,218,13,21,252
463,dark,sv3,4,0.9896881769097599,299,15,23,337
463,dark,sv3,5,0.9895846816133144,280,13,32,325
463,dark,sv3,6,0.9824706889216417,238,14,47,299
463,dark,sv3,7,0.9932459340630304,270,12,19,301
463,dark,sv3,8,0.9868561266198903,302,16,27,345
463,dark,sv3,9,0.9901234318765055,295,12,20,327
128,bright,sv3,0,0.9927856213762277,259,128,3,390
128,bright,sv3,1,0.9851848419621512,214,118,6,338
128,bright,sv3,2,0.9919918019586174,241,125,4,370
128,bright,sv3,3,0.9904823518347866,197,113,5,315
128,bright,sv3,4,0.9926648518531686,245,127,5,377
128,bright,sv3,5,0.9910122720222273,244,127,4,375
128,bright,sv3,6,0.9923357835520845,223,112,3,338
128,bright,sv3,7,0.9905620757248438,198,117,4,319
128,bright,sv3,8,0.9942500676379595,220,143,7,370
128,bright,sv3,9,0.9939878728895002,266,115,4,385
172,dark,sv3,0,0.9907355962415063,298,17,19,334
172,dark,sv3,1,0.9898306202457812,282,17,20,319
172,dark,sv3,2,0.9898671815032692,303,19,22,344
172,dark,sv3,3,0.9858580598872508,236,10,24,270
172,dark,sv3,4,0.9923458145540643,274,12,23,309
172,dark,sv3,5,0.9826794341884026,297,13,24,334
172,dark,sv3,6,0.9870608866364234,245,12,11,268
172,dark,sv3,7,0.9805054801753624,257,12,20,289
172,dark,sv3,8,0.9903486655880411,298,13,18,329
172,dark,sv3,9,0.9846337898164733,298,20,17,335
543,dark,sv3,0,0.9906988009780702,275,12,71,358
543,dark,sv3,1,0.9944736359256034,252,12,63,327
543,dark,sv3,2,0.9950068647970631,281,14,55,350
543,dark,sv3,3,0.9904076135198708,224,12,63,299
543,dark,sv3,4,0.992827385469655,250,12,57,319
543,dark,sv3,5,0.9897613404553868,253,17,71,341
543,dark,sv3,6,0.9925633930033952,227,15,61,303
543,dark,sv3,7,0.9903179331967782,178,21,54,253
543,dark,sv3,8,0.988628516178317,178,13,41,232
543,dark,sv3,9,0.9886676611822712,259,11,59,329
575,dark,sv3,0,0.990662052053607,307,13,53,373
575,dark,sv3,1,0.9912518616710755,258,10,70,338
575,dark,sv3,2,0.9915449484373285,285,13,70,368
575,dark,sv3,3,0.9779995951992748,177,4,37,218
575,dark,sv3,4,0.9921686890344061,240,7,35,282
575,dark,sv3,5,0.991917527832549,279,10,60,349
575,dark,sv3,6,0.9835781890813826,274,12,38,324
575,dark,sv3,7,0.9811783675251989,260,10,46,316
575,dark,sv3,8,0.9963469407717597,304,11,64,379
575,dark,sv3,9,0.9912513882671177,318,12,48,378
529,bright,sv3,0,0.9919457181034335,175,247,1,423
529,bright,sv3,1,0.9932345583878969,145,246,2,393
529,bright,sv3,2,0.9898536163912062,156,259,4,419
529,bright,sv3,3,0.9876639507137316,118,200,0,318
529,bright,sv3,4,0.9931504226727714,137,227,0,364
529,bright,sv3,5,0.9901129867233476,202,199,6,407
529,bright,sv3,6,0.9918687352352829,181,178,3,362
529,bright,sv3,7,0.9906892898432859,230,136,1,367
529,bright,sv3,8,0.9960080029899466,209,209,1,419
529,bright,sv3,9,0.9917489262228392,255,167,6,428
558,bright,sv3,0,0.9900792010889499,184,243,4,431
558,bright,sv3,1,0.9972852300126416,139,254,2,395
558,bright,sv3,2,0.9948398404418196,156,265,2,423
558,bright,sv3,3,0.9902963114451352,164,169,1,334
558,bright,sv3,4,0.9935830444934753,151,250,6,407
558,bright,sv3,5,0.9926121620539119,173,237,3,413
558,bright,sv3,6,0.9873406669884677,136,231,1,368
558,bright,sv3,7,0.9949749635098505,133,235,2,370
558,bright,sv3,8,0.9953308937438696,150,275,2,427
558,bright,sv3,9,0.991267680369406,208,224,5,437
590,bright,sv3,0,0.9937128374707973,148,262,3,413
590,bright,sv3,1,0.9966837460362653,152,235,1,388
590,bright,sv3,2,0.9828105927063727,184,218,9,411
590,bright,sv3,3,0.9927700872903747,128,182,7,317
590,bright,sv3,4,0.9940049472293203,160,230,4,394
590,bright,sv3,5,0.9930025514888426,174,218,4,396
590,bright,sv3,6,0.9922465106686325,119,227,2,348
590,bright,sv3,7,0.9873242151814093,117,235,3,355
590,bright,sv3,8,0.9953406602990674,147,257,5,409
590,bright,sv3,9,0.9909172538048924,167,249,1,417
497,bright,sv3,0,0.9931935228815646,289,117,8,414
497,bright,sv3,1,0.989325498873279,247,114,8,369
497,bright,sv3,2,0.9861729895404481,251,133,6,390
497,bright,sv3,3,0.9934813136248171,228,93,0,321
497,bright,sv3,4,0.993761991863725,305,82,1,388
497,bright,sv3,5,0.9906360754795361,258,122,4,384
497,bright,sv3,6,0.9937309189567872,250,92,6,348
497,bright,sv3,7,0.9894435687457007,260,80,3,343
497,bright,sv3,8,0.9871774439068441,275,119,8,402
497,bright,sv3,9,0.9924231378549709,319,86,3,408
37,dark,sv3,0,0.9831995795478201,303,11,22,336
37,dark,sv3,1,0.9897337778078081,282,16,14,312
37,dark,sv3,2,0.9887520458705051,300,14,22,336
37,dark,sv3,3,0.9921122099601098,291,13,17,321
37,dark,sv3,4,0.9881244654272335,287,13,19,319
37,dark,sv3,5,0.9852529194869069,286,12,15,313
37,dark,sv3,6,0.9910709539752449,237,13,13,263
37,dark,sv3,7,0.9847131181950259,249,14,15,278
37,dark,sv3,8,0.987121046312377,285,11,15,311
37,dark,sv3,9,0.9913636781929712,274,15,22,311
345,bright,sv3,0,0.9905306971780066,164,212,2,378
345,bright,sv3,1,0.9955055276841411,129,210,1,340
345,bright,sv3,2,0.9934566961704655,152,215,3,370
345,bright,sv3,3,0.9870965947643427,133,195,1,329
345,bright,sv3,4,0.9945539368118437,149,197,4,350
345,bright,sv3,5,0.993124843893594,147,213,3,363
345,bright,sv3,6,0.9921045585521882,129,186,1,316
345,bright,sv3,7,0.9832799162464332,96,183,5,284
345,bright,sv3,8,0.9882100723136673,159,216,2,377
345,bright,sv3,9,0.9970638213188701,167,191,6,364
487,dark,sv3,0,0.9943565098057131,320,11,30,361
487,dark,sv3,1,0.9859839946250364,299,12,22,333
487,dark,sv3,2,0.991884453176605,308,13,34,355
487,dark,sv3,3,0.9920883374465532,289,11,30,330
487,dark,sv3,4,0.9893300290617962,321,14,27,362
487,dark,sv3,5,0.9935343022749672,290,10,41,341
487,dark,sv3,6,0.9872356701332521,276,9,37,322
487,dark,sv3,7,0.9888639251920808,273,10,23,306
487,dark,sv3,8,0.9910115800224714,306,11,33,350
487,dark,sv3,9,0.9955766849550831,307,17,33,357
399,bright,sv3,1,0.9953887541976331,97,300,3,400
399,bright,sv3,2,0.9961753340021894,117,297,5,419
399,bright,sv3,3,0.9936889555708134,115,278,4,397
399,bright,sv3,4,0.9870312067571437,111,293,1,405
399,bright,sv3,5,0.9948153046213074,109,299,2,410
399,bright,sv3,6,0.99265134235218,85,275,0,360
399,bright,sv3,7,0.9891215414249126,91,268,2,361
399,bright,sv3,8,0.9902916695233699,82,339,1,422
399,bright,sv3,9,0.9946680309590289,110,318,0,428
264,bright,sv3,0,0.993634847975463,156,278,2,436
264,bright,sv3,1,0.9939316032887123,143,248,2,393
264,bright,sv3,2,0.993839338030944,172,250,6,428
264,bright,sv3,3,0.9950045841475552,174,214,3,391
264,bright,sv3,4,0.9871141103237154,154,245,2,401
264,bright,sv3,5,0.9937229572994045,155,251,1,407
264,bright,sv3,6,0.9912560439567817,152,208,4,364
264,bright,sv3,7,0.9939099426011935,117,246,0,363
264,bright,sv3,8,0.992437376986572,139,274,4,417
264,bright,sv3,9,0.9932046299931765,149,272,2,423
426,bright,sv3,0,0.9864342991410299,119,307,0,426
426,bright,sv3,1,0.9886038845636014,109,283,1,393
426,bright,sv3,2,0.9943956169845508,116,294,4,414
426,bright,sv3,3,0.9931231368367264,136,248,1,385
426,bright,sv3,4,0.989898357312076,112,281,1,394
426,bright,sv3,5,0.9961128610851504,98,304,2,404
426,bright,sv3,6,0.9892546003698439,77,284,1,362
426,bright,sv3,7,0.9905976885428172,97,264,0,361
426,bright,sv3,8,0.9922734572384486,99,328,1,428
426,bright,sv3,9,0.9939940519255768,103,319,1,423
515,dark,sv3,0,0.9885097682446903,301,12,37,350
515,dark,sv3,1,0.991750741472833,271,12,54,337
515,dark,sv3,2,0.9926534298904202,282,12,60,354
515,dark,sv3,3,0.9895463798956691,279,14,39,332
515,dark,sv3,4,0.9855091611954411,266,14,50,330
515,dark,sv3,5,0.9939271376871834,275,9,50,334
515,dark,sv3,6,0.9916567302071322,256,14,39,309
515,dark,sv3,7,0.9862124846616445,247,10,37,294
515,dark,sv3,8,0.9908782228335961,281,11,49,341
515,dark,sv3,9,0.9930208474067099,277,12,42,331
559,bright,sv3,0,0.995604610787643,127,308,5,440
559,bright,sv3,1,0.9892515431500103,143,259,0,402
559,bright,sv3,2,0.9954208697957971,125,304,1,430
559,bright,sv3,3,0.992776353307855,96,299,2,397
559,bright,sv3,4,0.9889581432617399,94,316,4,414
559,bright,sv3,5,0.9856392622248459,107,302,5,414
559,bright,sv3,6,0.9952476839365129,99,271,2,372
559,bright,sv3,7,0.9906491624571775,116,249,3,368
559,bright,sv3,8,0.9923412245119619,142,284,2,428
559,bright,sv3,9,0.9947214966914842,185,243,2,430
530,bright,sv3,0,0.9910835885636059,151,276,2,429
530,bright,sv3,1,0.9891399150879389,137,246,4,387
530,bright,sv3,2,0.9955006960552968,141,280,5,426
530,bright,sv3,3,0.9903397253847945,131,256,1,388
530,bright,sv3,4,0.9922932109909853,149,241,1,391
530,bright,sv3,5,0.995473937372248,178,219,2,399
530,bright,sv3,6,0.9894117500424793,155,207,0,362
530,bright,sv3,7,0.9905459994994141,205,158,1,364
530,bright,sv3,8,0.9907763571543315,159,256,4,419
530,bright,sv3,9,0.9905107523727689,173,250,2,425
156,bright,sv3,0,0.9890790309551348,220,201,5,426
156,bright,sv3,1,0.9890752815959559,190,197,3,390
156,bright,sv3,2,0.9865614874698208,209,198,1,408
156,bright,sv3,3,0.9839412627816887,181,189,1,371
156,bright,sv3,4,0.991174161919476,175,212,1,388
156,bright,sv3,5,0.9912987806728568,182,205,2,389
156,bright,sv3,6,0.9959075076875059,180,177,2,359
156,bright,sv3,7,0.9922481395192807,164,180,4,348
156,bright,sv3,8,0.9928216254330534,195,223,1,419
156,bright,sv3,9,0.9906233467943393,195,204,3,402
576,dark,sv3,0,0.9817407240893777,304,11,39,354
576,dark,sv3,1,0.9914209247766842,279,14,40,333
576,dark,sv3,2,0.9891216767554263,297,16,37,350
576,dark,sv3,3,0.9878678160613137,280,13,48,341
576,dark,sv3,4,0.9912141626629247,302,14,39,355
576,dark,sv3,5,0.9923581062064598,290,11,62,363
576,dark,sv3,6,0.990067123069799,265,16,32,313
576,dark,sv3,7,0.9915900689309668,259,13,39,311
576,dark,sv3,8,0.9946261424483747,298,11,58,367
576,dark,sv3,9,0.9939881927503117,314,14,49,377
498,bright,sv3,0,0.9937316912698839,258,142,7,407
498,bright,sv3,1,0.9938292185887818,199,165,6,370
498,bright,sv3,2,0.9868983210381814,239,159,3,401
498,bright,sv3,3,0.9895289355394975,278,97,6,381
498,bright,sv3,4,0.9913529951996202,277,105,7,389
498,bright,sv3,5,0.9939533156894933,236,144,10,390
498,bright,sv3,6,0.9904630070299125,210,138,5,353
498,bright,sv3,7,0.9858281042736347,229,117,7,353
498,bright,sv3,8,0.9961218989328194,266,128,8,402
498,bright,sv3,9,0.9897472811821668,287,118,2,407
74,bright,sv3,0,0.9917996931678248,206,206,5,417
74,bright,sv3,1,0.9952372855352258,218,166,4,388
74,bright,sv3,2,0.9939594242906606,203,211,1,415
74,bright,sv3,3,0.993884534018605,191,179,7,377
74,bright,sv3,4,0.9921347513165862,219,168,5,392
74,bright,sv3,5,0.9876837395765421,205,184,0,389
74,bright,sv3,6,0.987630528220783,212,145,2,359
74,bright,sv3,7,0.9875946947325878,194,155,2,351
74,bright,sv3,8,0.9908134339652935,227,180,6,413
74,bright,sv3,9,0.9903954543489073,240,168,4,412
499,bright,sv3,0,0.9911421409801562,258,149,5,412
499,bright,sv3,1,0.9865619281967222,199,163,5,367
499,bright,sv3,2,0.9903789501465733,219,168,1,388
499,bright,sv3,3,0.9871348024202947,226,141,2,369
499,bright,sv3,4,0.995363895451524,242,142,4,388
499,bright,sv3,5,0.9892373090947049,213,160,9,382
499,bright,sv3,6,0.9937599279978682,197,145,3,345
499,bright,sv3,7,0.9931838121229064,219,123,4,346
499,bright,sv3,8,0.9897307379965042,224,168,4,396
499,bright,sv3,9,0.9939799616667063,292,102,8,402
183,bright,sv3,0,0.9869560840454417,218,171,6,395
183,bright,sv3,1,0.9863366782975868,219,141,0,360
183,bright,sv3,2,0.990344375808535,244,157,6,407
183,bright,sv3,3,0.9921145066241495,242,136,4,382
183,bright,sv3,4,0.9912758630127818,211,165,6,382
183,bright,sv3,5,0.9937291879046302,199,169,4,372
183,bright,sv3,6,0.9925751653313872,186,163,1,350
183,bright,sv3,7,0.9895375635135182,167,162,3,332
183,bright,sv3,8,0.9841834068037831,214,168,3,385
183,bright,sv3,9,0.9955780296101086,174,188,8,370
129,bright,sv3,0,0.9919175376568502,252,121,3,376
129,bright,sv3,1,0.9918303428780619,241,126,2,369
129,bright,sv3,2,0.9888142353012374,231,131,5,367
129,bright,sv3,3,0.9882563927190271,241,112,7,360
129,bright,sv3,4,0.9925516355911612,245,122,5,372
129,bright,sv3,5,0.9846161851641906,238,135,1,374
129,bright,sv3,6,0.9851965578424059,222,125,4,351
129,bright,sv3,7,0.9826049920314985,200,122,0,322
129,bright,sv3,8,0.994147235186565,240,124,3,367
129,bright,sv3,9,0.9908720779537488,279,112,3,394
102,bright,sv3,0,0.9931223113368561,229,175,11,415
102,bright,sv3,1,0.9894150036623213,221,149,8,378
102,bright,sv3,2,0.9913228262363789,242,147,5,394
102,bright,sv3,3,0.9952472301302683,230,140,4,374
102,bright,sv3,4,0.9912832290131453,252,133,3,388
102,bright,sv3,5,0.991283091190536,221,155,10,386
102,bright,sv3,6,0.9959455478427995,194,149,3,346
102,bright,sv3,7,0.9943068479750959,195,146,6,347
102,bright,sv3,8,0.9929004204171015,239,157,4,400
102,bright,sv3,9,0.9935577857858903,230,159,3,392
560,bright,sv3,0,0.9923036723929157,98,342,0,440
560,bright,sv3,1,0.9950599994388507,79,323,2,404
560,bright,sv3,2,0.9918697863653017,86,319,3,408
560,bright,sv3,3,0.9942684386499716,72,263,1,336
560,bright,sv3,4,0.9909744033697432,70,329,3,402
560,bright,sv3,5,0.9919492727535233,97,304,7,408
560,bright,sv3,6,0.9931105960882509,90,281,3,374
560,bright,sv3,7,0.9950925251551201,98,273,1,372
560,bright,sv3,8,0.9893082098454085,83,345,2,430
560,bright,sv3,9,0.9929596175815503,116,313,2,431
544,dark,sv3,0,0.9954272599488427,299,13,63,375
544,dark,sv3,1,0.9968272942372781,286,11,60,357
544,dark,sv3,2,0.9929989428270773,307,15,51,373
544,dark,sv3,3,0.9958605238646421,261,18,68,347
544,dark,sv3,4,0.993362146118697,294,17,55,366
544,dark,sv3,5,0.9871949453806314,294,15,61,370
544,dark,sv3,6,0.9900065997994552,245,17,62,324
544,dark,sv3,7,0.9943787245614613,252,22,57,331
544,dark,sv3,8,0.9923281077832035,335,16,48,399
544,dark,sv3,9,0.9924991517562506,301,14,64,379
577,dark,sv3,0,0.9881591510187826,299,14,25,338
577,dark,sv3,1,0.9950881842705059,287,18,29,334
577,dark,sv3,2,0.9881279865390474,303,13,33,349
577,dark,sv3,3,0.9907349973648052,299,14,29,342
577,dark,sv3,4,0.9912976696824941,302,10,28,340
577,dark,sv3,5,0.9898398923219717,141,5,17,163
577,dark,sv3,6,0.9928983516252989,259,14,23,296
577,dark,sv3,7,0.9848341185189378,264,11,30,305
577,dark,sv3,8,0.9949481446829225,303,13,39,355
577,dark,sv3,9,0.9930236486939331,320,13,37,370
173,dark,sv3,0,0.9831862151273617,308,12,27,347
173,dark,sv3,1,0.9917144177838177,296,14,25,335
173,dark,sv3,2,0.9907834528914571,288,16,21,325
173,dark,sv3,3,0.9901107820682142,263,14,16,293
173,dark,sv3,4,0.9903744410509873,266,14,19,299
173,dark,sv3,5,0.9892771543320205,272,11,24,307
173,dark,sv3,6,0.9917975200155993,235,12,16,263
173,dark,sv3,7,0.9825888052642484,259,11,23,293
173,dark,sv3,8,0.9918321475034755,288,11,31,330
173,dark,sv3,9,0.9941561641858873,301,18,22,341
591,bright,sv3,0,0.9926878528053517,172,242,5,419
591,bright,sv3,1,0.9952362295877094,166,222,3,391
591,bright,sv3,2,0.9906313304609449,179,222,7,408
591,bright,sv3,3,0.992599915315053,190,189,2,381
591,bright,sv3,4,0.994506949892364,166,221,3,390
591,bright,sv3,5,0.9957172108041268,140,251,4,395
591,bright,sv3,6,0.9874295329948027,130,210,2,342
591,bright,sv3,7,0.9935097581336305,135,220,2,357
591,bright,sv3,8,0.9894634634583289,141,263,5,409
591,bright,sv3,9,0.9942522402443993,178,232,4,414
372,bright,sv3,0,0.9946264908380534,174,218,3,395
372,bright,sv3,1,0.992079079378957,150,199,4,353
372,bright,sv3,2,0.991077930662206,171,211,0,382
372,bright,sv3,3,0.9905185413780644,149,179,0,328
372,bright,sv3,4,0.9889982995140748,145,202,4,351
372,bright,sv3,5,0.9919126939062386,155,206,0,361
372,bright,sv3,6,0.9914213128367169,150,172,4,326
372,bright,sv3,7,0.9894606017951113,96,188,1,285
372,bright,sv3,8,0.9975485874314842,164,218,3,385
372,bright,sv3,9,0.9898160902012436,152,211,2,365
291,bright,sv3,0,0.9962216698035563,178,250,4,432
291,bright,sv3,1,0.9936141104514484,179,208,2,389
291,bright,sv3,2,0.9960620689393561,191,237,2,430
291,bright,sv3,3,0.9834937233627208,165,215,4,384
291,bright,sv3,4,0.9904995567083057,196,204,1,401
291,bright,sv3,5,0.9862446758572365,210,188,2,400
291,bright,sv3,6,0.9921543612189601,164,194,1,359
291,bright,sv3,7,0.9954788172406129,144,213,3,360
291,bright,sv3,8,0.9916128445472107,163,244,4,411
291,bright,sv3,9,0.9894351456057944,185,240,2,427
578,dark,sv3,0,0.9957131602464317,309,14,22,345
578,dark,sv3,1,0.9821178873812586,277,14,36,327
578,dark,sv3,2,0.9902294260754646,319,18,36,373
578,dark,sv3,3,0.9850667785645871,285,16,30,331
578,dark,sv3,4,0.9906457731312236,311,10,13,334
578,dark,sv3,5,0.9887896367073976,298,14,21,333
578,dark,sv3,6,0.9875962444758866,266,20,12,298
578,dark,sv3,7,0.9890081615524466,274,13,18,305
578,dark,sv3,8,0.9916886553334494,301,18,28,347
578,dark,sv3,9,0.9858754257876877,318,13,30,361
500,bright,sv3,0,0.994684149779656,233,175,1,409
500,bright,sv3,1,0.9922591360513554,202,165,4,371
500,bright,sv3,2,0.9956232722126224,224,161,1,386
500,bright,sv3,3,0.9950486812561992,219,153,2,374
500,bright,sv3,4,0.9919113949309895,242,144,5,391
500,bright,sv3,5,0.991055753505178,223,154,6,383
500,bright,sv3,6,0.9912570594028781,222,124,4,350
500,bright,sv3,7,0.994909719324343,203,136,3,342
500,bright,sv3,8,0.9873728574514163,225,164,4,393
500,bright,sv3,9,0.9917387548708518,243,159,4,406
531,bright,sv3,0,0.9866201032565988,156,266,5,427
531,bright,sv3,1,0.9941926312922152,135,253,5,393
531,bright,sv3,2,0.9925764906496456,152,254,2,408
531,bright,sv3,3,0.989724556049862,150,234,5,389
531,bright,sv3,4,0.9941093088587938,153,247,2,402
531,bright,sv3,5,0.9955124455918862,182,226,2,410
531,bright,sv3,6,0.9835856410068344,140,223,2,365
531,bright,sv3,7,0.9901237114607258,181,185,0,366
531,bright,sv3,8,0.991326650979152,174,251,2,427
531,bright,sv3,9,0.9942552169485659,155,273,0,428
561,bright,sv3,0,0.9898414138001134,84,355,1,440
561,bright,sv3,1,0.990758038973102,70,332,2,404
561,bright,sv3,2,0.9937245170036054,94,338,1,433
561,bright,sv3,3,0.9887370912907688,96,297,2,395
561,bright,sv3,4,0.990105094737918,79,324,4,407
561,bright,sv3,5,0.9932756570702082,75,323,10,408
561,bright,sv3,6,0.9810610916372459,70,301,1,372
561,bright,sv3,7,0.9905762134163897,62,305,3,370
561,bright,sv3,8,0.9903013551590337,67,357,1,425
561,bright,sv3,9,0.9949511011666906,100,332,2,434
545,dark,sv3,0,0.9921525334068884,300,18,55,373
545,dark,sv3,1,0.9875239623048505,277,13,66,356
545,dark,sv3,2,0.9942330365169857,320,15,46,381
545,dark,sv3,3,0.9901678142971707,269,16,48,333
545,dark,sv3,4,0.9963598091870872,285,13,48,346
545,dark,sv3,5,0.9936384921018786,302,14,53,369
545,dark,sv3,6,0.9910594015344414,251,17,55,323
545,dark,sv3,7,0.9886964942618525,236,22,58,316
545,dark,sv3,8,0.9928294174566837,309,14,40,363
545,dark,sv3,9,0.9897119980460511,276,15,66,357
103,bright,sv3,0,0.9935350794271585,242,160,6,408
103,bright,sv3,1,0.9946536125278952,228,139,5,372
103,bright,sv3,2,0.9887251716666,233,157,2,392
103,bright,sv3,3,0.9831419812280221,239,137,5,381
103,bright,sv3,4,0.9951787602622909,237,137,3,377
103,bright,sv3,5,0.9936001139447675,218,149,4,371
103,bright,sv3,6,0.9939316845046622,203,128,2,333
103,bright,sv3,7,0.9873026543531835,191,152,4,347
103,bright,sv3,8,0.9839780634617217,144,127,1,272
103,bright,sv3,9,0.9887435087646673,227,162,2,391
460,dark,sv3,0,0.9889611281854448,306,17,26,349
460,dark,sv3,1,0.9877792257877085,276,10,21,307
460,dark,sv3,2,0.9905361215153858,315,16,24,355
460,dark,sv3,3,0.9877313003145038,278,11,22,311
460,dark,sv3,4,0.9882052161007996,272,13,34,319
460,dark,sv3,5,0.9941723643392829,277,14,28,319
460,dark,sv3,6,0.9852149737116837,240,16,29,285
460,dark,sv3,7,0.9928477342595923,243,12,22,277
460,dark,sv3,8,0.9845411114711569,273,12,28,313
460,dark,sv3,9,0.9945415727644399,274,18,18,310
488,dark,sv3,0,0.9948546386861723,327,12,37,376
488,dark,sv3,1,0.9921223586837178,285,11,26,322
488,dark,sv3,2,0.9916397562002156,328,13,17,358
488,dark,sv3,3,0.989373144328813,287,12,23,322
488,dark,sv3,4,0.9876420770497392,318,11,16,345
488,dark,sv3,5,0.9887822447644289,297,13,24,334
488,dark,sv3,6,0.9904539616861007,258,11,25,294
488,dark,sv3,7,0.9832150165125815,258,12,26,296
488,dark,sv3,8,0.988853923523267,316,12,23,351
488,dark,sv3,9,0.9867215676712463,303,15,24,342
80865,unwisegreen,sv1,0,0.9929063663537895,320,21,7,348
80865,unwisegreen,sv1,1,0.9929637907046369,296,16,9,321
80865,unwisegreen,sv1,2,0.9909130106991592,319,19,6,344
80865,unwisegreen,sv1,3,0.9917166258814649,300,18,6,324
80865,unwisegreen,sv1,4,0.9885233330564307,292,19,7,318
80865,unwisegreen,sv1,5,0.98597845132053,303,16,6,325
80865,unwisegreen,sv1,6,0.9903887334427647,281,22,1,304
80865,unwisegreen,sv1,7,0.9897196465796031,265,13,8,286
80865,unwisegreen,sv1,8,0.9905726335245687,328,19,5,352
80865,unwisegreen,sv1,9,0.9921173671399315,330,19,3,352
592,bright,sv3,0,0.99399981447334,189,221,1,411
592,bright,sv3,1,0.9973759437466715,173,217,3,393
592,bright,sv3,2,0.9947584750564474,205,212,4,421
592,bright,sv3,3,0.9919929550922799,171,202,5,378
592,bright,sv3,4,0.9867504687653158,149,246,2,397
592,bright,sv3,5,0.9889834413019898,161,235,0,396
592,bright,sv3,6,0.9904438449226277,126,216,3,345
592,bright,sv3,7,0.9944675488207805,127,216,1,344
592,bright,sv3,8,0.9924587282756654,176,228,2,406
592,bright,sv3,9,0.9946445526340486,173,238,2,413
237,bright,sv3,0,0.9888106727012294,173,249,0,422
237,bright,sv3,1,0.9925272379883641,132,257,4,393
237,bright,sv3,2,0.9925602090710094,160,258,2,420
237,bright,sv3,3,0.9803439064806704,186,208,1,395
237,bright,sv3,4,0.9916556606761774,175,216,3,394
237,bright,sv3,5,0.9878371129604285,187,219,2,408
237,bright,sv3,6,0.9925332130967189,157,206,1,364
237,bright,sv3,7,0.9878748714031205,131,223,3,357
237,bright,sv3,8,0.9930812861436311,150,264,5,419
237,bright,sv3,9,0.9756937909685045,178,243,1,422
81099,dark,sv2,0,0.994824194306919,241,10,73,324
81099,dark,sv2,1,0.9886373284585915,248,10,57,315
81099,dark,sv2,2,0.9937169525234973,241,10,69,320
81099,dark,sv2,3,0.9936763082213667,241,12,60,313
81099,dark,sv2,4,0.9815358335866035,246,11,60,317
81099,dark,sv2,5,0.9822797804842792,253,10,48,311
81099,dark,sv2,6,0.9908943754913823,202,10,62,274
81099,dark,sv2,7,0.981562865076904,216,9,62,287
81099,dark,sv2,8,0.9899575562684192,235,10,73,318
81099,dark,sv2,9,0.9906022639324737,232,11,71,314
452,dark,sv3,0,0.9882258052430385,313,11,33,357
452,dark,sv3,1,0.9916989837451797,279,11,42,332
452,dark,sv3,2,0.9897891929402459,313,15,41,369
452,dark,sv3,3,0.9921143430663233,307,14,21,342
452,dark,sv3,4,0.996350316606411,291,15,23,329
452,dark,sv3,5,0.9910214184337258,297,16,22,335
452,dark,sv3,6,0.9909121951388761,259,12,19,290
452,dark,sv3,7,0.9894506659950123,274,18,20,312
452,dark,sv3,8,0.9907612137957867,311,9,22,342
452,dark,sv3,9,0.9911565929305584,303,17,26,346
489,dark,sv3,0,0.9907633646910619,264,11,32,307
489,dark,sv3,1,0.9833559464626257,286,14,17,317
489,dark,sv3,2,0.9935399238297589,292,11,21,324
489,dark,sv3,3,0.9903519481142462,294,12,12,318
489,dark,sv3,4,0.986448882712778,295,11,12,318
489,dark,sv3,5,0.985148643356206,289,9,29,327
489,dark,sv3,6,0.9888070692098226,237,12,18,267
489,dark,sv3,7,0.989420081908701,239,14,22,275
489,dark,sv3,8,0.9939011978867321,291,13,29,333
489,dark,sv3,9,0.9910587162497516,298,13,29,340
75,bright,sv3,0,0.993728827761911,231,181,5,417
75,bright,sv3,1,0.9938947669690944,222,163,5,390
75,bright,sv3,2,0.9935637457347332,219,182,2,403
75,bright,sv3,3,0.9943580857153829,228,148,1,377
75,bright,sv3,4,0.990983500799372,220,164,3,387
75,bright,sv3,5,0.992516531078151,243,148,0,391
75,bright,sv3,6,0.9885946283128568,217,128,3,348
75,bright,sv3,7,0.9886830684597038,167,170,4,341
75,bright,sv3,8,0.9849915059359289,244,158,3,405
75,bright,sv3,9,0.9910570138197788,227,175,5,407
80972,dc3r2,sv1,0,0.9958000582782833,316,23,9,348
80972,dc3r2,sv1,1,0.9942336846341218,345,33,16,394
80972,dc3r2,sv1,2,0.9956599614107742,398,27,5,430
80972,dc3r2,sv1,3,0.9851686612435577,362,19,12,393
80972,dc3r2,sv1,4,0.995593921593895,368,25,13,406
80972,dc3r2,sv1,5,0.9948960768360089,357,31,16,404
80972,dc3r2,sv1,6,0.9913536147512206,331,27,9,367
80972,dc3r2,sv1,7,0.9915754015706638,333,23,7,363
80972,dc3r2,sv1,8,0.9931939713907588,360,39,20,419
80972,dc3r2,sv1,9,0.9935212320201933,379,31,11,421
562,bright,sv3,0,0.9840121563052491,95,251,2,348
562,bright,sv3,1,0.9888652800920342,85,312,1,398
562,bright,sv3,2,0.9900738669344317,99,333,0,432
562,bright,sv3,3,0.9936041559501175,92,307,3,402
562,bright,sv3,4,0.9969491406690252,82,326,1,409
562,bright,sv3,5,0.9955718271869244,78,333,1,412
562,bright,sv3,6,0.9890066227129376,71,301,1,373
562,bright,sv3,7,0.9876040665875961,58,306,2,366
562,bright,sv3,8,0.9936340475559091,89,336,2,427
562,bright,sv3,9,0.9961878799115734,102,332,1,435
546,dark,sv3,0,0.9898694460278745,237,11,27,275
546,dark,sv3,1,0.9904768805997963,283,12,44,339
546,dark,sv3,2,0.9935920641238609,305,14,40,359
546,dark,sv3,3,0.9914837634872972,290,15,35,340
546,dark,sv3,4,0.9917825756164368,299,12,43,354
546,dark,sv3,5,0.9899250583319882,282,16,46,344
546,dark,sv3,6,0.9900795006170777,239,21,46,306
546,dark,sv3,7,0.9864765380859564,233,19,53,305
546,dark,sv3,8,0.9850882039455796,287,19,36,342
546,dark,sv3,9,0.9941143139897965,309,13,37,359
501,bright,sv3,0,0.9866572009539557,232,171,8,411
501,bright,sv3,1,0.9944191444960031,194,175,6,375
501,bright,sv3,2,0.9931687531024923,225,173,6,404
501,bright,sv3,3,0.9960660846492145,223,144,0,367
501,bright,sv3,4,0.9967846568571633,246,138,2,386
501,bright,sv3,5,0.9857136977329121,226,149,3,378
501,bright,sv3,6,0.9955128333730718,205,138,5,348
501,bright,sv3,7,0.9942307518930543,206,132,4,342
501,bright,sv3,8,0.9906527614139259,237,159,5,401
501,bright,sv3,9,0.995337445009873,255,155,2,412
516,dark,sv3,0,0.9893056964565484,236,8,16,260
516,dark,sv3,1,0.9854107569044758,267,10,38,315
516,dark,sv3,2,0.9917547136340636,264,14,45,323
516,dark,sv3,3,0.9928121925591091,264,13,32,309
516,dark,sv3,4,0.9918180843730433,260,9,44,313
516,dark,sv3,5,0.9904879448302583,267,14,41,322
516,dark,sv3,6,0.9887955657676822,247,11,35,293
516,dark,sv3,7,0.9911051212384513,237,12,37,286
516,dark,sv3,8,0.993449507373608,276,16,34,326
516,dark,sv3,9,0.9886629658979372,304,10,26,340
593,bright,sv3,0,0.9887470790511317,149,182,0,331
593,bright,sv3,1,0.9909344986231109,168,217,1,386
593,bright,sv3,2,0.9954725814937386,195,224,4,423
593,bright,sv3,3,0.9949333000832364,161,212,3,376
593,bright,sv3,4,0.9939920604472812,166,219,1,386
593,bright,sv3,5,0.9866070701458568,167,216,5,388
593,bright,sv3,6,0.9911108275565725,131,216,5,352
593,bright,sv3,7,0.9891611879163584,148,201,2,351
593,bright,sv3,8,0.9914677252168469,167,237,3,407
593,bright,sv3,9,0.9945072515308574,187,230,2,419
80869,scndhetdex,sv1,0,0.9816338462291974,191,73,19,283
80869,scndhetdex,sv1,1,0.9899593720232442,140,62,26,228
80869,scndhetdex,sv1,2,0.9894541883591002,170,55,26,251
80869,scndhetdex,sv1,3,0.9822055756851946,187,55,23,265
80869,scndhetdex,sv1,4,0.9894557637104078,182,77,26,285
80869,scndhetdex,sv1,5,0.9808920603743078,184,82,19,285
80869,scndhetdex,sv1,6,0.9865382151769744,138,63,17,218
80869,scndhetdex,sv1,7,0.9836733561939817,114,53,24,191
80869,scndhetdex,sv1,8,0.993786937368151,164,77,32,273
80869,scndhetdex,sv1,9,0.9789075753745266,193,46,24,263
579,dark,sv3,0,0.9883224088374968,237,13,17,267
579,dark,sv3,1,0.991813782080707,270,16,24,310
579,dark,sv3,2,0.9929852025589639,294,16,17,327
579,dark,sv3,3,0.9882392283864336,283,16,21,320
579,dark,sv3,4,0.9918763746893312,285,12,22,319
579,dark,sv3,5,0.99061956963476,282,11,19,312
579,dark,sv3,6,0.9795409719836216,247,12,20,279
579,dark,sv3,7,0.9925259864249536,256,13,22,291
579,dark,sv3,8,0.9904798714754813,282,18,33,333
579,dark,sv3,9,0.9880019866335287,317,14,23,354
532,bright,sv3,0,0.9933603444684874,185,243,2,430
532,bright,sv3,1,0.9945450671085425,152,229,4,385
532,bright,sv3,2,0.9920170532422024,167,244,3,414
532,bright,sv3,3,0.9941770090564049,150,226,2,378
532,bright,sv3,4,0.9929357704414049,140,245,3,388
532,bright,sv3,5,0.9890261448706367,158,242,0,400
532,bright,sv3,6,0.987832447825468,146,219,3,368
532,bright,sv3,7,0.9862188251475356,165,189,4,358
532,bright,sv3,8,0.9895678681159474,148,256,1,405
532,bright,sv3,9,0.9928794200525586,177,246,1,424
547,dark,sv3,0,0.9926731055565672,308,17,28,353
547,dark,sv3,1,0.9896228789186587,284,16,29,329
547,dark,sv3,2,0.9890439992368562,272,18,35,325
547,dark,sv3,3,0.9845468790277019,287,15,34,336
547,dark,sv3,4,0.9783232533442472,295,12,40,347
547,dark,sv3,5,0.988656120243761,233,17,28,278
547,dark,sv3,6,0.9965412329716411,248,23,23,294
547,dark,sv3,7,0.9917497946068455,231,19,44,294
547,dark,sv3,8,0.9899356829681838,295,16,30,341
547,dark,sv3,9,0.988373489990581,284,14,31,329
563,bright,sv3,0,0.9922468660046001,99,341,1,441
563,bright,sv3,1,0.9901558283094799,81,310,2,393
563,bright,sv3,2,0.9934620784119966,107,316,0,423
563,bright,sv3,3,0.9893137740955259,84,308,1,393
563,bright,sv3,4,0.9894201870868328,77,323,2,402
563,bright,sv3,5,0.9920206354799717,82,249,4,335
563,bright,sv3,6,0.9925510761435082,79,286,2,367
563,bright,sv3,7,0.9926903042319281,74,289,2,365
563,bright,sv3,8,0.9928922032015797,92,335,1,428
563,bright,sv3,9,0.9902123549479223,109,316,1,426
594,bright,sv3,0,0.9962116576574908,190,234,1,425
594,bright,sv3,1,0.9931238654283466,172,213,4,389
594,bright,sv3,2,0.9920395631980308,202,194,2,398
594,bright,sv3,3,0.9856870150859349,189,191,1,381
594,bright,sv3,4,0.9927300013671996,156,232,2,390
594,bright,sv3,5,0.9933264941712151,147,168,2,317
594,bright,sv3,6,0.9936178986985758,146,191,5,342
594,bright,sv3,7,0.9919005901958956,152,201,1,354
594,bright,sv3,8,0.9932077221245001,200,200,6,406
594,bright,sv3,9,0.9943792000677277,192,220,2,414
580,dark,sv3,0,0.9933022043692544,291,15,27,333
580,dark,sv3,1,0.9904003636403681,266,15,25,306
580,dark,sv3,2,0.9909959150854096,278,15,38,331
580,dark,sv3,3,0.9914465404559273,275,20,24,319
580,dark,sv3,4,0.9869665229638617,280,17,17,314
580,dark,sv3,5,0.9890164717054385,221,12,18,251
580,dark,sv3,6,0.9815196879788917,251,19,12,282
580,dark,sv3,7,0.9868398086493522,247,15,20,282
580,dark,sv3,8,0.9935805348988994,298,16,17,331
580,dark,sv3,9,0.9825241834193111,305,17,17,339
80872,scndcosmos,sv1,0,0.9885766390394608,168,19,29,216
80872,scndcosmos,sv1,1,0.9756812092035905,157,22,20,199
80872,scndcosmos,sv1,2,0.9851866926649573,164,21,34,219
80872,scndcosmos,sv1,3,0.9862521797469916,206,18,14,238
80872,scndcosmos,sv1,4,0.9792475054204381,160,18,25,203
80872,scndcosmos,sv1,5,0.987199889425575,177,32,31,240
80872,scndcosmos,sv1,6,0.9812546481637211,152,11,30,193
80872,scndcosmos,sv1,7,0.9842334146286617,135,16,15,166
80872,scndcosmos,sv1,8,0.9882165375989508,164,26,39,229
80872,scndcosmos,sv1,9,0.9904425250265331,186,34,23,243
502,bright,sv3,0,0.9955103438383318,262,149,3,414
502,bright,sv3,1,0.9950626134724849,214,158,1,373
502,bright,sv3,2,0.992510117482763,247,143,4,394
502,bright,sv3,3,0.9842561624314038,226,135,4,365
502,bright,sv3,4,0.9935177622253294,255,135,5,395
502,bright,sv3,5,0.994115860005553,227,154,1,382
502,bright,sv3,6,0.9941080150776272,212,127,3,342
502,bright,sv3,7,0.994429280157189,202,137,2,341
502,bright,sv3,8,0.9921726671735879,226,176,3,405
502,bright,sv3,9,0.9949327442749625,266,142,5,413
65,dark,sv3,0,0.9934346471406605,285,17,28,330
65,dark,sv3,1,0.9902435343875398,258,14,22,294
65,dark,sv3,2,0.9908945639580758,280,16,16,312
65,dark,sv3,3,0.9887982178254312,260,15,14,289
65,dark,sv3,4,0.9901643843830319,279,18,14,311
65,dark,sv3,5,0.994048266955303,250,18,19,287
65,dark,sv3,6,0.9881288368721747,214,13,18,245
65,dark,sv3,7,0.9859752026030161,241,12,18,271
65,dark,sv3,8,0.9915565423298833,288,16,23,327
65,dark,sv3,9,0.9898457264944865,292,14,23,329
517,dark,sv3,0,0.9908460601854591,268,14,23,305
517,dark,sv3,1,0.9900298439350841,251,13,26,290
517,dark,sv3,2,0.989554018482153,261,15,27,303
517,dark,sv3,3,0.9926395464383738,274,17,28,319
517,dark,sv3,4,0.9930435408680275,250,11,30,291
517,dark,sv3,5,0.9840498337735732,286,11,25,322
517,dark,sv3,6,0.9853823715860548,231,15,33,279
517,dark,sv3,7,0.978245564286476,242,12,22,276
517,dark,sv3,8,0.9839803860658733,256,13,22,291
517,dark,sv3,9,0.9924572684214916,294,13,21,328
38,dark,sv3,0,0.9876022341323994,301,16,18,335
38,dark,sv3,1,0.9894028152581614,272,14,19,305
38,dark,sv3,2,0.9911200296591195,281,17,16,314
38,dark,sv3,3,0.9977391046690651,285,17,17,319
38,dark,sv3,4,0.9903061493739793,267,18,15,300
38,dark,sv3,5,0.9942853109618404,264,12,12,288
38,dark,sv3,6,0.9900416872421409,241,13,13,267
38,dark,sv3,7,0.9836633343737313,247,14,19,280
38,dark,sv3,8,0.9928836072474367,292,19,22,333
38,dark,sv3,9,0.9891370100155142,284,16,25,325
490,dark,sv3,0,0.9880482973726692,300,15,28,343
490,dark,sv3,1,0.9898981360453311,277,12,25,314
490,dark,sv3,2,0.988461705866083,263,18,22,303
490,dark,sv3,3,0.986617690970704,276,11,14,301
490,dark,sv3,4,0.9816710789315303,287,9,11,307
490,dark,sv3,5,0.9932913920266898,286,12,20,318
490,dark,sv3,6,0.9889819356535351,261,13,18,292
490,dark,sv3,7,0.9891955815296842,242,12,18,272
490,dark,sv3,8,0.9836643694667647,279,11,21,311
490,dark,sv3,9,0.9941244219804144,294,12,19,325
81101,dark,special,0,0.9914062959557295,105,10,44,159
81101,dark,special,1,0.9892519459870184,96,12,38,146
81101,dark,special,2,0.9642552517370325,98,10,52,160
81101,dark,special,3,0.9710692244064617,90,10,47,147
81101,dark,special,4,0.9871478472613409,94,9,46,149
81101,dark,special,5,0.9867053815979018,92,9,52,153
81101,dark,special,6,0.9751338134335726,91,10,29,130
81101,dark,special,7,0.9882199123738065,109,9,29,147
81101,dark,special,8,0.9716214919189249,103,11,41,155
81101,dark,special,9,0.9791336668832255,103,10,41,154
81102,dark,special,0,0.9886385993833554,155,10,55,220
81102,dark,special,1,0.9824555183880359,135,11,50,196
81102,dark,special,2,0.9796605935113057,135,10,70,215
81102,dark,special,3,0.9776246336313266,134,10,59,203
81102,dark,special,4,0.9846774284960983,138,10,55,203
81102,dark,special,5,0.9897529247386904,139,10,59,208
81102,dark,special,6,0.9750668705769167,128,11,43,182
81102,dark,special,7,0.9867832119441262,137,9,40,186
81102,dark,special,8,0.9849155731476515,145,11,56,212
81102,dark,special,9,0.9868927283030947,152,10,54,216
81103,dark,special,0,0.9787900253258666,97,9,44,150
81103,dark,special,1,0.9813965202974908,85,12,40,137
81103,dark,special,2,0.9753019053570833,81,10,46,137
81103,dark,special,3,0.978683153686745,74,10,42,126
81103,dark,special,4,0.9754577530720381,78,10,41,129
81103,dark,special,5,0.9820753068386073,89,10,52,151
81103,dark,special,6,0.9498546870308473,86,10,34,130
81103,dark,special,7,0.9836512895774888,90,9,24,123
81103,dark,special,8,0.9860540644699064,86,11,42,139
81103,dark,special,9,0.993232532904346,101,10,41,152
81105,dark,special,0,0.990504575174265,143,10,52,205
81105,dark,special,1,0.9830365152842797,126,12,52,190
81105,dark,special,2,0.9777458519703809,118,10,60,188
81105,dark,special,3,0.9772228287112056,112,10,56,178
81105,dark,special,4,0.9797386271125367,136,10,51,197
81105,dark,special,5,0.9910594211097238,130,10,61,201
81105,dark,special,6,0.9796935833008509,116,10,40,166
81105,dark,special,7,0.9849801821312293,132,10,33,175
81105,dark,special,8,0.9839824335404008,139,11,56,206
81105,dark,special,9,0.9915478652085713,166,10,51,227
81104,dark,special,0,0.9879911594591294,144,10,55,209
81104,dark,special,1,0.9795771051794183,127,12,56,195
81104,dark,special,2,0.9843610987853654,123,10,67,200
81104,dark,special,3,0.9889769143102943,125,10,58,193
81104,dark,special,4,0.9896534375529086,144,10,51,205
81104,dark,special,5,0.9854377914537947,140,10,65,215
81104,dark,special,6,0.980395892715827,136,10,37,183
81104,dark,special,7,0.9733033667103244,151,9,33,193
81104,dark,special,8,0.9950163780473844,145,10,53,208
81104,dark,special,9,0.9894613924899895,152,10,56,218
81106,dark,special,0,0.9812086793551645,146,10,49,205
81106,dark,special,1,0.9784268608343882,130,12,56,198
81106,dark,special,2,0.9754358040694504,135,10,68,213
81106,dark,special,3,0.9726488162079413,133,10,65,208
81106,dark,special,4,0.9873353963616243,147,10,47,204
81106,dark,special,5,0.9883113612073677,119,10,66,195
81106,dark,special,6,0.9726536905569781,128,10,40,178
81106,dark,special,7,0.9900525562656417,156,10,34,200
81106,dark,special,8,0.9891547196410589,142,11,61,214
81106,dark,special,9,0.9945432112923425,164,10,56,230
81107,dark,special,0,0.9862750339583889,155,9,49,213
81107,dark,special,1,0.9867372729437648,127,11,48,186
81107,dark,special,2,0.9885592480899793,135,10,63,208
81107,dark,special,3,0.9797311121788851,107,10,58,175
81107,dark,special,4,0.9884294297666576,138,10,52,200
81107,dark,special,5,0.9824352878646259,105,10,60,175
81107,dark,special,6,0.977262983743057,124,10,36,170
81107,dark,special,7,0.9866836921327689,145,10,35,190
81107,dark,special,8,0.9859852357498384,137,11,53,201
81107,dark,special,9,0.9829772825304599,153,10,52,215
80974,dc3r2,sv1,0,0.9813203167864003,413,30,1,444
80974,dc3r2,sv1,1,0.9944615809666654,375,19,3,397
80974,dc3r2,sv1,2,0.9949336672238893,398,30,0,428
80974,dc3r2,sv1,3,0.9917234842987337,370,29,0,399
80974,dc3r2,sv1,4,0.9884207628617514,384,23,2,409
80974,dc3r2,sv1,5,0.9933583067555654,319,16,1,336
80974,dc3r2,sv1,6,0.9909529243070678,344,24,1,369
80974,dc3r2,sv1,7,0.9912721521725345,340,30,1,371
80974,dc3r2,sv1,8,0.9924420055830502,394,30,1,425
80974,dc3r2,sv1,9,0.9900672643857338,397,32,1,430
80971,dc3r2,sv1,0,0.9947963795964111,397,24,9,430
80971,dc3r2,sv1,1,0.9946340682444731,343,31,13,387
80971,dc3r2,sv1,2,0.9950433040952463,388,27,5,420
80971,dc3r2,sv1,3,0.9877063545875999,336,40,15,391
80971,dc3r2,sv1,4,0.9952491422676059,332,35,24,391
80971,dc3r2,sv1,5,0.9931874641109927,369,23,14,406
80971,dc3r2,sv1,6,0.9907136455875446,311,32,21,364
80971,dc3r2,sv1,7,0.983943166806361,311,33,15,359
80971,dc3r2,sv1,8,0.9927591532273821,364,35,16,415
80971,dc3r2,sv1,9,0.9914612826033617,381,29,17,427
81100,dark,special,0,0.9966960076630306,191,10,60,261
81100,dark,special,1,0.9797219951124034,170,13,68,251
81100,dark,special,2,0.9849337574274238,186,10,78,274
81100,dark,special,3,0.9847091784697877,157,10,73,240
81100,dark,special,4,0.9828349524186518,167,10,62,239
81100,dark,special,5,0.9893389024407434,171,9,76,256
81100,dark,special,6,0.9900723367945181,158,10,56,224
81100,dark,special,7,0.9914978815311913,184,10,47,241
81100,dark,special,8,0.9943837191709133,178,11,69,258
81100,dark,special,9,0.9901562585630195,185,10,68,263
81109,dark,special,0,0.9437482149844744,42,9,10,61
81109,dark,special,1,0.9354945538855028,35,9,11,55
81109,dark,special,2,0.9114280986717255,45,9,12,66
81109,dark,special,3,0.9388506374288779,47,11,17,75
81109,dark,special,4,0.8935321003066309,33,9,17,59
81109,dark,special,5,0.963586140322523,48,10,13,71
81109,dark,special,6,0.9716749735216554,50,7,12,69
81109,dark,special,7,0.9794729309439514,47,10,11,68
81109,dark,special,8,0.9222020379359525,31,8,10,49
81109,dark,special,9,0.95308071367753,43,12,15,70
81110,dark,special,0,0.9596257277983709,59,8,9,76
81110,dark,special,1,0.9810089025912951,53,9,26,88
81110,dark,special,2,0.9364438578931307,48,9,15,72
81110,dark,special,3,0.9175711532267953,46,10,10,66
81110,dark,special,4,0.9362863545700794,44,12,21,77
81110,dark,special,5,0.9792296758016339,49,9,21,79
81110,dark,special,6,0.9379180108237412,47,9,15,71
81110,dark,special,7,0.9104163585059797,47,16,24,87
81110,dark,special,8,0.9699688261840904,43,12,26,81
81110,dark,special,9,0.9726515241678946,58,13,15,86
81111,dark,special,0,0.9865527686498237,89,11,55,155
81111,dark,special,1,0.9751914306985529,91,10,39,140
81111,dark,special,2,0.960961457819139,107,9,29,145
81111,dark,special,3,0.9777626518988081,101,10,47,158
81111,dark,special,4,0.987694477339716,96,11,45,152
81111,dark,special,5,0.972428956181122,97,11,45,153
81111,dark,special,6,0.963967170216709,93,12,27,132
81111,dark,special,7,0.9791822950654259,76,9,34,119
81111,dark,special,8,0.9782259647307532,92,11,56,159
81111,dark,special,9,0.9738332522346866,115,12,41,168
81108,dark,special,0,0.9388181033864219,55,10,20,85
81108,dark,special,1,0.9497002503195427,54,10,16,80
81108,dark,special,2,0.9672181638390641,54,9,23,86
81108,dark,special,3,0.9450247464980569,58,11,18,87
81108,dark,special,4,0.9633991401332096,61,6,17,84
81108,dark,special,5,0.9719590910314406,56,10,30,96
81108,dark,special,6,0.9555210282359768,42,7,10,59
81108,dark,special,7,0.9304569545387927,50,12,13,75
81108,dark,special,8,0.9833824334420381,64,10,22,96
81108,dark,special,9,0.9468580923051501,43,9,17,69
445,dark,sv3,0,0.9897936420375235,292,11,17,320
445,dark,sv3,1,0.9905424226874664,285,17,9,311
445,dark,sv3,2,0.9862614724746321,308,17,13,338
445,dark,sv3,3,0.9932494253930584,280,11,29,320
445,dark,sv3,4,0.9910247639159643,266,15,32,313
445,dark,sv3,5,0.988872165139284,264,16,23,303
445,dark,sv3,6,0.9928492338261161,237,15,28,280
445,dark,sv3,7,0.9868807947742527,228,17,17,262
445,dark,sv3,8,0.9902625112629665,278,21,16,315
445,dark,sv3,9,0.9872772758338455,297,16,19,332
80870,scndhetdex,sv1,0,0.983505830819746,183,120,25,328
80870,scndhetdex,sv1,1,0.9910699728017407,140,85,15,240
80870,scndhetdex,sv1,2,0.9852345816227733,134,65,26,225
80870,scndhetdex,sv1,3,0.9790504762320096,186,62,10,258
80870,scndhetdex,sv1,4,0.984623239565745,152,106,12,270
80870,scndhetdex,sv1,5,0.9912444729728371,151,121,21,293
80870,scndhetdex,sv1,6,0.9888613914778992,126,101,15,242
80870,scndhetdex,sv1,7,0.9854322837778039,143,62,19,224
80870,scndhetdex,sv1,8,0.9842513789652662,139,64,13,216
80870,scndhetdex,sv1,9,0.9945480503013264,146,97,17,260
81112,dark,special,0,0.9890036363730969,110,57,46,213
81112,dark,special,1,0.9892597450537965,133,35,46,214
81112,dark,special,2,0.9726299872057436,133,35,39,207
81112,dark,special,3,0.9863610170198684,152,34,37,223
81112,dark,special,4,0.9734037308368616,123,28,54,205
81112,dark,special,5,0.9808305676523292,145,25,59,229
81112,dark,special,6,0.9892184829098247,126,24,39,189
81112,dark,special,7,0.9857054703127989,138,33,38,209
81112,dark,special,8,0.9806399176620608,153,35,39,227
81112,dark,special,9,0.9898874815140587,151,36,45,232
81113,dark,special,0,0.9557504069207671,62,11,33,106
81113,dark,special,1,0.9764284787900543,74,10,26,110
81113,dark,special,2,0.9568662446256001,64,10,33,107
81113,dark,special,3,0.9810880173529769,78,9,27,114
81113,dark,special,4,0.9140087837144181,58,10,32,100
81113,dark,special,5,0.963732314456998,69,9,37,115
81113,dark,special,6,0.9635055706584981,64,10,26,100
81113,dark,special,7,0.9765982217678295,74,10,29,113
81113,dark,special,8,0.9696684589238828,76,9,26,111
81113,dark,special,9,0.9710971236386754,76,9,40,125
81115,dark,special,0,0.9675953815989099,95,15,42,152
81115,dark,special,1,0.9850408699407704,103,14,23,140
81115,dark,special,2,0.9833441459156868,109,11,38,158
81115,dark,special,3,0.9727298837562026,108,17,42,167
81115,dark,special,4,0.9770699969415751,100,15,27,142
81115,dark,special,5,0.9792898595823256,91,23,42,156
81115,dark,special,6,0.9834664169947889,98,14,20,132
81115,dark,special,7,0.9776696703668062,97,19,35,151
81115,dark,special,8,0.9747343213444675,95,12,26,133
81115,dark,special,9,0.9663899635576368,120,11,20,151
80975,dc3r2,sv1,0,0.9944151175400954,421,21,0,442
80975,dc3r2,sv1,1,0.9957570693232336,381,24,1,406
80975,dc3r2,sv1,2,0.9882572132711898,417,18,0,435
80975,dc3r2,sv1,3,0.993174885572283,384,17,0,401
80975,dc3r2,sv1,4,0.9923196656756968,395,16,0,411
80975,dc3r2,sv1,5,0.9930689693248932,387,21,3,411
80975,dc3r2,sv1,6,0.9944643294658928,347,23,0,370
80975,dc3r2,sv1,7,0.9926240874047059,343,20,1,364
80975,dc3r2,sv1,8,0.9942864381855115,396,29,1,426
80975,dc3r2,sv1,9,0.9945228466697759,405,23,1,429
581,dark,sv3,0,0.9941606883920399,314,21,22,357
581,dark,sv3,1,0.9885520982548616,279,14,22,315
581,dark,sv3,2,0.9902082130127898,295,16,27,338
581,dark,sv3,3,0.9881522446886413,271,15,22,308
581,dark,sv3,4,0.9932206097586559,278,19,27,324
581,dark,sv3,5,0.9899290943368325,275,12,17,304
581,dark,sv3,6,0.9906440672065042,261,18,18,297
581,dark,sv3,7,0.984897428525336,244,15,28,287
581,dark,sv3,8,0.9866046250172624,302,18,34,354
581,dark,sv3,9,0.9908181836356368,309,14,26,349
491,dark,sv3,0,0.9945148283252621,316,18,22,356
491,dark,sv3,1,0.986833039446673,280,12,23,315
491,dark,sv3,2,0.9899196576636033,274,17,23,314
491,dark,sv3,3,0.9885284384855008,268,14,11,293
491,dark,sv3,4,0.993038347410202,278,12,10,300
491,dark,sv3,5,0.9872008254859503,303,15,18,336
491,dark,sv3,6,0.987802351771944,264,14,17,295
491,dark,sv3,7,0.9965410921976777,253,15,27,295
491,dark,sv3,8,0.9910478371842127,290,12,26,328
491,dark,sv3,9,0.9951749328436713,293,14,32,339
564,bright,sv3,0,0.9921956517183108,128,310,0,438
564,bright,sv3,1,0.9956657070006818,97,300,3,400
564,bright,sv3,2,0.9920857995558242,122,297,4,423
564,bright,sv3,3,0.9918550783655087,130,268,1,399
564,bright,sv3,4,0.9931652693575951,99,301,3,403
564,bright,sv3,5,0.9959304665382864,99,311,0,410
564,bright,sv3,6,0.9896036069878522,81,287,2,370
564,bright,sv3,7,0.9907531703369665,76,292,0,368
564,bright,sv3,8,0.9896153022049089,103,319,1,423
564,bright,sv3,9,0.9865252029569205,128,298,5,431
503,bright,sv3,0,0.9914680785900617,258,155,3,416
503,bright,sv3,1,0.9911123493909344,225,144,1,370
503,bright,sv3,2,0.9897117621780157,250,132,5,387
503,bright,sv3,3,0.9912830524239739,240,134,3,377
503,bright,sv3,4,0.9907556155752427,240,140,3,383
503,bright,sv3,5,0.9962099322493412,249,130,5,384
503,bright,sv3,6,0.9922436351917212,223,123,2,348
503,bright,sv3,7,0.9950666557288882,216,127,5,348
503,bright,sv3,8,0.9903489378032488,225,174,3,402
503,bright,sv3,9,0.9923435457047034,281,122,3,406
466,dark,sv3,0,0.9899441365816122,243,15,15,273
466,dark,sv3,1,0.9915008729886032,231,18,13,262
466,dark,sv3,2,0.9880126609560568,252,19,22,293
466,dark,sv3,3,0.9880471946240752,241,16,35,292
466,dark,sv3,4,0.9912392856579207,244,16,25,285
466,dark,sv3,5,0.9910987162872364,244,15,30,289
466,dark,sv3,6,0.9849515715748295,216,16,15,247
466,dark,sv3,7,0.9841934354581737,197,16,12,225
466,dark,sv3,8,0.9903830804302896,244,19,18,281
466,dark,sv3,9,0.9879200316791198,235,18,14,267
448,dark,sv3,0,0.9892188073728092,301,15,23,339
448,dark,sv3,1,0.9923752350834085,283,16,17,316
448,dark,sv3,2,0.9928553663843676,294,19,23,336
448,dark,sv3,3,0.9912373257749312,260,17,22,299
448,dark,sv3,4,0.9892670517034938,297,18,14,329
448,dark,sv3,5,0.9862569176572861,269,19,24,312
448,dark,sv3,6,0.9863901261703235,246,11,17,274
448,dark,sv3,7,0.9864775100785486,218,15,23,256
448,dark,sv3,8,0.9887535087493858,286,17,28,331
448,dark,sv3,9,0.9923491063589499,279,15,46,340
518,dark,sv3,0,0.9910169589605656,287,16,17,320
518,dark,sv3,1,0.9919162939063337,274,13,27,314
518,dark,sv3,2,0.9880363781301266,267,18,35,320
518,dark,sv3,3,0.9899066441313139,259,17,33,309
518,dark,sv3,4,0.984868043351548,282,11,16,309
518,dark,sv3,5,0.9867655063878717,267,14,32,313
518,dark,sv3,6,0.9920617579287613,264,17,16,297
518,dark,sv3,7,0.9908552872969707,236,11,18,265
518,dark,sv3,8,0.992272386635725,273,11,14,298
518,dark,sv3,9,0.9922632541209085,295,13,16,324
533,bright,sv3,0,0.9944764049892986,204,220,2,426
533,bright,sv3,1,0.9934100781899874,163,224,3,390
533,bright,sv3,2,0.9949389796734697,160,244,5,409
533,bright,sv3,3,0.9935567138911814,147,232,4,383
533,bright,sv3,4,0.9946164785800361,163,223,3,389
533,bright,sv3,5,0.9936967372559582,197,204,1,402
533,bright,sv3,6,0.987111607634389,161,199,2,362
533,bright,sv3,7,0.987525923536784,183,179,1,363
533,bright,sv3,8,0.9911383193375368,184,232,2,418
533,bright,sv3,9,0.9941541378201753,176,237,3,416
548,dark,sv3,0,0.9875894270665385,289,23,34,346
548,dark,sv3,1,0.9865582270996767,269,15,32,316
548,dark,sv3,2,0.9865417228098764,293,16,26,335
548,dark,sv3,3,0.9932983345143807,272,18,26,316
548,dark,sv3,4,0.9920912471162221,292,17,18,327
548,dark,sv3,5,0.9819477748179586,276,19,28,323
548,dark,sv3,6,0.9908433147629314,276,12,25,313
548,dark,sv3,7,0.984619095777856,231,28,32,291
548,dark,sv3,8,0.9872762307710491,301,20,24,345
548,dark,sv3,9,0.9952268791461332,267,12,40,319
81114,dark,special,0,0.9830362562651362,108,10,30,148
81114,dark,special,1,0.9902103183255687,116,9,44,169
81114,dark,special,2,0.9553783424918594,102,11,38,151
81114,dark,special,3,0.9733189055670899,93,12,43,148
81114,dark,special,4,0.9729887389829571,98,13,47,158
81114,dark,special,5,0.9823791059325876,117,9,38,164
81114,dark,special,6,0.9928869946045374,88,12,36,136
81114,dark,special,7,0.9687063704530728,86,10,39,135
81114,dark,special,8,0.9780218857571132,97,10,27,134
81114,dark,special,9,0.9837252076825915,94,12,45,151
534,bright,sv3,0,0.9918976608540462,178,244,3,425
534,bright,sv3,1,0.9914902810109665,146,239,3,388
534,bright,sv3,2,0.9945005772578752,168,239,3,410
534,bright,sv3,3,0.9943551936869375,155,224,3,382
534,bright,sv3,4,0.9841535584295504,123,149,2,274
534,bright,sv3,5,0.9902448698923424,173,223,5,401
534,bright,sv3,6,0.9934306126620898,176,185,2,363
534,bright,sv3,7,0.9951064656916887,161,190,0,351
534,bright,sv3,8,0.9964955222801858,188,219,2,409
534,bright,sv3,9,0.9878713850297018,200,218,2,420
519,dark,sv3,0,0.9875194479276767,267,19,11,297
519,dark,sv3,1,0.9885707096550808,245,14,12,271
519,dark,sv3,2,0.9835270804207648,238,17,23,278
519,dark,sv3,3,0.9900336058382176,278,16,12,306
519,dark,sv3,4,0.9880753358252963,173,5,9,187
519,dark,sv3,5,0.9936847231966386,261,16,20,297
519,dark,sv3,6,0.9845333840390652,232,14,18,264
519,dark,sv3,7,0.988651917624905,220,14,27,261
519,dark,sv3,8,0.9861923782257671,250,14,22,286
519,dark,sv3,9,0.9896350760158928,275,13,19,307
549,dark,sv3,0,0.9904190877381694,274,20,24,318
549,dark,sv3,1,0.9876459897854004,277,16,26,319
549,dark,sv3,2,0.9886682297692688,274,22,20,316
549,dark,sv3,3,0.9951529934445938,257,18,21,296
549,dark,sv3,4,0.987860682269755,187,16,19,222
549,dark,sv3,5,0.9921120433312441,264,21,28,313
549,dark,sv3,6,0.9899149664776508,225,24,29,278
549,dark,sv3,7,0.9855602440296288,230,24,33,287
549,dark,sv3,8,0.9939721186700063,292,20,24,336
549,dark,sv3,9,0.9901634600349374,274,17,28,319
550,dark,sv3,0,0.9906018145829019,272,18,29,319
550,dark,sv3,1,0.9911586175103495,198,13,102,313
550,dark,sv3,2,0.992344234680624,279,13,28,320
550,dark,sv3,3,0.9837963055331446,270,17,21,308
550,dark,sv3,4,0.9827330415449694,224,15,12,251
550,dark,sv3,5,0.9840760130867338,270,18,23,311
550,dark,sv3,6,0.9878821238756721,217,24,19,260
550,dark,sv3,7,0.9940305587023996,222,35,20,277
550,dark,sv3,8,0.994521152443219,246,25,21,292
550,dark,sv3,9,0.991655513128465,256,18,17,291
520,dark,sv3,0,0.993374084322612,268,16,19,303
520,dark,sv3,1,0.9897769081938137,242,19,26,287
520,dark,sv3,2,0.9875810149090158,243,16,21,280
520,dark,sv3,3,0.992613897528128,257,14,20,291
520,dark,sv3,4,0.9950018610119948,245,16,17,278
520,dark,sv3,5,0.9871946870215307,253,16,23,292
520,dark,sv3,6,0.9796810776830535,230,21,14,265
520,dark,sv3,7,0.9785748633021508,219,12,13,244
520,dark,sv3,8,0.9864869573974808,248,16,10,274
520,dark,sv3,9,0.984759562835211,262,16,14,292
551,dark,sv3,0,0.9973151069743488,290,20,27,337
551,dark,sv3,1,0.9841221237211625,264,21,16,301
551,dark,sv3,2,0.9936732158682352,292,19,15,326
551,dark,sv3,3,0.989404744622272,257,23,26,306
551,dark,sv3,4,0.9805038979544215,231,18,10,259
551,dark,sv3,5,0.9885386522504115,265,19,26,310
551,dark,sv3,6,0.9881034091582331,246,17,24,287
551,dark,sv3,7,0.9802492771470999,221,26,29,276
551,dark,sv3,8,0.9918903198385165,272,30,27,329
551,dark,sv3,9,0.9923668061320976,263,14,33,310
49,bright,sv3,0,0.9928982236994758,237,143,2,382
49,bright,sv3,1,0.9890318904510578,187,151,2,340
49,bright,sv3,2,0.990754953938139,235,144,3,382
49,bright,sv3,3,0.9885636648872527,173,147,2,322
49,bright,sv3,4,0.9958983657606256,183,155,0,338
49,bright,sv3,5,0.9896744415498095,219,136,3,358
49,bright,sv3,6,0.9921193033262169,203,111,4,318
49,bright,sv3,7,0.9931374897608541,156,119,3,278
49,bright,sv3,8,0.9936713478042443,217,151,3,371
49,bright,sv3,9,0.9970891621495649,204,144,0,348
76,bright,sv3,0,0.9827783794690091,236,175,7,418
76,bright,sv3,1,0.9947870211724806,212,173,5,390
76,bright,sv3,2,0.9904070072852781,218,190,4,412
76,bright,sv3,3,0.9942673549908864,203,162,4,369
76,bright,sv3,4,0.9840125221704609,213,162,4,379
76,bright,sv3,5,0.9937465346254357,235,150,2,387
76,bright,sv3,6,0.9971729650535962,218,138,6,362
76,bright,sv3,7,0.9912960530087821,179,155,6,340
76,bright,sv3,8,0.9927510275542709,240,164,6,410
76,bright,sv3,9,0.9879984945841108,238,150,2,390
184,bright,sv3,0,0.9915725629433636,185,197,3,385
184,bright,sv3,1,0.99295900340455,198,165,5,368
184,bright,sv3,2,0.9888075316616433,218,190,5,413
184,bright,sv3,3,0.9875156411802883,196,165,2,363
184,bright,sv3,4,0.9919154264791579,203,169,4,376
184,bright,sv3,5,0.9964772929193555,203,170,3,376
184,bright,sv3,6,0.9892971857187339,185,149,2,336
184,bright,sv3,7,0.9896481331048931,179,152,1,332
184,bright,sv3,8,0.992510434540346,208,172,1,381
184,bright,sv3,9,0.9927444244096969,188,176,9,373
238,bright,sv3,0,0.9951085875116764,171,261,3,435
238,bright,sv3,1,0.9929476960818444,139,251,2,392
238,bright,sv3,2,0.9943174178286981,165,256,1,422
238,bright,sv3,3,0.9903127086793913,180,205,2,387
238,bright,sv3,4,0.9930436610785508,188,207,4,399
238,bright,sv3,5,0.9944769481065521,208,195,3,406
238,bright,sv3,6,0.992406467303848,164,202,4,370
238,bright,sv3,7,0.9894725748736386,142,210,1,353
238,bright,sv3,8,0.9941623806865931,164,252,3,419
238,bright,sv3,9,0.9956099998466237,182,234,3,419
265,bright,sv3,0,0.9870319985959722,156,277,0,433
265,bright,sv3,1,0.9965289238733651,162,237,1,400
265,bright,sv3,2,0.9945003364480957,182,234,3,419
265,bright,sv3,3,0.9928669023493248,165,227,4,396
265,bright,sv3,4,0.9947727336911788,188,218,2,408
265,bright,sv3,5,0.9930615090361488,156,250,2,408
265,bright,sv3,6,0.9921872718654616,141,230,1,372
265,bright,sv3,7,0.9901356743171265,143,217,0,360
265,bright,sv3,8,0.9871119448834335,152,270,2,424
265,bright,sv3,9,0.9950263871996559,154,265,7,426
346,bright,sv3,0,0.9884427023042903,187,236,1,424
346,bright,sv3,1,0.996797288574031,155,231,3,389
346,bright,sv3,2,0.9940979397072529,184,233,3,420
346,bright,sv3,3,0.9945638020626958,162,218,3,383
346,bright,sv3,4,0.9921907757955499,182,222,3,407
346,bright,sv3,5,0.9895825877123439,156,235,2,393
346,bright,sv3,6,0.9923253694658704,146,205,2,353
346,bright,sv3,7,0.9922663786840018,149,205,0,354
346,bright,sv3,8,0.987912509999606,208,204,2,414
346,bright,sv3,9,0.9925385046456756,181,237,6,424
373,bright,sv3,0,0.9922320236510952,191,234,3,428
373,bright,sv3,1,0.9952016845087462,205,190,1,396
373,bright,sv3,2,0.9943195381629619,218,210,2,430
373,bright,sv3,3,0.988636536177199,167,223,1,391
373,bright,sv3,4,0.9932173154547864,179,220,4,403
373,bright,sv3,5,0.9895680237737644,178,230,1,409
373,bright,sv3,6,0.9968471160965542,156,208,0,364
373,bright,sv3,7,0.9921040983638062,132,225,5,362
373,bright,sv3,8,0.9886501298787256,177,239,1,417
373,bright,sv3,9,0.9869528128987548,161,257,1,419
400,bright,sv3,0,0.9930463425256573,126,305,2,433
400,bright,sv3,1,0.994396531960008,138,257,1,396
400,bright,sv3,2,0.9971164512489065,145,278,4,427
400,bright,sv3,3,0.9899623217235716,133,263,0,396
400,bright,sv3,4,0.9882535686571213,105,296,4,405
400,bright,sv3,5,0.9900406676656809,116,291,3,410
400,bright,sv3,6,0.9941450572599598,83,281,0,364
400,bright,sv3,7,0.993227186664498,102,255,1,358
400,bright,sv3,8,0.9925921792007659,113,306,0,419
400,bright,sv3,9,0.9929080955146744,154,276,2,432
402,backup,sv3,0,0.9934437313488744,2,401,0,403
402,backup,sv3,1,0.9912725778312884,1,370,0,371
402,backup,sv3,2,0.9921098885649896,1,396,0,397
402,backup,sv3,3,0.9899086712096073,3,335,0,338
402,backup,sv3,4,0.992225871302163,0,363,1,364
402,backup,sv3,5,0.991163413173131,1,376,0,377
402,backup,sv3,6,0.9943853972819757,4,327,0,331
402,backup,sv3,7,0.9896035021380407,2,300,0,302
402,backup,sv3,8,0.9933338521058477,1,390,0,391
402,backup,sv3,9,0.9918416953354495,2,383,0,385
427,bright,sv3,0,0.994675548102245,133,308,2,443
427,bright,sv3,1,0.9934624567611342,121,277,2,400
427,bright,sv3,2,0.9932365913683281,136,285,3,424
427,bright,sv3,3,0.9921965473424572,142,245,1,388
427,bright,sv3,4,0.991300842770084,143,256,2,401
427,bright,sv3,5,0.9943424792629452,104,294,3,401
427,bright,sv3,6,0.991842017186184,101,259,0,360
427,bright,sv3,7,0.9937568066678178,110,253,1,364
427,bright,sv3,8,0.9940737561577115,120,305,0,425
427,bright,sv3,9,0.9886834420832062,123,301,2,426
504,bright,sv3,0,0.9894204206247055,240,156,4,400
504,bright,sv3,1,0.9784412497615289,213,149,6,368
504,bright,sv3,2,0.9923175941887218,245,142,6,393
504,bright,sv3,3,0.9917056326657129,242,133,2,377
504,bright,sv3,4,0.9885418487921299,258,118,8,384
504,bright,sv3,5,0.9875495915016392,228,146,4,378
504,bright,sv3,6,0.9851958590954896,221,114,2,337
504,bright,sv3,7,0.9928653232480876,214,125,4,343
504,bright,sv3,8,0.9886623261616642,262,136,5,403
504,bright,sv3,9,0.9938556916400585,264,135,4,403
506,backup,sv3,0,0.9907642179927624,3,295,4,302
506,backup,sv3,1,0.990712613042191,1,255,0,256
506,backup,sv3,2,0.9884855563094262,0,270,0,270
506,backup,sv3,3,0.9879133832642198,3,241,1,245
506,backup,sv3,4,0.986261770000834,3,241,2,246
506,backup,sv3,5,0.9908692939110225,2,253,2,257
506,backup,sv3,6,0.9827933968706378,2,252,1,255
506,backup,sv3,7,0.9880773969510814,1,218,1,220
506,backup,sv3,8,0.9820780469222016,3,279,1,283
506,backup,sv3,9,0.9825996258110937,5,254,2,261
565,bright,sv3,0,0.9883249358007681,138,300,5,443
565,bright,sv3,1,0.9913864078229281,124,273,4,401
565,bright,sv3,2,0.995188233076569,114,316,1,431
565,bright,sv3,3,0.9933359540910415,126,259,0,385
565,bright,sv3,4,0.9905403268046652,112,289,4,405
565,bright,sv3,5,0.9927814286965755,116,289,2,407
565,bright,sv3,6,0.9889055875751075,93,277,1,371
565,bright,sv3,7,0.9945110743191266,87,274,1,362
565,bright,sv3,8,0.9963847765690044,126,296,2,424
565,bright,sv3,9,0.9941053923221218,141,287,2,430
595,bright,sv3,0,0.9945187912897157,190,227,2,419
595,bright,sv3,1,0.9856548473617482,199,195,1,395
595,bright,sv3,2,0.989188643439342,199,207,7,413
595,bright,sv3,3,0.9780622718841697,188,189,5,382
595,bright,sv3,4,0.9883322931229294,145,232,3,380
595,bright,sv3,5,0.9922395593672307,181,203,2,386
595,bright,sv3,6,0.9892766005267635,154,194,3,351
595,bright,sv3,7,0.9924674123591252,136,203,4,343
595,bright,sv3,8,0.9875506311883465,184,218,4,406
595,bright,sv3,9,0.991811439979466,195,204,1,400
596,backup,sv3,0,0.9887870104321552,6,352,0,358
596,backup,sv3,1,0.9913886923955613,4,333,1,338
596,backup,sv3,2,0.9827305108637546,0,344,3,347
596,backup,sv3,3,0.9866563320737266,5,313,0,318
596,backup,sv3,4,0.9940196047702098,6,323,1,330
596,backup,sv3,5,0.9896994736330281,3,338,0,341
596,backup,sv3,6,0.9884583185887492,3,300,0,303
596,backup,sv3,7,0.9768103132768886,1,279,0,280
596,backup,sv3,8,0.9924239121593451,0,351,2,353
596,backup,sv3,9,0.9916176073979015,3,340,0,343
521,dark,sv3,0,0.9888462947551472,248,19,17,284
521,dark,sv3,1,0.986286641339493,235,14,11,260
521,dark,sv3,2,0.989346348168864,243,18,20,281
521,dark,sv3,3,0.9862595550771583,245,16,10,271
521,dark,sv3,4,0.9872145987734098,227,16,13,256
521,dark,sv3,5,0.9882502531299951,259,15,12,286
521,dark,sv3,6,0.9910264810374166,205,22,13,240
521,dark,sv3,7,0.9806432943119077,209,19,12,240
521,dark,sv3,8,0.9922204695724812,237,17,21,275
521,dark,sv3,9,0.9907929521046275,238,19,24,281
